node,degree,in_degree,out_degree,pagerank,interval_start,interval_end
18,2,1,1,0.031163961590191188,2019-03-11 21:15:00,2019-03-11 21:30:00
18,2,1,1,0.031163961590191188,2019-03-11 21:30:00,2019-03-11 21:45:00
18,2,1,1,0.031163961590191188,2019-03-11 21:45:00,2019-03-11 22:00:00
18,2,1,1,0.031163961590191188,2019-03-11 22:00:00,2019-03-11 22:15:00
196,8,4,4,0.031163961590191188,2019-03-15 10:15:00,2019-03-15 10:30:00
18,2,2,0,0.007780214528068985,2019-03-15 10:30:00,2019-03-15 10:45:00
196,12,5,7,0.01220907788976232,2019-03-15 10:30:00,2019-03-15 10:45:00
18,6,3,3,0.031163961590191188,2019-03-15 10:45:00,2019-03-15 11:00:00
18,3,1,2,0.008403129969889143,2019-03-15 11:00:00,2019-03-15 11:15:00
58,1,1,0,0.008403129969889143,2019-03-15 11:00:00,2019-03-15 11:15:00
18,2,0,2,0.00462493300539134,2019-03-15 11:15:00,2019-03-15 11:30:00
58,4,3,1,0.056513666900167014,2019-03-15 11:15:00,2019-03-15 11:30:00
58,6,2,4,0.008403129969889143,2019-03-15 11:30:00,2019-03-15 11:45:00
109,2,2,0,0.008403129969889143,2019-03-15 11:30:00,2019-03-15 11:45:00
58,2,0,2,0.00462493300539134,2019-03-15 11:45:00,2019-03-15 12:00:00
109,6,4,2,0.056513666900167014,2019-03-15 11:45:00,2019-03-15 12:00:00
109,6,3,3,0.031163961590191188,2019-03-15 12:00:00,2019-03-15 12:15:00
109,2,0,2,0.004857906588702999,2019-03-15 12:15:00,2019-03-15 12:30:00
196,2,2,0,0.008987055904586403,2019-03-15 12:15:00,2019-03-15 12:30:00
196,2,1,1,0.031163961590191188,2019-03-15 13:30:00,2019-03-15 13:45:00
114,8,5,3,0.056513666900167014,2019-03-18 13:00:00,2019-03-18 13:15:00
196,2,0,2,0.00462493300539134,2019-03-18 13:00:00,2019-03-18 13:15:00
114,6,3,3,0.031163961590191188,2019-03-18 13:15:00,2019-03-18 13:30:00
46,4,2,2,0.008918651314884705,2019-03-18 13:30:00,2019-03-18 13:45:00
112,2,0,2,0.004821022333877474,2019-03-18 13:30:00,2019-03-18 13:45:00
138,2,2,0,0.012413814907984053,2019-03-18 13:30:00,2019-03-18 13:45:00
119,1,1,0,0.008987055904586403,2019-03-18 13:45:00,2019-03-18 14:00:00
138,1,0,1,0.004857906588702999,2019-03-18 13:45:00,2019-03-18 14:00:00
119,2,0,2,0.004857906588702999,2019-03-18 14:00:00,2019-03-18 14:15:00
164,2,2,0,0.008987055904586403,2019-03-18 14:00:00,2019-03-18 14:15:00
164,2,1,1,0.031163961590191188,2019-03-18 14:15:00,2019-03-18 14:30:00
154,1,1,0,0.008987055904586403,2019-03-18 14:30:00,2019-03-18 14:45:00
164,1,0,1,0.004857906588702999,2019-03-18 14:30:00,2019-03-18 14:45:00
154,1,1,0,0.008987055904586403,2019-03-18 14:45:00,2019-03-18 15:00:00
196,1,0,1,0.004857906588702999,2019-03-18 14:45:00,2019-03-18 15:00:00
154,1,1,0,0.008987055904586403,2019-03-18 15:00:00,2019-03-18 15:15:00
196,1,0,1,0.004857906588702999,2019-03-18 15:00:00,2019-03-18 15:15:00
116,1,1,0,0.008987055904586403,2019-03-18 15:15:00,2019-03-18 15:30:00
154,1,0,1,0.004857906588702999,2019-03-18 15:15:00,2019-03-18 15:30:00
116,3,2,1,0.056513666900167014,2019-03-18 15:30:00,2019-03-18 15:45:00
154,1,0,1,0.00462493300539134,2019-03-18 15:30:00,2019-03-18 15:45:00
116,2,1,1,0.03103880199262298,2019-03-18 15:45:00,2019-03-18 16:00:00
127,1,0,1,0.004730099271074233,2019-03-18 15:45:00,2019-03-18 16:00:00
196,1,1,0,0.008751045979315475,2019-03-18 15:45:00,2019-03-18 16:00:00
127,1,0,1,0.004857906588702999,2019-03-18 16:00:00,2019-03-18 16:15:00
196,1,1,0,0.008987055904586403,2019-03-18 16:00:00,2019-03-18 16:15:00
70,1,1,0,0.008987055904586403,2019-03-19 10:30:00,2019-03-19 10:45:00
119,1,0,1,0.004857906588702999,2019-03-19 10:30:00,2019-03-19 10:45:00
70,1,1,0,0.008987055904586403,2019-03-19 10:45:00,2019-03-19 11:00:00
119,1,0,1,0.004857906588702999,2019-03-19 10:45:00,2019-03-19 11:00:00
67,1,1,0,0.012413814907984053,2019-03-19 11:00:00,2019-03-19 11:15:00
70,2,1,1,0.008918651314884705,2019-03-19 11:00:00,2019-03-19 11:15:00
119,1,0,1,0.004821022333877474,2019-03-19 11:00:00,2019-03-19 11:15:00
109,1,0,1,0.004857906588702999,2019-03-19 11:30:00,2019-03-19 11:45:00
112,1,1,0,0.008987055904586403,2019-03-19 11:30:00,2019-03-19 11:45:00
23,1,1,0,0.008987055904586403,2019-03-19 11:45:00,2019-03-19 12:00:00
147,1,0,1,0.004857906588702999,2019-03-19 11:45:00,2019-03-19 12:00:00
23,5,3,2,0.056513666900167014,2019-03-19 12:00:00,2019-03-19 12:15:00
147,1,0,1,0.00462493300539134,2019-03-19 12:00:00,2019-03-19 12:15:00
127,1,1,0,0.008987055904586403,2019-03-19 12:30:00,2019-03-19 12:45:00
196,1,0,1,0.004857906588702999,2019-03-19 12:30:00,2019-03-19 12:45:00
127,2,0,2,0.004857906588702999,2019-03-19 12:45:00,2019-03-19 13:00:00
196,2,2,0,0.008987055904586403,2019-03-19 12:45:00,2019-03-19 13:00:00
112,2,1,1,0.03103880199262298,2019-03-19 13:00:00,2019-03-19 13:15:00
127,2,0,2,0.004730099271074233,2019-03-19 13:00:00,2019-03-19 13:15:00
196,2,2,0,0.008751045979315475,2019-03-19 13:00:00,2019-03-19 13:15:00
127,2,0,2,0.004857906588702999,2019-03-19 13:15:00,2019-03-19 13:30:00
196,2,2,0,0.008987055904586403,2019-03-19 13:15:00,2019-03-19 13:30:00
127,2,0,2,0.004857906588702999,2019-03-19 13:30:00,2019-03-19 13:45:00
196,2,2,0,0.008987055904586403,2019-03-19 13:30:00,2019-03-19 13:45:00
127,2,0,2,0.004857906588702999,2019-03-19 13:45:00,2019-03-19 14:00:00
196,2,2,0,0.008987055904586403,2019-03-19 13:45:00,2019-03-19 14:00:00
127,2,0,2,0.004857906588702999,2019-03-19 14:00:00,2019-03-19 14:15:00
196,2,2,0,0.008987055904586403,2019-03-19 14:00:00,2019-03-19 14:15:00
46,1,1,0,0.008949889293538973,2019-03-19 14:15:00,2019-03-19 14:30:00
112,1,0,1,0.004837932125186799,2019-03-19 14:15:00,2019-03-19 14:30:00
127,2,0,2,0.004837932125186799,2019-03-19 14:15:00,2019-03-19 14:30:00
196,2,2,0,0.008949889293538973,2019-03-19 14:15:00,2019-03-19 14:30:00
46,1,1,0,0.008987055904586403,2019-03-19 14:30:00,2019-03-19 14:45:00
112,1,0,1,0.004857906588702999,2019-03-19 14:30:00,2019-03-19 14:45:00
46,3,1,2,0.008403129969889143,2019-03-19 14:45:00,2019-03-19 15:00:00
112,1,1,0,0.008403129969889143,2019-03-19 14:45:00,2019-03-19 15:00:00
46,1,0,1,0.004857906588702999,2019-03-19 15:00:00,2019-03-19 15:15:00
112,1,1,0,0.008987055904586403,2019-03-19 15:00:00,2019-03-19 15:15:00
46,1,0,1,0.004857906588702999,2019-03-19 15:15:00,2019-03-19 15:30:00
112,1,1,0,0.008987055904586403,2019-03-19 15:15:00,2019-03-19 15:30:00
46,1,0,1,0.004857906588702999,2019-03-19 15:30:00,2019-03-19 15:45:00
112,1,1,0,0.008987055904586403,2019-03-19 15:30:00,2019-03-19 15:45:00
46,1,0,1,0.004857906588702999,2019-03-19 15:45:00,2019-03-19 16:00:00
112,1,1,0,0.008987055904586403,2019-03-19 15:45:00,2019-03-19 16:00:00
46,1,0,1,0.004857906588702999,2019-03-19 16:00:00,2019-03-19 16:15:00
112,1,1,0,0.008987055904586403,2019-03-19 16:00:00,2019-03-19 16:15:00
5,2,1,1,0.031163961590191188,2019-03-20 08:15:00,2019-03-20 08:30:00
18,1,1,0,0.008987055904586403,2019-03-20 12:30:00,2019-03-20 12:45:00
196,1,0,1,0.004857906588702999,2019-03-20 12:30:00,2019-03-20 12:45:00
19,2,0,2,0.004857906588702999,2019-03-20 13:30:00,2019-03-20 13:45:00
113,1,1,0,0.0069224812466447015,2019-03-20 13:30:00,2019-03-20 13:45:00
196,1,1,0,0.0069224812466447015,2019-03-20 13:30:00,2019-03-20 13:45:00
19,3,0,3,0.004857906588702999,2019-03-20 13:45:00,2019-03-20 14:00:00
113,1,1,0,0.006234289693997468,2019-03-20 13:45:00,2019-03-20 14:00:00
196,2,2,0,0.007610672799291935,2019-03-20 13:45:00,2019-03-20 14:00:00
104,2,1,1,0.031163961590191188,2019-03-20 16:00:00,2019-03-20 16:15:00
104,2,1,1,0.031163961590191188,2019-03-20 16:15:00,2019-03-20 16:30:00
162,2,1,1,0.031163961590191188,2019-03-20 19:30:00,2019-03-20 19:45:00
162,2,1,1,0.031163961590191188,2019-03-20 20:15:00,2019-03-20 20:30:00
26,2,1,1,0.031163961590191188,2019-03-20 21:00:00,2019-03-20 21:15:00
162,2,1,1,0.031163961590191188,2019-03-20 22:15:00,2019-03-20 22:30:00
162,2,1,1,0.031163961590191188,2019-03-20 22:30:00,2019-03-20 22:45:00
151,6,3,3,0.031163961590191188,2019-03-21 12:15:00,2019-03-21 12:30:00
151,4,2,2,0.031163961590191188,2019-03-21 12:30:00,2019-03-21 12:45:00
196,4,2,2,0.031163961590191188,2019-03-21 12:45:00,2019-03-21 13:00:00
196,2,1,1,0.031163961590191188,2019-03-21 13:00:00,2019-03-21 13:15:00
196,4,2,2,0.031163961590191188,2019-03-21 13:15:00,2019-03-21 13:30:00
196,16,8,8,0.031163961590191188,2019-03-21 13:30:00,2019-03-21 13:45:00
18,7,5,2,0.055265503678372886,2019-03-21 13:45:00,2019-03-21 14:00:00
196,5,1,4,0.005873096227185463,2019-03-21 13:45:00,2019-03-21 14:00:00
18,14,7,7,0.03056929995277917,2019-03-21 14:00:00,2019-03-21 14:15:00
196,2,1,1,0.03056929995277917,2019-03-21 14:00:00,2019-03-21 14:15:00
18,24,12,12,0.03056929995277917,2019-03-21 14:15:00,2019-03-21 14:30:00
196,2,1,1,0.03056929995277917,2019-03-21 14:15:00,2019-03-21 14:30:00
18,13,4,9,0.007433432856556677,2019-03-21 14:30:00,2019-03-21 14:45:00
196,7,6,1,0.053705167049001676,2019-03-21 14:30:00,2019-03-21 14:45:00
18,5,0,5,0.00462493300539134,2019-03-21 14:45:00,2019-03-21 15:00:00
196,7,6,1,0.056513666900167014,2019-03-21 14:45:00,2019-03-21 15:00:00
127,1,1,0,0.008987055904586403,2019-03-22 10:15:00,2019-03-22 10:30:00
196,1,0,1,0.004857906588702999,2019-03-22 10:15:00,2019-03-22 10:30:00
18,2,2,0,0.008661735290240702,2019-03-22 10:30:00,2019-03-22 10:45:00
127,4,1,3,0.006755947244787761,2019-03-22 10:30:00,2019-03-22 10:45:00
18,4,2,2,0.031163961590191188,2019-03-22 10:45:00,2019-03-22 11:00:00
18,2,1,1,0.031163961590191188,2019-03-22 11:00:00,2019-03-22 11:15:00
18,2,1,1,0.031163961590191188,2019-03-22 11:15:00,2019-03-22 11:30:00
18,12,6,6,0.031163961590191188,2019-03-22 11:30:00,2019-03-22 11:45:00
18,4,2,2,0.031163961590191188,2019-03-22 11:45:00,2019-03-22 12:00:00
119,2,2,0,0.008987055904586403,2019-03-22 12:45:00,2019-03-22 13:00:00
196,2,0,2,0.004857906588702999,2019-03-22 12:45:00,2019-03-22 13:00:00
119,8,5,3,0.056513666900167014,2019-03-22 13:00:00,2019-03-22 13:15:00
196,2,0,2,0.00462493300539134,2019-03-22 13:00:00,2019-03-22 13:15:00
119,2,1,1,0.031163961590191188,2019-03-22 13:15:00,2019-03-22 13:30:00
119,4,2,2,0.031163961590191188,2019-03-22 13:45:00,2019-03-22 14:00:00
119,4,0,4,0.004857906588702999,2019-03-22 14:00:00,2019-03-22 14:15:00
196,4,4,0,0.008987055904586403,2019-03-22 14:00:00,2019-03-22 14:15:00
113,1,1,0,0.012413814907984053,2019-03-22 14:15:00,2019-03-22 14:30:00
119,4,0,4,0.004821022333877474,2019-03-22 14:15:00,2019-03-22 14:30:00
196,5,4,1,0.008918651314884705,2019-03-22 14:15:00,2019-03-22 14:30:00
119,1,0,1,0.004857906588702999,2019-03-22 14:30:00,2019-03-22 14:45:00
196,1,1,0,0.008987055904586403,2019-03-22 14:30:00,2019-03-22 14:45:00
119,1,0,1,0.00462493300539134,2019-03-22 14:45:00,2019-03-22 15:00:00
196,9,5,4,0.056513666900167014,2019-03-22 14:45:00,2019-03-22 15:00:00
196,10,5,5,0.031163961590191188,2019-03-22 15:00:00,2019-03-22 15:15:00
119,5,5,0,0.007672836962386735,2019-03-22 15:15:00,2019-03-22 15:30:00
196,33,14,19,0.012798467375511553,2019-03-22 15:15:00,2019-03-22 15:30:00
26,1,0,1,0.004837932125186799,2019-03-22 15:30:00,2019-03-22 15:45:00
104,1,1,0,0.008949889293538973,2019-03-22 15:30:00,2019-03-22 15:45:00
119,5,5,0,0.008949889293538973,2019-03-22 15:30:00,2019-03-22 15:45:00
196,5,0,5,0.004837932125186799,2019-03-22 15:30:00,2019-03-22 15:45:00
26,1,0,1,0.004606821559903428,2019-03-22 15:45:00,2019-03-22 16:00:00
104,1,1,0,0.008523006079501598,2019-03-22 15:45:00,2019-03-22 16:00:00
119,7,5,2,0.05629221726010927,2019-03-22 15:45:00,2019-03-22 16:00:00
196,3,0,3,0.004606821559903428,2019-03-22 15:45:00,2019-03-22 16:00:00
119,5,4,1,0.056513666900167014,2019-03-22 16:00:00,2019-03-22 16:15:00
196,3,0,3,0.00462493300539134,2019-03-22 16:00:00,2019-03-22 16:15:00
119,5,4,1,0.056513666900167014,2019-03-22 16:15:00,2019-03-22 16:30:00
196,3,0,3,0.00462493300539134,2019-03-22 16:15:00,2019-03-22 16:30:00
119,4,0,4,0.004857906588702999,2019-03-22 16:30:00,2019-03-22 16:45:00
196,4,4,0,0.008987055904586403,2019-03-22 16:30:00,2019-03-22 16:45:00
119,4,0,4,0.004857906588702999,2019-03-22 16:45:00,2019-03-22 17:00:00
196,4,4,0,0.008987055904586403,2019-03-22 16:45:00,2019-03-22 17:00:00
151,2,1,1,0.031163961590191188,2019-03-22 18:30:00,2019-03-22 18:45:00
151,2,1,1,0.031163961590191188,2019-03-22 18:45:00,2019-03-22 19:00:00
18,1,1,0,0.008987055904586403,2019-03-22 23:45:00,2019-03-23 00:00:00
153,1,0,1,0.004857906588702999,2019-03-22 23:45:00,2019-03-23 00:00:00
15,6,3,3,0.030449519410006357,2019-03-23 00:00:00,2019-03-23 00:15:00
16,1,0,1,0.004606821559903428,2019-03-23 00:00:00,2019-03-23 00:15:00
20,2,1,1,0.030449519410006357,2019-03-23 00:00:00,2019-03-23 00:15:00
104,1,1,0,0.008523006079501598,2019-03-23 00:00:00,2019-03-23 00:15:00
15,6,3,3,0.030462158704084197,2019-03-23 00:15:00,2019-03-23 00:30:00
16,1,0,1,0.004655633981730945,2019-03-23 00:15:00,2019-03-23 00:30:00
18,1,0,1,0.004655633981730945,2019-03-23 00:15:00,2019-03-23 00:30:00
27,1,0,1,0.004655633981730945,2019-03-23 00:15:00,2019-03-23 00:30:00
28,1,1,0,0.008613335786292085,2019-03-23 00:15:00,2019-03-23 00:30:00
58,1,1,0,0.008613335786292085,2019-03-23 00:15:00,2019-03-23 00:30:00
67,1,1,0,0.008613335786292085,2019-03-23 00:15:00,2019-03-23 00:30:00
88,1,0,1,0.004655633981730945,2019-03-23 00:15:00,2019-03-23 00:30:00
104,1,1,0,0.008613335786292085,2019-03-23 00:15:00,2019-03-23 00:30:00
138,1,0,1,0.004655633981730945,2019-03-23 00:15:00,2019-03-23 00:30:00
197,1,1,0,0.008613335786292085,2019-03-23 00:15:00,2019-03-23 00:30:00
27,1,0,1,0.0046372802150000175,2019-03-23 00:30:00,2019-03-23 00:45:00
28,1,1,0,0.008579377591766347,2019-03-23 00:30:00,2019-03-23 00:45:00
57,1,0,1,0.0046372802150000175,2019-03-23 00:30:00,2019-03-23 00:45:00
67,1,1,0,0.008579377591766347,2019-03-23 00:30:00,2019-03-23 00:45:00
68,1,0,1,0.0046372802150000175,2019-03-23 00:30:00,2019-03-23 00:45:00
88,1,0,1,0.0046372802150000175,2019-03-23 00:30:00,2019-03-23 00:45:00
104,2,1,1,0.030342251879397833,2019-03-23 00:30:00,2019-03-23 00:45:00
112,1,0,1,0.0046372802150000175,2019-03-23 00:30:00,2019-03-23 00:45:00
118,1,1,0,0.008579377591766347,2019-03-23 00:30:00,2019-03-23 00:45:00
138,1,0,1,0.0046372802150000175,2019-03-23 00:30:00,2019-03-23 00:45:00
164,1,1,0,0.008579377591766347,2019-03-23 00:30:00,2019-03-23 00:45:00
171,1,1,0,0.008579377591766347,2019-03-23 00:30:00,2019-03-23 00:45:00
197,1,1,0,0.008579377591766347,2019-03-23 00:30:00,2019-03-23 00:45:00
57,1,0,1,0.00455332850147198,2019-03-23 00:45:00,2019-03-23 01:00:00
67,1,1,0,0.008424034146636145,2019-03-23 00:45:00,2019-03-23 01:00:00
68,1,0,1,0.00455332850147198,2019-03-23 00:45:00,2019-03-23 01:00:00
88,1,0,1,0.00455332850147198,2019-03-23 00:45:00,2019-03-23 01:00:00
104,2,1,1,0.03009574581026738,2019-03-23 00:45:00,2019-03-23 01:00:00
112,1,0,1,0.00455332850147198,2019-03-23 00:45:00,2019-03-23 01:00:00
118,1,1,0,0.008424034146636145,2019-03-23 00:45:00,2019-03-23 01:00:00
126,2,1,1,0.03009574581026738,2019-03-23 00:45:00,2019-03-23 01:00:00
164,1,1,0,0.008424034146636145,2019-03-23 00:45:00,2019-03-23 01:00:00
171,1,1,0,0.008424034146636145,2019-03-23 00:45:00,2019-03-23 01:00:00
1,4,1,3,0.006563559600414819,2019-03-23 01:00:00,2019-03-23 01:15:00
16,1,0,1,0.004703705274703731,2019-03-23 01:00:00,2019-03-23 01:15:00
30,2,2,0,0.008423413926125906,2019-03-23 01:00:00,2019-03-23 01:15:00
58,1,1,0,0.008702212102115931,2019-03-23 01:00:00,2019-03-23 01:15:00
126,2,1,1,0.030866054155892143,2019-03-23 01:00:00,2019-03-23 01:15:00
1,2,0,2,0.004781889030446655,2019-03-23 01:15:00,2019-03-23 01:30:00
16,3,2,1,0.008846454948781574,2019-03-23 01:15:00,2019-03-23 01:30:00
18,2,0,2,0.004781889030446655,2019-03-23 01:15:00,2019-03-23 01:30:00
30,2,2,0,0.008846454948781574,2019-03-23 01:15:00,2019-03-23 01:30:00
58,1,1,0,0.012300940033879014,2019-03-23 01:15:00,2019-03-23 01:30:00
137,2,0,2,0.004781889030446655,2019-03-23 01:15:00,2019-03-23 01:30:00
138,2,2,0,0.008846454948781574,2019-03-23 01:15:00,2019-03-23 01:30:00
16,2,2,0,0.0088771775537988,2019-03-23 01:30:00,2019-03-23 01:45:00
18,2,0,2,0.004798464128282619,2019-03-23 01:30:00,2019-03-23 01:45:00
120,1,1,0,0.0088771775537988,2019-03-23 01:30:00,2019-03-23 01:45:00
127,1,0,1,0.004798464128282619,2019-03-23 01:30:00,2019-03-23 01:45:00
137,2,0,2,0.004798464128282619,2019-03-23 01:30:00,2019-03-23 01:45:00
138,2,2,0,0.0088771775537988,2019-03-23 01:30:00,2019-03-23 01:45:00
141,1,0,1,0.004798464128282619,2019-03-23 01:30:00,2019-03-23 01:45:00
203,1,1,0,0.0088771775537988,2019-03-23 01:30:00,2019-03-23 01:45:00
109,2,0,2,0.004837932125186799,2019-03-23 01:45:00,2019-03-23 02:00:00
114,2,2,0,0.008949889293538973,2019-03-23 01:45:00,2019-03-23 02:00:00
127,1,0,1,0.004837932125186799,2019-03-23 01:45:00,2019-03-23 02:00:00
203,1,1,0,0.008949889293538973,2019-03-23 01:45:00,2019-03-23 02:00:00
15,4,2,2,0.030583016964900303,2019-03-23 02:00:00,2019-03-23 02:15:00
90,1,1,0,0.008647563925333808,2019-03-23 02:00:00,2019-03-23 02:15:00
99,1,1,0,0.008647563925333808,2019-03-23 02:00:00,2019-03-23 02:15:00
109,2,0,2,0.004674133636668848,2019-03-23 02:00:00,2019-03-23 02:15:00
114,2,2,0,0.008647563925333808,2019-03-23 02:00:00,2019-03-23 02:15:00
116,1,1,0,0.008647563925333808,2019-03-23 02:00:00,2019-03-23 02:15:00
164,1,0,1,0.004674133636668848,2019-03-23 02:00:00,2019-03-23 02:15:00
173,1,0,1,0.004674133636668848,2019-03-23 02:00:00,2019-03-23 02:15:00
196,1,0,1,0.004674133636668848,2019-03-23 02:00:00,2019-03-23 02:15:00
15,4,2,2,0.030583016964900303,2019-03-23 02:15:00,2019-03-23 02:30:00
58,2,2,0,0.008647563925333808,2019-03-23 02:15:00,2019-03-23 02:30:00
90,1,1,0,0.008647563925333808,2019-03-23 02:15:00,2019-03-23 02:30:00
99,1,1,0,0.008647563925333808,2019-03-23 02:15:00,2019-03-23 02:30:00
109,2,0,2,0.004674133636668848,2019-03-23 02:15:00,2019-03-23 02:30:00
114,2,2,0,0.008647563925333808,2019-03-23 02:15:00,2019-03-23 02:30:00
158,2,0,2,0.004674133636668848,2019-03-23 02:15:00,2019-03-23 02:30:00
164,1,0,1,0.004674133636668848,2019-03-23 02:15:00,2019-03-23 02:30:00
173,1,0,1,0.004674133636668848,2019-03-23 02:15:00,2019-03-23 02:30:00
61,1,1,0,0.008877177553798802,2019-03-23 02:30:00,2019-03-23 02:45:00
90,1,1,0,0.008877177553798802,2019-03-23 02:30:00,2019-03-23 02:45:00
99,1,1,0,0.008877177553798802,2019-03-23 02:30:00,2019-03-23 02:45:00
109,2,0,2,0.004798464128282619,2019-03-23 02:30:00,2019-03-23 02:45:00
114,2,2,0,0.008877177553798802,2019-03-23 02:30:00,2019-03-23 02:45:00
164,1,0,1,0.004798464128282619,2019-03-23 02:30:00,2019-03-23 02:45:00
172,1,0,1,0.004798464128282619,2019-03-23 02:30:00,2019-03-23 02:45:00
173,1,0,1,0.004798464128282619,2019-03-23 02:30:00,2019-03-23 02:45:00
61,1,1,0,0.008949889293538972,2019-03-23 02:45:00,2019-03-23 03:00:00
90,1,1,0,0.008949889293538972,2019-03-23 02:45:00,2019-03-23 03:00:00
164,1,0,1,0.004837932125186798,2019-03-23 02:45:00,2019-03-23 03:00:00
172,1,0,1,0.004837932125186798,2019-03-23 02:45:00,2019-03-23 03:00:00
5,1,1,0,0.008906146489072444,2019-03-23 03:00:00,2019-03-23 03:15:00
16,6,1,5,0.00579939144467484,2019-03-23 03:00:00,2019-03-23 03:15:00
23,1,0,1,0.004814094695951926,2019-03-23 03:00:00,2019-03-23 03:15:00
90,1,1,0,0.008906146489072444,2019-03-23 03:00:00,2019-03-23 03:15:00
141,4,4,0,0.008755281690843579,2019-03-23 03:00:00,2019-03-23 03:15:00
164,1,0,1,0.004814094695951926,2019-03-23 03:00:00,2019-03-23 03:15:00
2,1,1,0,0.008810650146251556,2019-03-23 03:15:00,2019-03-23 03:30:00
5,1,1,0,0.008810650146251556,2019-03-23 03:15:00,2019-03-23 03:30:00
16,4,0,4,0.0047625316609125595,2019-03-23 03:15:00,2019-03-23 03:30:00
23,1,0,1,0.0047625316609125595,2019-03-23 03:15:00,2019-03-23 03:30:00
90,1,1,0,0.008810650146251556,2019-03-23 03:15:00,2019-03-23 03:30:00
120,1,0,1,0.0047625316609125595,2019-03-23 03:15:00,2019-03-23 03:30:00
140,4,4,0,0.012251067232480723,2019-03-23 03:15:00,2019-03-23 03:30:00
141,8,4,4,0.008810650146251556,2019-03-23 03:15:00,2019-03-23 03:30:00
164,1,0,1,0.0047625316609125595,2019-03-23 03:15:00,2019-03-23 03:30:00
2,1,1,0,0.0088771775537988,2019-03-23 03:30:00,2019-03-23 03:45:00
5,1,1,0,0.0088771775537988,2019-03-23 03:30:00,2019-03-23 03:45:00
23,1,0,1,0.004798464128282619,2019-03-23 03:30:00,2019-03-23 03:45:00
90,1,1,0,0.0088771775537988,2019-03-23 03:30:00,2019-03-23 03:45:00
120,1,0,1,0.004798464128282619,2019-03-23 03:30:00,2019-03-23 03:45:00
140,4,4,0,0.0088771775537988,2019-03-23 03:30:00,2019-03-23 03:45:00
141,4,0,4,0.004798464128282619,2019-03-23 03:30:00,2019-03-23 03:45:00
164,1,0,1,0.004798464128282619,2019-03-23 03:30:00,2019-03-23 03:45:00
1,2,2,0,0.008805391265007892,2019-03-23 03:45:00,2019-03-23 04:00:00
5,1,1,0,0.008805391265007892,2019-03-23 03:45:00,2019-03-23 04:00:00
19,1,0,1,0.004759636444271105,2019-03-23 03:45:00,2019-03-23 04:00:00
23,1,0,1,0.004759636444271105,2019-03-23 03:45:00,2019-03-23 04:00:00
88,2,2,0,0.008805391265007892,2019-03-23 03:45:00,2019-03-23 04:00:00
90,1,1,0,0.008805391265007892,2019-03-23 03:45:00,2019-03-23 04:00:00
137,3,0,3,0.004759636444271105,2019-03-23 03:45:00,2019-03-23 04:00:00
138,2,0,2,0.004759636444271105,2019-03-23 03:45:00,2019-03-23 04:00:00
164,1,0,1,0.004759636444271105,2019-03-23 03:45:00,2019-03-23 04:00:00
168,3,3,0,0.008805391265007892,2019-03-23 03:45:00,2019-03-23 04:00:00
190,2,0,2,0.004759636444271105,2019-03-23 03:45:00,2019-03-23 04:00:00
191,1,1,0,0.008805391265007892,2019-03-23 03:45:00,2019-03-23 04:00:00
1,2,2,0,0.008775135004045597,2019-03-23 04:00:00,2019-03-23 04:15:00
5,1,1,0,0.008775135004045597,2019-03-23 04:00:00,2019-03-23 04:15:00
23,1,0,1,0.004743330249772313,2019-03-23 04:00:00,2019-03-23 04:15:00
88,2,2,0,0.008775135004045597,2019-03-23 04:00:00,2019-03-23 04:15:00
90,1,1,0,0.008775135004045597,2019-03-23 04:00:00,2019-03-23 04:15:00
137,4,1,3,0.008775135004045597,2019-03-23 04:00:00,2019-03-23 04:15:00
138,2,0,2,0.004743330249772313,2019-03-23 04:00:00,2019-03-23 04:15:00
158,1,0,1,0.004743330249772313,2019-03-23 04:00:00,2019-03-23 04:15:00
164,1,0,1,0.004743330249772313,2019-03-23 04:00:00,2019-03-23 04:15:00
168,3,3,0,0.012201605275080553,2019-03-23 04:00:00,2019-03-23 04:15:00
190,2,0,2,0.004743330249772313,2019-03-23 04:00:00,2019-03-23 04:15:00
1,2,2,0,0.0088771775537988,2019-03-23 04:15:00,2019-03-23 04:30:00
5,1,1,0,0.0088771775537988,2019-03-23 04:15:00,2019-03-23 04:30:00
23,1,0,1,0.004798464128282619,2019-03-23 04:15:00,2019-03-23 04:30:00
90,1,1,0,0.0088771775537988,2019-03-23 04:15:00,2019-03-23 04:30:00
137,1,1,0,0.0088771775537988,2019-03-23 04:15:00,2019-03-23 04:30:00
158,1,0,1,0.004798464128282619,2019-03-23 04:15:00,2019-03-23 04:30:00
164,1,0,1,0.004798464128282619,2019-03-23 04:15:00,2019-03-23 04:30:00
190,2,0,2,0.004798464128282619,2019-03-23 04:15:00,2019-03-23 04:30:00
1,2,2,0,0.0088771775537988,2019-03-23 04:30:00,2019-03-23 04:45:00
5,1,1,0,0.0088771775537988,2019-03-23 04:30:00,2019-03-23 04:45:00
23,1,0,1,0.004798464128282619,2019-03-23 04:30:00,2019-03-23 04:45:00
90,1,1,0,0.0088771775537988,2019-03-23 04:30:00,2019-03-23 04:45:00
137,1,1,0,0.0088771775537988,2019-03-23 04:30:00,2019-03-23 04:45:00
158,1,0,1,0.004798464128282619,2019-03-23 04:30:00,2019-03-23 04:45:00
164,1,0,1,0.004798464128282619,2019-03-23 04:30:00,2019-03-23 04:45:00
190,2,0,2,0.004798464128282619,2019-03-23 04:30:00,2019-03-23 04:45:00
1,2,2,0,0.0088771775537988,2019-03-23 04:45:00,2019-03-23 05:00:00
5,1,1,0,0.0088771775537988,2019-03-23 04:45:00,2019-03-23 05:00:00
23,1,0,1,0.004798464128282619,2019-03-23 04:45:00,2019-03-23 05:00:00
90,1,1,0,0.0088771775537988,2019-03-23 04:45:00,2019-03-23 05:00:00
137,1,1,0,0.0088771775537988,2019-03-23 04:45:00,2019-03-23 05:00:00
158,1,0,1,0.004798464128282619,2019-03-23 04:45:00,2019-03-23 05:00:00
164,1,0,1,0.004798464128282619,2019-03-23 04:45:00,2019-03-23 05:00:00
190,2,0,2,0.004798464128282619,2019-03-23 04:45:00,2019-03-23 05:00:00
1,2,2,0,0.0088771775537988,2019-03-23 05:00:00,2019-03-23 05:15:00
5,1,1,0,0.0088771775537988,2019-03-23 05:00:00,2019-03-23 05:15:00
23,1,0,1,0.004798464128282619,2019-03-23 05:00:00,2019-03-23 05:15:00
90,1,1,0,0.0088771775537988,2019-03-23 05:00:00,2019-03-23 05:15:00
137,1,1,0,0.0088771775537988,2019-03-23 05:00:00,2019-03-23 05:15:00
158,1,0,1,0.004798464128282619,2019-03-23 05:00:00,2019-03-23 05:15:00
164,1,0,1,0.004798464128282619,2019-03-23 05:00:00,2019-03-23 05:15:00
190,2,0,2,0.004798464128282619,2019-03-23 05:00:00,2019-03-23 05:15:00
1,2,2,0,0.0088771775537988,2019-03-23 05:15:00,2019-03-23 05:30:00
5,1,1,0,0.0088771775537988,2019-03-23 05:15:00,2019-03-23 05:30:00
23,1,0,1,0.004798464128282619,2019-03-23 05:15:00,2019-03-23 05:30:00
90,1,1,0,0.0088771775537988,2019-03-23 05:15:00,2019-03-23 05:30:00
116,1,1,0,0.0088771775537988,2019-03-23 05:15:00,2019-03-23 05:30:00
126,1,0,1,0.004798464128282619,2019-03-23 05:15:00,2019-03-23 05:30:00
164,1,0,1,0.004798464128282619,2019-03-23 05:15:00,2019-03-23 05:30:00
190,2,0,2,0.004798464128282619,2019-03-23 05:15:00,2019-03-23 05:30:00
1,2,2,0,0.0088771775537988,2019-03-23 05:30:00,2019-03-23 05:45:00
5,1,1,0,0.0088771775537988,2019-03-23 05:30:00,2019-03-23 05:45:00
23,1,0,1,0.004798464128282619,2019-03-23 05:30:00,2019-03-23 05:45:00
90,1,1,0,0.0088771775537988,2019-03-23 05:30:00,2019-03-23 05:45:00
116,1,1,0,0.0088771775537988,2019-03-23 05:30:00,2019-03-23 05:45:00
126,1,0,1,0.004798464128282619,2019-03-23 05:30:00,2019-03-23 05:45:00
164,1,0,1,0.004798464128282619,2019-03-23 05:30:00,2019-03-23 05:45:00
190,2,0,2,0.004798464128282619,2019-03-23 05:30:00,2019-03-23 05:45:00
1,2,2,0,0.008913522582695454,2019-03-23 05:45:00,2019-03-23 06:00:00
5,1,1,0,0.008913522582695454,2019-03-23 05:45:00,2019-03-23 06:00:00
23,1,0,1,0.004818116001247109,2019-03-23 05:45:00,2019-03-23 06:00:00
90,1,1,0,0.008913522582695454,2019-03-23 05:45:00,2019-03-23 06:00:00
164,1,0,1,0.004818116001247109,2019-03-23 05:45:00,2019-03-23 06:00:00
190,2,0,2,0.004818116001247109,2019-03-23 05:45:00,2019-03-23 06:00:00
1,2,2,0,0.008877177553798802,2019-03-23 06:00:00,2019-03-23 06:15:00
5,1,1,0,0.008877177553798802,2019-03-23 06:00:00,2019-03-23 06:15:00
16,1,0,1,0.0047984641282826195,2019-03-23 06:00:00,2019-03-23 06:15:00
18,1,1,0,0.008877177553798802,2019-03-23 06:00:00,2019-03-23 06:15:00
23,1,0,1,0.0047984641282826195,2019-03-23 06:00:00,2019-03-23 06:15:00
90,1,1,0,0.008877177553798802,2019-03-23 06:00:00,2019-03-23 06:15:00
164,1,0,1,0.0047984641282826195,2019-03-23 06:00:00,2019-03-23 06:15:00
190,2,0,2,0.0047984641282826195,2019-03-23 06:00:00,2019-03-23 06:15:00
1,2,2,0,0.008913522582695454,2019-03-23 06:15:00,2019-03-23 06:30:00
5,1,1,0,0.008913522582695454,2019-03-23 06:15:00,2019-03-23 06:30:00
23,1,0,1,0.004818116001247109,2019-03-23 06:15:00,2019-03-23 06:30:00
90,1,1,0,0.008913522582695454,2019-03-23 06:15:00,2019-03-23 06:30:00
164,1,0,1,0.004818116001247109,2019-03-23 06:15:00,2019-03-23 06:30:00
190,2,0,2,0.004818116001247109,2019-03-23 06:15:00,2019-03-23 06:30:00
1,2,2,0,0.008913522582695454,2019-03-23 06:30:00,2019-03-23 06:45:00
5,1,1,0,0.008913522582695454,2019-03-23 06:30:00,2019-03-23 06:45:00
23,1,0,1,0.004818116001247109,2019-03-23 06:30:00,2019-03-23 06:45:00
90,1,1,0,0.008913522582695454,2019-03-23 06:30:00,2019-03-23 06:45:00
164,1,0,1,0.004818116001247109,2019-03-23 06:30:00,2019-03-23 06:45:00
190,2,0,2,0.004818116001247109,2019-03-23 06:30:00,2019-03-23 06:45:00
1,2,2,0,0.008913522582695454,2019-03-23 06:45:00,2019-03-23 07:00:00
5,1,1,0,0.008913522582695454,2019-03-23 06:45:00,2019-03-23 07:00:00
23,1,0,1,0.004818116001247109,2019-03-23 06:45:00,2019-03-23 07:00:00
90,1,1,0,0.008913522582695454,2019-03-23 06:45:00,2019-03-23 07:00:00
164,1,0,1,0.004818116001247109,2019-03-23 06:45:00,2019-03-23 07:00:00
190,2,0,2,0.004818116001247109,2019-03-23 06:45:00,2019-03-23 07:00:00
1,2,2,0,0.008913522582695454,2019-03-23 07:00:00,2019-03-23 07:15:00
5,1,1,0,0.008913522582695454,2019-03-23 07:00:00,2019-03-23 07:15:00
23,1,0,1,0.004818116001247109,2019-03-23 07:00:00,2019-03-23 07:15:00
90,1,1,0,0.008913522582695454,2019-03-23 07:00:00,2019-03-23 07:15:00
164,1,0,1,0.004818116001247109,2019-03-23 07:00:00,2019-03-23 07:15:00
190,2,0,2,0.004818116001247109,2019-03-23 07:00:00,2019-03-23 07:15:00
1,2,2,0,0.008913522582695454,2019-03-23 07:15:00,2019-03-23 07:30:00
5,1,1,0,0.008913522582695454,2019-03-23 07:15:00,2019-03-23 07:30:00
23,1,0,1,0.004818116001247109,2019-03-23 07:15:00,2019-03-23 07:30:00
90,1,1,0,0.008913522582695454,2019-03-23 07:15:00,2019-03-23 07:30:00
164,1,0,1,0.004818116001247109,2019-03-23 07:15:00,2019-03-23 07:30:00
190,2,0,2,0.004818116001247109,2019-03-23 07:15:00,2019-03-23 07:30:00
1,2,2,0,0.008913522582695454,2019-03-23 07:30:00,2019-03-23 07:45:00
5,1,1,0,0.008913522582695454,2019-03-23 07:30:00,2019-03-23 07:45:00
23,1,0,1,0.004818116001247109,2019-03-23 07:30:00,2019-03-23 07:45:00
90,1,1,0,0.008913522582695454,2019-03-23 07:30:00,2019-03-23 07:45:00
164,1,0,1,0.004818116001247109,2019-03-23 07:30:00,2019-03-23 07:45:00
190,2,0,2,0.004818116001247109,2019-03-23 07:30:00,2019-03-23 07:45:00
1,2,2,0,0.008800527647513847,2019-03-23 07:45:00,2019-03-23 08:00:00
5,1,1,0,0.008800527647513847,2019-03-23 07:45:00,2019-03-23 08:00:00
23,1,0,1,0.0047570782978519355,2019-03-23 07:45:00,2019-03-23 08:00:00
57,1,1,0,0.006104894747739239,2019-03-23 07:45:00,2019-03-23 08:00:00
90,3,2,1,0.01014834409740115,2019-03-23 07:45:00,2019-03-23 08:00:00
111,1,1,0,0.006104894747739239,2019-03-23 07:45:00,2019-03-23 08:00:00
137,1,1,0,0.0133822298395566,2019-03-23 07:45:00,2019-03-23 08:00:00
164,3,0,3,0.0047570782978519355,2019-03-23 07:45:00,2019-03-23 08:00:00
190,2,0,2,0.0047570782978519355,2019-03-23 07:45:00,2019-03-23 08:00:00
201,1,0,1,0.0047570782978519355,2019-03-23 07:45:00,2019-03-23 08:00:00
1,2,2,0,0.008795074578753576,2019-03-23 08:00:00,2019-03-23 08:15:00
5,1,1,0,0.008795074578753576,2019-03-23 08:00:00,2019-03-23 08:15:00
23,1,0,1,0.004754190866483972,2019-03-23 08:00:00,2019-03-23 08:15:00
57,1,1,0,0.006101152103907174,2019-03-23 08:00:00,2019-03-23 08:15:00
62,2,2,0,0.008795074578753576,2019-03-23 08:00:00,2019-03-23 08:15:00
90,2,1,1,0.006101152103907174,2019-03-23 08:00:00,2019-03-23 08:15:00
111,1,1,0,0.006101152103907174,2019-03-23 08:00:00,2019-03-23 08:15:00
137,1,1,0,0.009940644675917964,2019-03-23 08:00:00,2019-03-23 08:15:00
153,1,0,1,0.004754190866483972,2019-03-23 08:00:00,2019-03-23 08:15:00
164,3,0,3,0.004754190866483972,2019-03-23 08:00:00,2019-03-23 08:15:00
173,1,1,0,0.008795074578753576,2019-03-23 08:00:00,2019-03-23 08:15:00
190,2,0,2,0.004754190866483972,2019-03-23 08:00:00,2019-03-23 08:15:00
191,2,0,2,0.004754190866483972,2019-03-23 08:00:00,2019-03-23 08:15:00
1,2,2,0,0.008359320140900768,2019-03-23 08:15:00,2019-03-23 08:30:00
5,3,2,1,0.05521050806890302,2019-03-23 08:15:00,2019-03-23 08:30:00
19,1,1,0,0.008359320140900768,2019-03-23 08:15:00,2019-03-23 08:30:00
23,1,0,1,0.004518351369119639,2019-03-23 08:15:00,2019-03-23 08:30:00
35,1,0,1,0.004518351369119639,2019-03-23 08:15:00,2019-03-23 08:30:00
62,2,2,0,0.008359320140900768,2019-03-23 08:15:00,2019-03-23 08:30:00
88,1,0,1,0.004518351369119639,2019-03-23 08:15:00,2019-03-23 08:30:00
90,1,1,0,0.008359320140900768,2019-03-23 08:15:00,2019-03-23 08:30:00
118,1,1,0,0.008359320140900768,2019-03-23 08:15:00,2019-03-23 08:30:00
153,1,0,1,0.004518351369119639,2019-03-23 08:15:00,2019-03-23 08:30:00
164,1,0,1,0.004518351369119639,2019-03-23 08:15:00,2019-03-23 08:30:00
173,1,1,0,0.008359320140900768,2019-03-23 08:15:00,2019-03-23 08:30:00
190,2,0,2,0.004518351369119639,2019-03-23 08:15:00,2019-03-23 08:30:00
191,2,0,2,0.004518351369119639,2019-03-23 08:15:00,2019-03-23 08:30:00
1,2,2,0,0.008237498317301306,2019-03-23 08:30:00,2019-03-23 08:45:00
5,3,2,1,0.05440578852591525,2019-03-23 08:30:00,2019-03-23 08:45:00
18,1,1,0,0.008237498317301306,2019-03-23 08:30:00,2019-03-23 08:45:00
19,1,1,0,0.008237498317301306,2019-03-23 08:30:00,2019-03-23 08:45:00
22,1,0,1,0.004452508327469177,2019-03-23 08:30:00,2019-03-23 08:45:00
23,1,0,1,0.004452508327469177,2019-03-23 08:30:00,2019-03-23 08:45:00
35,1,0,1,0.004452508327469177,2019-03-23 08:30:00,2019-03-23 08:45:00
57,1,0,1,0.004452508327469177,2019-03-23 08:30:00,2019-03-23 08:45:00
58,2,0,2,0.004452508327469177,2019-03-23 08:30:00,2019-03-23 08:45:00
62,2,2,0,0.011455101079183697,2019-03-23 08:30:00,2019-03-23 08:45:00
67,1,1,0,0.008237498317301306,2019-03-23 08:30:00,2019-03-23 08:45:00
88,1,0,1,0.004452508327469177,2019-03-23 08:30:00,2019-03-23 08:45:00
90,1,1,0,0.008237498317301306,2019-03-23 08:30:00,2019-03-23 08:45:00
109,1,1,0,0.006345003322385241,2019-03-23 08:30:00,2019-03-23 08:45:00
118,1,1,0,0.008237498317301306,2019-03-23 08:30:00,2019-03-23 08:45:00
126,1,1,0,0.006345003322385241,2019-03-23 08:30:00,2019-03-23 08:45:00
164,1,0,1,0.004452508327469177,2019-03-23 08:30:00,2019-03-23 08:45:00
190,2,0,2,0.004452508327469177,2019-03-23 08:30:00,2019-03-23 08:45:00
191,3,1,2,0.008237498317301306,2019-03-23 08:30:00,2019-03-23 08:45:00
201,1,0,1,0.004452508327469177,2019-03-23 08:30:00,2019-03-23 08:45:00
1,2,2,0,0.008038198490936392,2019-03-23 08:45:00,2019-03-23 09:00:00
5,3,2,1,0.05308967222273421,2019-03-23 08:45:00,2019-03-23 09:00:00
16,1,0,1,0.004344789491034231,2019-03-23 08:45:00,2019-03-23 09:00:00
18,5,2,3,0.011731607490838555,2019-03-23 08:45:00,2019-03-23 09:00:00
22,1,0,1,0.004344789491034231,2019-03-23 08:45:00,2019-03-23 09:00:00
23,1,0,1,0.004344789491034231,2019-03-23 08:45:00,2019-03-23 09:00:00
57,1,0,1,0.004344789491034231,2019-03-23 08:45:00,2019-03-23 09:00:00
58,2,0,2,0.004344789491034231,2019-03-23 08:45:00,2019-03-23 09:00:00
62,2,2,0,0.011177937142824298,2019-03-23 08:45:00,2019-03-23 09:00:00
67,2,1,1,0.008038198490936392,2019-03-23 08:45:00,2019-03-23 09:00:00
87,3,3,0,0.014317675794712202,2019-03-23 08:45:00,2019-03-23 09:00:00
90,1,1,0,0.008038198490936392,2019-03-23 08:45:00,2019-03-23 09:00:00
99,1,1,0,0.008038198490936392,2019-03-23 08:45:00,2019-03-23 09:00:00
109,2,2,0,0.009884902990887474,2019-03-23 08:45:00,2019-03-23 09:00:00
118,1,0,1,0.004344789491034231,2019-03-23 08:45:00,2019-03-23 09:00:00
120,1,1,0,0.008038198490936392,2019-03-23 08:45:00,2019-03-23 09:00:00
126,1,1,0,0.006191493990985312,2019-03-23 08:45:00,2019-03-23 09:00:00
127,1,0,1,0.004344789491034231,2019-03-23 08:45:00,2019-03-23 09:00:00
138,1,1,0,0.011177937142824298,2019-03-23 08:45:00,2019-03-23 09:00:00
162,1,0,1,0.004344789491034231,2019-03-23 08:45:00,2019-03-23 09:00:00
164,1,0,1,0.004344789491034231,2019-03-23 08:45:00,2019-03-23 09:00:00
190,2,0,2,0.004344789491034231,2019-03-23 08:45:00,2019-03-23 09:00:00
191,3,1,2,0.008038198490936392,2019-03-23 08:45:00,2019-03-23 09:00:00
201,1,0,1,0.004344789491034231,2019-03-23 08:45:00,2019-03-23 09:00:00
1,5,5,0,0.01563738263972788,2019-03-23 09:00:00,2019-03-23 09:15:00
5,1,1,0,0.008148854699341561,2019-03-23 09:00:00,2019-03-23 09:15:00
16,1,1,0,0.011331842539053921,2019-03-23 09:00:00,2019-03-23 09:15:00
18,4,1,3,0.008148854699341561,2019-03-23 09:00:00,2019-03-23 09:15:00
22,1,0,1,0.0044045907291484,2019-03-23 09:00:00,2019-03-23 09:15:00
23,1,0,1,0.0044045907291484,2019-03-23 09:00:00,2019-03-23 09:15:00
28,2,0,2,0.0044045907291484,2019-03-23 09:00:00,2019-03-23 09:15:00
57,1,0,1,0.0044045907291484,2019-03-23 09:00:00,2019-03-23 09:15:00
58,1,0,1,0.0044045907291484,2019-03-23 09:00:00,2019-03-23 09:15:00
62,2,2,0,0.011331842539053921,2019-03-23 09:00:00,2019-03-23 09:15:00
67,2,1,1,0.008148854699341561,2019-03-23 09:00:00,2019-03-23 09:15:00
68,2,1,1,0.028823316371783883,2019-03-23 09:00:00,2019-03-23 09:15:00
87,3,3,0,0.011331842539053921,2019-03-23 09:00:00,2019-03-23 09:15:00
90,1,1,0,0.008148854699341561,2019-03-23 09:00:00,2019-03-23 09:15:00
99,1,1,0,0.008148854699341561,2019-03-23 09:00:00,2019-03-23 09:15:00
106,1,1,0,0.008148854699341561,2019-03-23 09:00:00,2019-03-23 09:15:00
110,1,0,1,0.0044045907291484,2019-03-23 09:00:00,2019-03-23 09:15:00
118,1,0,1,0.0044045907291484,2019-03-23 09:00:00,2019-03-23 09:15:00
120,2,1,1,0.008148854699341561,2019-03-23 09:00:00,2019-03-23 09:15:00
126,1,1,0,0.008148854699341561,2019-03-23 09:00:00,2019-03-23 09:15:00
127,1,0,1,0.0044045907291484,2019-03-23 09:00:00,2019-03-23 09:15:00
138,1,1,0,0.011331842539053921,2019-03-23 09:00:00,2019-03-23 09:15:00
162,1,0,1,0.0044045907291484,2019-03-23 09:00:00,2019-03-23 09:15:00
164,1,0,1,0.0044045907291484,2019-03-23 09:00:00,2019-03-23 09:15:00
190,2,0,2,0.0044045907291484,2019-03-23 09:00:00,2019-03-23 09:15:00
191,3,1,2,0.008148854699341561,2019-03-23 09:00:00,2019-03-23 09:15:00
199,1,0,1,0.0044045907291484,2019-03-23 09:00:00,2019-03-23 09:15:00
1,5,5,0,0.014686744029319106,2019-03-23 09:15:00,2019-03-23 09:30:00
5,1,1,0,0.005895122056312485,2019-03-23 09:15:00,2019-03-23 09:30:00
16,1,1,0,0.010642975490861413,2019-03-23 09:15:00,2019-03-23 09:30:00
18,3,0,3,0.004136797661711161,2019-03-23 09:15:00,2019-03-23 09:30:00
22,1,0,1,0.004136797661711161,2019-03-23 09:15:00,2019-03-23 09:30:00
23,2,0,2,0.004136797661711161,2019-03-23 09:15:00,2019-03-23 09:30:00
26,1,0,1,0.004136797661711161,2019-03-23 09:15:00,2019-03-23 09:30:00
28,2,0,2,0.004136797661711161,2019-03-23 09:15:00,2019-03-23 09:30:00
40,2,2,0,0.009411770845515133,2019-03-23 09:15:00,2019-03-23 09:30:00
58,1,1,0,0.007653446450913809,2019-03-23 09:15:00,2019-03-23 09:30:00
67,2,1,1,0.007653446450913809,2019-03-23 09:15:00,2019-03-23 09:30:00
68,2,1,1,0.027443720019529633,2019-03-23 09:15:00,2019-03-23 09:30:00
87,4,4,0,0.011170095240116458,2019-03-23 09:15:00,2019-03-23 09:30:00
90,1,1,0,0.007653446450913809,2019-03-23 09:15:00,2019-03-23 09:30:00
99,3,2,1,0.05075064237734811,2019-03-23 09:15:00,2019-03-23 09:30:00
106,1,1,0,0.007653446450913809,2019-03-23 09:15:00,2019-03-23 09:30:00
110,1,0,1,0.004136797661711161,2019-03-23 09:15:00,2019-03-23 09:30:00
118,1,0,1,0.004136797661711161,2019-03-23 09:15:00,2019-03-23 09:30:00
120,2,1,1,0.007653446450913809,2019-03-23 09:15:00,2019-03-23 09:30:00
137,1,1,0,0.007653446450913809,2019-03-23 09:15:00,2019-03-23 09:30:00
138,1,1,0,0.010642975490861413,2019-03-23 09:15:00,2019-03-23 09:30:00
141,1,0,1,0.004136797661711161,2019-03-23 09:15:00,2019-03-23 09:30:00
158,1,0,1,0.004136797661711161,2019-03-23 09:15:00,2019-03-23 09:30:00
159,2,1,1,0.027443720019529633,2019-03-23 09:15:00,2019-03-23 09:30:00
162,1,0,1,0.004136797661711161,2019-03-23 09:15:00,2019-03-23 09:30:00
164,1,0,1,0.004136797661711161,2019-03-23 09:15:00,2019-03-23 09:30:00
168,1,0,1,0.004136797661711161,2019-03-23 09:15:00,2019-03-23 09:30:00
190,2,0,2,0.004136797661711161,2019-03-23 09:15:00,2019-03-23 09:30:00
199,1,0,1,0.004136797661711161,2019-03-23 09:15:00,2019-03-23 09:30:00
1,2,2,0,0.007735850430707241,2019-03-23 09:30:00,2019-03-23 09:45:00
5,1,1,0,0.007735850430707241,2019-03-23 09:30:00,2019-03-23 09:45:00
18,2,1,1,0.027693913403915117,2019-03-23 09:30:00,2019-03-23 09:45:00
22,1,0,1,0.0041813428776557564,2019-03-23 09:30:00,2019-03-23 09:45:00
23,1,0,1,0.0041813428776557564,2019-03-23 09:30:00,2019-03-23 09:45:00
26,1,0,1,0.0041813428776557564,2019-03-23 09:30:00,2019-03-23 09:45:00
40,1,1,0,0.007735850430707241,2019-03-23 09:30:00,2019-03-23 09:45:00
57,1,1,0,0.010531113196303853,2019-03-23 09:30:00,2019-03-23 09:45:00
58,2,2,0,0.007735850430707241,2019-03-23 09:30:00,2019-03-23 09:45:00
62,2,0,2,0.0041813428776557564,2019-03-23 09:30:00,2019-03-23 09:45:00
67,2,1,1,0.007735850430707241,2019-03-23 09:30:00,2019-03-23 09:45:00
68,2,1,1,0.027693913403915117,2019-03-23 09:30:00,2019-03-23 09:45:00
87,2,2,0,0.007735850430707241,2019-03-23 09:30:00,2019-03-23 09:45:00
88,3,0,3,0.0041813428776557564,2019-03-23 09:30:00,2019-03-23 09:45:00
90,2,1,1,0.007735850430707241,2019-03-23 09:30:00,2019-03-23 09:45:00
99,2,1,1,0.027693913403915117,2019-03-23 09:30:00,2019-03-23 09:45:00
106,1,1,0,0.007735850430707241,2019-03-23 09:30:00,2019-03-23 09:45:00
109,2,1,1,0.007469447876567216,2019-03-23 09:30:00,2019-03-23 09:45:00
110,1,0,1,0.0041813428776557564,2019-03-23 09:30:00,2019-03-23 09:45:00
115,1,1,0,0.007735850430707241,2019-03-23 09:30:00,2019-03-23 09:45:00
116,1,0,1,0.0041813428776557564,2019-03-23 09:30:00,2019-03-23 09:45:00
118,1,0,1,0.0041813428776557564,2019-03-23 09:30:00,2019-03-23 09:45:00
120,1,1,0,0.007735850430707241,2019-03-23 09:30:00,2019-03-23 09:45:00
122,1,1,0,0.005366178728672918,2019-03-23 09:30:00,2019-03-23 09:45:00
137,3,3,0,0.009839119578601539,2019-03-23 09:30:00,2019-03-23 09:45:00
138,1,1,0,0.010757552875478676,2019-03-23 09:30:00,2019-03-23 09:45:00
141,3,1,2,0.007735850430707241,2019-03-23 09:30:00,2019-03-23 09:45:00
158,2,0,2,0.0041813428776557564,2019-03-23 09:30:00,2019-03-23 09:45:00
164,1,0,1,0.0041813428776557564,2019-03-23 09:30:00,2019-03-23 09:45:00
168,2,0,2,0.0041813428776557564,2019-03-23 09:30:00,2019-03-23 09:45:00
190,2,0,2,0.0041813428776557564,2019-03-23 09:30:00,2019-03-23 09:45:00
191,2,2,0,0.007735850430707241,2019-03-23 09:30:00,2019-03-23 09:45:00
201,1,0,1,0.0041813428776557564,2019-03-23 09:30:00,2019-03-23 09:45:00
202,1,1,0,0.010757552875478676,2019-03-23 09:30:00,2019-03-23 09:45:00
1,2,2,0,0.007990764931831262,2019-03-23 09:45:00,2019-03-23 10:00:00
5,1,1,0,0.007990764931831262,2019-03-23 09:45:00,2019-03-23 10:00:00
16,3,0,3,0.00431914537550729,2019-03-23 09:45:00,2019-03-23 10:00:00
18,1,0,1,0.00431914537550729,2019-03-23 09:45:00,2019-03-23 10:00:00
22,1,0,1,0.00431914537550729,2019-03-23 09:45:00,2019-03-23 10:00:00
23,1,0,1,0.00431914537550729,2019-03-23 09:45:00,2019-03-23 10:00:00
26,1,0,1,0.00431914537550729,2019-03-23 09:45:00,2019-03-23 10:00:00
40,2,2,0,0.011662384488155235,2019-03-23 09:45:00,2019-03-23 10:00:00
46,2,2,0,0.009214638117272586,2019-03-23 09:45:00,2019-03-23 10:00:00
57,1,1,0,0.011111989049663692,2019-03-23 09:45:00,2019-03-23 10:00:00
58,1,1,0,0.007990764931831262,2019-03-23 09:45:00,2019-03-23 10:00:00
61,1,0,1,0.00431914537550729,2019-03-23 09:45:00,2019-03-23 10:00:00
62,2,0,2,0.00431914537550729,2019-03-23 09:45:00,2019-03-23 10:00:00
67,2,1,1,0.007990764931831262,2019-03-23 09:45:00,2019-03-23 10:00:00
68,2,1,1,0.028265028203103254,2019-03-23 09:45:00,2019-03-23 10:00:00
87,3,3,0,0.01582401664526514,2019-03-23 09:45:00,2019-03-23 10:00:00
88,3,0,3,0.00431914537550729,2019-03-23 09:45:00,2019-03-23 10:00:00
90,2,1,1,0.007990764931831262,2019-03-23 09:45:00,2019-03-23 10:00:00
106,1,1,0,0.005543018560948614,2019-03-23 09:45:00,2019-03-23 10:00:00
109,2,1,1,0.007990764931831262,2019-03-23 09:45:00,2019-03-23 10:00:00
110,3,0,3,0.00431914537550729,2019-03-23 09:45:00,2019-03-23 10:00:00
115,1,1,0,0.007990764931831262,2019-03-23 09:45:00,2019-03-23 10:00:00
116,1,0,1,0.00431914537550729,2019-03-23 09:45:00,2019-03-23 10:00:00
118,1,0,1,0.00431914537550729,2019-03-23 09:45:00,2019-03-23 10:00:00
120,1,1,0,0.007990764931831262,2019-03-23 09:45:00,2019-03-23 10:00:00
122,1,1,0,0.005543018560948614,2019-03-23 09:45:00,2019-03-23 10:00:00
137,5,4,1,0.009214638117272586,2019-03-23 09:45:00,2019-03-23 10:00:00
138,1,1,0,0.011111989049663692,2019-03-23 09:45:00,2019-03-23 10:00:00
141,1,0,1,0.00431914537550729,2019-03-23 09:45:00,2019-03-23 10:00:00
158,1,0,1,0.00431914537550729,2019-03-23 09:45:00,2019-03-23 10:00:00
164,1,0,1,0.00431914537550729,2019-03-23 09:45:00,2019-03-23 10:00:00
168,2,0,2,0.00431914537550729,2019-03-23 09:45:00,2019-03-23 10:00:00
169,2,2,0,0.006766891746389938,2019-03-23 09:45:00,2019-03-23 10:00:00
170,1,0,1,0.00431914537550729,2019-03-23 09:45:00,2019-03-23 10:00:00
171,1,1,0,0.007990764931831262,2019-03-23 09:45:00,2019-03-23 10:00:00
190,2,0,2,0.00431914537550729,2019-03-23 09:45:00,2019-03-23 10:00:00
191,2,2,0,0.007990764931831262,2019-03-23 09:45:00,2019-03-23 10:00:00
202,1,1,0,0.011111989049663692,2019-03-23 09:45:00,2019-03-23 10:00:00
1,3,2,1,0.013704078793094323,2019-03-23 10:00:00,2019-03-23 10:15:00
5,1,1,0,0.00683512912406662,2019-03-23 10:00:00,2019-03-23 10:15:00
11,1,0,1,0.0036945110969326365,2019-03-23 10:00:00,2019-03-23 10:15:00
16,3,0,3,0.0036945110969326365,2019-03-23 10:00:00,2019-03-23 10:15:00
18,2,0,2,0.0036945110969326365,2019-03-23 10:00:00,2019-03-23 10:15:00
22,1,0,1,0.0036945110969326365,2019-03-23 10:00:00,2019-03-23 10:15:00
23,1,0,1,0.0036945110969326365,2019-03-23 10:00:00,2019-03-23 10:15:00
28,2,0,2,0.0036945110969326365,2019-03-23 10:00:00,2019-03-23 10:15:00
40,1,1,0,0.0052648201104996285,2019-03-23 10:00:00,2019-03-23 10:15:00
46,2,2,0,0.006311692786210956,2019-03-23 10:00:00,2019-03-23 10:15:00
58,1,1,0,0.00683512912406662,2019-03-23 10:00:00,2019-03-23 10:15:00
61,3,1,2,0.006425740895545418,2019-03-23 10:00:00,2019-03-23 10:15:00
62,3,1,2,0.00683512912406662,2019-03-23 10:00:00,2019-03-23 10:15:00
67,2,1,1,0.00683512912406662,2019-03-23 10:00:00,2019-03-23 10:15:00
68,2,1,1,0.024543305817778232,2019-03-23 10:00:00,2019-03-23 10:15:00
80,2,1,1,0.024543305817778232,2019-03-23 10:00:00,2019-03-23 10:15:00
87,3,3,0,0.015717405867251722,2019-03-23 10:00:00,2019-03-23 10:15:00
90,2,1,1,0.00683512912406662,2019-03-23 10:00:00,2019-03-23 10:15:00
109,1,1,0,0.009504944219614644,2019-03-23 10:00:00,2019-03-23 10:15:00
110,3,2,1,0.018387220962799745,2019-03-23 10:00:00,2019-03-23 10:15:00
111,2,1,1,0.00683512912406662,2019-03-23 10:00:00,2019-03-23 10:15:00
118,1,0,1,0.0036945110969326365,2019-03-23 10:00:00,2019-03-23 10:15:00
120,1,1,0,0.00683512912406662,2019-03-23 10:00:00,2019-03-23 10:15:00
137,4,2,2,0.020896233474498645,2019-03-23 10:00:00,2019-03-23 10:15:00
138,4,3,1,0.07352467459275822,2019-03-23 10:00:00,2019-03-23 10:15:00
140,1,0,1,0.0036945110969326365,2019-03-23 10:00:00,2019-03-23 10:15:00
141,2,1,1,0.00683512912406662,2019-03-23 10:00:00,2019-03-23 10:15:00
157,2,0,2,0.0036945110969326365,2019-03-23 10:00:00,2019-03-23 10:15:00
158,1,0,1,0.0036945110969326365,2019-03-23 10:00:00,2019-03-23 10:15:00
164,1,0,1,0.0036945110969326365,2019-03-23 10:00:00,2019-03-23 10:15:00
168,2,0,2,0.0036945110969326365,2019-03-23 10:00:00,2019-03-23 10:15:00
169,4,4,0,0.008928874475489276,2019-03-23 10:00:00,2019-03-23 10:15:00
171,1,1,0,0.006425740895545418,2019-03-23 10:00:00,2019-03-23 10:15:00
189,1,0,1,0.0036945110969326365,2019-03-23 10:00:00,2019-03-23 10:15:00
190,3,1,2,0.011774583151270142,2019-03-23 10:00:00,2019-03-23 10:15:00
191,3,2,1,0.009504944219614644,2019-03-23 10:00:00,2019-03-23 10:15:00
199,1,1,0,0.01534445926022834,2019-03-23 10:00:00,2019-03-23 10:15:00
202,1,1,0,0.009504944219614644,2019-03-23 10:00:00,2019-03-23 10:15:00
1,2,2,0,0.0071265156429152435,2019-03-23 10:15:00,2019-03-23 10:30:00
5,1,1,0,0.0054892561843459045,2019-03-23 10:15:00,2019-03-23 10:30:00
11,4,1,3,0.005375106304351035,2019-03-23 10:15:00,2019-03-23 10:30:00
18,6,2,4,0.006699697895410143,2019-03-23 10:15:00,2019-03-23 10:30:00
20,1,0,1,0.0038519967257765655,2019-03-23 10:15:00,2019-03-23 10:30:00
21,1,1,0,0.0071265156429152435,2019-03-23 10:15:00,2019-03-23 10:30:00
22,1,0,1,0.0038519967257765655,2019-03-23 10:15:00,2019-03-23 10:30:00
23,2,0,2,0.0038519967257765655,2019-03-23 10:15:00,2019-03-23 10:30:00
28,3,0,3,0.0038519967257765655,2019-03-23 10:15:00,2019-03-23 10:30:00
61,1,0,1,0.0038519967257765655,2019-03-23 10:15:00,2019-03-23 10:30:00
62,2,2,0,0.0068982158829255045,2019-03-23 10:15:00,2019-03-23 10:30:00
67,2,1,1,0.0071265156429152435,2019-03-23 10:15:00,2019-03-23 10:30:00
68,2,1,1,0.025590097971580072,2019-03-23 10:15:00,2019-03-23 10:30:00
70,1,1,0,0.011815869807054392,2019-03-23 10:15:00,2019-03-23 10:30:00
75,1,1,0,0.009032199351037143,2019-03-23 10:15:00,2019-03-23 10:30:00
80,2,1,1,0.025590097971580072,2019-03-23 10:15:00,2019-03-23 10:30:00
87,2,2,0,0.009032199351037143,2019-03-23 10:15:00,2019-03-23 10:30:00
88,1,0,1,0.0038519967257765655,2019-03-23 10:15:00,2019-03-23 10:30:00
89,1,0,1,0.0038519967257765655,2019-03-23 10:15:00,2019-03-23 10:30:00
90,3,1,2,0.0071265156429152435,2019-03-23 10:15:00,2019-03-23 10:30:00
110,2,1,1,0.006093660116301287,2019-03-23 10:15:00,2019-03-23 10:30:00
111,3,2,1,0.009368179033439965,2019-03-23 10:15:00,2019-03-23 10:30:00
115,1,1,0,0.006881091412354529,2019-03-23 10:15:00,2019-03-23 10:30:00
118,1,0,1,0.0038519967257765655,2019-03-23 10:15:00,2019-03-23 10:30:00
120,2,2,0,0.008763775101484583,2019-03-23 10:15:00,2019-03-23 10:30:00
126,1,1,0,0.005275847310593354,2019-03-23 10:15:00,2019-03-23 10:30:00
137,7,2,5,0.01318470501607117,2019-03-23 10:15:00,2019-03-23 10:30:00
138,4,3,1,0.07523698158413335,2019-03-23 10:15:00,2019-03-23 10:30:00
157,3,2,1,0.0071265156429152435,2019-03-23 10:15:00,2019-03-23 10:30:00
159,1,1,0,0.004943503031489458,2019-03-23 10:15:00,2019-03-23 10:30:00
164,1,0,1,0.0038519967257765655,2019-03-23 10:15:00,2019-03-23 10:30:00
168,3,1,2,0.006093660116301287,2019-03-23 10:15:00,2019-03-23 10:30:00
169,6,6,0,0.01336603728788537,2019-03-23 10:15:00,2019-03-23 10:30:00
170,1,1,0,0.0071265156429152435,2019-03-23 10:15:00,2019-03-23 10:30:00
171,1,1,0,0.0071265156429152435,2019-03-23 10:15:00,2019-03-23 10:30:00
189,1,0,1,0.0038519967257765655,2019-03-23 10:15:00,2019-03-23 10:30:00
190,2,0,2,0.0038519967257765655,2019-03-23 10:15:00,2019-03-23 10:30:00
197,2,0,2,0.0038519967257765655,2019-03-23 10:15:00,2019-03-23 10:30:00
202,1,1,0,0.006881091412354529,2019-03-23 10:15:00,2019-03-23 10:30:00
203,6,2,4,0.006699697895410143,2019-03-23 10:15:00,2019-03-23 10:30:00
1,2,2,0,0.00643967702523539,2019-03-23 10:30:00,2019-03-23 10:45:00
5,1,1,0,0.006947325224948106,2019-03-23 10:30:00,2019-03-23 10:45:00
11,2,0,2,0.0034807328325881025,2019-03-23 10:30:00,2019-03-23 10:45:00
18,8,4,4,0.01634721376314687,2019-03-23 10:30:00,2019-03-23 10:45:00
20,1,0,1,0.0034807328325881025,2019-03-23 10:30:00,2019-03-23 10:45:00
21,1,1,0,0.0044670475634705316,2019-03-23 10:30:00,2019-03-23 10:45:00
22,1,0,1,0.0034807328325881025,2019-03-23 10:30:00,2019-03-23 10:45:00
23,5,2,3,0.012233220630804256,2019-03-23 10:30:00,2019-03-23 10:45:00
28,4,1,3,0.00643967702523539,2019-03-23 10:30:00,2019-03-23 10:45:00
57,1,0,1,0.0034807328325881025,2019-03-23 10:30:00,2019-03-23 10:45:00
58,1,0,1,0.0034807328325881025,2019-03-23 10:30:00,2019-03-23 10:45:00
61,1,0,1,0.0034807328325881025,2019-03-23 10:30:00,2019-03-23 10:45:00
62,8,5,3,0.04281524650131718,2019-03-23 10:30:00,2019-03-23 10:45:00
67,2,1,1,0.00643967702523539,2019-03-23 10:30:00,2019-03-23 10:45:00
68,2,1,1,0.02314798966695265,2019-03-23 10:30:00,2019-03-23 10:45:00
70,1,1,0,0.00643967702523539,2019-03-23 10:30:00,2019-03-23 10:45:00
75,1,1,0,0.00643967702523539,2019-03-23 10:30:00,2019-03-23 10:45:00
80,2,1,1,0.02314798966695265,2019-03-23 10:30:00,2019-03-23 10:45:00
87,2,1,1,0.02314798966695265,2019-03-23 10:30:00,2019-03-23 10:45:00
88,1,0,1,0.0034807328325881025,2019-03-23 10:30:00,2019-03-23 10:45:00
89,3,0,3,0.0034807328325881025,2019-03-23 10:30:00,2019-03-23 10:45:00
90,3,1,2,0.00643967702523539,2019-03-23 10:30:00,2019-03-23 10:45:00
109,1,0,1,0.0034807328325881025,2019-03-23 10:30:00,2019-03-23 10:45:00
110,1,0,1,0.0034807328325881025,2019-03-23 10:30:00,2019-03-23 10:45:00
111,1,0,1,0.0034807328325881025,2019-03-23 10:30:00,2019-03-23 10:45:00
115,2,1,1,0.006217922900799351,2019-03-23 10:30:00,2019-03-23 10:45:00
118,1,0,1,0.0034807328325881025,2019-03-23 10:30:00,2019-03-23 10:45:00
120,2,2,0,0.009906269417595395,2019-03-23 10:30:00,2019-03-23 10:45:00
126,1,1,0,0.0069550291052201995,2019-03-23 10:30:00,2019-03-23 10:45:00
127,1,1,0,0.0089551129690106,2019-03-23 10:30:00,2019-03-23 10:45:00
137,4,1,3,0.00643967702523539,2019-03-23 10:30:00,2019-03-23 10:45:00
138,2,2,0,0.012429409241642698,2019-03-23 10:30:00,2019-03-23 10:45:00
151,1,0,1,0.0034807328325881025,2019-03-23 10:30:00,2019-03-23 10:45:00
153,2,1,1,0.00643967702523539,2019-03-23 10:30:00,2019-03-23 10:45:00
157,3,3,0,0.009398621217882677,2019-03-23 10:30:00,2019-03-23 10:45:00
159,3,3,0,0.008264470404042889,2019-03-23 10:30:00,2019-03-23 10:45:00
161,2,1,1,0.02314798966695265,2019-03-23 10:30:00,2019-03-23 10:45:00
164,1,0,1,0.0034807328325881025,2019-03-23 10:30:00,2019-03-23 10:45:00
168,3,3,0,0.007278155673160459,2019-03-23 10:30:00,2019-03-23 10:45:00
169,6,6,0,0.013353202533929853,2019-03-23 10:30:00,2019-03-23 10:45:00
170,1,1,0,0.00643967702523539,2019-03-23 10:30:00,2019-03-23 10:45:00
171,3,2,1,0.04281524650131718,2019-03-23 10:30:00,2019-03-23 10:45:00
173,1,0,1,0.0034807328325881025,2019-03-23 10:30:00,2019-03-23 10:45:00
177,2,1,1,0.02314798966695265,2019-03-23 10:30:00,2019-03-23 10:45:00
190,2,0,2,0.0034807328325881025,2019-03-23 10:30:00,2019-03-23 10:45:00
196,2,0,2,0.0034807328325881025,2019-03-23 10:30:00,2019-03-23 10:45:00
197,2,0,2,0.0034807328325881025,2019-03-23 10:30:00,2019-03-23 10:45:00
202,1,1,0,0.006217922900799351,2019-03-23 10:30:00,2019-03-23 10:45:00
203,6,2,4,0.006054029018699857,2019-03-23 10:30:00,2019-03-23 10:45:00
1,2,2,0,0.00633013400068045,2019-03-23 10:45:00,2019-03-23 11:00:00
5,1,1,0,0.005129929117369555,2019-03-23 10:45:00,2019-03-23 11:00:00
11,4,1,3,0.004774443318888178,2019-03-23 10:45:00,2019-03-23 11:00:00
18,2,1,1,0.005659453984078684,2019-03-23 10:45:00,2019-03-23 11:00:00
21,1,1,0,0.004391061731427351,2019-03-23 10:45:00,2019-03-23 11:00:00
22,1,0,1,0.0034215255968008014,2019-03-23 10:45:00,2019-03-23 11:00:00
23,6,2,4,0.008038537521249204,2019-03-23 10:45:00,2019-03-23 11:00:00
28,4,1,3,0.007782499276156757,2019-03-23 10:45:00,2019-03-23 11:00:00
40,1,1,0,0.006637669912253117,2019-03-23 10:45:00,2019-03-23 11:00:00
57,3,0,3,0.0034215255968008014,2019-03-23 10:45:00,2019-03-23 11:00:00
58,5,2,3,0.007897382371356567,2019-03-23 10:45:00,2019-03-23 11:00:00
61,1,0,1,0.0034215255968008014,2019-03-23 10:45:00,2019-03-23 11:00:00
62,8,5,3,0.040734380556837244,2019-03-23 10:45:00,2019-03-23 11:00:00
66,1,1,0,0.006112150000200155,2019-03-23 10:45:00,2019-03-23 11:00:00
67,5,3,2,0.008269206269933549,2019-03-23 10:45:00,2019-03-23 11:00:00
68,3,2,1,0.061248955872303945,2019-03-23 10:45:00,2019-03-23 11:00:00
80,2,1,1,0.022754411937862717,2019-03-23 10:45:00,2019-03-23 11:00:00
87,2,1,1,0.022754411937862717,2019-03-23 10:45:00,2019-03-23 11:00:00
89,3,0,3,0.0034215255968008014,2019-03-23 10:45:00,2019-03-23 11:00:00
90,3,1,2,0.0075664542021399795,2019-03-23 10:45:00,2019-03-23 11:00:00
99,1,0,1,0.0034215255968008014,2019-03-23 10:45:00,2019-03-23 11:00:00
106,1,1,0,0.01340839001224155,2019-03-23 10:45:00,2019-03-23 11:00:00
109,1,1,0,0.00633013400068045,2019-03-23 10:45:00,2019-03-23 11:00:00
115,2,0,2,0.0034215255968008014,2019-03-23 10:45:00,2019-03-23 11:00:00
116,2,0,2,0.0034215255968008014,2019-03-23 10:45:00,2019-03-23 11:00:00
118,4,3,1,0.011335391391807947,2019-03-23 10:45:00,2019-03-23 11:00:00
119,1,1,0,0.008802774403599509,2019-03-23 10:45:00,2019-03-23 11:00:00
120,1,1,0,0.013057912543358283,2019-03-23 10:45:00,2019-03-23 11:00:00
122,1,1,0,0.006637669912253117,2019-03-23 10:45:00,2019-03-23 11:00:00
127,1,0,1,0.0034215255968008014,2019-03-23 10:45:00,2019-03-23 11:00:00
137,2,0,2,0.0034215255968008014,2019-03-23 10:45:00,2019-03-23 11:00:00
138,3,2,1,0.01174756025069649,2019-03-23 10:45:00,2019-03-23 11:00:00
151,2,1,1,0.005129929117369555,2019-03-23 10:45:00,2019-03-23 11:00:00
153,1,1,0,0.00633013400068045,2019-03-23 10:45:00,2019-03-23 11:00:00
157,3,3,0,0.007299670135306999,2019-03-23 10:45:00,2019-03-23 11:00:00
159,5,5,0,0.011444072357084441,2019-03-23 10:45:00,2019-03-23 11:00:00
160,2,1,1,0.022754411937862717,2019-03-23 10:45:00,2019-03-23 11:00:00
161,2,1,1,0.022754411937862717,2019-03-23 10:45:00,2019-03-23 11:00:00
162,2,1,1,0.00633013400068045,2019-03-23 10:45:00,2019-03-23 11:00:00
164,2,1,1,0.004875829798740626,2019-03-23 10:45:00,2019-03-23 11:00:00
168,4,3,1,0.006814902067993725,2019-03-23 10:45:00,2019-03-23 11:00:00
169,6,6,0,0.012978722293007016,2019-03-23 10:45:00,2019-03-23 11:00:00
170,1,0,1,0.0034215255968008014,2019-03-23 10:45:00,2019-03-23 11:00:00
171,3,1,2,0.00633013400068045,2019-03-23 10:45:00,2019-03-23 11:00:00
190,2,0,2,0.0034215255968008014,2019-03-23 10:45:00,2019-03-23 11:00:00
191,1,0,1,0.0034215255968008014,2019-03-23 10:45:00,2019-03-23 11:00:00
196,2,0,2,0.0034215255968008014,2019-03-23 10:45:00,2019-03-23 11:00:00
197,2,0,2,0.0034215255968008014,2019-03-23 10:45:00,2019-03-23 11:00:00
203,10,4,6,0.007897382371356567,2019-03-23 10:45:00,2019-03-23 11:00:00
1,2,2,0,0.005452783713890939,2019-03-23 11:00:00,2019-03-23 11:15:00
2,1,0,1,0.0029473164547549903,2019-03-23 11:00:00,2019-03-23 11:15:00
5,1,1,0,0.004106160189102246,2019-03-23 11:00:00,2019-03-23 11:15:00
10,1,0,1,0.0029473164547549903,2019-03-23 11:00:00,2019-03-23 11:15:00
11,5,3,2,0.0177936298833493,2019-03-23 11:00:00,2019-03-23 11:15:00
16,1,1,0,0.004106160189102246,2019-03-23 11:00:00,2019-03-23 11:15:00
18,4,2,2,0.004084848254214842,2019-03-23 11:00:00,2019-03-23 11:15:00
19,4,3,1,0.004653614153944767,2019-03-23 11:00:00,2019-03-23 11:15:00
22,1,0,1,0.0029473164547549903,2019-03-23 11:00:00,2019-03-23 11:15:00
23,5,1,4,0.005452783713890939,2019-03-23 11:00:00,2019-03-23 11:15:00
27,1,1,0,0.0037824722078003063,2019-03-23 11:00:00,2019-03-23 11:15:00
28,3,0,3,0.0029473164547549903,2019-03-23 11:00:00,2019-03-23 11:15:00
30,1,1,0,0.0037824722078003063,2019-03-23 11:00:00,2019-03-23 11:15:00
35,1,1,0,0.004785170766389315,2019-03-23 11:00:00,2019-03-23 11:15:00
40,1,1,0,0.017656140362728154,2019-03-23 11:00:00,2019-03-23 11:15:00
57,3,0,3,0.0029473164547549903,2019-03-23 11:00:00,2019-03-23 11:15:00
58,4,2,2,0.019615190969521436,2019-03-23 11:00:00,2019-03-23 11:15:00
61,2,1,1,0.003516082354484916,2019-03-23 11:00:00,2019-03-23 11:15:00
62,9,4,5,0.02143675205569357,2019-03-23 11:00:00,2019-03-23 11:15:00
64,1,1,0,0.005452783713890939,2019-03-23 11:00:00,2019-03-23 11:15:00
67,5,3,2,0.007123095219981571,2019-03-23 11:00:00,2019-03-23 11:15:00
68,3,2,1,0.05549013700099818,2019-03-23 11:00:00,2019-03-23 11:15:00
80,2,1,1,0.019615190969521436,2019-03-23 11:00:00,2019-03-23 11:15:00
85,4,4,0,0.013141287632470862,2019-03-23 11:00:00,2019-03-23 11:15:00
86,2,2,0,0.004617627960845623,2019-03-23 11:00:00,2019-03-23 11:15:00
87,2,1,1,0.019615190969521436,2019-03-23 11:00:00,2019-03-23 11:15:00
88,2,1,1,0.005452783713890939,2019-03-23 11:00:00,2019-03-23 11:15:00
89,2,0,2,0.0029473164547549903,2019-03-23 11:00:00,2019-03-23 11:15:00
90,2,1,1,0.017301376734839564,2019-03-23 11:00:00,2019-03-23 11:15:00
99,3,2,1,0.004084848254214842,2019-03-23 11:00:00,2019-03-23 11:15:00
104,1,0,1,0.0029473164547549903,2019-03-23 11:00:00,2019-03-23 11:15:00
106,1,1,0,0.009502664676719452,2019-03-23 11:00:00,2019-03-23 11:15:00
109,3,2,1,0.006705517343458913,2019-03-23 11:00:00,2019-03-23 11:15:00
110,1,1,0,0.007582691392144014,2019-03-23 11:00:00,2019-03-23 11:15:00
115,5,1,4,0.00864764523127055,2019-03-23 11:00:00,2019-03-23 11:15:00
116,4,1,3,0.009989207856873752,2019-03-23 11:00:00,2019-03-23 11:15:00
118,4,3,1,0.012180252711874315,2019-03-23 11:00:00,2019-03-23 11:15:00
119,1,1,0,0.008404813173352366,2019-03-23 11:00:00,2019-03-23 11:15:00
120,3,1,2,0.013301878819301052,2019-03-23 11:00:00,2019-03-23 11:15:00
126,3,2,1,0.008283471132571713,2019-03-23 11:00:00,2019-03-23 11:15:00
127,1,0,1,0.0029473164547549903,2019-03-23 11:00:00,2019-03-23 11:15:00
137,5,1,4,0.004200050084322964,2019-03-23 11:00:00,2019-03-23 11:15:00
138,3,2,1,0.0077112249392821425,2019-03-23 11:00:00,2019-03-23 11:15:00
141,3,3,0,0.007290638025525263,2019-03-23 11:00:00,2019-03-23 11:15:00
151,1,1,0,0.004106160189102246,2019-03-23 11:00:00,2019-03-23 11:15:00
153,11,2,9,0.0060215496136208635,2019-03-23 11:00:00,2019-03-23 11:15:00
154,2,0,2,0.0029473164547549903,2019-03-23 11:00:00,2019-03-23 11:15:00
157,5,3,2,0.006287939466936255,2019-03-23 11:00:00,2019-03-23 11:15:00
159,4,4,0,0.011114158551252489,2019-03-23 11:00:00,2019-03-23 11:15:00
160,2,1,1,0.019615190969521436,2019-03-23 11:00:00,2019-03-23 11:15:00
162,2,1,1,0.006419820034251553,2019-03-23 11:00:00,2019-03-23 11:15:00
164,5,4,1,0.016884432757698332,2019-03-23 11:00:00,2019-03-23 11:15:00
168,4,3,1,0.00634538898845656,2019-03-23 11:00:00,2019-03-23 11:15:00
169,7,6,1,0.022967937528823354,2019-03-23 11:00:00,2019-03-23 11:15:00
170,2,0,2,0.0029473164547549903,2019-03-23 11:00:00,2019-03-23 11:15:00
171,2,1,1,0.005936301874071246,2019-03-23 11:00:00,2019-03-23 11:15:00
173,1,1,0,0.0038399217293206118,2019-03-23 11:00:00,2019-03-23 11:15:00
175,1,0,1,0.0029473164547549903,2019-03-23 11:00:00,2019-03-23 11:15:00
190,2,0,2,0.0029473164547549903,2019-03-23 11:00:00,2019-03-23 11:15:00
191,1,0,1,0.0029473164547549903,2019-03-23 11:00:00,2019-03-23 11:15:00
196,2,0,2,0.0029473164547549903,2019-03-23 11:00:00,2019-03-23 11:15:00
197,2,0,2,0.0029473164547549903,2019-03-23 11:00:00,2019-03-23 11:15:00
199,3,0,3,0.0029473164547549903,2019-03-23 11:00:00,2019-03-23 11:15:00
203,11,5,6,0.05181387632162869,2019-03-23 11:00:00,2019-03-23 11:15:00
1,4,3,1,0.011829534723375735,2019-03-23 11:15:00,2019-03-23 11:30:00
2,2,1,1,0.0074596085402913875,2019-03-23 11:15:00,2019-03-23 11:30:00
5,1,1,0,0.0034742250717695222,2019-03-23 11:15:00,2019-03-23 11:30:00
10,1,0,1,0.0028652850021509825,2019-03-23 11:15:00,2019-03-23 11:30:00
11,4,3,1,0.03229654798342733,2019-03-23 11:15:00,2019-03-23 11:30:00
15,1,1,0,0.007371725884485751,2019-03-23 11:15:00,2019-03-23 11:30:00
16,1,1,0,0.0034742250717695222,2019-03-23 11:15:00,2019-03-23 11:30:00
18,5,4,1,0.06631046916198305,2019-03-23 11:15:00,2019-03-23 11:30:00
19,4,3,1,0.006636674935579642,2019-03-23 11:15:00,2019-03-23 11:30:00
22,1,0,1,0.0028652850021509825,2019-03-23 11:15:00,2019-03-23 11:30:00
23,4,0,4,0.0028652850021509825,2019-03-23 11:15:00,2019-03-23 11:30:00
26,1,1,0,0.004495454655491386,2019-03-23 11:15:00,2019-03-23 11:30:00
27,1,1,0,0.005301045280625141,2019-03-23 11:15:00,2019-03-23 11:30:00
28,1,0,1,0.0028652850021509825,2019-03-23 11:15:00,2019-03-23 11:30:00
30,1,1,0,0.003677205094975702,2019-03-23 11:15:00,2019-03-23 11:30:00
35,2,2,0,0.004286145164594242,2019-03-23 11:15:00,2019-03-23 11:30:00
40,1,1,0,0.005301045280625141,2019-03-23 11:15:00,2019-03-23 11:30:00
41,1,0,1,0.0028652850021509825,2019-03-23 11:15:00,2019-03-23 11:30:00
50,4,2,2,0.01907248588158693,2019-03-23 11:15:00,2019-03-23 11:30:00
57,4,0,4,0.0028652850021509825,2019-03-23 11:15:00,2019-03-23 11:30:00
58,4,2,2,0.01907248588158693,2019-03-23 11:15:00,2019-03-23 11:30:00
61,5,2,3,0.005752584633300939,2019-03-23 11:15:00,2019-03-23 11:30:00
62,8,3,5,0.00584842377974654,2019-03-23 11:15:00,2019-03-23 11:30:00
64,2,1,1,0.005720364282615683,2019-03-23 11:15:00,2019-03-23 11:30:00
67,4,3,1,0.00651892541986222,2019-03-23 11:15:00,2019-03-23 11:30:00
68,2,1,1,0.01907248588158693,2019-03-23 11:15:00,2019-03-23 11:30:00
80,2,1,1,0.01907248588158693,2019-03-23 11:15:00,2019-03-23 11:30:00
85,4,4,0,0.012328702606352975,2019-03-23 11:15:00,2019-03-23 11:30:00
86,6,4,2,0.029877286467877566,2019-03-23 11:15:00,2019-03-23 11:30:00
88,5,2,3,0.010074874127759561,2019-03-23 11:15:00,2019-03-23 11:30:00
89,2,0,2,0.0028652850021509825,2019-03-23 11:15:00,2019-03-23 11:30:00
99,3,3,0,0.006247320102871205,2019-03-23 11:15:00,2019-03-23 11:30:00
104,1,0,1,0.0028652850021509825,2019-03-23 11:15:00,2019-03-23 11:30:00
106,1,1,0,0.010012296240301895,2019-03-23 11:15:00,2019-03-23 11:30:00
108,2,0,2,0.0028652850021509825,2019-03-23 11:15:00,2019-03-23 11:30:00
109,3,3,0,0.010293692101570481,2019-03-23 11:15:00,2019-03-23 11:30:00
110,1,1,0,0.005301045280625141,2019-03-23 11:15:00,2019-03-23 11:30:00
112,3,2,1,0.005301045280625141,2019-03-23 11:15:00,2019-03-23 11:30:00
115,4,0,4,0.0028652850021509825,2019-03-23 11:15:00,2019-03-23 11:30:00
116,4,0,4,0.0028652850021509825,2019-03-23 11:15:00,2019-03-23 11:30:00
118,3,2,1,0.007295916781394933,2019-03-23 11:15:00,2019-03-23 11:30:00
119,1,1,0,0.005301045280625141,2019-03-23 11:15:00,2019-03-23 11:30:00
120,1,1,0,0.009067742595142553,2019-03-23 11:15:00,2019-03-23 11:30:00
122,1,0,1,0.0028652850021509825,2019-03-23 11:15:00,2019-03-23 11:30:00
126,4,2,2,0.01535808510310157,2019-03-23 11:15:00,2019-03-23 11:30:00
127,1,0,1,0.0028652850021509825,2019-03-23 11:15:00,2019-03-23 11:30:00
137,5,1,4,0.0040831651413880616,2019-03-23 11:15:00,2019-03-23 11:30:00
138,2,1,1,0.008407066186416056,2019-03-23 11:15:00,2019-03-23 11:30:00
141,7,5,2,0.010808223818348364,2019-03-23 11:15:00,2019-03-23 11:30:00
151,2,2,0,0.004692105211006601,2019-03-23 11:15:00,2019-03-23 11:30:00
153,10,2,8,0.011829534723375735,2019-03-23 11:15:00,2019-03-23 11:30:00
154,3,0,3,0.0028652850021509825,2019-03-23 11:15:00,2019-03-23 11:30:00
157,3,1,2,0.0034742250717695222,2019-03-23 11:15:00,2019-03-23 11:30:00
159,4,4,0,0.00562974103802217,2019-03-23 11:15:00,2019-03-23 11:30:00
162,1,0,1,0.0028652850021509825,2019-03-23 11:15:00,2019-03-23 11:30:00
164,1,0,1,0.0028652850021509825,2019-03-23 11:15:00,2019-03-23 11:30:00
168,6,4,2,0.03527968676102288,2019-03-23 11:15:00,2019-03-23 11:30:00
169,9,6,3,0.008808786377398983,2019-03-23 11:15:00,2019-03-23 11:30:00
170,2,0,2,0.0028652850021509825,2019-03-23 11:15:00,2019-03-23 11:30:00
171,2,1,1,0.004495454655491386,2019-03-23 11:15:00,2019-03-23 11:30:00
173,1,1,0,0.0037330601472520984,2019-03-23 11:15:00,2019-03-23 11:30:00
175,1,1,0,0.007728426736092354,2019-03-23 11:15:00,2019-03-23 11:30:00
177,3,2,1,0.03527968676102288,2019-03-23 11:15:00,2019-03-23 11:30:00
190,2,0,2,0.0028652850021509825,2019-03-23 11:15:00,2019-03-23 11:30:00
191,1,1,0,0.003638572950468037,2019-03-23 11:15:00,2019-03-23 11:30:00
196,5,1,4,0.003638572950468037,2019-03-23 11:15:00,2019-03-23 11:30:00
197,1,1,0,0.0034742250717695222,2019-03-23 11:15:00,2019-03-23 11:30:00
199,3,0,3,0.0028652850021509825,2019-03-23 11:15:00,2019-03-23 11:30:00
203,11,5,6,0.012377090606171336,2019-03-23 11:15:00,2019-03-23 11:30:00
1,4,3,1,0.006340908165960035,2019-03-23 11:30:00,2019-03-23 11:45:00
5,3,3,0,0.009613506883945203,2019-03-23 11:30:00,2019-03-23 11:45:00
11,4,3,1,0.018928873552002894,2019-03-23 11:30:00,2019-03-23 11:45:00
15,6,3,3,0.015150907231655986,2019-03-23 11:30:00,2019-03-23 11:45:00
16,2,1,1,0.004063695655542315,2019-03-23 11:30:00,2019-03-23 11:45:00
18,6,2,4,0.011989431756840967,2019-03-23 11:30:00,2019-03-23 11:45:00
19,3,1,2,0.004792961829653969,2019-03-23 11:30:00,2019-03-23 11:45:00
20,1,0,1,0.0023661419773464217,2019-03-23 11:30:00,2019-03-23 11:45:00
22,1,0,1,0.0023661419773464217,2019-03-23 11:30:00,2019-03-23 11:45:00
23,7,4,3,0.01836746783163779,2019-03-23 11:30:00,2019-03-23 11:45:00
26,4,4,0,0.008422433541228442,2019-03-23 11:30:00,2019-03-23 11:45:00
27,1,1,0,0.004377530801197633,2019-03-23 11:30:00,2019-03-23 11:45:00
28,1,0,1,0.0023661419773464217,2019-03-23 11:30:00,2019-03-23 11:45:00
35,4,3,1,0.006016915063448169,2019-03-23 11:30:00,2019-03-23 11:45:00
40,1,1,0,0.006659509947610814,2019-03-23 11:30:00,2019-03-23 11:45:00
41,3,1,2,0.007571184883235556,2019-03-23 11:30:00,2019-03-23 11:45:00
46,1,1,0,0.004377530801197633,2019-03-23 11:30:00,2019-03-23 11:45:00
50,4,2,2,0.0157591526938892,2019-03-23 11:30:00,2019-03-23 11:45:00
57,4,0,4,0.0023661419773464217,2019-03-23 11:30:00,2019-03-23 11:45:00
58,7,2,5,0.0035852423162100297,2019-03-23 11:30:00,2019-03-23 11:45:00
61,5,0,5,0.0023661419773464217,2019-03-23 11:30:00,2019-03-23 11:45:00
62,14,3,11,0.003080269261434446,2019-03-23 11:30:00,2019-03-23 11:45:00
64,2,1,1,0.0030366049186301585,2019-03-23 11:30:00,2019-03-23 11:45:00
67,4,3,1,0.038855598585841505,2019-03-23 11:30:00,2019-03-23 11:45:00
68,2,1,1,0.0157591526938892,2019-03-23 11:30:00,2019-03-23 11:45:00
69,5,2,3,0.005461240081744198,2019-03-23 11:30:00,2019-03-23 11:45:00
74,1,0,1,0.0023661419773464217,2019-03-23 11:30:00,2019-03-23 11:45:00
75,2,0,2,0.0023661419773464217,2019-03-23 11:30:00,2019-03-23 11:45:00
80,4,2,2,0.0157591526938892,2019-03-23 11:30:00,2019-03-23 11:45:00
85,6,2,4,0.0048049960898594556,2019-03-23 11:30:00,2019-03-23 11:45:00
86,8,5,3,0.02915216341043199,2019-03-23 11:30:00,2019-03-23 11:45:00
87,2,0,2,0.0023661419773464217,2019-03-23 11:30:00,2019-03-23 11:45:00
88,3,0,3,0.0023661419773464217,2019-03-23 11:30:00,2019-03-23 11:45:00
89,4,2,2,0.005761249333738208,2019-03-23 11:30:00,2019-03-23 11:45:00
90,1,0,1,0.0023661419773464217,2019-03-23 11:30:00,2019-03-23 11:45:00
99,4,4,0,0.010033105881224587,2019-03-23 11:30:00,2019-03-23 11:45:00
108,2,0,2,0.0023661419773464217,2019-03-23 11:30:00,2019-03-23 11:45:00
109,5,4,1,0.011858857675622232,2019-03-23 11:30:00,2019-03-23 11:45:00
110,3,2,1,0.02915216341043199,2019-03-23 11:30:00,2019-03-23 11:45:00
111,1,1,0,0.004063695655542315,2019-03-23 11:30:00,2019-03-23 11:45:00
112,4,3,1,0.005925079853396522,2019-03-23 11:30:00,2019-03-23 11:45:00
113,3,3,0,0.006133487562077863,2019-03-23 11:30:00,2019-03-23 11:45:00
114,2,2,0,0.0028422268334051047,2019-03-23 11:30:00,2019-03-23 11:45:00
115,2,0,2,0.0023661419773464217,2019-03-23 11:30:00,2019-03-23 11:45:00
116,5,1,4,0.005584477930146404,2019-03-23 11:30:00,2019-03-23 11:45:00
118,3,2,1,0.009924545938016225,2019-03-23 11:30:00,2019-03-23 11:45:00
119,3,1,2,0.0033718363892720274,2019-03-23 11:30:00,2019-03-23 11:45:00
120,5,3,2,0.07187400528291486,2019-03-23 11:30:00,2019-03-23 11:45:00
122,1,0,1,0.0023661419773464217,2019-03-23 11:30:00,2019-03-23 11:45:00
126,8,4,4,0.009238298691313145,2019-03-23 11:30:00,2019-03-23 11:45:00
137,13,7,6,0.011981360926073352,2019-03-23 11:30:00,2019-03-23 11:45:00
138,5,4,1,0.03756373040851483,2019-03-23 11:30:00,2019-03-23 11:45:00
140,2,1,1,0.004377530801197633,2019-03-23 11:30:00,2019-03-23 11:45:00
141,8,6,2,0.01664438773365878,2019-03-23 11:30:00,2019-03-23 11:45:00
151,1,1,0,0.005232461378521279,2019-03-23 11:30:00,2019-03-23 11:45:00
153,5,1,4,0.004329519342108824,2019-03-23 11:30:00,2019-03-23 11:45:00
154,4,1,3,0.002768419742116664,2019-03-23 11:30:00,2019-03-23 11:45:00
157,3,1,2,0.0028689891833092243,2019-03-23 11:30:00,2019-03-23 11:45:00
159,4,4,0,0.007220775567546478,2019-03-23 11:30:00,2019-03-23 11:45:00
162,2,0,2,0.0023661419773464217,2019-03-23 11:30:00,2019-03-23 11:45:00
164,2,1,1,0.0029756921467782257,2019-03-23 11:30:00,2019-03-23 11:45:00
168,6,4,2,0.04835358741301621,2019-03-23 11:30:00,2019-03-23 11:45:00
169,8,5,3,0.007757025484324293,2019-03-23 11:30:00,2019-03-23 11:45:00
170,2,1,1,0.0033718363892720274,2019-03-23 11:30:00,2019-03-23 11:45:00
171,2,1,1,0.002768419742116664,2019-03-23 11:30:00,2019-03-23 11:45:00
172,1,0,1,0.0023661419773464217,2019-03-23 11:30:00,2019-03-23 11:45:00
173,3,1,2,0.004063695655542315,2019-03-23 11:30:00,2019-03-23 11:45:00
175,1,1,0,0.004947484519413396,2019-03-23 11:30:00,2019-03-23 11:45:00
177,4,2,2,0.009713630010161105,2019-03-23 11:30:00,2019-03-23 11:45:00
189,2,2,0,0.0033718363892720274,2019-03-23 11:30:00,2019-03-23 11:45:00
190,2,0,2,0.0023661419773464217,2019-03-23 11:30:00,2019-03-23 11:45:00
191,4,2,2,0.006272826635164529,2019-03-23 11:30:00,2019-03-23 11:45:00
196,4,1,3,0.004377530801197633,2019-03-23 11:30:00,2019-03-23 11:45:00
197,5,5,0,0.011621535920190256,2019-03-23 11:30:00,2019-03-23 11:45:00
199,2,0,2,0.0023661419773464217,2019-03-23 11:30:00,2019-03-23 11:45:00
203,10,5,5,0.014271533989846683,2019-03-23 11:30:00,2019-03-23 11:45:00
1,3,3,0,0.006811031418857598,2019-03-23 11:45:00,2019-03-23 12:00:00
2,2,2,0,0.004085614492953671,2019-03-23 11:45:00,2019-03-23 12:00:00
5,5,3,2,0.004944216285739514,2019-03-23 11:45:00,2019-03-23 12:00:00
11,4,3,1,0.020587042458498545,2019-03-23 11:45:00,2019-03-23 12:00:00
15,2,1,1,0.006889937344403399,2019-03-23 11:45:00,2019-03-23 12:00:00
16,4,3,1,0.005506854430905782,2019-03-23 11:45:00,2019-03-23 12:00:00
18,5,2,3,0.0053763988971806675,2019-03-23 11:45:00,2019-03-23 12:00:00
19,5,1,4,0.007412153784635084,2019-03-23 11:45:00,2019-03-23 12:00:00
20,4,0,4,0.0022083352729776995,2019-03-23 11:45:00,2019-03-23 12:00:00
22,1,0,1,0.0022083352729776995,2019-03-23 11:45:00,2019-03-23 12:00:00
23,10,5,5,0.01056994930914943,2019-03-23 11:45:00,2019-03-23 12:00:00
26,2,2,0,0.0043202615155323604,2019-03-23 11:45:00,2019-03-23 12:00:00
27,1,1,0,0.0031469748829656852,2019-03-23 11:45:00,2019-03-23 12:00:00
28,2,0,2,0.0022083352729776995,2019-03-23 11:45:00,2019-03-23 12:00:00
35,3,2,1,0.0033419754485765254,2019-03-23 11:45:00,2019-03-23 12:00:00
40,1,1,0,0.008065838012096717,2019-03-23 11:45:00,2019-03-23 12:00:00
41,3,1,2,0.004005576675751528,2019-03-23 11:45:00,2019-03-23 12:00:00
46,3,1,2,0.004085614492953671,2019-03-23 11:45:00,2019-03-23 12:00:00
50,4,2,2,0.014710632300017935,2019-03-23 11:45:00,2019-03-23 12:00:00
57,3,0,3,0.0022083352729776995,2019-03-23 11:45:00,2019-03-23 12:00:00
58,8,2,6,0.0030815417850602,2019-03-23 11:45:00,2019-03-23 12:00:00
61,4,0,4,0.0022083352729776995,2019-03-23 11:45:00,2019-03-23 12:00:00
62,13,3,10,0.0051929183289284656,2019-03-23 11:45:00,2019-03-23 12:00:00
64,2,0,2,0.0022083352729776995,2019-03-23 11:45:00,2019-03-23 12:00:00
66,2,2,0,0.0033419754485765254,2019-03-23 11:45:00,2019-03-23 12:00:00
67,4,3,1,0.04462289518788129,2019-03-23 11:45:00,2019-03-23 12:00:00
68,2,1,1,0.014710632300017935,2019-03-23 11:45:00,2019-03-23 12:00:00
69,5,2,3,0.005097330238284974,2019-03-23 11:45:00,2019-03-23 12:00:00
74,1,0,1,0.0022083352729776995,2019-03-23 11:45:00,2019-03-23 12:00:00
75,2,0,2,0.0022083352729776995,2019-03-23 11:45:00,2019-03-23 12:00:00
80,2,1,1,0.014710632300017935,2019-03-23 11:45:00,2019-03-23 12:00:00
85,4,0,4,0.0022083352729776995,2019-03-23 11:45:00,2019-03-23 12:00:00
86,4,3,1,0.027212929327058166,2019-03-23 11:45:00,2019-03-23 12:00:00
87,5,2,3,0.005802818078525358,2019-03-23 11:45:00,2019-03-23 12:00:00
88,2,0,2,0.0022083352729776995,2019-03-23 11:45:00,2019-03-23 12:00:00
89,4,2,2,0.0044589841706588335,2019-03-23 11:45:00,2019-03-23 12:00:00
90,2,1,1,0.014710632300017935,2019-03-23 11:45:00,2019-03-23 12:00:00
99,6,6,0,0.010129778956106084,2019-03-23 11:45:00,2019-03-23 12:00:00
108,2,0,2,0.0022083352729776995,2019-03-23 11:45:00,2019-03-23 12:00:00
109,8,5,3,0.009826242129571252,2019-03-23 11:45:00,2019-03-23 12:00:00
110,6,5,1,0.06317268237973024,2019-03-23 11:45:00,2019-03-23 12:00:00
111,3,1,2,0.0033336597218182667,2019-03-23 11:45:00,2019-03-23 12:00:00
112,4,4,0,0.007407391195583281,2019-03-23 11:45:00,2019-03-23 12:00:00
113,2,2,0,0.0030815417850602,2019-03-23 11:45:00,2019-03-23 12:00:00
114,5,4,1,0.005203206738514101,2019-03-23 11:45:00,2019-03-23 12:00:00
116,7,4,3,0.008908872186838836,2019-03-23 11:45:00,2019-03-23 12:00:00
118,2,1,1,0.004484590414482811,2019-03-23 11:45:00,2019-03-23 12:00:00
119,6,1,5,0.0033336597218182667,2019-03-23 11:45:00,2019-03-23 12:00:00
120,7,5,2,0.052214126573985775,2019-03-23 11:45:00,2019-03-23 12:00:00
122,2,2,0,0.007777620405038455,2019-03-23 11:45:00,2019-03-23 12:00:00
126,7,3,4,0.0049685597159354125,2019-03-23 11:45:00,2019-03-23 12:00:00
137,18,10,8,0.01058877432600041,2019-03-23 11:45:00,2019-03-23 12:00:00
138,7,6,1,0.046618293699997454,2019-03-23 11:45:00,2019-03-23 12:00:00
140,1,0,1,0.0022083352729776995,2019-03-23 11:45:00,2019-03-23 12:00:00
141,8,5,3,0.008877536094758855,2019-03-23 11:45:00,2019-03-23 12:00:00
151,1,1,0,0.005483763264646348,2019-03-23 11:45:00,2019-03-23 12:00:00
153,6,2,4,0.005360366835725018,2019-03-23 11:45:00,2019-03-23 12:00:00
154,3,1,2,0.0026776550779716926,2019-03-23 11:45:00,2019-03-23 12:00:00
157,1,1,0,0.00283409501296969,2019-03-23 11:45:00,2019-03-23 12:00:00
158,1,0,1,0.0022083352729776995,2019-03-23 11:45:00,2019-03-23 12:00:00
159,2,2,0,0.005681518179070227,2019-03-23 11:45:00,2019-03-23 12:00:00
162,1,0,1,0.0022083352729776995,2019-03-23 11:45:00,2019-03-23 12:00:00
164,5,2,3,0.0032117586168183628,2019-03-23 11:45:00,2019-03-23 12:00:00
168,6,4,2,0.039930385797983727,2019-03-23 11:45:00,2019-03-23 12:00:00
169,4,3,1,0.00890201205388372,2019-03-23 11:45:00,2019-03-23 12:00:00
170,2,1,1,0.0038527914149055556,2019-03-23 11:45:00,2019-03-23 12:00:00
171,2,1,1,0.0026776550779716926,2019-03-23 11:45:00,2019-03-23 12:00:00
172,1,0,1,0.0022083352729776995,2019-03-23 11:45:00,2019-03-23 12:00:00
173,5,1,4,0.002804320735933898,2019-03-23 11:45:00,2019-03-23 12:00:00
177,2,1,1,0.003910997184417585,2019-03-23 11:45:00,2019-03-23 12:00:00
189,2,2,0,0.0034598547529616805,2019-03-23 11:45:00,2019-03-23 12:00:00
190,3,1,2,0.0043099731059467235,2019-03-23 11:45:00,2019-03-23 12:00:00
191,5,1,4,0.002804320735933898,2019-03-23 11:45:00,2019-03-23 12:00:00
196,3,1,2,0.004085614492953671,2019-03-23 11:45:00,2019-03-23 12:00:00
197,8,6,2,0.042690907938903344,2019-03-23 11:45:00,2019-03-23 12:00:00
199,2,0,2,0.0022083352729776995,2019-03-23 11:45:00,2019-03-23 12:00:00
202,1,0,1,0.0022083352729776995,2019-03-23 11:45:00,2019-03-23 12:00:00
203,10,5,5,0.030591833151730384,2019-03-23 11:45:00,2019-03-23 12:00:00
1,3,3,0,0.006333935832770117,2019-03-23 12:00:00,2019-03-23 12:15:00
2,4,2,2,0.004293575073296734,2019-03-23 12:00:00,2019-03-23 12:15:00
5,6,4,2,0.007104944303299086,2019-03-23 12:00:00,2019-03-23 12:15:00
11,4,3,1,0.032905060320266556,2019-03-23 12:00:00,2019-03-23 12:15:00
15,3,0,3,0.002320754283423125,2019-03-23 12:00:00,2019-03-23 12:15:00
16,2,2,0,0.0038333591806506916,2019-03-23 12:00:00,2019-03-23 12:15:00
18,6,2,4,0.0037424184011992582,2019-03-23 12:00:00,2019-03-23 12:15:00
19,5,1,4,0.006498698082860155,2019-03-23 12:00:00,2019-03-23 12:15:00
20,3,0,3,0.002320754283423125,2019-03-23 12:00:00,2019-03-23 12:15:00
23,3,1,2,0.004293575073296734,2019-03-23 12:00:00,2019-03-23 12:15:00
27,1,1,0,0.0033071646783599295,2019-03-23 12:00:00,2019-03-23 12:15:00
28,2,0,2,0.002320754283423125,2019-03-23 12:00:00,2019-03-23 12:15:00
35,1,0,1,0.002320754283423125,2019-03-23 12:00:00,2019-03-23 12:15:00
41,3,1,2,0.002947068483219667,2019-03-23 12:00:00,2019-03-23 12:15:00
46,2,0,2,0.002320754283423125,2019-03-23 12:00:00,2019-03-23 12:15:00
50,5,2,3,0.005356654999583448,2019-03-23 12:00:00,2019-03-23 12:15:00
57,1,0,1,0.002320754283423125,2019-03-23 12:00:00,2019-03-23 12:15:00
58,13,5,8,0.004951726794876936,2019-03-23 12:00:00,2019-03-23 12:15:00
61,2,0,2,0.002320754283423125,2019-03-23 12:00:00,2019-03-23 12:15:00
62,13,6,7,0.010790139593551152,2019-03-23 12:00:00,2019-03-23 12:15:00
64,2,0,2,0.002320754283423125,2019-03-23 12:00:00,2019-03-23 12:15:00
66,2,2,0,0.007013953637544024,2019-03-23 12:00:00,2019-03-23 12:15:00
67,3,2,1,0.005645607095598899,2019-03-23 12:00:00,2019-03-23 12:15:00
68,4,2,2,0.009826109609554554,2019-03-23 12:00:00,2019-03-23 12:15:00
69,4,2,2,0.015459856609358473,2019-03-23 12:00:00,2019-03-23 12:15:00
75,2,0,2,0.002320754283423125,2019-03-23 12:00:00,2019-03-23 12:15:00
80,2,1,1,0.015459856609358473,2019-03-23 12:00:00,2019-03-23 12:15:00
85,2,0,2,0.002320754283423125,2019-03-23 12:00:00,2019-03-23 12:15:00
86,3,1,2,0.004036445535832055,2019-03-23 12:00:00,2019-03-23 12:15:00
87,5,1,4,0.002947068483219667,2019-03-23 12:00:00,2019-03-23 12:15:00
88,3,1,2,0.002978361213380995,2019-03-23 12:00:00,2019-03-23 12:15:00
89,4,2,2,0.00507164346253984,2019-03-23 12:00:00,2019-03-23 12:15:00
90,4,2,2,0.015459856609358473,2019-03-23 12:00:00,2019-03-23 12:15:00
99,6,6,0,0.009705830393813387,2019-03-23 12:00:00,2019-03-23 12:15:00
109,2,0,2,0.002320754283423125,2019-03-23 12:00:00,2019-03-23 12:15:00
110,6,3,3,0.005073674595364114,2019-03-23 12:00:00,2019-03-23 12:15:00
111,2,2,0,0.005133905325006732,2019-03-23 12:00:00,2019-03-23 12:15:00
112,2,2,0,0.005790396718771934,2019-03-23 12:00:00,2019-03-23 12:15:00
113,2,2,0,0.0033731432880046495,2019-03-23 12:00:00,2019-03-23 12:15:00
114,7,5,2,0.014276332248306536,2019-03-23 12:00:00,2019-03-23 12:15:00
116,7,3,4,0.007043025118365017,2019-03-23 12:00:00,2019-03-23 12:15:00
118,3,2,1,0.006384751913018561,2019-03-23 12:00:00,2019-03-23 12:15:00
119,7,4,3,0.008280761639955211,2019-03-23 12:00:00,2019-03-23 12:15:00
120,9,6,3,0.06836459756352682,2019-03-23 12:00:00,2019-03-23 12:15:00
122,2,2,0,0.004293575073296734,2019-03-23 12:00:00,2019-03-23 12:15:00
126,4,2,2,0.010362360293885835,2019-03-23 12:00:00,2019-03-23 12:15:00
127,1,0,1,0.002320754283423125,2019-03-23 12:00:00,2019-03-23 12:15:00
137,15,8,7,0.011325245695235506,2019-03-23 12:00:00,2019-03-23 12:15:00
138,8,6,2,0.07627713962458288,2019-03-23 12:00:00,2019-03-23 12:15:00
140,1,0,1,0.002320754283423125,2019-03-23 12:00:00,2019-03-23 12:15:00
141,10,5,5,0.00977769905989458,2019-03-23 12:00:00,2019-03-23 12:15:00
147,1,1,0,0.008389539504012226,2019-03-23 12:00:00,2019-03-23 12:15:00
153,8,4,4,0.007259324388072514,2019-03-23 12:00:00,2019-03-23 12:15:00
154,5,5,0,0.00687825512017181,2019-03-23 12:00:00,2019-03-23 12:15:00
157,3,2,1,0.028598958935293822,2019-03-23 12:00:00,2019-03-23 12:15:00
158,1,0,1,0.002320754283423125,2019-03-23 12:00:00,2019-03-23 12:15:00
159,2,2,0,0.005716233535518543,2019-03-23 12:00:00,2019-03-23 12:15:00
161,1,1,0,0.0041457131184886725,2019-03-23 12:00:00,2019-03-23 12:15:00
162,1,0,1,0.002320754283423125,2019-03-23 12:00:00,2019-03-23 12:15:00
164,6,2,4,0.005927063915281529,2019-03-23 12:00:00,2019-03-23 12:15:00
168,8,6,2,0.06244905329116802,2019-03-23 12:00:00,2019-03-23 12:15:00
169,5,4,1,0.006905097410332706,2019-03-23 12:00:00,2019-03-23 12:15:00
170,1,1,0,0.002947068483219667,2019-03-23 12:00:00,2019-03-23 12:15:00
171,2,1,1,0.0033071646783599295,2019-03-23 12:00:00,2019-03-23 12:15:00
172,3,0,3,0.002320754283423125,2019-03-23 12:00:00,2019-03-23 12:15:00
173,4,1,3,0.0032383943874034547,2019-03-23 12:00:00,2019-03-23 12:15:00
177,1,0,1,0.002320754283423125,2019-03-23 12:00:00,2019-03-23 12:15:00
190,4,1,3,0.0053406999287623665,2019-03-23 12:00:00,2019-03-23 12:15:00
191,6,1,5,0.0027961451278064957,2019-03-23 12:00:00,2019-03-23 12:15:00
196,5,2,3,0.005991314699344443,2019-03-23 12:00:00,2019-03-23 12:15:00
197,7,4,3,0.011738590153423281,2019-03-23 12:00:00,2019-03-23 12:15:00
202,1,0,1,0.002320754283423125,2019-03-23 12:00:00,2019-03-23 12:15:00
203,9,5,4,0.054538722575868795,2019-03-23 12:00:00,2019-03-23 12:15:00
1,3,3,0,0.0035896809525568485,2019-03-23 12:15:00,2019-03-23 12:30:00
2,6,2,4,0.003845896829450895,2019-03-23 12:15:00,2019-03-23 12:30:00
5,5,4,1,0.015564129907881299,2019-03-23 12:15:00,2019-03-23 12:30:00
11,8,5,3,0.06872204109738068,2019-03-23 12:15:00,2019-03-23 12:30:00
15,6,2,4,0.0058300901478769915,2019-03-23 12:15:00,2019-03-23 12:30:00
16,5,3,2,0.022554770356208797,2019-03-23 12:15:00,2019-03-23 12:30:00
18,3,0,3,0.002211238235481638,2019-03-23 12:15:00,2019-03-23 12:30:00
19,1,1,0,0.004176302047550801,2019-03-23 12:15:00,2019-03-23 12:30:00
20,4,1,3,0.004090932849675107,2019-03-23 12:15:00,2019-03-23 12:30:00
23,6,5,1,0.012111122733276265,2019-03-23 12:15:00,2019-03-23 12:30:00
28,3,0,3,0.002211238235481638,2019-03-23 12:15:00,2019-03-23 12:30:00
35,1,0,1,0.002211238235481638,2019-03-23 12:15:00,2019-03-23 12:30:00
41,3,1,2,0.003641694268166096,2019-03-23 12:15:00,2019-03-23 12:30:00
46,7,2,5,0.006918262612367271,2019-03-23 12:15:00,2019-03-23 12:30:00
50,5,2,3,0.005103618219233925,2019-03-23 12:15:00,2019-03-23 12:30:00
57,2,0,2,0.002211238235481638,2019-03-23 12:15:00,2019-03-23 12:30:00
58,10,4,6,0.005103618219233925,2019-03-23 12:15:00,2019-03-23 12:30:00
61,1,0,1,0.002211238235481638,2019-03-23 12:15:00,2019-03-23 12:30:00
62,18,12,6,0.028696617047499186,2019-03-23 12:15:00,2019-03-23 12:30:00
64,6,2,4,0.003845896829450895,2019-03-23 12:15:00,2019-03-23 12:30:00
67,3,2,1,0.005024045041397834,2019-03-23 12:15:00,2019-03-23 12:30:00
68,4,2,2,0.004623189852533476,2019-03-23 12:15:00,2019-03-23 12:30:00
69,7,4,3,0.014052483383790592,2019-03-23 12:15:00,2019-03-23 12:30:00
70,1,1,0,0.006193399102576023,2019-03-23 12:15:00,2019-03-23 12:30:00
75,7,7,0,0.019474359018611182,2019-03-23 12:15:00,2019-03-23 12:30:00
80,2,1,1,0.014727121521075344,2019-03-23 12:15:00,2019-03-23 12:30:00
85,2,0,2,0.002211238235481638,2019-03-23 12:15:00,2019-03-23 12:30:00
86,3,1,2,0.003845896829450895,2019-03-23 12:15:00,2019-03-23 12:30:00
87,5,2,3,0.005048097671124194,2019-03-23 12:15:00,2019-03-23 12:30:00
88,4,2,2,0.00532994919368279,2019-03-23 12:15:00,2019-03-23 12:30:00
90,3,2,1,0.02249268718245475,2019-03-23 12:15:00,2019-03-23 12:30:00
99,9,6,3,0.013552246942189544,2019-03-23 12:15:00,2019-03-23 12:30:00
104,2,2,0,0.009891871939452259,2019-03-23 12:15:00,2019-03-23 12:30:00
106,2,1,1,0.014727121521075344,2019-03-23 12:15:00,2019-03-23 12:30:00
108,2,0,2,0.002211238235481638,2019-03-23 12:15:00,2019-03-23 12:30:00
109,6,2,4,0.00456370517688032,2019-03-23 12:15:00,2019-03-23 12:30:00
110,8,3,5,0.005649847504130878,2019-03-23 12:15:00,2019-03-23 12:30:00
112,3,3,0,0.004835800310859005,2019-03-23 12:15:00,2019-03-23 12:30:00
113,5,3,2,0.005537122841551251,2019-03-23 12:15:00,2019-03-23 12:30:00
114,6,2,4,0.004544328891753761,2019-03-23 12:15:00,2019-03-23 12:30:00
116,9,2,7,0.005638810344029013,2019-03-23 12:15:00,2019-03-23 12:30:00
118,3,2,1,0.004863145457813609,2019-03-23 12:15:00,2019-03-23 12:30:00
119,4,3,1,0.010484446247687542,2019-03-23 12:15:00,2019-03-23 12:30:00
120,5,3,2,0.04224261491167707,2019-03-23 12:15:00,2019-03-23 12:30:00
122,1,0,1,0.002211238235481638,2019-03-23 12:15:00,2019-03-23 12:30:00
126,5,2,3,0.0041168471677540674,2019-03-23 12:15:00,2019-03-23 12:30:00
127,1,0,1,0.002211238235481638,2019-03-23 12:15:00,2019-03-23 12:30:00
137,16,11,5,0.01434905054464965,2019-03-23 12:15:00,2019-03-23 12:30:00
138,9,6,3,0.03751437908614831,2019-03-23 12:15:00,2019-03-23 12:30:00
140,1,0,1,0.002211238235481638,2019-03-23 12:15:00,2019-03-23 12:30:00
141,11,5,6,0.009926428570990199,2019-03-23 12:15:00,2019-03-23 12:30:00
147,2,1,1,0.0031769998606573325,2019-03-23 12:15:00,2019-03-23 12:30:00
153,4,2,2,0.004283993098755605,2019-03-23 12:15:00,2019-03-23 12:30:00
154,5,3,2,0.004257090828592162,2019-03-23 12:15:00,2019-03-23 12:30:00
157,7,4,3,0.020985063163872192,2019-03-23 12:15:00,2019-03-23 12:30:00
159,2,2,0,0.00576145946029161,2019-03-23 12:15:00,2019-03-23 12:30:00
161,1,1,0,0.0030285675324662666,2019-03-23 12:15:00,2019-03-23 12:30:00
162,2,0,2,0.002211238235481638,2019-03-23 12:15:00,2019-03-23 12:30:00
164,3,1,2,0.012843661030798245,2019-03-23 12:15:00,2019-03-23 12:30:00
168,14,5,9,0.010269622376809867,2019-03-23 12:15:00,2019-03-23 12:30:00
169,8,7,1,0.008921679399259723,2019-03-23 12:15:00,2019-03-23 12:30:00
170,2,2,0,0.006081335412273478,2019-03-23 12:15:00,2019-03-23 12:30:00
171,6,2,4,0.005194962577653173,2019-03-23 12:15:00,2019-03-23 12:30:00
172,3,0,3,0.002211238235481638,2019-03-23 12:15:00,2019-03-23 12:30:00
173,5,2,3,0.0041168471677540674,2019-03-23 12:15:00,2019-03-23 12:30:00
177,1,0,1,0.002211238235481638,2019-03-23 12:15:00,2019-03-23 12:30:00
189,8,4,4,0.007561007643247696,2019-03-23 12:15:00,2019-03-23 12:30:00
190,5,0,5,0.002211238235481638,2019-03-23 12:15:00,2019-03-23 12:30:00
191,8,3,5,0.004174011839133634,2019-03-23 12:15:00,2019-03-23 12:30:00
196,3,1,2,0.004176302047550801,2019-03-23 12:15:00,2019-03-23 12:30:00
197,5,2,3,0.005103618219233925,2019-03-23 12:15:00,2019-03-23 12:30:00
200,2,2,0,0.004090932849675107,2019-03-23 12:15:00,2019-03-23 12:30:00
202,1,0,1,0.002211238235481638,2019-03-23 12:15:00,2019-03-23 12:30:00
203,13,8,5,0.07608839273850827,2019-03-23 12:15:00,2019-03-23 12:30:00
1,4,4,0,0.00393545631144091,2019-03-23 12:30:00,2019-03-23 12:45:00
2,3,0,3,0.0021360706638394403,2019-03-23 12:30:00,2019-03-23 12:45:00
5,2,1,1,0.014226858072787193,2019-03-23 12:30:00,2019-03-23 12:45:00
11,8,5,3,0.032156285962766575,2019-03-23 12:30:00,2019-03-23 12:45:00
15,12,5,7,0.011361252286901071,2019-03-23 12:30:00,2019-03-23 12:45:00
16,7,5,2,0.030318354599427617,2019-03-23 12:30:00,2019-03-23 12:45:00
18,5,2,3,0.004594517468721836,2019-03-23 12:30:00,2019-03-23 12:45:00
19,2,1,1,0.003300086727747297,2019-03-23 12:30:00,2019-03-23 12:45:00
20,4,1,3,0.003951855843868632,2019-03-23 12:30:00,2019-03-23 12:45:00
23,13,6,7,0.010121536901845182,2019-03-23 12:30:00,2019-03-23 12:45:00
27,1,1,0,0.0025736174264190167,2019-03-23 12:30:00,2019-03-23 12:45:00
28,6,1,5,0.0025736174264190167,2019-03-23 12:30:00,2019-03-23 12:45:00
35,10,3,7,0.0033602664492105782,2019-03-23 12:30:00,2019-03-23 12:45:00
41,4,0,4,0.0021360706638394403,2019-03-23 12:30:00,2019-03-23 12:45:00
46,11,3,8,0.006705207638364795,2019-03-23 12:30:00,2019-03-23 12:45:00
50,6,3,3,0.010896245706231208,2019-03-23 12:30:00,2019-03-23 12:45:00
57,2,1,1,0.005341882244346048,2019-03-23 12:30:00,2019-03-23 12:45:00
58,11,5,6,0.006327057429701013,2019-03-23 12:30:00,2019-03-23 12:45:00
61,1,0,1,0.0021360706638394403,2019-03-23 12:30:00,2019-03-23 12:45:00
62,22,14,8,0.012677429091153842,2019-03-23 12:30:00,2019-03-23 12:45:00
64,7,3,4,0.005893918173490441,2019-03-23 12:30:00,2019-03-23 12:45:00
67,6,3,3,0.006911784468833316,2019-03-23 12:30:00,2019-03-23 12:45:00
68,2,1,1,0.003533066252459965,2019-03-23 12:30:00,2019-03-23 12:45:00
69,13,7,6,0.011582768377330677,2019-03-23 12:30:00,2019-03-23 12:45:00
70,1,1,0,0.0037771469029290504,2019-03-23 12:30:00,2019-03-23 12:45:00
71,1,1,0,0.004094675279973008,2019-03-23 12:30:00,2019-03-23 12:45:00
75,11,9,2,0.12310728524872931,2019-03-23 12:30:00,2019-03-23 12:45:00
80,2,1,1,0.014226858072787193,2019-03-23 12:30:00,2019-03-23 12:45:00
85,2,1,1,0.014226858072787193,2019-03-23 12:30:00,2019-03-23 12:45:00
86,3,1,2,0.003715138526810072,2019-03-23 12:30:00,2019-03-23 12:45:00
87,7,5,2,0.014385301613685878,2019-03-23 12:30:00,2019-03-23 12:45:00
88,1,1,0,0.0035160917689940245,2019-03-23 12:30:00,2019-03-23 12:45:00
89,2,2,0,0.00818402903826448,2019-03-23 12:30:00,2019-03-23 12:45:00
90,6,3,3,0.010671182182658372,2019-03-23 12:30:00,2019-03-23 12:45:00
99,4,2,2,0.004464102791655154,2019-03-23 12:30:00,2019-03-23 12:45:00
104,2,2,0,0.005930953054017389,2019-03-23 12:30:00,2019-03-23 12:45:00
106,7,2,5,0.003236602889657236,2019-03-23 12:30:00,2019-03-23 12:45:00
108,4,2,2,0.003236602889657236,2019-03-23 12:30:00,2019-03-23 12:45:00
109,14,8,6,0.008675624999924594,2019-03-23 12:30:00,2019-03-23 12:45:00
110,8,3,5,0.005899248408171643,2019-03-23 12:30:00,2019-03-23 12:45:00
111,2,0,2,0.0021360706638394403,2019-03-23 12:30:00,2019-03-23 12:45:00
112,5,4,1,0.006855752948193602,2019-03-23 12:30:00,2019-03-23 12:45:00
113,4,2,2,0.003928933183432028,2019-03-23 12:30:00,2019-03-23 12:45:00
114,1,0,1,0.0021360706638394403,2019-03-23 12:30:00,2019-03-23 12:45:00
116,6,0,6,0.0021360706638394403,2019-03-23 12:30:00,2019-03-23 12:45:00
118,4,2,2,0.003399512354295005,2019-03-23 12:30:00,2019-03-23 12:45:00
119,7,6,1,0.012390560006505659,2019-03-23 12:30:00,2019-03-23 12:45:00
120,5,3,2,0.02384641613845402,2019-03-23 12:30:00,2019-03-23 12:45:00
126,7,2,5,0.004859748433883228,2019-03-23 12:30:00,2019-03-23 12:45:00
127,3,2,1,0.0054182231420186605,2019-03-23 12:30:00,2019-03-23 12:45:00
137,16,12,4,0.015084041979221004,2019-03-23 12:30:00,2019-03-23 12:45:00
138,11,7,4,0.011997644432207962,2019-03-23 12:30:00,2019-03-23 12:45:00
141,8,2,6,0.00785500903206995,2019-03-23 12:30:00,2019-03-23 12:45:00
147,1,0,1,0.0021360706638394403,2019-03-23 12:30:00,2019-03-23 12:45:00
151,1,0,1,0.0021360706638394403,2019-03-23 12:30:00,2019-03-23 12:45:00
153,2,2,0,0.005914874537477534,2019-03-23 12:30:00,2019-03-23 12:45:00
154,3,0,3,0.0021360706638394403,2019-03-23 12:30:00,2019-03-23 12:45:00
157,10,5,5,0.020879429819674417,2019-03-23 12:30:00,2019-03-23 12:45:00
158,1,1,0,0.005686608808367645,2019-03-23 12:30:00,2019-03-23 12:45:00
159,2,2,0,0.006505032382050463,2019-03-23 12:30:00,2019-03-23 12:45:00
160,6,3,3,0.009121048606942064,2019-03-23 12:30:00,2019-03-23 12:45:00
161,1,1,0,0.0027413323905158375,2019-03-23 12:30:00,2019-03-23 12:45:00
162,2,0,2,0.0021360706638394403,2019-03-23 12:30:00,2019-03-23 12:45:00
164,7,5,2,0.0096027596346836,2019-03-23 12:30:00,2019-03-23 12:45:00
168,15,4,11,0.011052770638890012,2019-03-23 12:30:00,2019-03-23 12:45:00
169,8,7,1,0.008773291923989037,2019-03-23 12:30:00,2019-03-23 12:45:00
170,2,2,0,0.011456585907133046,2019-03-23 12:30:00,2019-03-23 12:45:00
171,7,2,5,0.004761351239316898,2019-03-23 12:30:00,2019-03-23 12:45:00
172,4,1,3,0.002438701527177639,2019-03-23 12:30:00,2019-03-23 12:45:00
173,3,2,1,0.004859748433883228,2019-03-23 12:30:00,2019-03-23 12:45:00
175,2,1,1,0.014226858072787193,2019-03-23 12:30:00,2019-03-23 12:45:00
177,1,0,1,0.0021360706638394403,2019-03-23 12:30:00,2019-03-23 12:45:00
189,11,4,7,0.007904603937648587,2019-03-23 12:30:00,2019-03-23 12:45:00
190,4,0,4,0.0021360706638394403,2019-03-23 12:30:00,2019-03-23 12:45:00
191,8,4,4,0.005477127322614758,2019-03-23 12:30:00,2019-03-23 12:45:00
196,3,1,2,0.005139456636784823,2019-03-23 12:30:00,2019-03-23 12:45:00
197,5,2,3,0.0049300618410804894,2019-03-23 12:30:00,2019-03-23 12:45:00
199,1,0,1,0.0021360706638394403,2019-03-23 12:30:00,2019-03-23 12:45:00
200,2,2,0,0.004887401228383928,2019-03-23 12:30:00,2019-03-23 12:45:00
202,2,2,0,0.004594488773288224,2019-03-23 12:30:00,2019-03-23 12:45:00
203,14,8,6,0.037078177140857004,2019-03-23 12:30:00,2019-03-23 12:45:00
1,3,3,0,0.002834577934256905,2019-03-23 12:45:00,2019-03-23 13:00:00
2,5,0,5,0.0018092779112691567,2019-03-23 12:45:00,2019-03-23 13:00:00
5,4,1,3,0.0025246215548645084,2019-03-23 12:45:00,2019-03-23 13:00:00
11,6,3,3,0.012058188268708043,2019-03-23 12:45:00,2019-03-23 13:00:00
15,6,1,5,0.0032270776232922664,2019-03-23 12:45:00,2019-03-23 13:00:00
16,11,9,2,0.07133598946758213,2019-03-23 12:45:00,2019-03-23 13:00:00
18,8,3,5,0.006162894337695042,2019-03-23 12:45:00,2019-03-23 13:00:00
19,3,2,1,0.004963644176308529,2019-03-23 12:45:00,2019-03-23 13:00:00
20,6,3,3,0.004777915232941483,2019-03-23 12:45:00,2019-03-23 13:00:00
22,1,0,1,0.0018092779112691567,2019-03-23 12:45:00,2019-03-23 13:00:00
23,12,5,7,0.004142547340104955,2019-03-23 12:45:00,2019-03-23 13:00:00
26,2,2,0,0.002834577934256905,2019-03-23 12:45:00,2019-03-23 13:00:00
28,4,1,3,0.0025246215548645084,2019-03-23 12:45:00,2019-03-23 13:00:00
35,8,3,5,0.00411620296299159,2019-03-23 12:45:00,2019-03-23 13:00:00
40,1,0,1,0.0018092779112691567,2019-03-23 12:45:00,2019-03-23 13:00:00
41,6,0,6,0.0018092779112691567,2019-03-23 12:45:00,2019-03-23 13:00:00
46,12,4,8,0.005441658224147611,2019-03-23 12:45:00,2019-03-23 13:00:00
50,8,3,5,0.0036839930932803227,2019-03-23 12:45:00,2019-03-23 13:00:00
57,2,1,1,0.003391060690783847,2019-03-23 12:45:00,2019-03-23 13:00:00
58,8,3,5,0.003906554872116202,2019-03-23 12:45:00,2019-03-23 13:00:00
61,1,0,1,0.0018092779112691567,2019-03-23 12:45:00,2019-03-23 13:00:00
62,14,10,4,0.020255572463079557,2019-03-23 12:45:00,2019-03-23 13:00:00
64,5,2,3,0.004175673927490856,2019-03-23 12:45:00,2019-03-23 13:00:00
66,4,0,4,0.0018092779112691567,2019-03-23 12:45:00,2019-03-23 13:00:00
67,11,7,4,0.007624781221669128,2019-03-23 12:45:00,2019-03-23 13:00:00
68,1,1,0,0.0024779883920114155,2019-03-23 12:45:00,2019-03-23 13:00:00
69,10,5,5,0.005734747873023118,2019-03-23 12:45:00,2019-03-23 13:00:00
71,1,1,0,0.0034298516873426874,2019-03-23 12:45:00,2019-03-23 13:00:00
74,1,1,0,0.003347227945750779,2019-03-23 12:45:00,2019-03-23 13:00:00
75,14,12,2,0.2217366243065865,2019-03-23 12:45:00,2019-03-23 13:00:00
80,3,1,2,0.0031466988727536747,2019-03-23 12:45:00,2019-03-23 13:00:00
85,1,0,1,0.0018092779112691567,2019-03-23 12:45:00,2019-03-23 13:00:00
86,2,1,1,0.012058188268708043,2019-03-23 12:45:00,2019-03-23 13:00:00
87,13,8,5,0.0194471659952564,2019-03-23 12:45:00,2019-03-23 13:00:00
88,5,2,3,0.003939728893230594,2019-03-23 12:45:00,2019-03-23 13:00:00
89,4,2,2,0.006513677663164263,2019-03-23 12:45:00,2019-03-23 13:00:00
90,6,4,2,0.004554335992010611,2019-03-23 12:45:00,2019-03-23 13:00:00
99,2,0,2,0.0018092779112691567,2019-03-23 12:45:00,2019-03-23 13:00:00
104,5,2,3,0.003347227945750779,2019-03-23 12:45:00,2019-03-23 13:00:00
106,3,0,3,0.0018092779112691567,2019-03-23 12:45:00,2019-03-23 13:00:00
108,5,3,2,0.003783004544274059,2019-03-23 12:45:00,2019-03-23 13:00:00
109,17,9,8,0.00864946849426338,2019-03-23 12:45:00,2019-03-23 13:00:00
110,7,2,5,0.002906614316162651,2019-03-23 12:45:00,2019-03-23 13:00:00
111,2,0,2,0.0018092779112691567,2019-03-23 12:45:00,2019-03-23 13:00:00
112,7,5,2,0.006806045355363841,2019-03-23 12:45:00,2019-03-23 13:00:00
113,4,4,0,0.004975823488414922,2019-03-23 12:45:00,2019-03-23 13:00:00
114,3,0,3,0.0018092779112691567,2019-03-23 12:45:00,2019-03-23 13:00:00
116,7,2,5,0.0069433530797162624,2019-03-23 12:45:00,2019-03-23 13:00:00
118,7,2,5,0.0028696759180902734,2019-03-23 12:45:00,2019-03-23 13:00:00
119,11,10,1,0.02869379016929483,2019-03-23 12:45:00,2019-03-23 13:00:00
120,8,3,5,0.003480634866746743,2019-03-23 12:45:00,2019-03-23 13:00:00
122,1,1,0,0.002728399728038922,2019-03-23 12:45:00,2019-03-23 13:00:00
126,6,4,2,0.005112515821366653,2019-03-23 12:45:00,2019-03-23 13:00:00
127,3,2,1,0.003759243306456912,2019-03-23 12:45:00,2019-03-23 13:00:00
137,21,12,9,0.01674544005881443,2019-03-23 12:45:00,2019-03-23 13:00:00
138,18,11,7,0.020462914962661546,2019-03-23 12:45:00,2019-03-23 13:00:00
140,1,1,0,0.0037450525590733987,2019-03-23 12:45:00,2019-03-23 13:00:00
141,8,3,5,0.007583514058875109,2019-03-23 12:45:00,2019-03-23 13:00:00
147,1,0,1,0.0018092779112691567,2019-03-23 12:45:00,2019-03-23 13:00:00
151,3,1,2,0.0031466988727536747,2019-03-23 12:45:00,2019-03-23 13:00:00
153,4,3,1,0.005465293368718859,2019-03-23 12:45:00,2019-03-23 13:00:00
154,2,0,2,0.0018092779112691567,2019-03-23 12:45:00,2019-03-23 13:00:00
157,11,7,4,0.03126235828532979,2019-03-23 12:45:00,2019-03-23 13:00:00
158,4,2,2,0.009504695135664248,2019-03-23 12:45:00,2019-03-23 13:00:00
159,2,2,0,0.003347227945750779,2019-03-23 12:45:00,2019-03-23 13:00:00
160,9,3,6,0.0043908535085320066,2019-03-23 12:45:00,2019-03-23 13:00:00
161,1,1,0,0.0021168679181654813,2019-03-23 12:45:00,2019-03-23 13:00:00
162,1,0,1,0.0018092779112691567,2019-03-23 12:45:00,2019-03-23 13:00:00
164,8,7,1,0.007076151592647243,2019-03-23 12:45:00,2019-03-23 13:00:00
168,12,5,7,0.009024735433738561,2019-03-23 12:45:00,2019-03-23 13:00:00
169,8,7,1,0.007838987268672706,2019-03-23 12:45:00,2019-03-23 13:00:00
170,2,2,0,0.006698269178252926,2019-03-23 12:45:00,2019-03-23 13:00:00
171,8,3,5,0.004729535169594363,2019-03-23 12:45:00,2019-03-23 13:00:00
172,2,1,1,0.002989741088283938,2019-03-23 12:45:00,2019-03-23 13:00:00
173,5,1,4,0.002297524029692348,2019-03-23 12:45:00,2019-03-23 13:00:00
175,4,2,2,0.012058188268708043,2019-03-23 12:45:00,2019-03-23 13:00:00
177,1,0,1,0.0018092779112691567,2019-03-23 12:45:00,2019-03-23 13:00:00
189,6,2,4,0.004808860402806956,2019-03-23 12:45:00,2019-03-23 13:00:00
190,4,0,4,0.0018092779112691567,2019-03-23 12:45:00,2019-03-23 13:00:00
191,10,6,4,0.011833987932200243,2019-03-23 12:45:00,2019-03-23 13:00:00
195,2,0,2,0.0018092779112691567,2019-03-23 12:45:00,2019-03-23 13:00:00
196,2,0,2,0.0018092779112691567,2019-03-23 12:45:00,2019-03-23 13:00:00
197,6,2,4,0.0031466988727536747,2019-03-23 12:45:00,2019-03-23 13:00:00
199,2,1,1,0.012058188268708043,2019-03-23 12:45:00,2019-03-23 13:00:00
200,2,2,0,0.005024995199680103,2019-03-23 12:45:00,2019-03-23 13:00:00
202,2,2,0,0.002815399351189238,2019-03-23 12:45:00,2019-03-23 13:00:00
203,14,6,8,0.01334183953191423,2019-03-23 12:45:00,2019-03-23 13:00:00
1,5,3,2,0.0038851205423199348,2019-03-23 13:00:00,2019-03-23 13:15:00
2,4,0,4,0.001691959655656498,2019-03-23 13:00:00,2019-03-23 13:15:00
5,7,4,3,0.005780945942335512,2019-03-23 13:00:00,2019-03-23 13:15:00
11,6,3,3,0.011278277457096067,2019-03-23 13:00:00,2019-03-23 13:15:00
15,3,0,3,0.001691959655656498,2019-03-23 13:00:00,2019-03-23 13:15:00
16,9,7,2,0.04992926133252565,2019-03-23 13:00:00,2019-03-23 13:15:00
18,5,3,2,0.004600538168613963,2019-03-23 13:00:00,2019-03-23 13:15:00
19,5,4,1,0.004943850547950274,2019-03-23 13:00:00,2019-03-23 13:15:00
20,12,5,7,0.00681720982490924,2019-03-23 13:00:00,2019-03-23 13:15:00
22,1,0,1,0.001691959655656498,2019-03-23 13:00:00,2019-03-23 13:15:00
23,10,5,5,0.004711182410051914,2019-03-23 13:00:00,2019-03-23 13:15:00
26,4,3,1,0.017669155991389105,2019-03-23 13:00:00,2019-03-23 13:15:00
27,1,1,0,0.0019066586674486446,2019-03-23 13:00:00,2019-03-23 13:15:00
28,7,6,1,0.0243754545850694,2019-03-23 13:00:00,2019-03-23 13:15:00
35,6,1,5,0.0031301741972311918,2019-03-23 13:00:00,2019-03-23 13:15:00
40,1,0,1,0.001691959655656498,2019-03-23 13:00:00,2019-03-23 13:15:00
41,7,0,7,0.001691959655656498,2019-03-23 13:00:00,2019-03-23 13:15:00
46,9,5,4,0.004115093872381849,2019-03-23 13:00:00,2019-03-23 13:15:00
50,9,3,6,0.002811912374570583,2019-03-23 13:00:00,2019-03-23 13:15:00
57,2,1,1,0.0034259464055463587,2019-03-23 13:00:00,2019-03-23 13:15:00
58,6,2,4,0.002942648608703923,2019-03-23 13:00:00,2019-03-23 13:15:00
61,1,0,1,0.001691959655656498,2019-03-23 13:00:00,2019-03-23 13:15:00
62,15,9,6,0.016757145037335212,2019-03-23 13:00:00,2019-03-23 13:15:00
64,5,2,3,0.0039049447551238107,2019-03-23 13:00:00,2019-03-23 13:15:00
66,4,2,2,0.0033959342756672956,2019-03-23 13:00:00,2019-03-23 13:15:00
67,10,7,3,0.005537357314407526,2019-03-23 13:00:00,2019-03-23 13:15:00
68,2,0,2,0.001691959655656498,2019-03-23 13:00:00,2019-03-23 13:15:00
69,19,10,9,0.012936761814703442,2019-03-23 13:00:00,2019-03-23 13:15:00
70,1,1,0,0.0033676725023087414,2019-03-23 13:00:00,2019-03-23 13:15:00
71,1,1,0,0.0032610153792358198,2019-03-23 13:00:00,2019-03-23 13:15:00
74,1,1,0,0.0031301741972311918,2019-03-23 13:00:00,2019-03-23 13:15:00
75,26,18,8,0.2090849966301854,2019-03-23 13:00:00,2019-03-23 13:15:00
80,3,1,2,0.002942648608703923,2019-03-23 13:00:00,2019-03-23 13:15:00
85,5,2,3,0.0038031622850955033,2019-03-23 13:00:00,2019-03-23 13:15:00
86,6,3,3,0.00587276414413177,2019-03-23 13:00:00,2019-03-23 13:15:00
87,20,9,11,0.012425169089458083,2019-03-23 13:00:00,2019-03-23 13:15:00
88,3,0,3,0.001691959655656498,2019-03-23 13:00:00,2019-03-23 13:15:00
89,7,1,6,0.0019712270514330677,2019-03-23 13:00:00,2019-03-23 13:15:00
90,1,0,1,0.001691959655656498,2019-03-23 13:00:00,2019-03-23 13:15:00
99,3,1,2,0.002942648608703923,2019-03-23 13:00:00,2019-03-23 13:15:00
104,12,2,10,0.0025257522910214483,2019-03-23 13:00:00,2019-03-23 13:15:00
106,5,2,3,0.0039049447551238107,2019-03-23 13:00:00,2019-03-23 13:15:00
108,4,2,2,0.002121357679240791,2019-03-23 13:00:00,2019-03-23 13:15:00
109,15,10,5,0.009049952914834637,2019-03-23 13:00:00,2019-03-23 13:15:00
110,8,3,5,0.003307368091317885,2019-03-23 13:00:00,2019-03-23 13:15:00
112,5,3,2,0.008295054078878155,2019-03-23 13:00:00,2019-03-23 13:15:00
113,6,4,2,0.006019881179464972,2019-03-23 13:00:00,2019-03-23 13:15:00
114,3,0,3,0.001691959655656498,2019-03-23 13:00:00,2019-03-23 13:15:00
115,2,2,0,0.00351377524444527,2019-03-23 13:00:00,2019-03-23 13:15:00
116,9,3,6,0.012223892803260973,2019-03-23 13:00:00,2019-03-23 13:15:00
118,6,1,5,0.0023529638808419597,2019-03-23 13:00:00,2019-03-23 13:15:00
119,19,18,1,0.027527209795455886,2019-03-23 13:00:00,2019-03-23 13:15:00
120,7,3,4,0.003638388608395348,2019-03-23 13:00:00,2019-03-23 13:15:00
122,1,1,0,0.003230575941037023,2019-03-23 13:00:00,2019-03-23 13:15:00
126,8,4,4,0.004074603310228608,2019-03-23 13:00:00,2019-03-23 13:15:00
127,3,2,1,0.004136352006921673,2019-03-23 13:00:00,2019-03-23 13:15:00
135,7,2,5,0.004044007983198264,2019-03-23 13:00:00,2019-03-23 13:15:00
137,33,22,11,0.022434843379112394,2019-03-23 13:00:00,2019-03-23 13:15:00
138,17,11,6,0.011827159740459269,2019-03-23 13:00:00,2019-03-23 13:15:00
140,1,1,0,0.0031301741972311918,2019-03-23 13:00:00,2019-03-23 13:15:00
141,8,3,5,0.007893677056570184,2019-03-23 13:00:00,2019-03-23 13:15:00
147,1,0,1,0.001691959655656498,2019-03-23 13:00:00,2019-03-23 13:15:00
151,9,3,6,0.002942648608703923,2019-03-23 13:00:00,2019-03-23 13:15:00
153,5,4,1,0.009782053533112315,2019-03-23 13:00:00,2019-03-23 13:15:00
154,1,0,1,0.001691959655656498,2019-03-23 13:00:00,2019-03-23 13:15:00
157,10,7,3,0.060177395754921224,2019-03-23 13:00:00,2019-03-23 13:15:00
158,4,1,3,0.0036474083688736807,2019-03-23 13:00:00,2019-03-23 13:15:00
159,2,2,0,0.003468814531698231,2019-03-23 13:00:00,2019-03-23 13:15:00
160,10,3,7,0.002661579039458087,2019-03-23 13:00:00,2019-03-23 13:15:00
162,5,2,3,0.0039049447551238107,2019-03-23 13:00:00,2019-03-23 13:15:00
164,12,9,3,0.021841029095014473,2019-03-23 13:00:00,2019-03-23 13:15:00
168,11,4,7,0.00515832283711226,2019-03-23 13:00:00,2019-03-23 13:15:00
169,9,6,3,0.005712418532474563,2019-03-23 13:00:00,2019-03-23 13:15:00
170,8,3,5,0.005284918434420615,2019-03-23 13:00:00,2019-03-23 13:15:00
171,9,3,6,0.004665676902464307,2019-03-23 13:00:00,2019-03-23 13:15:00
172,3,2,1,0.006442651611083011,2019-03-23 13:00:00,2019-03-23 13:15:00
173,3,0,3,0.001691959655656498,2019-03-23 13:00:00,2019-03-23 13:15:00
175,2,0,2,0.001691959655656498,2019-03-23 13:00:00,2019-03-23 13:15:00
177,1,0,1,0.001691959655656498,2019-03-23 13:00:00,2019-03-23 13:15:00
189,6,2,4,0.004277933715551758,2019-03-23 13:00:00,2019-03-23 13:15:00
190,4,2,2,0.0023383725781908906,2019-03-23 13:00:00,2019-03-23 13:15:00
191,5,1,4,0.005894831542397437,2019-03-23 13:00:00,2019-03-23 13:15:00
195,2,2,0,0.006809291154164893,2019-03-23 13:00:00,2019-03-23 13:15:00
196,3,1,2,0.0020903327844799422,2019-03-23 13:00:00,2019-03-23 13:15:00
197,10,3,7,0.002661579039458087,2019-03-23 13:00:00,2019-03-23 13:15:00
199,3,2,1,0.014473716724242589,2019-03-23 13:00:00,2019-03-23 13:15:00
200,2,2,0,0.003495187243816558,2019-03-23 13:00:00,2019-03-23 13:15:00
202,2,0,2,0.001691959655656498,2019-03-23 13:00:00,2019-03-23 13:15:00
203,19,9,10,0.010021231107671905,2019-03-23 13:00:00,2019-03-23 13:15:00
1,5,4,1,0.0072726002267802445,2019-03-23 13:15:00,2019-03-23 13:30:00
2,3,1,2,0.0021975003453461243,2019-03-23 13:15:00,2019-03-23 13:30:00
5,10,7,3,0.009889493381223902,2019-03-23 13:15:00,2019-03-23 13:30:00
11,4,2,2,0.011532436197309561,2019-03-23 13:15:00,2019-03-23 13:30:00
15,2,1,1,0.003853832033443584,2019-03-23 13:15:00,2019-03-23 13:30:00
16,10,6,4,0.01732294600489642,2019-03-23 13:15:00,2019-03-23 13:30:00
18,10,1,9,0.0019110034177816048,2019-03-23 13:15:00,2019-03-23 13:30:00
19,5,2,3,0.0025255503878962187,2019-03-23 13:15:00,2019-03-23 13:30:00
20,9,2,7,0.002776764392907474,2019-03-23 13:15:00,2019-03-23 13:30:00
22,1,0,1,0.0017305129024081977,2019-03-23 13:15:00,2019-03-23 13:30:00
23,11,6,5,0.008907968173344804,2019-03-23 13:15:00,2019-03-23 13:30:00
26,5,3,2,0.004715261115337868,2019-03-23 13:15:00,2019-03-23 13:30:00
27,3,2,1,0.03599112987980386,2019-03-23 13:15:00,2019-03-23 13:30:00
28,8,7,1,0.03447269432887452,2019-03-23 13:15:00,2019-03-23 13:30:00
35,4,1,3,0.003201503168841941,2019-03-23 13:15:00,2019-03-23 13:30:00
37,5,1,4,0.0021975003453461243,2019-03-23 13:15:00,2019-03-23 13:30:00
40,1,0,1,0.0017305129024081977,2019-03-23 13:15:00,2019-03-23 13:30:00
41,5,1,4,0.002461607923388762,2019-03-23 13:15:00,2019-03-23 13:30:00
46,9,5,4,0.007475335325944311,2019-03-23 13:15:00,2019-03-23 13:30:00
50,5,2,3,0.003993793008660025,2019-03-23 13:15:00,2019-03-23 13:30:00
57,3,0,3,0.0017305129024081977,2019-03-23 13:15:00,2019-03-23 13:30:00
58,7,2,5,0.002622047334720599,2019-03-23 13:15:00,2019-03-23 13:30:00
61,2,0,2,0.0017305129024081977,2019-03-23 13:15:00,2019-03-23 13:30:00
62,21,10,11,0.016436480700319864,2019-03-23 13:15:00,2019-03-23 13:30:00
64,5,2,3,0.003993793008660025,2019-03-23 13:15:00,2019-03-23 13:30:00
66,2,2,0,0.006495975732650594,2019-03-23 13:15:00,2019-03-23 13:30:00
67,14,8,6,0.009807629263854388,2019-03-23 13:15:00,2019-03-23 13:30:00
68,3,1,2,0.0019110034177816048,2019-03-23 13:15:00,2019-03-23 13:30:00
69,20,9,11,0.01955308731190832,2019-03-23 13:15:00,2019-03-23 13:30:00
70,1,1,0,0.0026557010772661213,2019-03-23 13:15:00,2019-03-23 13:30:00
71,1,1,0,0.003120087589343729,2019-03-23 13:15:00,2019-03-23 13:30:00
74,2,0,2,0.0017305129024081977,2019-03-23 13:15:00,2019-03-23 13:30:00
75,30,20,10,0.13745666834379336,2019-03-23 13:15:00,2019-03-23 13:30:00
79,6,1,5,0.0020849720091279562,2019-03-23 13:15:00,2019-03-23 13:30:00
80,3,1,2,0.003009690707949485,2019-03-23 13:15:00,2019-03-23 13:30:00
85,5,2,3,0.0034410024075038174,2019-03-23 13:15:00,2019-03-23 13:30:00
86,5,3,2,0.00826715995060239,2019-03-23 13:15:00,2019-03-23 13:30:00
87,22,10,12,0.010050160260784625,2019-03-23 13:15:00,2019-03-23 13:30:00
88,7,1,6,0.002016144404638581,2019-03-23 13:15:00,2019-03-23 13:30:00
89,5,0,5,0.0017305129024081977,2019-03-23 13:15:00,2019-03-23 13:30:00
99,1,0,1,0.0017305129024081977,2019-03-23 13:15:00,2019-03-23 13:30:00
104,12,4,8,0.0039947357078813734,2019-03-23 13:15:00,2019-03-23 13:30:00
106,17,9,8,0.009524632763515006,2019-03-23 13:15:00,2019-03-23 13:30:00
108,6,5,1,0.029521181796305418,2019-03-23 13:15:00,2019-03-23 13:30:00
109,16,12,4,0.00999103525844344,2019-03-23 13:15:00,2019-03-23 13:30:00
110,12,7,5,0.010414915617271637,2019-03-23 13:15:00,2019-03-23 13:30:00
112,7,5,2,0.009291408979858683,2019-03-23 13:15:00,2019-03-23 13:30:00
113,4,2,2,0.002622047334720599,2019-03-23 13:15:00,2019-03-23 13:30:00
114,3,0,3,0.0017305129024081977,2019-03-23 13:15:00,2019-03-23 13:30:00
115,4,2,2,0.0029413325794965047,2019-03-23 13:15:00,2019-03-23 13:30:00
116,11,1,10,0.0018912775872780992,2019-03-23 13:15:00,2019-03-23 13:30:00
118,8,3,5,0.005451652517197708,2019-03-23 13:15:00,2019-03-23 13:30:00
119,16,13,3,0.018901736958058142,2019-03-23 13:15:00,2019-03-23 13:30:00
120,9,4,5,0.004300114616747307,2019-03-23 13:15:00,2019-03-23 13:30:00
126,8,2,6,0.0028604318939900886,2019-03-23 13:15:00,2019-03-23 13:30:00
127,7,6,1,0.008999477123502297,2019-03-23 13:15:00,2019-03-23 13:30:00
135,7,1,6,0.005244839632710548,2019-03-23 13:15:00,2019-03-23 13:30:00
137,36,25,11,0.03477392223168706,2019-03-23 13:15:00,2019-03-23 13:30:00
138,27,15,12,0.01306046678865426,2019-03-23 13:15:00,2019-03-23 13:30:00
141,6,3,3,0.021654711472248143,2019-03-23 13:15:00,2019-03-23 13:30:00
151,7,2,5,0.002622047334720599,2019-03-23 13:15:00,2019-03-23 13:30:00
153,5,5,0,0.012025155986795936,2019-03-23 13:15:00,2019-03-23 13:30:00
154,1,0,1,0.0017305129024081977,2019-03-23 13:15:00,2019-03-23 13:30:00
157,11,8,3,0.03353224824112696,2019-03-23 13:15:00,2019-03-23 13:30:00
158,2,0,2,0.0017305129024081977,2019-03-23 13:15:00,2019-03-23 13:30:00
159,2,2,0,0.004163468115313939,2019-03-23 13:15:00,2019-03-23 13:30:00
160,8,3,5,0.003531849086806871,2019-03-23 13:15:00,2019-03-23 13:30:00
162,6,2,4,0.003009690707949485,2019-03-23 13:15:00,2019-03-23 13:30:00
164,11,7,4,0.012669535826544127,2019-03-23 13:15:00,2019-03-23 13:30:00
168,16,4,12,0.005610803005376568,2019-03-23 13:15:00,2019-03-23 13:30:00
169,15,12,3,0.02140694719147643,2019-03-23 13:15:00,2019-03-23 13:30:00
170,4,2,2,0.005130308995048644,2019-03-23 13:15:00,2019-03-23 13:30:00
171,4,1,3,0.0024660080356250693,2019-03-23 13:15:00,2019-03-23 13:30:00
172,4,3,1,0.0058596530903729255,2019-03-23 13:15:00,2019-03-23 13:30:00
173,4,2,2,0.009879669625518728,2019-03-23 13:15:00,2019-03-23 13:30:00
175,2,0,2,0.0017305129024081977,2019-03-23 13:15:00,2019-03-23 13:30:00
189,6,2,4,0.006800978192265734,2019-03-23 13:15:00,2019-03-23 13:30:00
190,6,4,2,0.0026573139597179684,2019-03-23 13:15:00,2019-03-23 13:30:00
191,9,6,3,0.01210590660362149,2019-03-23 13:15:00,2019-03-23 13:30:00
195,2,2,0,0.003959348983189201,2019-03-23 13:15:00,2019-03-23 13:30:00
196,3,1,2,0.002862152955534111,2019-03-23 13:15:00,2019-03-23 13:30:00
197,20,8,12,0.003993793008660025,2019-03-23 13:15:00,2019-03-23 13:30:00
199,3,1,2,0.003009690707949485,2019-03-23 13:15:00,2019-03-23 13:30:00
201,2,2,0,0.0025255503878962187,2019-03-23 13:15:00,2019-03-23 13:30:00
202,2,0,2,0.0017305129024081977,2019-03-23 13:15:00,2019-03-23 13:30:00
203,15,7,8,0.0224202457054171,2019-03-23 13:15:00,2019-03-23 13:30:00
1,9,7,2,0.006720050155740696,2019-03-23 13:30:00,2019-03-23 13:45:00
2,14,8,6,0.012342766329519146,2019-03-23 13:30:00,2019-03-23 13:45:00
5,12,6,6,0.010447456594404355,2019-03-23 13:30:00,2019-03-23 13:45:00
10,1,0,1,0.0016794185185753808,2019-03-23 13:30:00,2019-03-23 13:45:00
11,4,2,2,0.01119163349324794,2019-03-23 13:30:00,2019-03-23 13:45:00
15,5,1,4,0.0033062208783005294,2019-03-23 13:30:00,2019-03-23 13:45:00
16,11,6,5,0.010298479180924299,2019-03-23 13:30:00,2019-03-23 13:45:00
18,9,2,7,0.004836047567478587,2019-03-23 13:30:00,2019-03-23 13:45:00
19,4,1,3,0.0023931886539594847,2019-03-23 13:30:00,2019-03-23 13:45:00
20,5,1,4,0.0021326098757232033,2019-03-23 13:30:00,2019-03-23 13:45:00
23,13,5,8,0.014852605805286127,2019-03-23 13:30:00,2019-03-23 13:45:00
26,2,2,0,0.0028642299074924248,2019-03-23 13:30:00,2019-03-23 13:45:00
27,3,2,1,0.0228205214392252,2019-03-23 13:30:00,2019-03-23 13:45:00
28,7,6,1,0.0486484244512833,2019-03-23 13:30:00,2019-03-23 13:45:00
30,8,1,7,0.004535657407778305,2019-03-23 13:30:00,2019-03-23 13:45:00
35,1,0,1,0.0016794185185753808,2019-03-23 13:30:00,2019-03-23 13:45:00
37,3,0,3,0.0016794185185753808,2019-03-23 13:30:00,2019-03-23 13:45:00
40,1,0,1,0.0016794185185753808,2019-03-23 13:30:00,2019-03-23 13:45:00
41,9,3,6,0.004385713315813361,2019-03-23 13:30:00,2019-03-23 13:45:00
46,5,1,4,0.0048766810863739175,2019-03-23 13:30:00,2019-03-23 13:45:00
50,5,2,3,0.003875767852091057,2019-03-23 13:30:00,2019-03-23 13:45:00
57,5,2,3,0.004302261738228363,2019-03-23 13:30:00,2019-03-23 13:45:00
58,9,4,5,0.007327874838655678,2019-03-23 13:30:00,2019-03-23 13:45:00
61,2,0,2,0.0016794185185753808,2019-03-23 13:30:00,2019-03-23 13:45:00
62,17,8,9,0.016075101182103854,2019-03-23 13:30:00,2019-03-23 13:45:00
66,4,0,4,0.0016794185185753808,2019-03-23 13:30:00,2019-03-23 13:45:00
67,16,6,10,0.006028178664215955,2019-03-23 13:30:00,2019-03-23 13:45:00
68,4,2,2,0.0029693577864252033,2019-03-23 13:30:00,2019-03-23 13:45:00
69,19,9,10,0.01768247529142221,2019-03-23 13:30:00,2019-03-23 13:45:00
70,1,1,0,0.0023980960768483287,2019-03-23 13:30:00,2019-03-23 13:45:00
74,9,3,6,0.0032400397666998274,2019-03-23 13:30:00,2019-03-23 13:45:00
75,33,18,15,0.023136306716574507,2019-03-23 13:30:00,2019-03-23 13:45:00
79,5,0,5,0.0016794185185753808,2019-03-23 13:30:00,2019-03-23 13:45:00
80,4,1,3,0.0023433995630895168,2019-03-23 13:30:00,2019-03-23 13:45:00
85,5,2,3,0.003339371129860721,2019-03-23 13:30:00,2019-03-23 13:45:00
86,4,3,1,0.024780275737953657,2019-03-23 13:30:00,2019-03-23 13:45:00
87,14,9,5,0.034813755070655476,2019-03-23 13:30:00,2019-03-23 13:45:00
88,4,1,3,0.0021552652754981165,2019-03-23 13:30:00,2019-03-23 13:45:00
89,5,0,5,0.0016794185185753808,2019-03-23 13:30:00,2019-03-23 13:45:00
90,3,0,3,0.0016794185185753808,2019-03-23 13:30:00,2019-03-23 13:45:00
99,3,2,1,0.003442951564108741,2019-03-23 13:30:00,2019-03-23 13:45:00
104,13,4,9,0.00435484932368495,2019-03-23 13:30:00,2019-03-23 13:45:00
106,12,7,5,0.02350057337190857,2019-03-23 13:30:00,2019-03-23 13:45:00
108,6,5,1,0.02651571157411431,2019-03-23 13:30:00,2019-03-23 13:45:00
109,13,9,4,0.007654601971910103,2019-03-23 13:30:00,2019-03-23 13:45:00
110,13,10,3,0.016344047581964075,2019-03-23 13:30:00,2019-03-23 13:45:00
112,9,6,3,0.004618594872906596,2019-03-23 13:30:00,2019-03-23 13:45:00
113,6,5,1,0.03457969107639695,2019-03-23 13:30:00,2019-03-23 13:45:00
114,4,1,3,0.002090751389759225,2019-03-23 13:30:00,2019-03-23 13:45:00
115,4,2,2,0.003100728562258197,2019-03-23 13:30:00,2019-03-23 13:45:00
116,10,1,9,0.002191836474439888,2019-03-23 13:30:00,2019-03-23 13:45:00
118,11,4,7,0.006105746121467033,2019-03-23 13:30:00,2019-03-23 13:45:00
119,14,11,3,0.018581393277206433,2019-03-23 13:30:00,2019-03-23 13:45:00
120,7,4,3,0.006943457533509008,2019-03-23 13:30:00,2019-03-23 13:45:00
126,7,5,2,0.0066399072769675795,2019-03-23 13:30:00,2019-03-23 13:45:00
127,7,7,0,0.008224808195005729,2019-03-23 13:30:00,2019-03-23 13:45:00
135,4,0,4,0.0016794185185753808,2019-03-23 13:30:00,2019-03-23 13:45:00
137,42,27,15,0.05640699101451696,2019-03-23 13:30:00,2019-03-23 13:45:00
138,20,10,10,0.00845457100714371,2019-03-23 13:30:00,2019-03-23 13:45:00
141,2,1,1,0.01119163349324794,2019-03-23 13:30:00,2019-03-23 13:45:00
151,6,1,5,0.0020234063730255724,2019-03-23 13:30:00,2019-03-23 13:45:00
153,3,3,0,0.008839424242366343,2019-03-23 13:30:00,2019-03-23 13:45:00
154,4,1,3,0.0023433995630895168,2019-03-23 13:30:00,2019-03-23 13:45:00
157,10,7,3,0.047957612192107445,2019-03-23 13:30:00,2019-03-23 13:45:00
158,2,0,2,0.0016794185185753808,2019-03-23 13:30:00,2019-03-23 13:45:00
159,2,2,0,0.0029771717255526334,2019-03-23 13:30:00,2019-03-23 13:45:00
160,7,4,3,0.014604705746375108,2019-03-23 13:30:00,2019-03-23 13:45:00
162,6,2,4,0.0029207921347618303,2019-03-23 13:30:00,2019-03-23 13:45:00
164,16,13,3,0.02609435624857978,2019-03-23 13:30:00,2019-03-23 13:45:00
168,14,4,10,0.006546426321601801,2019-03-23 13:30:00,2019-03-23 13:45:00
169,17,12,5,0.015265925902813685,2019-03-23 13:30:00,2019-03-23 13:45:00
170,3,2,1,0.010797324435232286,2019-03-23 13:30:00,2019-03-23 13:45:00
171,4,1,3,0.0023931886539594847,2019-03-23 13:30:00,2019-03-23 13:45:00
172,5,4,1,0.0062652058439074294,2019-03-23 13:30:00,2019-03-23 13:45:00
173,2,1,1,0.0029881080994547168,2019-03-23 13:30:00,2019-03-23 13:45:00
175,2,0,2,0.0016794185185753808,2019-03-23 13:30:00,2019-03-23 13:45:00
189,6,1,5,0.0031027797930019575,2019-03-23 13:30:00,2019-03-23 13:45:00
190,4,2,2,0.002854032083455289,2019-03-23 13:30:00,2019-03-23 13:45:00
191,10,6,4,0.00993323191143158,2019-03-23 13:30:00,2019-03-23 13:45:00
195,4,2,2,0.01119163349324794,2019-03-23 13:30:00,2019-03-23 13:45:00
196,4,1,3,0.0022900925998473537,2019-03-23 13:30:00,2019-03-23 13:45:00
197,16,7,9,0.0049561946919766415,2019-03-23 13:30:00,2019-03-23 13:45:00
199,5,2,3,0.003111981242105556,2019-03-23 13:30:00,2019-03-23 13:45:00
201,3,3,0,0.0034032560899992753,2019-03-23 13:30:00,2019-03-23 13:45:00
202,1,0,1,0.0016794185185753808,2019-03-23 13:30:00,2019-03-23 13:45:00
203,19,11,8,0.013393847644766005,2019-03-23 13:30:00,2019-03-23 13:45:00
1,6,6,0,0.009584248013912989,2019-03-23 13:45:00,2019-03-23 14:00:00
2,20,12,8,0.01965514811006969,2019-03-23 13:45:00,2019-03-23 14:00:00
5,10,6,4,0.009964099630832054,2019-03-23 13:45:00,2019-03-23 14:00:00
10,1,0,1,0.0017979357097083382,2019-03-23 13:45:00,2019-03-23 14:00:00
11,4,2,2,0.011976716689384714,2019-03-23 13:45:00,2019-03-23 14:00:00
15,6,0,6,0.0017979357097083382,2019-03-23 13:45:00,2019-03-23 14:00:00
16,10,5,5,0.014209022024249875,2019-03-23 13:45:00,2019-03-23 14:00:00
18,7,1,6,0.004422756705824793,2019-03-23 13:45:00,2019-03-23 14:00:00
20,4,2,2,0.006175402871427224,2019-03-23 13:45:00,2019-03-23 14:00:00
23,13,6,7,0.013869853884982828,2019-03-23 13:45:00,2019-03-23 14:00:00
26,3,2,1,0.004699924866449527,2019-03-23 13:45:00,2019-03-23 14:00:00
27,4,2,2,0.0073295408658529074,2019-03-23 13:45:00,2019-03-23 14:00:00
28,8,6,2,0.012431056062784633,2019-03-23 13:45:00,2019-03-23 14:00:00
30,5,0,5,0.0017979357097083382,2019-03-23 13:45:00,2019-03-23 14:00:00
35,9,4,5,0.004383114758532548,2019-03-23 13:45:00,2019-03-23 14:00:00
37,4,1,3,0.005473870129673751,2019-03-23 13:45:00,2019-03-23 14:00:00
40,1,0,1,0.0017979357097083382,2019-03-23 13:45:00,2019-03-23 14:00:00
41,7,1,6,0.0021035948528591755,2019-03-23 13:45:00,2019-03-23 14:00:00
46,4,2,2,0.005569482330569999,2019-03-23 13:45:00,2019-03-23 14:00:00
50,6,3,3,0.004737190603614444,2019-03-23 13:45:00,2019-03-23 14:00:00
57,7,3,4,0.007366904278149305,2019-03-23 13:45:00,2019-03-23 14:00:00
58,8,4,4,0.010032428139897612,2019-03-23 13:45:00,2019-03-23 14:00:00
61,1,0,1,0.0017979357097083382,2019-03-23 13:45:00,2019-03-23 14:00:00
62,18,11,7,0.01536471473336231,2019-03-23 13:45:00,2019-03-23 14:00:00
66,4,0,4,0.0017979357097083382,2019-03-23 13:45:00,2019-03-23 14:00:00
67,16,5,11,0.004524872912046266,2019-03-23 13:45:00,2019-03-23 14:00:00
68,6,3,3,0.0051399692716721755,2019-03-23 13:45:00,2019-03-23 14:00:00
69,16,9,7,0.012371215415748834,2019-03-23 13:45:00,2019-03-23 14:00:00
70,1,1,0,0.0024391482411110256,2019-03-23 13:45:00,2019-03-23 14:00:00
74,14,7,7,0.008023992318211307,2019-03-23 13:45:00,2019-03-23 14:00:00
75,34,17,17,0.031073163798634916,2019-03-23 13:45:00,2019-03-23 14:00:00
79,5,0,5,0.0017979357097083382,2019-03-23 13:45:00,2019-03-23 14:00:00
80,4,1,3,0.0025087834077558643,2019-03-23 13:45:00,2019-03-23 14:00:00
85,3,2,1,0.017066107179222904,2019-03-23 13:45:00,2019-03-23 14:00:00
86,9,6,3,0.046749596896418784,2019-03-23 13:45:00,2019-03-23 14:00:00
87,16,9,7,0.027235113953784244,2019-03-23 13:45:00,2019-03-23 14:00:00
88,3,1,2,0.0025087834077558643,2019-03-23 13:45:00,2019-03-23 14:00:00
89,12,4,8,0.003200071553678096,2019-03-23 13:45:00,2019-03-23 14:00:00
90,4,0,4,0.0017979357097083382,2019-03-23 13:45:00,2019-03-23 14:00:00
99,4,3,1,0.007089987511161311,2019-03-23 13:45:00,2019-03-23 14:00:00
104,11,4,7,0.006271206610747261,2019-03-23 13:45:00,2019-03-23 14:00:00
106,12,7,5,0.01354320256473671,2019-03-23 13:45:00,2019-03-23 14:00:00
108,6,4,2,0.015929525679020094,2019-03-23 13:45:00,2019-03-23 14:00:00
109,12,8,4,0.01226067894146418,2019-03-23 13:45:00,2019-03-23 14:00:00
110,13,9,4,0.017294524692667092,2019-03-23 13:45:00,2019-03-23 14:00:00
112,13,11,2,0.006505543256118941,2019-03-23 13:45:00,2019-03-23 14:00:00
113,6,3,3,0.0034846440195099816,2019-03-23 13:45:00,2019-03-23 14:00:00
114,4,1,3,0.00512070176394214,2019-03-23 13:45:00,2019-03-23 14:00:00
115,5,2,3,0.002693864193736723,2019-03-23 13:45:00,2019-03-23 14:00:00
116,9,4,5,0.005874984073049988,2019-03-23 13:45:00,2019-03-23 14:00:00
118,7,1,6,0.002094694215296262,2019-03-23 13:45:00,2019-03-23 14:00:00
119,11,7,4,0.009049349986079619,2019-03-23 13:45:00,2019-03-23 14:00:00
120,6,3,3,0.00483422142801221,2019-03-23 13:45:00,2019-03-23 14:00:00
122,2,2,0,0.006369164765313653,2019-03-23 13:45:00,2019-03-23 14:00:00
126,7,5,2,0.007817508154613571,2019-03-23 13:45:00,2019-03-23 14:00:00
127,6,6,0,0.00736777086255898,2019-03-23 13:45:00,2019-03-23 14:00:00
135,7,1,6,0.002094694215296262,2019-03-23 13:45:00,2019-03-23 14:00:00
137,44,28,16,0.05891366181887313,2019-03-23 13:45:00,2019-03-23 14:00:00
138,23,8,15,0.01131462040453019,2019-03-23 13:45:00,2019-03-23 14:00:00
140,2,0,2,0.0017979357097083382,2019-03-23 13:45:00,2019-03-23 14:00:00
141,4,1,3,0.0025087834077558643,2019-03-23 13:45:00,2019-03-23 14:00:00
151,7,1,6,0.002094694215296262,2019-03-23 13:45:00,2019-03-23 14:00:00
153,4,4,0,0.009624819365612167,2019-03-23 13:45:00,2019-03-23 14:00:00
154,4,1,3,0.0025087834077558643,2019-03-23 13:45:00,2019-03-23 14:00:00
157,15,10,5,0.06359809528018498,2019-03-23 13:45:00,2019-03-23 14:00:00
158,2,0,2,0.0017979357097083382,2019-03-23 13:45:00,2019-03-23 14:00:00
159,2,2,0,0.003015269101376725,2019-03-23 13:45:00,2019-03-23 14:00:00
160,3,2,1,0.014303585786223864,2019-03-23 13:45:00,2019-03-23 14:00:00
161,1,0,1,0.0017979357097083382,2019-03-23 13:45:00,2019-03-23 14:00:00
162,9,5,4,0.004983235141533077,2019-03-23 13:45:00,2019-03-23 14:00:00
164,19,14,5,0.013443649908781137,2019-03-23 13:45:00,2019-03-23 14:00:00
168,10,5,5,0.01083947335864322,2019-03-23 13:45:00,2019-03-23 14:00:00
169,24,16,8,0.023155045648560264,2019-03-23 13:45:00,2019-03-23 14:00:00
170,4,3,1,0.010159315746388835,2019-03-23 13:45:00,2019-03-23 14:00:00
171,2,2,0,0.004782759741879892,2019-03-23 13:45:00,2019-03-23 14:00:00
172,8,4,4,0.008246784510834496,2019-03-23 13:45:00,2019-03-23 14:00:00
173,2,0,2,0.0017979357097083382,2019-03-23 13:45:00,2019-03-23 14:00:00
175,2,0,2,0.0017979357097083382,2019-03-23 13:45:00,2019-03-23 14:00:00
189,4,0,4,0.0017979357097083382,2019-03-23 13:45:00,2019-03-23 14:00:00
190,4,1,3,0.0025087834077558643,2019-03-23 13:45:00,2019-03-23 14:00:00
191,10,0,10,0.0017979357097083382,2019-03-23 13:45:00,2019-03-23 14:00:00
195,4,1,3,0.0025087834077558643,2019-03-23 13:45:00,2019-03-23 14:00:00
196,5,1,4,0.002864207256779627,2019-03-23 13:45:00,2019-03-23 14:00:00
197,16,7,9,0.005306044355144347,2019-03-23 13:45:00,2019-03-23 14:00:00
199,5,2,3,0.008083792052948525,2019-03-23 13:45:00,2019-03-23 14:00:00
203,21,14,7,0.026426272732672115,2019-03-23 13:45:00,2019-03-23 14:00:00
1,5,3,2,0.0073735865604694925,2019-03-23 14:00:00,2019-03-23 14:15:00
2,17,11,6,0.020168263291933036,2019-03-23 14:00:00,2019-03-23 14:15:00
5,14,6,8,0.005372302330240671,2019-03-23 14:00:00,2019-03-23 14:15:00
11,4,2,2,0.010053054874873471,2019-03-23 14:00:00,2019-03-23 14:15:00
15,5,1,4,0.005064773597853212,2019-03-23 14:00:00,2019-03-23 14:15:00
16,9,7,2,0.009550192425650996,2019-03-23 14:00:00,2019-03-23 14:15:00
18,8,3,5,0.0037604363306031584,2019-03-23 14:00:00,2019-03-23 14:15:00
19,4,1,3,0.0023497648056606184,2019-03-23 14:00:00,2019-03-23 14:15:00
20,3,2,1,0.004183398450455874,2019-03-23 14:00:00,2019-03-23 14:15:00
22,1,0,1,0.001508355647171466,2019-03-23 14:00:00,2019-03-23 14:15:00
23,10,7,3,0.013331217403936666,2019-03-23 14:00:00,2019-03-23 14:15:00
26,2,1,1,0.002480783411853489,2019-03-23 14:00:00,2019-03-23 14:15:00
27,3,1,2,0.002623256627793891,2019-03-23 14:00:00,2019-03-23 14:15:00
28,6,5,1,0.008280542736861577,2019-03-23 14:00:00,2019-03-23 14:15:00
30,2,0,2,0.001508355647171466,2019-03-23 14:00:00,2019-03-23 14:15:00
35,4,2,2,0.003779415084193046,2019-03-23 14:00:00,2019-03-23 14:15:00
37,9,2,7,0.006927973052292095,2019-03-23 14:00:00,2019-03-23 14:15:00
41,7,1,6,0.0017647793482222607,2019-03-23 14:00:00,2019-03-23 14:15:00
46,3,1,2,0.0016722148085725514,2019-03-23 14:00:00,2019-03-23 14:15:00
50,7,3,4,0.004495538877034212,2019-03-23 14:00:00,2019-03-23 14:15:00
57,6,3,3,0.00467895279103328,2019-03-23 14:00:00,2019-03-23 14:15:00
58,11,6,5,0.00547858411376366,2019-03-23 14:00:00,2019-03-23 14:15:00
61,4,2,2,0.006620475907948443,2019-03-23 14:00:00,2019-03-23 14:15:00
62,15,9,6,0.012513177826748793,2019-03-23 14:00:00,2019-03-23 14:15:00
66,5,0,5,0.001508355647171466,2019-03-23 14:00:00,2019-03-23 14:15:00
67,16,7,9,0.007037811475161803,2019-03-23 14:00:00,2019-03-23 14:15:00
68,4,1,3,0.002529663306932859,2019-03-23 14:00:00,2019-03-23 14:15:00
69,17,9,8,0.014298359445269557,2019-03-23 14:00:00,2019-03-23 14:15:00
70,2,1,1,0.0016722148085725514,2019-03-23 14:00:00,2019-03-23 14:15:00
74,14,9,5,0.02172314918492847,2019-03-23 14:00:00,2019-03-23 14:15:00
75,31,15,16,0.02022436298845338,2019-03-23 14:00:00,2019-03-23 14:15:00
79,5,0,5,0.001508355647171466,2019-03-23 14:00:00,2019-03-23 14:15:00
80,4,1,3,0.0021046938441439426,2019-03-23 14:00:00,2019-03-23 14:15:00
85,8,7,1,0.0351045139690662,2019-03-23 14:00:00,2019-03-23 14:15:00
86,7,3,4,0.00679247091834842,2019-03-23 14:00:00,2019-03-23 14:15:00
87,15,8,7,0.02181128920964047,2019-03-23 14:00:00,2019-03-23 14:15:00
88,4,4,0,0.00360452126977924,2019-03-23 14:00:00,2019-03-23 14:15:00
89,13,6,7,0.007452309558859925,2019-03-23 14:00:00,2019-03-23 14:15:00
90,1,0,1,0.001508355647171466,2019-03-23 14:00:00,2019-03-23 14:15:00
99,6,3,3,0.003781210705617953,2019-03-23 14:00:00,2019-03-23 14:15:00
101,3,2,1,0.007336964748146214,2019-03-23 14:00:00,2019-03-23 14:15:00
104,10,3,7,0.0061031559662375395,2019-03-23 14:00:00,2019-03-23 14:15:00
106,12,7,5,0.022391590051769866,2019-03-23 14:00:00,2019-03-23 14:15:00
108,7,6,1,0.06231619807000974,2019-03-23 14:00:00,2019-03-23 14:15:00
109,18,10,8,0.01885042999291422,2019-03-23 14:00:00,2019-03-23 14:15:00
110,11,8,3,0.01615529596262301,2019-03-23 14:00:00,2019-03-23 14:15:00
111,4,2,2,0.0035509709666942525,2019-03-23 14:00:00,2019-03-23 14:15:00
112,16,8,8,0.0046661358727379774,2019-03-23 14:00:00,2019-03-23 14:15:00
113,12,8,4,0.01696310730103206,2019-03-23 14:00:00,2019-03-23 14:15:00
114,2,1,1,0.004068584414341509,2019-03-23 14:00:00,2019-03-23 14:15:00
115,4,1,3,0.0016722148085725514,2019-03-23 14:00:00,2019-03-23 14:15:00
116,17,8,9,0.01802420771052889,2019-03-23 14:00:00,2019-03-23 14:15:00
118,4,0,4,0.001508355647171466,2019-03-23 14:00:00,2019-03-23 14:15:00
119,16,13,3,0.01813957263503924,2019-03-23 14:00:00,2019-03-23 14:15:00
120,7,4,3,0.01094882992824714,2019-03-23 14:00:00,2019-03-23 14:15:00
122,4,2,2,0.003449446686057335,2019-03-23 14:00:00,2019-03-23 14:15:00
126,14,9,5,0.015058249787170361,2019-03-23 14:00:00,2019-03-23 14:15:00
127,6,6,0,0.00520270439008483,2019-03-23 14:00:00,2019-03-23 14:15:00
133,1,1,0,0.003014916774111836,2019-03-23 14:00:00,2019-03-23 14:15:00
135,5,0,5,0.001508355647171466,2019-03-23 14:00:00,2019-03-23 14:15:00
137,40,25,15,0.04647684395410755,2019-03-23 14:00:00,2019-03-23 14:15:00
138,15,3,12,0.002313274061199538,2019-03-23 14:00:00,2019-03-23 14:15:00
140,3,1,2,0.002413411420205973,2019-03-23 14:00:00,2019-03-23 14:15:00
141,3,0,3,0.001508355647171466,2019-03-23 14:00:00,2019-03-23 14:15:00
151,5,2,3,0.0038937084350613724,2019-03-23 14:00:00,2019-03-23 14:15:00
153,5,3,2,0.006013439943705555,2019-03-23 14:00:00,2019-03-23 14:15:00
154,5,1,4,0.0019153792058483662,2019-03-23 14:00:00,2019-03-23 14:15:00
157,10,5,5,0.008860511695618946,2019-03-23 14:00:00,2019-03-23 14:15:00
158,1,0,1,0.001508355647171466,2019-03-23 14:00:00,2019-03-23 14:15:00
159,5,4,1,0.00442079178614143,2019-03-23 14:00:00,2019-03-23 14:15:00
160,5,2,3,0.003032268878656768,2019-03-23 14:00:00,2019-03-23 14:15:00
161,1,0,1,0.001508355647171466,2019-03-23 14:00:00,2019-03-23 14:15:00
162,9,5,4,0.0043583331115189606,2019-03-23 14:00:00,2019-03-23 14:15:00
164,24,15,9,0.010275322419891196,2019-03-23 14:00:00,2019-03-23 14:15:00
168,10,7,3,0.06466184244137468,2019-03-23 14:00:00,2019-03-23 14:15:00
169,29,14,15,0.018020718169041477,2019-03-23 14:00:00,2019-03-23 14:15:00
170,4,3,1,0.011931806740774747,2019-03-23 14:00:00,2019-03-23 14:15:00
171,2,2,0,0.005039218768130344,2019-03-23 14:00:00,2019-03-23 14:15:00
172,8,3,5,0.0057192040742415585,2019-03-23 14:00:00,2019-03-23 14:15:00
173,1,0,1,0.001508355647171466,2019-03-23 14:00:00,2019-03-23 14:15:00
175,7,3,4,0.005173253256934363,2019-03-23 14:00:00,2019-03-23 14:15:00
177,2,1,1,0.010053054874873471,2019-03-23 14:00:00,2019-03-23 14:15:00
189,4,0,4,0.001508355647171466,2019-03-23 14:00:00,2019-03-23 14:15:00
190,4,0,4,0.001508355647171466,2019-03-23 14:00:00,2019-03-23 14:15:00
191,10,0,10,0.001508355647171466,2019-03-23 14:00:00,2019-03-23 14:15:00
195,4,0,4,0.001508355647171466,2019-03-23 14:00:00,2019-03-23 14:15:00
196,6,1,5,0.003511556840408403,2019-03-23 14:00:00,2019-03-23 14:15:00
197,15,8,7,0.021813122801257218,2019-03-23 14:00:00,2019-03-23 14:15:00
199,6,2,4,0.004593370742793973,2019-03-23 14:00:00,2019-03-23 14:15:00
201,2,0,2,0.001508355647171466,2019-03-23 14:00:00,2019-03-23 14:15:00
202,2,0,2,0.001508355647171466,2019-03-23 14:00:00,2019-03-23 14:15:00
203,25,16,9,0.030851500836835057,2019-03-23 14:00:00,2019-03-23 14:15:00
1,14,6,8,0.009218317123769814,2019-03-23 14:15:00,2019-03-23 14:30:00
2,10,7,3,0.016429697323505497,2019-03-23 14:15:00,2019-03-23 14:30:00
5,9,5,4,0.007146859938109196,2019-03-23 14:15:00,2019-03-23 14:30:00
11,4,2,2,0.010181102357824772,2019-03-23 14:15:00,2019-03-23 14:30:00
15,5,3,2,0.010529720873623822,2019-03-23 14:15:00,2019-03-23 14:30:00
16,14,11,3,0.012702068151446387,2019-03-23 14:15:00,2019-03-23 14:30:00
18,15,6,9,0.005745622732787359,2019-03-23 14:15:00,2019-03-23 14:30:00
19,7,2,5,0.003448930351033592,2019-03-23 14:15:00,2019-03-23 14:30:00
20,14,11,3,0.009755203842376154,2019-03-23 14:15:00,2019-03-23 14:30:00
22,1,0,1,0.0015277933786673977,2019-03-23 14:15:00,2019-03-23 14:30:00
23,10,7,3,0.013263268870653627,2019-03-23 14:15:00,2019-03-23 14:30:00
26,7,3,4,0.0035071783718118067,2019-03-23 14:15:00,2019-03-23 14:30:00
27,3,1,2,0.0026571012124721053,2019-03-23 14:15:00,2019-03-23 14:30:00
28,7,5,2,0.003941777723994928,2019-03-23 14:15:00,2019-03-23 14:30:00
30,2,0,2,0.0015277933786673977,2019-03-23 14:15:00,2019-03-23 14:30:00
35,4,3,1,0.003911676491387871,2019-03-23 14:15:00,2019-03-23 14:30:00
37,6,0,6,0.0015277933786673977,2019-03-23 14:15:00,2019-03-23 14:30:00
40,9,5,4,0.01768666905570618,2019-03-23 14:15:00,2019-03-23 14:30:00
41,5,1,4,0.0017875257509502704,2019-03-23 14:15:00,2019-03-23 14:30:00
46,3,1,2,0.002493407025011608,2019-03-23 14:15:00,2019-03-23 14:30:00
50,7,3,4,0.004214993200376797,2019-03-23 14:15:00,2019-03-23 14:30:00
57,4,1,3,0.0030282685071604054,2019-03-23 14:15:00,2019-03-23 14:30:00
58,13,8,5,0.010025689875867494,2019-03-23 14:15:00,2019-03-23 14:30:00
61,3,2,1,0.002889973818152893,2019-03-23 14:15:00,2019-03-23 14:30:00
62,21,14,7,0.010876634071315882,2019-03-23 14:15:00,2019-03-23 14:30:00
66,5,0,5,0.0015277933786673977,2019-03-23 14:15:00,2019-03-23 14:30:00
67,18,8,10,0.010698695456694756,2019-03-23 14:15:00,2019-03-23 14:30:00
68,9,3,6,0.004113604262793429,2019-03-23 14:15:00,2019-03-23 14:30:00
69,16,10,6,0.01660835378926641,2019-03-23 14:15:00,2019-03-23 14:30:00
70,1,0,1,0.0015277933786673977,2019-03-23 14:15:00,2019-03-23 14:30:00
74,16,10,6,0.025202951921158304,2019-03-23 14:15:00,2019-03-23 14:30:00
75,31,18,13,0.060645316018536,2019-03-23 14:15:00,2019-03-23 14:30:00
79,5,0,5,0.0015277933786673977,2019-03-23 14:15:00,2019-03-23 14:30:00
80,6,2,4,0.0026571012124721053,2019-03-23 14:15:00,2019-03-23 14:30:00
85,8,7,1,0.026123749993778235,2019-03-23 14:15:00,2019-03-23 14:30:00
86,6,2,4,0.006696892550385129,2019-03-23 14:15:00,2019-03-23 14:30:00
87,17,11,6,0.015809407632908792,2019-03-23 14:15:00,2019-03-23 14:30:00
88,4,4,0,0.003226882596399195,2019-03-23 14:15:00,2019-03-23 14:30:00
89,16,7,9,0.005350934201963243,2019-03-23 14:15:00,2019-03-23 14:30:00
90,1,0,1,0.0015277933786673977,2019-03-23 14:15:00,2019-03-23 14:30:00
99,7,2,5,0.002326749499542444,2019-03-23 14:15:00,2019-03-23 14:30:00
101,3,2,1,0.009019046603420776,2019-03-23 14:15:00,2019-03-23 14:30:00
104,9,2,7,0.0032434974806015045,2019-03-23 14:15:00,2019-03-23 14:30:00
106,6,4,2,0.013642425949487719,2019-03-23 14:15:00,2019-03-23 14:30:00
108,7,5,2,0.06395525614407335,2019-03-23 14:15:00,2019-03-23 14:30:00
109,19,9,10,0.009299649589120905,2019-03-23 14:15:00,2019-03-23 14:30:00
110,8,6,2,0.014923461180511235,2019-03-23 14:15:00,2019-03-23 14:30:00
111,2,2,0,0.004528743635653414,2019-03-23 14:15:00,2019-03-23 14:30:00
112,14,3,11,0.002831972661989846,2019-03-23 14:15:00,2019-03-23 14:30:00
113,6,4,2,0.004426117266446398,2019-03-23 14:15:00,2019-03-23 14:30:00
114,6,4,2,0.006706013251385578,2019-03-23 14:15:00,2019-03-23 14:30:00
115,5,3,2,0.005314466161942855,2019-03-23 14:15:00,2019-03-23 14:30:00
116,6,0,6,0.0015277933786673977,2019-03-23 14:15:00,2019-03-23 14:30:00
118,4,2,2,0.00334702541156849,2019-03-23 14:15:00,2019-03-23 14:30:00
119,14,8,6,0.0084648678754168,2019-03-23 14:15:00,2019-03-23 14:30:00
120,8,5,3,0.016209213537615307,2019-03-23 14:15:00,2019-03-23 14:30:00
122,4,0,4,0.0015277933786673977,2019-03-23 14:15:00,2019-03-23 14:30:00
126,15,8,7,0.007951040202117753,2019-03-23 14:15:00,2019-03-23 14:30:00
127,8,8,0,0.010764450790124221,2019-03-23 14:15:00,2019-03-23 14:30:00
133,1,1,0,0.0023557534311207276,2019-03-23 14:15:00,2019-03-23 14:30:00
137,34,15,19,0.025237884125007097,2019-03-23 14:15:00,2019-03-23 14:30:00
138,22,7,15,0.013006080602278657,2019-03-23 14:15:00,2019-03-23 14:30:00
140,3,1,2,0.0020332195121666435,2019-03-23 14:15:00,2019-03-23 14:30:00
141,2,0,2,0.0015277933786673977,2019-03-23 14:15:00,2019-03-23 14:30:00
147,4,2,2,0.010181102357824772,2019-03-23 14:15:00,2019-03-23 14:30:00
151,3,2,1,0.018834411336982146,2019-03-23 14:15:00,2019-03-23 14:30:00
153,6,2,4,0.0032047500756825133,2019-03-23 14:15:00,2019-03-23 14:30:00
154,3,0,3,0.0015277933786673977,2019-03-23 14:15:00,2019-03-23 14:30:00
157,9,4,5,0.004869806834960251,2019-03-23 14:15:00,2019-03-23 14:30:00
158,1,0,1,0.0015277933786673977,2019-03-23 14:15:00,2019-03-23 14:30:00
159,1,0,1,0.0015277933786673977,2019-03-23 14:15:00,2019-03-23 14:30:00
160,3,2,1,0.016218429038439345,2019-03-23 14:15:00,2019-03-23 14:30:00
161,1,0,1,0.0015277933786673977,2019-03-23 14:15:00,2019-03-23 14:30:00
162,9,5,4,0.005069712777580142,2019-03-23 14:15:00,2019-03-23 14:30:00
164,19,13,6,0.013205461918575427,2019-03-23 14:15:00,2019-03-23 14:30:00
168,14,8,6,0.011909200005717007,2019-03-23 14:15:00,2019-03-23 14:30:00
169,26,13,13,0.022943624666737324,2019-03-23 14:15:00,2019-03-23 14:30:00
170,5,4,1,0.011055393249266111,2019-03-23 14:15:00,2019-03-23 14:30:00
171,2,1,1,0.003984480205441383,2019-03-23 14:15:00,2019-03-23 14:30:00
172,10,4,6,0.005917720317998273,2019-03-23 14:15:00,2019-03-23 14:30:00
173,1,0,1,0.0015277933786673977,2019-03-23 14:15:00,2019-03-23 14:30:00
175,3,2,1,0.012344429602614114,2019-03-23 14:15:00,2019-03-23 14:30:00
177,6,3,3,0.010181102357824772,2019-03-23 14:15:00,2019-03-23 14:30:00
189,1,0,1,0.0015277933786673977,2019-03-23 14:15:00,2019-03-23 14:30:00
190,7,0,7,0.0015277933786673977,2019-03-23 14:15:00,2019-03-23 14:30:00
191,16,5,11,0.0064256883509490985,2019-03-23 14:15:00,2019-03-23 14:30:00
195,2,0,2,0.0015277933786673977,2019-03-23 14:15:00,2019-03-23 14:30:00
196,4,3,1,0.003484040731266578,2019-03-23 14:15:00,2019-03-23 14:30:00
197,15,8,7,0.01896588519375909,2019-03-23 14:15:00,2019-03-23 14:30:00
199,6,2,4,0.002886569112896472,2019-03-23 14:15:00,2019-03-23 14:30:00
201,3,0,3,0.0015277933786673977,2019-03-23 14:15:00,2019-03-23 14:30:00
202,5,1,4,0.0019606806658055186,2019-03-23 14:15:00,2019-03-23 14:30:00
203,26,16,10,0.04405406737696439,2019-03-23 14:15:00,2019-03-23 14:30:00
1,7,6,1,0.010138195806533407,2019-03-23 14:30:00,2019-03-23 14:45:00
2,12,6,6,0.010803958823549408,2019-03-23 14:30:00,2019-03-23 14:45:00
5,10,6,4,0.009154344128330704,2019-03-23 14:30:00,2019-03-23 14:45:00
10,1,0,1,0.0016033013959790695,2019-03-23 14:30:00,2019-03-23 14:45:00
11,4,1,3,0.0022372128221923547,2019-03-23 14:30:00,2019-03-23 14:45:00
15,6,3,3,0.010097772571264114,2019-03-23 14:30:00,2019-03-23 14:45:00
16,17,11,6,0.016577416216489237,2019-03-23 14:30:00,2019-03-23 14:45:00
18,13,4,9,0.002899646304982693,2019-03-23 14:30:00,2019-03-23 14:45:00
19,4,1,3,0.0035855719564622988,2019-03-23 14:30:00,2019-03-23 14:45:00
20,12,9,3,0.008587981577772769,2019-03-23 14:30:00,2019-03-23 14:45:00
23,11,9,2,0.025398198076291224,2019-03-23 14:30:00,2019-03-23 14:45:00
26,8,3,5,0.004238274186952519,2019-03-23 14:30:00,2019-03-23 14:45:00
27,1,0,1,0.0016033013959790695,2019-03-23 14:30:00,2019-03-23 14:45:00
28,6,4,2,0.0032842250488868074,2019-03-23 14:30:00,2019-03-23 14:45:00
30,2,0,2,0.0016033013959790695,2019-03-23 14:30:00,2019-03-23 14:45:00
35,5,4,1,0.007213534587862404,2019-03-23 14:30:00,2019-03-23 14:45:00
40,9,5,4,0.009147029043282188,2019-03-23 14:30:00,2019-03-23 14:45:00
41,4,0,4,0.0016033013959790695,2019-03-23 14:30:00,2019-03-23 14:45:00
46,2,1,1,0.0019300132809556313,2019-03-23 14:30:00,2019-03-23 14:45:00
50,8,4,4,0.009892113424313351,2019-03-23 14:30:00,2019-03-23 14:45:00
57,4,3,1,0.007805859767220878,2019-03-23 14:30:00,2019-03-23 14:45:00
58,15,7,8,0.018655845276588513,2019-03-23 14:30:00,2019-03-23 14:45:00
61,4,3,1,0.005150292292641814,2019-03-23 14:30:00,2019-03-23 14:45:00
62,20,11,9,0.010729619713554281,2019-03-23 14:30:00,2019-03-23 14:45:00
64,2,0,2,0.0016033013959790695,2019-03-23 14:30:00,2019-03-23 14:45:00
66,5,0,5,0.0016033013959790695,2019-03-23 14:30:00,2019-03-23 14:45:00
67,17,10,7,0.015733940875368314,2019-03-23 14:30:00,2019-03-23 14:45:00
68,11,4,7,0.00482059026355571,2019-03-23 14:30:00,2019-03-23 14:45:00
69,21,15,6,0.02329336348782484,2019-03-23 14:30:00,2019-03-23 14:45:00
70,5,2,3,0.0037002893168906004,2019-03-23 14:30:00,2019-03-23 14:45:00
71,4,2,2,0.010667231254400313,2019-03-23 14:30:00,2019-03-23 14:45:00
74,12,7,5,0.010508626139151425,2019-03-23 14:30:00,2019-03-23 14:45:00
75,36,23,13,0.10206761381652837,2019-03-23 14:30:00,2019-03-23 14:45:00
79,7,3,4,0.004343517417632609,2019-03-23 14:30:00,2019-03-23 14:45:00
80,4,1,3,0.0022372128221923547,2019-03-23 14:30:00,2019-03-23 14:45:00
85,8,7,1,0.02452630787437251,2019-03-23 14:30:00,2019-03-23 14:45:00
86,6,2,4,0.004592520266022769,2019-03-23 14:30:00,2019-03-23 14:45:00
87,17,11,6,0.019925711888784604,2019-03-23 14:30:00,2019-03-23 14:45:00
88,7,6,1,0.0050797127438565294,2019-03-23 14:30:00,2019-03-23 14:45:00
89,10,4,6,0.0038802804033886257,2019-03-23 14:30:00,2019-03-23 14:45:00
90,2,1,1,0.0022847376789922737,2019-03-23 14:30:00,2019-03-23 14:45:00
99,6,3,3,0.002750045016311816,2019-03-23 14:30:00,2019-03-23 14:45:00
101,2,2,0,0.005629578219795265,2019-03-23 14:30:00,2019-03-23 14:45:00
104,7,1,6,0.0029661739620054778,2019-03-23 14:30:00,2019-03-23 14:45:00
106,10,5,5,0.0063513989509474305,2019-03-23 14:30:00,2019-03-23 14:45:00
108,3,1,2,0.0027884749558609555,2019-03-23 14:30:00,2019-03-23 14:45:00
109,18,8,10,0.007383593209446835,2019-03-23 14:30:00,2019-03-23 14:45:00
110,12,9,3,0.015280870146212223,2019-03-23 14:30:00,2019-03-23 14:45:00
111,2,1,1,0.010667231254400313,2019-03-23 14:30:00,2019-03-23 14:45:00
112,15,3,12,0.002035967083608576,2019-03-23 14:30:00,2019-03-23 14:45:00
113,4,0,4,0.0016033013959790695,2019-03-23 14:30:00,2019-03-23 14:45:00
114,2,2,0,0.0037221810676977703,2019-03-23 14:30:00,2019-03-23 14:45:00
115,6,3,3,0.004172139501036662,2019-03-23 14:30:00,2019-03-23 14:45:00
116,3,0,3,0.0016033013959790695,2019-03-23 14:30:00,2019-03-23 14:45:00
118,4,3,1,0.0055693179416446215,2019-03-23 14:30:00,2019-03-23 14:45:00
119,13,5,8,0.0047195715219049954,2019-03-23 14:30:00,2019-03-23 14:45:00
120,12,6,6,0.015396029290526914,2019-03-23 14:30:00,2019-03-23 14:45:00
122,5,0,5,0.0016033013959790695,2019-03-23 14:30:00,2019-03-23 14:45:00
126,8,1,7,0.0026902575391323773,2019-03-23 14:30:00,2019-03-23 14:45:00
127,12,12,0,0.01581140082393082,2019-03-23 14:30:00,2019-03-23 14:45:00
133,2,1,1,0.0028889113829361837,2019-03-23 14:30:00,2019-03-23 14:45:00
137,38,20,18,0.020158454442763898,2019-03-23 14:30:00,2019-03-23 14:45:00
138,36,16,20,0.017851649611206305,2019-03-23 14:30:00,2019-03-23 14:45:00
140,8,3,5,0.0030476628778584383,2019-03-23 14:30:00,2019-03-23 14:45:00
141,3,0,3,0.0016033013959790695,2019-03-23 14:30:00,2019-03-23 14:45:00
147,6,3,3,0.010667231254400313,2019-03-23 14:30:00,2019-03-23 14:45:00
151,2,1,1,0.010667231254400313,2019-03-23 14:30:00,2019-03-23 14:45:00
153,8,4,4,0.004984933399154871,2019-03-23 14:30:00,2019-03-23 14:45:00
154,5,1,4,0.0031340758243885163,2019-03-23 14:30:00,2019-03-23 14:45:00
157,12,4,8,0.012096600070224419,2019-03-23 14:30:00,2019-03-23 14:45:00
158,1,0,1,0.0016033013959790695,2019-03-23 14:30:00,2019-03-23 14:45:00
159,3,0,3,0.0016033013959790695,2019-03-23 14:30:00,2019-03-23 14:45:00
160,4,3,1,0.02627725872315876,2019-03-23 14:30:00,2019-03-23 14:45:00
161,1,0,1,0.0016033013959790695,2019-03-23 14:30:00,2019-03-23 14:45:00
162,8,4,4,0.0051142227014997375,2019-03-23 14:30:00,2019-03-23 14:45:00
164,25,13,12,0.007843878192598686,2019-03-23 14:30:00,2019-03-23 14:45:00
168,23,16,7,0.02232891396691598,2019-03-23 14:30:00,2019-03-23 14:45:00
169,22,13,9,0.022950821256150868,2019-03-23 14:30:00,2019-03-23 14:45:00
170,5,1,4,0.0021048016643509916,2019-03-23 14:30:00,2019-03-23 14:45:00
171,2,1,1,0.0059814412255545304,2019-03-23 14:30:00,2019-03-23 14:45:00
172,9,4,5,0.0066763146109774145,2019-03-23 14:30:00,2019-03-23 14:45:00
173,1,0,1,0.0016033013959790695,2019-03-23 14:30:00,2019-03-23 14:45:00
175,3,2,1,0.01248001722608456,2019-03-23 14:30:00,2019-03-23 14:45:00
177,6,3,3,0.010667231254400313,2019-03-23 14:30:00,2019-03-23 14:45:00
189,3,3,0,0.005460131356850412,2019-03-23 14:30:00,2019-03-23 14:45:00
190,7,0,7,0.0016033013959790695,2019-03-23 14:30:00,2019-03-23 14:45:00
191,14,1,13,0.010222243914661783,2019-03-23 14:30:00,2019-03-23 14:45:00
196,5,4,1,0.0055699340326625674,2019-03-23 14:30:00,2019-03-23 14:45:00
197,12,6,6,0.010667231254400313,2019-03-23 14:30:00,2019-03-23 14:45:00
199,7,2,5,0.002799911949676823,2019-03-23 14:30:00,2019-03-23 14:45:00
201,1,0,1,0.0016033013959790695,2019-03-23 14:30:00,2019-03-23 14:45:00
202,6,1,5,0.0029661739620054778,2019-03-23 14:30:00,2019-03-23 14:45:00
203,25,14,11,0.026047152265845065,2019-03-23 14:30:00,2019-03-23 14:45:00
1,6,5,1,0.007518151784224455,2019-03-23 14:45:00,2019-03-23 15:00:00
2,13,6,7,0.014283280691300568,2019-03-23 14:45:00,2019-03-23 15:00:00
5,11,6,5,0.0035290341648636547,2019-03-23 14:45:00,2019-03-23 15:00:00
10,1,0,1,0.0014911183599675805,2019-03-23 14:45:00,2019-03-23 15:00:00
11,4,1,3,0.0020806381198551745,2019-03-23 14:45:00,2019-03-23 15:00:00
15,5,3,2,0.005552843032429986,2019-03-23 14:45:00,2019-03-23 15:00:00
16,18,8,10,0.012084161943366116,2019-03-23 14:45:00,2019-03-23 15:00:00
18,10,3,7,0.0022484095539229455,2019-03-23 14:45:00,2019-03-23 15:00:00
19,3,0,3,0.0014911183599675805,2019-03-23 14:45:00,2019-03-23 15:00:00
20,12,9,3,0.006260055289328585,2019-03-23 14:45:00,2019-03-23 15:00:00
23,18,14,4,0.02338554048249954,2019-03-23 14:45:00,2019-03-23 15:00:00
26,9,4,5,0.013555424640580058,2019-03-23 14:45:00,2019-03-23 15:00:00
27,3,0,3,0.0014911183599675805,2019-03-23 14:45:00,2019-03-23 15:00:00
28,10,8,2,0.018007718697434633,2019-03-23 14:45:00,2019-03-23 15:00:00
30,2,0,2,0.0014911183599675805,2019-03-23 14:45:00,2019-03-23 15:00:00
35,4,4,0,0.00505286034723678,2019-03-23 14:45:00,2019-03-23 15:00:00
37,1,1,0,0.0031333048492499065,2019-03-23 14:45:00,2019-03-23 15:00:00
40,3,2,1,0.003905286739661271,2019-03-23 14:45:00,2019-03-23 15:00:00
41,7,1,6,0.001737227873871844,2019-03-23 14:45:00,2019-03-23 15:00:00
46,5,3,2,0.0038746997293119087,2019-03-23 14:45:00,2019-03-23 15:00:00
50,1,1,0,0.0017023619776894254,2019-03-23 14:45:00,2019-03-23 15:00:00
57,7,5,2,0.00744218879515519,2019-03-23 14:45:00,2019-03-23 15:00:00
58,6,0,6,0.0014911183599675805,2019-03-23 14:45:00,2019-03-23 15:00:00
61,2,1,1,0.0019136055954112705,2019-03-23 14:45:00,2019-03-23 15:00:00
62,23,12,11,0.037529074886232514,2019-03-23 14:45:00,2019-03-23 15:00:00
64,2,0,2,0.0014911183599675805,2019-03-23 14:45:00,2019-03-23 15:00:00
66,5,1,4,0.004480230222836154,2019-03-23 14:45:00,2019-03-23 15:00:00
67,29,11,18,0.02193438762590809,2019-03-23 14:45:00,2019-03-23 15:00:00
68,9,2,7,0.003932261142841025,2019-03-23 14:45:00,2019-03-23 15:00:00
69,30,22,8,0.02882063722944166,2019-03-23 14:45:00,2019-03-23 15:00:00
70,2,1,1,0.009937051705358795,2019-03-23 14:45:00,2019-03-23 15:00:00
71,2,1,1,0.009937051705358795,2019-03-23 14:45:00,2019-03-23 15:00:00
74,13,7,6,0.011215909833576945,2019-03-23 14:45:00,2019-03-23 15:00:00
75,36,21,15,0.02574633341419199,2019-03-23 14:45:00,2019-03-23 15:00:00
79,5,3,2,0.005238431192220659,2019-03-23 14:45:00,2019-03-23 15:00:00
80,4,1,3,0.0020806381198551745,2019-03-23 14:45:00,2019-03-23 15:00:00
85,3,2,1,0.05180805862981898,2019-03-23 14:45:00,2019-03-23 15:00:00
86,4,1,3,0.002466359277283575,2019-03-23 14:45:00,2019-03-23 15:00:00
87,17,9,8,0.009562177062995138,2019-03-23 14:45:00,2019-03-23 15:00:00
88,7,5,2,0.004961022666849632,2019-03-23 14:45:00,2019-03-23 15:00:00
89,8,4,4,0.008612228000201956,2019-03-23 14:45:00,2019-03-23 15:00:00
90,6,5,1,0.0075444738974282805,2019-03-23 14:45:00,2019-03-23 15:00:00
99,11,6,5,0.009812332709675922,2019-03-23 14:45:00,2019-03-23 15:00:00
101,2,0,2,0.0014911183599675805,2019-03-23 14:45:00,2019-03-23 15:00:00
104,5,1,4,0.0019136055954112705,2019-03-23 14:45:00,2019-03-23 15:00:00
106,8,4,4,0.00729586566451208,2019-03-23 14:45:00,2019-03-23 15:00:00
108,3,1,2,0.0025932691929831915,2019-03-23 14:45:00,2019-03-23 15:00:00
109,19,9,10,0.019174927857019002,2019-03-23 14:45:00,2019-03-23 15:00:00
110,24,14,10,0.03515829535022942,2019-03-23 14:45:00,2019-03-23 15:00:00
111,4,1,3,0.0020806381198551745,2019-03-23 14:45:00,2019-03-23 15:00:00
112,15,7,8,0.013874833421909202,2019-03-23 14:45:00,2019-03-23 15:00:00
113,9,5,4,0.013765641230455636,2019-03-23 14:45:00,2019-03-23 15:00:00
115,5,2,3,0.003905286739661271,2019-03-23 14:45:00,2019-03-23 15:00:00
116,2,0,2,0.0014911183599675805,2019-03-23 14:45:00,2019-03-23 15:00:00
118,3,1,2,0.0029655854566896277,2019-03-23 14:45:00,2019-03-23 15:00:00
119,21,10,11,0.012508354002308139,2019-03-23 14:45:00,2019-03-23 15:00:00
120,12,6,6,0.0067588281095182536,2019-03-23 14:45:00,2019-03-23 15:00:00
122,6,0,6,0.0014911183599675805,2019-03-23 14:45:00,2019-03-23 15:00:00
126,9,4,5,0.00887788734942543,2019-03-23 14:45:00,2019-03-23 15:00:00
127,15,11,4,0.02442165158182651,2019-03-23 14:45:00,2019-03-23 15:00:00
133,3,0,3,0.0014911183599675805,2019-03-23 14:45:00,2019-03-23 15:00:00
137,36,20,16,0.015948058737311914,2019-03-23 14:45:00,2019-03-23 15:00:00
138,25,8,17,0.015679237893948556,2019-03-23 14:45:00,2019-03-23 15:00:00
140,9,3,6,0.0039551939159775725,2019-03-23 14:45:00,2019-03-23 15:00:00
141,3,1,2,0.004480230222836154,2019-03-23 14:45:00,2019-03-23 15:00:00
147,6,3,3,0.009937051705358795,2019-03-23 14:45:00,2019-03-23 15:00:00
151,2,1,1,0.009937051705358795,2019-03-23 14:45:00,2019-03-23 15:00:00
153,10,7,3,0.02041854835751157,2019-03-23 14:45:00,2019-03-23 15:00:00
154,2,1,1,0.0032256897847991683,2019-03-23 14:45:00,2019-03-23 15:00:00
157,9,2,7,0.0019694075350972845,2019-03-23 14:45:00,2019-03-23 15:00:00
158,3,2,1,0.007469342085704727,2019-03-23 14:45:00,2019-03-23 15:00:00
159,5,0,5,0.0014911183599675805,2019-03-23 14:45:00,2019-03-23 15:00:00
160,4,3,1,0.018470485455820397,2019-03-23 14:45:00,2019-03-23 15:00:00
161,1,1,0,0.003137979807568923,2019-03-23 14:45:00,2019-03-23 15:00:00
162,5,2,3,0.003441098366953907,2019-03-23 14:45:00,2019-03-23 15:00:00
164,28,17,11,0.023896332953500996,2019-03-23 14:45:00,2019-03-23 15:00:00
168,24,20,4,0.04741034594035219,2019-03-23 14:45:00,2019-03-23 15:00:00
169,9,5,4,0.007726779591621281,2019-03-23 14:45:00,2019-03-23 15:00:00
170,4,0,4,0.0014911183599675805,2019-03-23 14:45:00,2019-03-23 15:00:00
171,1,1,0,0.0031176980120004695,2019-03-23 14:45:00,2019-03-23 15:00:00
172,6,3,3,0.004221706159283852,2019-03-23 14:45:00,2019-03-23 15:00:00
173,1,0,1,0.0014911183599675805,2019-03-23 14:45:00,2019-03-23 15:00:00
175,3,2,1,0.011344707262923998,2019-03-23 14:45:00,2019-03-23 15:00:00
177,6,3,3,0.009937051705358795,2019-03-23 14:45:00,2019-03-23 15:00:00
189,4,3,1,0.002208552122662137,2019-03-23 14:45:00,2019-03-23 15:00:00
190,1,0,1,0.0014911183599675805,2019-03-23 14:45:00,2019-03-23 15:00:00
191,14,2,12,0.0019981030425000085,2019-03-23 14:45:00,2019-03-23 15:00:00
196,3,2,1,0.004763380380950909,2019-03-23 14:45:00,2019-03-23 15:00:00
197,14,6,8,0.0041135555118654655,2019-03-23 14:45:00,2019-03-23 15:00:00
199,6,2,4,0.004820464682437119,2019-03-23 14:45:00,2019-03-23 15:00:00
201,1,0,1,0.0014911183599675805,2019-03-23 14:45:00,2019-03-23 15:00:00
202,7,1,6,0.0027585800662986507,2019-03-23 14:45:00,2019-03-23 15:00:00
203,30,16,14,0.016061211976840746,2019-03-23 14:45:00,2019-03-23 15:00:00
1,8,4,4,0.004183944846742737,2019-03-23 15:00:00,2019-03-23 15:15:00
2,19,8,11,0.013491178832882826,2019-03-23 15:00:00,2019-03-23 15:15:00
5,12,7,5,0.0056387105750806,2019-03-23 15:00:00,2019-03-23 15:15:00
10,5,1,4,0.0018636678433013583,2019-03-23 15:00:00,2019-03-23 15:15:00
11,4,1,3,0.002047869612552289,2019-03-23 15:00:00,2019-03-23 15:15:00
15,5,4,1,0.0063196900238451275,2019-03-23 15:00:00,2019-03-23 15:15:00
16,13,4,9,0.009615331063925207,2019-03-23 15:00:00,2019-03-23 15:15:00
18,8,3,5,0.002529187944039821,2019-03-23 15:00:00,2019-03-23 15:15:00
19,2,2,0,0.002486013587108816,2019-03-23 15:00:00,2019-03-23 15:15:00
20,10,7,3,0.007276647359370084,2019-03-23 15:00:00,2019-03-23 15:15:00
23,21,14,7,0.020950469396716603,2019-03-23 15:00:00,2019-03-23 15:15:00
26,8,3,5,0.009118287216859136,2019-03-23 15:00:00,2019-03-23 15:15:00
27,2,0,2,0.0014676355392083155,2019-03-23 15:00:00,2019-03-23 15:15:00
28,12,9,3,0.007579642743261062,2019-03-23 15:00:00,2019-03-23 15:15:00
30,2,0,2,0.0014676355392083155,2019-03-23 15:00:00,2019-03-23 15:15:00
35,6,2,4,0.0026468497929065487,2019-03-23 15:00:00,2019-03-23 15:15:00
37,1,1,0,0.004894589180077173,2019-03-23 15:00:00,2019-03-23 15:15:00
40,11,4,7,0.0039975685989255254,2019-03-23 15:00:00,2019-03-23 15:15:00
41,7,3,4,0.0028694666964094616,2019-03-23 15:00:00,2019-03-23 15:15:00
46,8,5,3,0.00413839245101956,2019-03-23 15:00:00,2019-03-23 15:15:00
50,5,4,1,0.024822604774198204,2019-03-23 15:00:00,2019-03-23 15:15:00
57,5,3,2,0.00552250350440798,2019-03-23 15:00:00,2019-03-23 15:15:00
58,9,1,8,0.0018976009338239064,2019-03-23 15:00:00,2019-03-23 15:15:00
61,4,1,3,0.002047869612552289,2019-03-23 15:00:00,2019-03-23 15:15:00
62,21,12,9,0.027568291827805114,2019-03-23 15:00:00,2019-03-23 15:15:00
64,2,0,2,0.0014676355392083155,2019-03-23 15:00:00,2019-03-23 15:15:00
66,5,1,4,0.002705821377994586,2019-03-23 15:00:00,2019-03-23 15:15:00
67,21,8,13,0.008044641384984128,2019-03-23 15:00:00,2019-03-23 15:15:00
68,9,1,8,0.004312991437676522,2019-03-23 15:00:00,2019-03-23 15:15:00
69,27,16,11,0.01588495456947534,2019-03-23 15:00:00,2019-03-23 15:15:00
70,4,1,3,0.002047869612552289,2019-03-23 15:00:00,2019-03-23 15:15:00
71,4,2,2,0.009778861081081806,2019-03-23 15:00:00,2019-03-23 15:15:00
74,18,10,8,0.011308904404823059,2019-03-23 15:00:00,2019-03-23 15:15:00
75,36,20,16,0.03211290221775781,2019-03-23 15:00:00,2019-03-23 15:15:00
79,5,3,2,0.003675097974388844,2019-03-23 15:00:00,2019-03-23 15:15:00
80,2,1,1,0.009778861081081806,2019-03-23 15:00:00,2019-03-23 15:15:00
85,3,2,1,0.028937770089967375,2019-03-23 15:00:00,2019-03-23 15:15:00
86,3,0,3,0.0014676355392083155,2019-03-23 15:00:00,2019-03-23 15:15:00
87,8,5,3,0.015532955714544255,2019-03-23 15:00:00,2019-03-23 15:15:00
88,12,6,6,0.005897322387855927,2019-03-23 15:00:00,2019-03-23 15:15:00
89,10,6,4,0.013711190190528867,2019-03-23 15:00:00,2019-03-23 15:15:00
90,7,5,2,0.00747822850751869,2019-03-23 15:00:00,2019-03-23 15:15:00
99,7,4,3,0.011088825231941768,2019-03-23 15:00:00,2019-03-23 15:15:00
101,2,0,2,0.0014676355392083155,2019-03-23 15:00:00,2019-03-23 15:15:00
104,4,0,4,0.0014676355392083155,2019-03-23 15:00:00,2019-03-23 15:15:00
106,7,4,3,0.00804937805104118,2019-03-23 15:00:00,2019-03-23 15:15:00
109,18,8,10,0.012629079726344843,2019-03-23 15:00:00,2019-03-23 15:15:00
110,18,7,11,0.016020974445277298,2019-03-23 15:00:00,2019-03-23 15:15:00
111,9,5,4,0.005566320415973351,2019-03-23 15:00:00,2019-03-23 15:15:00
112,14,9,5,0.01673486851186755,2019-03-23 15:00:00,2019-03-23 15:15:00
113,6,4,2,0.01079980136618323,2019-03-23 15:00:00,2019-03-23 15:15:00
114,2,0,2,0.0014676355392083155,2019-03-23 15:00:00,2019-03-23 15:15:00
115,5,2,3,0.004508200197010426,2019-03-23 15:00:00,2019-03-23 15:15:00
116,7,2,5,0.0034636375953682455,2019-03-23 15:00:00,2019-03-23 15:15:00
118,6,3,3,0.004329178849159507,2019-03-23 15:00:00,2019-03-23 15:15:00
119,27,16,11,0.0213155011366425,2019-03-23 15:00:00,2019-03-23 15:15:00
120,10,4,6,0.004610364387161447,2019-03-23 15:00:00,2019-03-23 15:15:00
122,3,0,3,0.0014676355392083155,2019-03-23 15:00:00,2019-03-23 15:15:00
126,16,7,9,0.014896878241842717,2019-03-23 15:00:00,2019-03-23 15:15:00
127,11,8,3,0.020003868873638024,2019-03-23 15:00:00,2019-03-23 15:15:00
133,3,0,3,0.0014676355392083155,2019-03-23 15:00:00,2019-03-23 15:15:00
137,52,26,26,0.03712241860892499,2019-03-23 15:00:00,2019-03-23 15:15:00
138,26,12,14,0.032391860176332575,2019-03-23 15:00:00,2019-03-23 15:15:00
140,12,4,8,0.0066253305787918985,2019-03-23 15:00:00,2019-03-23 15:15:00
141,9,7,2,0.007480714282811124,2019-03-23 15:00:00,2019-03-23 15:15:00
147,6,3,3,0.009778861081081806,2019-03-23 15:00:00,2019-03-23 15:15:00
151,5,3,2,0.0180900866229553,2019-03-23 15:00:00,2019-03-23 15:15:00
153,12,8,4,0.021408834584288865,2019-03-23 15:00:00,2019-03-23 15:15:00
154,1,1,0,0.002510261180062031,2019-03-23 15:00:00,2019-03-23 15:15:00
157,9,2,7,0.0019383911451592724,2019-03-23 15:00:00,2019-03-23 15:15:00
158,5,3,2,0.006859865195248083,2019-03-23 15:00:00,2019-03-23 15:15:00
159,5,0,5,0.0014676355392083155,2019-03-23 15:00:00,2019-03-23 15:15:00
160,3,2,1,0.011441106189456506,2019-03-23 15:00:00,2019-03-23 15:15:00
161,1,1,0,0.002640259325359031,2019-03-23 15:00:00,2019-03-23 15:15:00
162,5,2,3,0.0033868979953002145,2019-03-23 15:00:00,2019-03-23 15:15:00
164,29,20,9,0.03178959005598357,2019-03-23 15:00:00,2019-03-23 15:15:00
168,25,19,6,0.03695095482914709,2019-03-23 15:00:00,2019-03-23 15:15:00
169,12,8,4,0.016124476854507762,2019-03-23 15:00:00,2019-03-23 15:15:00
170,1,0,1,0.0014676355392083155,2019-03-23 15:00:00,2019-03-23 15:15:00
171,1,1,0,0.002047869612552289,2019-03-23 15:00:00,2019-03-23 15:15:00
172,5,3,2,0.004421314097646935,2019-03-23 15:00:00,2019-03-23 15:15:00
173,1,0,1,0.0014676355392083155,2019-03-23 15:00:00,2019-03-23 15:15:00
175,2,1,1,0.009778861081081806,2019-03-23 15:00:00,2019-03-23 15:15:00
177,8,3,5,0.002995202611059066,2019-03-23 15:00:00,2019-03-23 15:15:00
189,8,7,1,0.005599930036708864,2019-03-23 15:00:00,2019-03-23 15:15:00
191,14,3,11,0.004114251872665413,2019-03-23 15:00:00,2019-03-23 15:15:00
195,1,0,1,0.0014676355392083155,2019-03-23 15:00:00,2019-03-23 15:15:00
196,5,1,4,0.004894589180077173,2019-03-23 15:00:00,2019-03-23 15:15:00
197,14,6,8,0.004048788068046484,2019-03-23 15:00:00,2019-03-23 15:15:00
199,6,3,3,0.005887980838394702,2019-03-23 15:00:00,2019-03-23 15:15:00
200,1,0,1,0.0014676355392083155,2019-03-23 15:00:00,2019-03-23 15:15:00
201,1,0,1,0.0014676355392083155,2019-03-23 15:00:00,2019-03-23 15:15:00
202,5,1,4,0.002715134342899127,2019-03-23 15:00:00,2019-03-23 15:15:00
203,27,15,12,0.023302464133715384,2019-03-23 15:00:00,2019-03-23 15:15:00
1,16,4,12,0.0031318831062048195,2019-03-23 15:15:00,2019-03-23 15:30:00
2,21,8,13,0.007330914364882552,2019-03-23 15:15:00,2019-03-23 15:30:00
5,14,7,7,0.006174148377358988,2019-03-23 15:15:00,2019-03-23 15:30:00
11,4,1,3,0.0023942304375136722,2019-03-23 15:15:00,2019-03-23 15:30:00
15,13,11,2,0.00954916064525328,2019-03-23 15:15:00,2019-03-23 15:30:00
16,18,9,9,0.016096485686492246,2019-03-23 15:15:00,2019-03-23 15:30:00
18,8,3,5,0.005027306709191369,2019-03-23 15:15:00,2019-03-23 15:30:00
19,4,4,0,0.008465132087494505,2019-03-23 15:15:00,2019-03-23 15:30:00
20,9,9,0,0.013122253512544611,2019-03-23 15:15:00,2019-03-23 15:30:00
23,15,10,5,0.01873509926113655,2019-03-23 15:15:00,2019-03-23 15:30:00
26,9,4,5,0.008090124255279624,2019-03-23 15:15:00,2019-03-23 15:30:00
27,4,1,3,0.0023942304375136722,2019-03-23 15:15:00,2019-03-23 15:30:00
28,12,9,3,0.010603761599384942,2019-03-23 15:15:00,2019-03-23 15:30:00
35,7,2,5,0.003468697247054996,2019-03-23 15:15:00,2019-03-23 15:30:00
37,2,1,1,0.006918343364110615,2019-03-23 15:15:00,2019-03-23 15:30:00
40,6,0,6,0.0017158370851764453,2019-03-23 15:15:00,2019-03-23 15:30:00
41,4,1,3,0.0019376882049751184,2019-03-23 15:15:00,2019-03-23 15:30:00
46,14,5,9,0.006201084575765321,2019-03-23 15:15:00,2019-03-23 15:30:00
50,3,0,3,0.0017158370851764453,2019-03-23 15:15:00,2019-03-23 15:30:00
57,8,6,2,0.012239528333450062,2019-03-23 15:15:00,2019-03-23 15:30:00
58,6,3,3,0.004872470913311406,2019-03-23 15:15:00,2019-03-23 15:30:00
61,4,1,3,0.0023942304375136722,2019-03-23 15:15:00,2019-03-23 15:30:00
62,28,16,12,0.01749105983691164,2019-03-23 15:15:00,2019-03-23 15:30:00
64,2,2,0,0.0072727879331794375,2019-03-23 15:15:00,2019-03-23 15:30:00
66,4,0,4,0.0017158370851764453,2019-03-23 15:15:00,2019-03-23 15:30:00
67,23,7,16,0.007050155370358804,2019-03-23 15:15:00,2019-03-23 15:30:00
68,3,0,3,0.0017158370851764453,2019-03-23 15:15:00,2019-03-23 15:30:00
69,27,15,12,0.018537864946855723,2019-03-23 15:15:00,2019-03-23 15:30:00
70,4,2,2,0.005268721623126976,2019-03-23 15:15:00,2019-03-23 15:30:00
71,4,2,2,0.011362828292722026,2019-03-23 15:15:00,2019-03-23 15:30:00
74,14,5,9,0.0060700158911678945,2019-03-23 15:15:00,2019-03-23 15:30:00
75,33,20,13,0.03608936643872343,2019-03-23 15:15:00,2019-03-23 15:30:00
79,5,3,2,0.004004178294531594,2019-03-23 15:15:00,2019-03-23 15:30:00
80,2,1,1,0.011362828292722026,2019-03-23 15:15:00,2019-03-23 15:30:00
85,5,2,3,0.004429410494525353,2019-03-23 15:15:00,2019-03-23 15:30:00
86,2,0,2,0.0017158370851764453,2019-03-23 15:15:00,2019-03-23 15:30:00
87,17,10,7,0.035034405228864335,2019-03-23 15:15:00,2019-03-23 15:30:00
88,6,2,4,0.004756674640282267,2019-03-23 15:15:00,2019-03-23 15:30:00
89,10,6,4,0.010728511686381658,2019-03-23 15:15:00,2019-03-23 15:30:00
90,4,2,2,0.002674604597331192,2019-03-23 15:15:00,2019-03-23 15:30:00
99,8,5,3,0.007057215474877783,2019-03-23 15:15:00,2019-03-23 15:30:00
104,4,0,4,0.0017158370851764453,2019-03-23 15:15:00,2019-03-23 15:30:00
106,6,3,3,0.00788803600441057,2019-03-23 15:15:00,2019-03-23 15:30:00
109,16,7,9,0.010947173388737293,2019-03-23 15:15:00,2019-03-23 15:30:00
110,12,7,5,0.010679699742215389,2019-03-23 15:15:00,2019-03-23 15:30:00
111,11,8,3,0.018266122420617006,2019-03-23 15:15:00,2019-03-23 15:30:00
112,16,8,8,0.006810123149314633,2019-03-23 15:15:00,2019-03-23 15:30:00
113,2,0,2,0.0017158370851764453,2019-03-23 15:15:00,2019-03-23 15:30:00
114,3,1,2,0.0030964837662147263,2019-03-23 15:15:00,2019-03-23 15:30:00
115,6,3,3,0.0050911265679236895,2019-03-23 15:15:00,2019-03-23 15:30:00
116,4,1,3,0.00243364960129029,2019-03-23 15:15:00,2019-03-23 15:30:00
118,6,4,2,0.004791314615334005,2019-03-23 15:15:00,2019-03-23 15:30:00
119,24,15,9,0.025514344716974367,2019-03-23 15:15:00,2019-03-23 15:30:00
120,13,6,7,0.01134997160885315,2019-03-23 15:15:00,2019-03-23 15:30:00
122,5,2,3,0.004919808295651855,2019-03-23 15:15:00,2019-03-23 15:30:00
126,13,4,9,0.007599214336185633,2019-03-23 15:15:00,2019-03-23 15:30:00
127,10,6,4,0.01124457870098525,2019-03-23 15:15:00,2019-03-23 15:30:00
133,3,1,2,0.0022020089758919593,2019-03-23 15:15:00,2019-03-23 15:30:00
137,47,14,33,0.022087185841023076,2019-03-23 15:15:00,2019-03-23 15:30:00
138,32,19,13,0.0368317988042192,2019-03-23 15:15:00,2019-03-23 15:30:00
140,9,2,7,0.004581784763998924,2019-03-23 15:15:00,2019-03-23 15:30:00
141,10,8,2,0.009381266234586141,2019-03-23 15:15:00,2019-03-23 15:30:00
147,3,2,1,0.015189733930536723,2019-03-23 15:15:00,2019-03-23 15:30:00
151,9,4,5,0.005377354441978038,2019-03-23 15:15:00,2019-03-23 15:30:00
153,12,6,6,0.023858156318605384,2019-03-23 15:15:00,2019-03-23 15:30:00
154,5,3,2,0.014465374466163994,2019-03-23 15:15:00,2019-03-23 15:30:00
157,9,4,5,0.003812534012613889,2019-03-23 15:15:00,2019-03-23 15:30:00
158,1,0,1,0.0017158370851764453,2019-03-23 15:15:00,2019-03-23 15:30:00
159,4,0,4,0.0017158370851764453,2019-03-23 15:15:00,2019-03-23 15:30:00
160,1,1,0,0.002080466003213081,2019-03-23 15:15:00,2019-03-23 15:30:00
161,1,1,0,0.002301554173527974,2019-03-23 15:15:00,2019-03-23 15:30:00
162,5,2,3,0.00395995880890114,2019-03-23 15:15:00,2019-03-23 15:30:00
164,23,18,5,0.04249279784831742,2019-03-23 15:15:00,2019-03-23 15:30:00
168,24,15,9,0.02719336112918077,2019-03-23 15:15:00,2019-03-23 15:30:00
169,14,7,7,0.013190839575955321,2019-03-23 15:15:00,2019-03-23 15:30:00
171,2,1,1,0.0023942304375136722,2019-03-23 15:15:00,2019-03-23 15:30:00
172,9,4,5,0.003889747113157419,2019-03-23 15:15:00,2019-03-23 15:30:00
173,1,0,1,0.0017158370851764453,2019-03-23 15:15:00,2019-03-23 15:30:00
175,4,2,2,0.0065362183231091366,2019-03-23 15:15:00,2019-03-23 15:30:00
177,11,5,6,0.0068193590362662666,2019-03-23 15:15:00,2019-03-23 15:30:00
189,7,7,0,0.0067731628226627046,2019-03-23 15:15:00,2019-03-23 15:30:00
191,14,5,9,0.008363596165076446,2019-03-23 15:15:00,2019-03-23 15:30:00
195,1,0,1,0.0017158370851764453,2019-03-23 15:15:00,2019-03-23 15:30:00
196,3,0,3,0.0017158370851764453,2019-03-23 15:15:00,2019-03-23 15:30:00
197,14,6,8,0.0047342619223718525,2019-03-23 15:15:00,2019-03-23 15:30:00
199,6,3,3,0.005113608299984107,2019-03-23 15:15:00,2019-03-23 15:30:00
200,1,0,1,0.0017158370851764453,2019-03-23 15:15:00,2019-03-23 15:30:00
201,1,0,1,0.0017158370851764453,2019-03-23 15:15:00,2019-03-23 15:30:00
202,3,1,2,0.003174352757322988,2019-03-23 15:15:00,2019-03-23 15:30:00
203,28,20,8,0.032883254292359554,2019-03-23 15:15:00,2019-03-23 15:30:00
1,15,6,9,0.008972696019308352,2019-03-23 15:30:00,2019-03-23 15:45:00
2,16,8,8,0.019306108573890635,2019-03-23 15:30:00,2019-03-23 15:45:00
5,13,6,7,0.004984311384025603,2019-03-23 15:30:00,2019-03-23 15:45:00
11,2,0,2,0.0016937883927682766,2019-03-23 15:30:00,2019-03-23 15:45:00
15,25,19,6,0.019878526030107306,2019-03-23 15:30:00,2019-03-23 15:45:00
16,16,12,4,0.009996219501844367,2019-03-23 15:30:00,2019-03-23 15:45:00
18,7,3,4,0.003505851072627582,2019-03-23 15:30:00,2019-03-23 15:45:00
19,4,4,0,0.0044002281234038505,2019-03-23 15:30:00,2019-03-23 15:45:00
20,10,10,0,0.020809489195581662,2019-03-23 15:30:00,2019-03-23 15:45:00
23,27,15,12,0.02932307945085773,2019-03-23 15:30:00,2019-03-23 15:45:00
26,8,3,5,0.0036571748880824795,2019-03-23 15:30:00,2019-03-23 15:45:00
27,3,0,3,0.0016937883927682766,2019-03-23 15:30:00,2019-03-23 15:45:00
28,14,8,6,0.011936699084803978,2019-03-23 15:30:00,2019-03-23 15:45:00
35,6,1,5,0.0024102168783090416,2019-03-23 15:30:00,2019-03-23 15:45:00
37,1,1,0,0.0029374953780632487,2019-03-23 15:30:00,2019-03-23 15:45:00
40,2,0,2,0.0016937883927682766,2019-03-23 15:30:00,2019-03-23 15:45:00
41,5,1,4,0.002541319410515218,2019-03-23 15:30:00,2019-03-23 15:45:00
46,10,3,7,0.003454049228580026,2019-03-23 15:30:00,2019-03-23 15:45:00
50,7,1,6,0.001973359065465102,2019-03-23 15:30:00,2019-03-23 15:45:00
57,7,4,3,0.004389109751869643,2019-03-23 15:30:00,2019-03-23 15:45:00
58,4,1,3,0.004022885702806181,2019-03-23 15:30:00,2019-03-23 15:45:00
61,5,1,4,0.0021508667554568832,2019-03-23 15:30:00,2019-03-23 15:45:00
62,37,18,19,0.027388544126886138,2019-03-23 15:30:00,2019-03-23 15:45:00
64,8,5,3,0.04495546175285256,2019-03-23 15:30:00,2019-03-23 15:45:00
66,5,0,5,0.0016937883927682766,2019-03-23 15:30:00,2019-03-23 15:45:00
67,16,6,10,0.00912727405544522,2019-03-23 15:30:00,2019-03-23 15:45:00
68,2,0,2,0.0016937883927682766,2019-03-23 15:30:00,2019-03-23 15:45:00
69,19,9,10,0.009626632258663677,2019-03-23 15:30:00,2019-03-23 15:45:00
70,4,2,2,0.004369244522770512,2019-03-23 15:30:00,2019-03-23 15:45:00
71,4,2,2,0.011269678449499882,2019-03-23 15:30:00,2019-03-23 15:45:00
74,10,3,7,0.004138733148200682,2019-03-23 15:30:00,2019-03-23 15:45:00
75,32,19,13,0.02648543280850856,2019-03-23 15:30:00,2019-03-23 15:45:00
79,5,3,2,0.0051437360353300925,2019-03-23 15:30:00,2019-03-23 15:45:00
80,2,1,1,0.011269678449499882,2019-03-23 15:30:00,2019-03-23 15:45:00
85,7,4,3,0.008708365382967043,2019-03-23 15:30:00,2019-03-23 15:45:00
86,1,0,1,0.0016937883927682766,2019-03-23 15:30:00,2019-03-23 15:45:00
87,20,12,8,0.022474867777369005,2019-03-23 15:30:00,2019-03-23 15:45:00
88,6,2,4,0.0059427916031372045,2019-03-23 15:30:00,2019-03-23 15:45:00
89,11,5,6,0.006964965263740332,2019-03-23 15:30:00,2019-03-23 15:45:00
90,3,2,1,0.005797236272388762,2019-03-23 15:30:00,2019-03-23 15:45:00
99,3,2,1,0.0033888504282621594,2019-03-23 15:30:00,2019-03-23 15:45:00
101,6,3,3,0.011269678449499882,2019-03-23 15:30:00,2019-03-23 15:45:00
104,2,2,0,0.00402322935095205,2019-03-23 15:30:00,2019-03-23 15:45:00
106,8,4,4,0.007687738078532954,2019-03-23 15:30:00,2019-03-23 15:45:00
108,3,3,0,0.005249339251524017,2019-03-23 15:30:00,2019-03-23 15:45:00
109,19,11,8,0.01871370647552328,2019-03-23 15:30:00,2019-03-23 15:45:00
110,13,8,5,0.013697962580460507,2019-03-23 15:30:00,2019-03-23 15:45:00
111,18,9,9,0.016446818629883196,2019-03-23 15:30:00,2019-03-23 15:45:00
112,21,8,13,0.0075613353754685406,2019-03-23 15:30:00,2019-03-23 15:45:00
113,4,0,4,0.0016937883927682766,2019-03-23 15:30:00,2019-03-23 15:45:00
114,4,1,3,0.0028337756065859357,2019-03-23 15:30:00,2019-03-23 15:45:00
115,4,2,2,0.002586691635359454,2019-03-23 15:30:00,2019-03-23 15:45:00
116,5,2,3,0.00414482847418917,2019-03-23 15:30:00,2019-03-23 15:45:00
118,5,4,1,0.00419684860850825,2019-03-23 15:30:00,2019-03-23 15:45:00
119,19,13,6,0.016790286120022185,2019-03-23 15:30:00,2019-03-23 15:45:00
120,14,5,9,0.007584878528104749,2019-03-23 15:30:00,2019-03-23 15:45:00
122,6,3,3,0.002659698383093052,2019-03-23 15:30:00,2019-03-23 15:45:00
126,14,6,8,0.008095238427881141,2019-03-23 15:30:00,2019-03-23 15:45:00
127,8,4,4,0.005768811310862358,2019-03-23 15:30:00,2019-03-23 15:45:00
133,2,1,1,0.001973359065465102,2019-03-23 15:30:00,2019-03-23 15:45:00
137,40,14,26,0.013771380253080435,2019-03-23 15:30:00,2019-03-23 15:45:00
138,33,11,22,0.010311420829516913,2019-03-23 15:30:00,2019-03-23 15:45:00
140,7,2,5,0.00310009293133774,2019-03-23 15:30:00,2019-03-23 15:45:00
141,12,8,4,0.0064085562774946585,2019-03-23 15:30:00,2019-03-23 15:45:00
147,3,2,1,0.014053959087269646,2019-03-23 15:30:00,2019-03-23 15:45:00
151,10,4,6,0.00384696157013924,2019-03-23 15:30:00,2019-03-23 15:45:00
153,11,8,3,0.026351605295250005,2019-03-23 15:30:00,2019-03-23 15:45:00
154,4,2,2,0.011269678449499882,2019-03-23 15:30:00,2019-03-23 15:45:00
157,12,4,8,0.0031980195911423346,2019-03-23 15:30:00,2019-03-23 15:45:00
158,1,0,1,0.0016937883927682766,2019-03-23 15:30:00,2019-03-23 15:45:00
159,8,2,6,0.0029372862685266396,2019-03-23 15:30:00,2019-03-23 15:45:00
160,3,3,0,0.003199961834027254,2019-03-23 15:30:00,2019-03-23 15:45:00
161,3,2,1,0.014053959087269646,2019-03-23 15:30:00,2019-03-23 15:45:00
162,5,2,3,0.003909020880159927,2019-03-23 15:30:00,2019-03-23 15:45:00
164,29,23,6,0.039225541684116655,2019-03-23 15:30:00,2019-03-23 15:45:00
168,22,13,9,0.018416014004453626,2019-03-23 15:30:00,2019-03-23 15:45:00
169,16,4,12,0.00454477112617336,2019-03-23 15:30:00,2019-03-23 15:45:00
170,2,1,1,0.011269678449499882,2019-03-23 15:30:00,2019-03-23 15:45:00
171,5,3,2,0.005137399742839948,2019-03-23 15:30:00,2019-03-23 15:45:00
172,7,1,6,0.002469672303461722,2019-03-23 15:30:00,2019-03-23 15:45:00
173,1,0,1,0.0016937883927682766,2019-03-23 15:30:00,2019-03-23 15:45:00
175,6,3,3,0.009003020296491854,2019-03-23 15:30:00,2019-03-23 15:45:00
177,11,5,6,0.006738336710898912,2019-03-23 15:30:00,2019-03-23 15:45:00
189,6,5,1,0.004349937969927536,2019-03-23 15:30:00,2019-03-23 15:45:00
191,16,6,10,0.00699696288744584,2019-03-23 15:30:00,2019-03-23 15:45:00
195,1,0,1,0.0016937883927682766,2019-03-23 15:30:00,2019-03-23 15:45:00
196,6,5,1,0.0035442957767158455,2019-03-23 15:30:00,2019-03-23 15:45:00
197,18,8,10,0.005293982318430207,2019-03-23 15:30:00,2019-03-23 15:45:00
199,4,3,1,0.018744528384367114,2019-03-23 15:30:00,2019-03-23 15:45:00
201,1,0,1,0.0016937883927682766,2019-03-23 15:30:00,2019-03-23 15:45:00
202,3,1,2,0.003133565631879957,2019-03-23 15:30:00,2019-03-23 15:45:00
203,29,20,9,0.025705227472280816,2019-03-23 15:30:00,2019-03-23 15:45:00
1,18,8,10,0.00959005892669772,2019-03-23 15:45:00,2019-03-23 16:00:00
2,17,9,8,0.019026259117871463,2019-03-23 15:45:00,2019-03-23 16:00:00
5,14,6,8,0.004241140722242661,2019-03-23 15:45:00,2019-03-23 16:00:00
10,2,2,0,0.0024803085420678815,2019-03-23 15:45:00,2019-03-23 16:00:00
15,23,16,7,0.02056753582580978,2019-03-23 15:45:00,2019-03-23 16:00:00
16,21,10,11,0.010370573976860628,2019-03-23 15:45:00,2019-03-23 16:00:00
18,8,4,4,0.004307209275384999,2019-03-23 15:45:00,2019-03-23 16:00:00
19,7,7,0,0.005414241554765574,2019-03-23 15:45:00,2019-03-23 16:00:00
20,10,8,2,0.012027889585252312,2019-03-23 15:45:00,2019-03-23 16:00:00
23,28,14,14,0.01804256154584772,2019-03-23 15:45:00,2019-03-23 16:00:00
26,7,3,4,0.004874526341271595,2019-03-23 15:45:00,2019-03-23 16:00:00
27,3,0,3,0.0015064455141877656,2019-03-23 15:45:00,2019-03-23 16:00:00
28,13,8,5,0.006409725524386669,2019-03-23 15:45:00,2019-03-23 16:00:00
35,8,3,5,0.0038640190968472817,2019-03-23 15:45:00,2019-03-23 16:00:00
37,2,1,1,0.0020390377366370374,2019-03-23 15:45:00,2019-03-23 16:00:00
40,3,1,2,0.0030495165308912237,2019-03-23 15:45:00,2019-03-23 16:00:00
41,3,0,3,0.0015064455141877656,2019-03-23 15:45:00,2019-03-23 16:00:00
46,11,4,7,0.005900508348924036,2019-03-23 15:45:00,2019-03-23 16:00:00
50,6,0,6,0.0015064455141877656,2019-03-23 15:45:00,2019-03-23 16:00:00
57,10,4,6,0.0037591959742336602,2019-03-23 15:45:00,2019-03-23 16:00:00
58,4,1,3,0.002206826963383481,2019-03-23 15:45:00,2019-03-23 16:00:00
61,7,1,6,0.0017550853347095543,2019-03-23 15:45:00,2019-03-23 16:00:00
62,33,12,21,0.017251825449827587,2019-03-23 15:45:00,2019-03-23 16:00:00
64,9,5,4,0.06513752385972581,2019-03-23 15:45:00,2019-03-23 16:00:00
66,5,0,5,0.0015064455141877656,2019-03-23 15:45:00,2019-03-23 16:00:00
67,19,8,11,0.009168754695299451,2019-03-23 15:45:00,2019-03-23 16:00:00
68,4,3,1,0.00487592550802356,2019-03-23 15:45:00,2019-03-23 16:00:00
69,21,13,8,0.011088699176957479,2019-03-23 15:45:00,2019-03-23 16:00:00
70,2,0,2,0.0015064455141877656,2019-03-23 15:45:00,2019-03-23 16:00:00
71,4,2,2,0.010041181285458492,2019-03-23 15:45:00,2019-03-23 16:00:00
74,8,4,4,0.004528628279826069,2019-03-23 15:45:00,2019-03-23 16:00:00
75,35,21,14,0.022731673795449495,2019-03-23 15:45:00,2019-03-23 16:00:00
79,2,1,1,0.0023217082241252583,2019-03-23 15:45:00,2019-03-23 16:00:00
80,2,1,1,0.010041181285458492,2019-03-23 15:45:00,2019-03-23 16:00:00
85,5,4,1,0.039063471777756056,2019-03-23 15:45:00,2019-03-23 16:00:00
86,1,0,1,0.0015064455141877656,2019-03-23 15:45:00,2019-03-23 16:00:00
87,25,12,13,0.010710702552081789,2019-03-23 15:45:00,2019-03-23 16:00:00
88,7,2,5,0.002939602655358308,2019-03-23 15:45:00,2019-03-23 16:00:00
89,11,5,6,0.011351103321505695,2019-03-23 15:45:00,2019-03-23 16:00:00
90,5,4,1,0.007522299905829059,2019-03-23 15:45:00,2019-03-23 16:00:00
99,3,2,1,0.003136970934062751,2019-03-23 15:45:00,2019-03-23 16:00:00
101,6,3,3,0.010041181285458492,2019-03-23 15:45:00,2019-03-23 16:00:00
104,3,3,0,0.004184918446114618,2019-03-23 15:45:00,2019-03-23 16:00:00
106,8,4,4,0.006794810666482052,2019-03-23 15:45:00,2019-03-23 16:00:00
108,9,7,2,0.03616669881339061,2019-03-23 15:45:00,2019-03-23 16:00:00
109,19,14,5,0.02749204565252716,2019-03-23 15:45:00,2019-03-23 16:00:00
110,23,12,11,0.012754939465617027,2019-03-23 15:45:00,2019-03-23 16:00:00
111,13,5,8,0.014520185227961318,2019-03-23 15:45:00,2019-03-23 16:00:00
112,13,4,9,0.0024210913854286658,2019-03-23 15:45:00,2019-03-23 16:00:00
113,3,2,1,0.0034361149005585094,2019-03-23 15:45:00,2019-03-23 16:00:00
114,3,0,3,0.0015064455141877656,2019-03-23 15:45:00,2019-03-23 16:00:00
115,3,2,1,0.001960581569454394,2019-03-23 15:45:00,2019-03-23 16:00:00
116,5,2,3,0.0029032906379872227,2019-03-23 15:45:00,2019-03-23 16:00:00
118,6,1,5,0.0017319201016441689,2019-03-23 15:45:00,2019-03-23 16:00:00
119,22,18,4,0.022901360612786855,2019-03-23 15:45:00,2019-03-23 16:00:00
120,12,2,10,0.0022857741167692474,2019-03-23 15:45:00,2019-03-23 16:00:00
122,6,3,3,0.0025408234756980025,2019-03-23 15:45:00,2019-03-23 16:00:00
126,19,10,9,0.010214679064825077,2019-03-23 15:45:00,2019-03-23 16:00:00
127,7,6,1,0.006183647620987336,2019-03-23 15:45:00,2019-03-23 16:00:00
133,2,1,1,0.0017198608779441752,2019-03-23 15:45:00,2019-03-23 16:00:00
137,50,17,33,0.014335669177193302,2019-03-23 15:45:00,2019-03-23 16:00:00
138,27,9,18,0.004774330247507316,2019-03-23 15:45:00,2019-03-23 16:00:00
140,8,2,6,0.0036290829877724208,2019-03-23 15:45:00,2019-03-23 16:00:00
141,17,10,7,0.008810704821463882,2019-03-23 15:45:00,2019-03-23 16:00:00
147,2,1,1,0.010041181285458492,2019-03-23 15:45:00,2019-03-23 16:00:00
151,13,4,9,0.004125576331436493,2019-03-23 15:45:00,2019-03-23 16:00:00
153,9,7,2,0.016530421889164156,2019-03-23 15:45:00,2019-03-23 16:00:00
154,4,2,2,0.010041181285458492,2019-03-23 15:45:00,2019-03-23 16:00:00
157,12,4,8,0.0026673291880190135,2019-03-23 15:45:00,2019-03-23 16:00:00
158,1,0,1,0.0015064455141877656,2019-03-23 15:45:00,2019-03-23 16:00:00
159,6,2,4,0.003578316726542749,2019-03-23 15:45:00,2019-03-23 16:00:00
160,3,2,1,0.015102991425619237,2019-03-23 15:45:00,2019-03-23 16:00:00
161,3,2,1,0.014805921721231853,2019-03-23 15:45:00,2019-03-23 16:00:00
162,5,2,3,0.003476485065436641,2019-03-23 15:45:00,2019-03-23 16:00:00
164,26,22,4,0.02205007350668758,2019-03-23 15:45:00,2019-03-23 16:00:00
168,35,20,15,0.019084168215452647,2019-03-23 15:45:00,2019-03-23 16:00:00
169,24,7,17,0.0068946568364211995,2019-03-23 15:45:00,2019-03-23 16:00:00
170,2,1,1,0.010041181285458492,2019-03-23 15:45:00,2019-03-23 16:00:00
171,4,3,1,0.014543312399365188,2019-03-23 15:45:00,2019-03-23 16:00:00
172,8,2,6,0.0029134392637980683,2019-03-23 15:45:00,2019-03-23 16:00:00
173,2,1,1,0.0024712802073731375,2019-03-23 15:45:00,2019-03-23 16:00:00
175,5,3,2,0.01955432797729885,2019-03-23 15:45:00,2019-03-23 16:00:00
177,10,4,6,0.003476485065436641,2019-03-23 15:45:00,2019-03-23 16:00:00
189,17,11,6,0.012469243390129588,2019-03-23 15:45:00,2019-03-23 16:00:00
190,2,2,0,0.003136970934062751,2019-03-23 15:45:00,2019-03-23 16:00:00
191,13,5,8,0.006328915411165367,2019-03-23 15:45:00,2019-03-23 16:00:00
195,2,2,0,0.002907208412579196,2019-03-23 15:45:00,2019-03-23 16:00:00
196,10,6,4,0.004146588929076351,2019-03-23 15:45:00,2019-03-23 16:00:00
197,12,5,7,0.0038346957965956735,2019-03-23 15:45:00,2019-03-23 16:00:00
199,2,1,1,0.010041181285458492,2019-03-23 15:45:00,2019-03-23 16:00:00
201,1,0,1,0.0015064455141877656,2019-03-23 15:45:00,2019-03-23 16:00:00
202,3,1,2,0.0027869376967262233,2019-03-23 15:45:00,2019-03-23 16:00:00
203,28,19,9,0.01702883646542455,2019-03-23 15:45:00,2019-03-23 16:00:00
1,13,7,6,0.007698815160482429,2019-03-23 16:00:00,2019-03-23 16:15:00
2,19,11,8,0.01272525970956428,2019-03-23 16:00:00,2019-03-23 16:15:00
5,16,8,8,0.006170156983962839,2019-03-23 16:00:00,2019-03-23 16:15:00
10,3,3,0,0.0034643705047418547,2019-03-23 16:00:00,2019-03-23 16:15:00
15,13,8,5,0.014503206909952784,2019-03-23 16:00:00,2019-03-23 16:15:00
16,20,5,15,0.005097791987434477,2019-03-23 16:00:00,2019-03-23 16:15:00
18,16,10,6,0.01456285396536442,2019-03-23 16:00:00,2019-03-23 16:15:00
19,6,6,0,0.008565010517893691,2019-03-23 16:00:00,2019-03-23 16:15:00
20,10,8,2,0.009244028839847991,2019-03-23 16:00:00,2019-03-23 16:15:00
21,2,2,0,0.0023628206998531987,2019-03-23 16:00:00,2019-03-23 16:15:00
23,23,9,14,0.006321936581303896,2019-03-23 16:00:00,2019-03-23 16:15:00
26,5,3,2,0.019565593797591513,2019-03-23 16:00:00,2019-03-23 16:15:00
27,1,0,1,0.0016761658529278224,2019-03-23 16:00:00,2019-03-23 16:15:00
28,14,7,7,0.0048279442392286905,2019-03-23 16:00:00,2019-03-23 16:15:00
30,2,1,1,0.01116347752240048,2019-03-23 16:00:00,2019-03-23 16:15:00
35,7,2,5,0.0029950101277951497,2019-03-23 16:00:00,2019-03-23 16:15:00
37,3,2,1,0.005160627195745643,2019-03-23 16:00:00,2019-03-23 16:15:00
40,10,4,6,0.006232545010526173,2019-03-23 16:00:00,2019-03-23 16:15:00
41,5,1,4,0.002128487613113803,2019-03-23 16:00:00,2019-03-23 16:15:00
46,9,5,4,0.0043308995028298386,2019-03-23 16:00:00,2019-03-23 16:15:00
50,5,0,5,0.0016761658529278224,2019-03-23 16:00:00,2019-03-23 16:15:00
57,6,2,4,0.0033089608146738294,2019-03-23 16:00:00,2019-03-23 16:15:00
58,3,1,2,0.0022802052789686568,2019-03-23 16:00:00,2019-03-23 16:15:00
61,9,1,8,0.0018754389660557284,2019-03-23 16:00:00,2019-03-23 16:15:00
62,28,9,19,0.01259113393117136,2019-03-23 16:00:00,2019-03-23 16:15:00
64,12,7,5,0.016953049325385133,2019-03-23 16:00:00,2019-03-23 16:15:00
66,5,1,4,0.0023269523836526662,2019-03-23 16:00:00,2019-03-23 16:15:00
67,22,11,11,0.018020404094727393,2019-03-23 16:00:00,2019-03-23 16:15:00
68,7,6,1,0.006743492218266336,2019-03-23 16:00:00,2019-03-23 16:15:00
69,27,15,12,0.017879898329897632,2019-03-23 16:00:00,2019-03-23 16:15:00
70,6,3,3,0.0058741345783850825,2019-03-23 16:00:00,2019-03-23 16:15:00
71,4,2,2,0.01116347752240048,2019-03-23 16:00:00,2019-03-23 16:15:00
74,11,5,6,0.008230775597594067,2019-03-23 16:00:00,2019-03-23 16:15:00
75,26,14,12,0.026244885193070864,2019-03-23 16:00:00,2019-03-23 16:15:00
79,1,0,1,0.0016761658529278224,2019-03-23 16:00:00,2019-03-23 16:15:00
80,2,1,1,0.01116347752240048,2019-03-23 16:00:00,2019-03-23 16:15:00
85,3,2,1,0.015907133357136807,2019-03-23 16:00:00,2019-03-23 16:15:00
86,2,1,1,0.005345998376164826,2019-03-23 16:00:00,2019-03-23 16:15:00
87,19,8,11,0.007815666773967764,2019-03-23 16:00:00,2019-03-23 16:15:00
88,10,3,7,0.004003087544565287,2019-03-23 16:00:00,2019-03-23 16:15:00
89,11,5,6,0.006716740262084103,2019-03-23 16:00:00,2019-03-23 16:15:00
90,7,4,3,0.005682368021545725,2019-03-23 16:00:00,2019-03-23 16:15:00
99,3,1,2,0.0029151680721075926,2019-03-23 16:00:00,2019-03-23 16:15:00
101,6,3,3,0.01116347752240048,2019-03-23 16:00:00,2019-03-23 16:15:00
104,3,3,0,0.007548559841272522,2019-03-23 16:00:00,2019-03-23 16:15:00
106,8,4,4,0.0061798529694609226,2019-03-23 16:00:00,2019-03-23 16:15:00
108,8,6,2,0.031356737524900445,2019-03-23 16:00:00,2019-03-23 16:15:00
109,19,11,8,0.016394324287050444,2019-03-23 16:00:00,2019-03-23 16:15:00
110,22,9,13,0.009950411826216924,2019-03-23 16:00:00,2019-03-23 16:15:00
111,11,6,5,0.013550422905700755,2019-03-23 16:00:00,2019-03-23 16:15:00
112,14,6,8,0.00851746106539056,2019-03-23 16:00:00,2019-03-23 16:15:00
113,4,3,1,0.0037535053366431433,2019-03-23 16:00:00,2019-03-23 16:15:00
114,2,1,1,0.00255926156316285,2019-03-23 16:00:00,2019-03-23 16:15:00
115,8,6,2,0.004708923447255974,2019-03-23 16:00:00,2019-03-23 16:15:00
116,3,2,1,0.0028029243546647516,2019-03-23 16:00:00,2019-03-23 16:15:00
118,4,0,4,0.0016761658529278224,2019-03-23 16:00:00,2019-03-23 16:15:00
119,24,20,4,0.017266545404304015,2019-03-23 16:00:00,2019-03-23 16:15:00
120,9,2,7,0.0020832500719007306,2019-03-23 16:00:00,2019-03-23 16:15:00
122,8,3,5,0.0026971746534668645,2019-03-23 16:00:00,2019-03-23 16:15:00
126,14,7,7,0.006139012328477324,2019-03-23 16:00:00,2019-03-23 16:15:00
127,11,7,4,0.007745047370434157,2019-03-23 16:00:00,2019-03-23 16:15:00
133,1,0,1,0.0016761658529278224,2019-03-23 16:00:00,2019-03-23 16:15:00
135,2,2,0,0.0025625914267812517,2019-03-23 16:00:00,2019-03-23 16:15:00
137,45,14,31,0.015914875480593997,2019-03-23 16:00:00,2019-03-23 16:15:00
138,23,9,14,0.00804124445046334,2019-03-23 16:00:00,2019-03-23 16:15:00
140,5,2,3,0.003666968099183908,2019-03-23 16:00:00,2019-03-23 16:15:00
141,17,10,7,0.00826299818923504,2019-03-23 16:00:00,2019-03-23 16:15:00
147,2,1,1,0.01116347752240048,2019-03-23 16:00:00,2019-03-23 16:15:00
151,7,0,7,0.0016761658529278224,2019-03-23 16:00:00,2019-03-23 16:15:00
153,11,8,3,0.014906502055198133,2019-03-23 16:00:00,2019-03-23 16:15:00
154,5,3,2,0.014900025395962274,2019-03-23 16:00:00,2019-03-23 16:15:00
157,9,7,2,0.014285778753517088,2019-03-23 16:00:00,2019-03-23 16:15:00
158,2,0,2,0.0016761658529278224,2019-03-23 16:00:00,2019-03-23 16:15:00
159,6,1,5,0.0020194932763905105,2019-03-23 16:00:00,2019-03-23 16:15:00
160,1,1,0,0.0020194932763905105,2019-03-23 16:00:00,2019-03-23 16:15:00
161,2,1,1,0.01116347752240048,2019-03-23 16:00:00,2019-03-23 16:15:00
162,5,2,3,0.0038683443440799274,2019-03-23 16:00:00,2019-03-23 16:15:00
164,35,27,8,0.032215953588279174,2019-03-23 16:00:00,2019-03-23 16:15:00
168,30,16,14,0.010859233905293806,2019-03-23 16:00:00,2019-03-23 16:15:00
169,23,6,17,0.008862287056748235,2019-03-23 16:00:00,2019-03-23 16:15:00
170,1,1,0,0.005900481922901441,2019-03-23 16:00:00,2019-03-23 16:15:00
171,3,2,1,0.012490340173306875,2019-03-23 16:00:00,2019-03-23 16:15:00
172,7,3,4,0.0042186078921879816,2019-03-23 16:00:00,2019-03-23 16:15:00
173,5,2,3,0.0038683443440799274,2019-03-23 16:00:00,2019-03-23 16:15:00
175,8,5,3,0.05979994228526195,2019-03-23 16:00:00,2019-03-23 16:15:00
177,10,4,6,0.0038683443440799274,2019-03-23 16:00:00,2019-03-23 16:15:00
189,16,8,8,0.008863793293539536,2019-03-23 16:00:00,2019-03-23 16:15:00
190,3,3,0,0.005921259975178285,2019-03-23 16:00:00,2019-03-23 16:15:00
191,13,5,8,0.005012111915571457,2019-03-23 16:00:00,2019-03-23 16:15:00
195,2,2,0,0.002884244705009491,2019-03-23 16:00:00,2019-03-23 16:15:00
196,8,5,3,0.004093558620168993,2019-03-23 16:00:00,2019-03-23 16:15:00
197,12,5,7,0.004266987541011236,2019-03-23 16:00:00,2019-03-23 16:15:00
199,3,1,2,0.0029151680721075926,2019-03-23 16:00:00,2019-03-23 16:15:00
201,4,3,1,0.002542859873346314,2019-03-23 16:00:00,2019-03-23 16:15:00
202,1,1,0,0.003837722345970832,2019-03-23 16:00:00,2019-03-23 16:15:00
203,25,15,10,0.01578807190717433,2019-03-23 16:00:00,2019-03-23 16:15:00
1,16,6,10,0.0036565354352147837,2019-03-23 16:15:00,2019-03-23 16:30:00
2,20,13,7,0.026081714868279617,2019-03-23 16:15:00,2019-03-23 16:30:00
5,15,8,7,0.006742968971479222,2019-03-23 16:15:00,2019-03-23 16:30:00
10,3,3,0,0.003932859603484559,2019-03-23 16:15:00,2019-03-23 16:30:00
15,12,9,3,0.014815646479583984,2019-03-23 16:15:00,2019-03-23 16:30:00
16,24,11,13,0.009473361141680642,2019-03-23 16:15:00,2019-03-23 16:30:00
18,19,13,6,0.035013329581011284,2019-03-23 16:15:00,2019-03-23 16:30:00
19,5,4,1,0.008026897051042283,2019-03-23 16:15:00,2019-03-23 16:30:00
20,6,4,2,0.006271592474296178,2019-03-23 16:15:00,2019-03-23 16:30:00
21,2,2,0,0.0022562455450144256,2019-03-23 16:15:00,2019-03-23 16:30:00
23,14,6,8,0.004570391150462772,2019-03-23 16:15:00,2019-03-23 16:30:00
26,5,3,2,0.01443690887845871,2019-03-23 16:15:00,2019-03-23 16:30:00
27,2,0,2,0.0015833151112487763,2019-03-23 16:15:00,2019-03-23 16:30:00
28,13,7,6,0.005208968413248119,2019-03-23 16:15:00,2019-03-23 16:30:00
35,3,2,1,0.0029945516069350125,2019-03-23 16:15:00,2019-03-23 16:30:00
37,3,2,1,0.0034045046930766825,2019-03-23 16:15:00,2019-03-23 16:30:00
40,7,2,5,0.006404292587428934,2019-03-23 16:15:00,2019-03-23 16:30:00
41,2,0,2,0.0015833151112487763,2019-03-23 16:15:00,2019-03-23 16:30:00
46,9,3,6,0.003214148001962158,2019-03-23 16:15:00,2019-03-23 16:30:00
50,5,0,5,0.0015833151112487763,2019-03-23 16:15:00,2019-03-23 16:30:00
57,6,2,4,0.007000347988850887,2019-03-23 16:15:00,2019-03-23 16:30:00
58,4,1,3,0.0022093075022443015,2019-03-23 16:15:00,2019-03-23 16:30:00
61,10,2,8,0.0021193301046920922,2019-03-23 16:15:00,2019-03-23 16:30:00
62,31,13,18,0.014569854871701135,2019-03-23 16:15:00,2019-03-23 16:30:00
64,8,5,3,0.01810540103626944,2019-03-23 16:15:00,2019-03-23 16:30:00
66,5,1,4,0.00178723962439304,2019-03-23 16:15:00,2019-03-23 16:30:00
67,18,9,9,0.023466523351720326,2019-03-23 16:15:00,2019-03-23 16:30:00
68,7,6,1,0.005904712795212364,2019-03-23 16:15:00,2019-03-23 16:30:00
69,26,10,16,0.011030922289938412,2019-03-23 16:15:00,2019-03-23 16:30:00
70,9,8,1,0.03845087307759307,2019-03-23 16:15:00,2019-03-23 16:30:00
71,4,2,2,0.010548120101160106,2019-03-23 16:15:00,2019-03-23 16:30:00
74,9,3,6,0.004663972412496346,2019-03-23 16:15:00,2019-03-23 16:30:00
75,26,12,14,0.009873440037555338,2019-03-23 16:15:00,2019-03-23 16:30:00
79,3,1,2,0.002753669300671604,2019-03-23 16:15:00,2019-03-23 16:30:00
80,5,3,2,0.013444443500143484,2019-03-23 16:15:00,2019-03-23 16:30:00
85,7,3,4,0.005094377679517259,2019-03-23 16:15:00,2019-03-23 16:30:00
86,6,3,3,0.006529364307870595,2019-03-23 16:15:00,2019-03-23 16:30:00
87,22,12,10,0.011609414561076118,2019-03-23 16:15:00,2019-03-23 16:30:00
88,5,2,3,0.002494089011903576,2019-03-23 16:15:00,2019-03-23 16:30:00
89,13,5,8,0.004301917502347144,2019-03-23 16:15:00,2019-03-23 16:30:00
90,5,2,3,0.00791887561143227,2019-03-23 16:15:00,2019-03-23 16:30:00
99,6,4,2,0.004375495672254981,2019-03-23 16:15:00,2019-03-23 16:30:00
101,6,3,3,0.010548120101160106,2019-03-23 16:15:00,2019-03-23 16:30:00
104,1,1,0,0.00256412065713849,2019-03-23 16:15:00,2019-03-23 16:30:00
106,7,3,4,0.00478915189276604,2019-03-23 16:15:00,2019-03-23 16:30:00
108,14,9,5,0.03515737185157025,2019-03-23 16:15:00,2019-03-23 16:30:00
109,22,12,10,0.010711120155152265,2019-03-23 16:15:00,2019-03-23 16:30:00
110,21,6,15,0.003598178662564973,2019-03-23 16:15:00,2019-03-23 16:30:00
111,10,5,5,0.005768504446271201,2019-03-23 16:15:00,2019-03-23 16:30:00
112,13,7,6,0.014797218775249404,2019-03-23 16:15:00,2019-03-23 16:30:00
113,4,1,3,0.002321310175452805,2019-03-23 16:15:00,2019-03-23 16:30:00
114,10,3,7,0.004058390866519085,2019-03-23 16:15:00,2019-03-23 16:30:00
115,13,7,6,0.005095895494549086,2019-03-23 16:15:00,2019-03-23 16:30:00
116,5,3,2,0.003647679109375655,2019-03-23 16:15:00,2019-03-23 16:30:00
118,1,0,1,0.0015833151112487763,2019-03-23 16:15:00,2019-03-23 16:30:00
119,15,8,7,0.010253107724127438,2019-03-23 16:15:00,2019-03-23 16:30:00
120,10,3,7,0.0030971716787565637,2019-03-23 16:15:00,2019-03-23 16:30:00
122,5,1,4,0.002019911984225866,2019-03-23 16:15:00,2019-03-23 16:30:00
126,17,7,10,0.005786830732424599,2019-03-23 16:15:00,2019-03-23 16:30:00
127,15,9,6,0.0077550991925782265,2019-03-23 16:15:00,2019-03-23 16:30:00
133,4,1,3,0.00178723962439304,2019-03-23 16:15:00,2019-03-23 16:30:00
135,2,2,0,0.002456508857202956,2019-03-23 16:15:00,2019-03-23 16:30:00
137,36,16,20,0.013396575856597204,2019-03-23 16:15:00,2019-03-23 16:30:00
138,24,10,14,0.008451228155238032,2019-03-23 16:15:00,2019-03-23 16:30:00
140,5,4,1,0.020329190764135585,2019-03-23 16:15:00,2019-03-23 16:30:00
141,17,9,8,0.00998655784391941,2019-03-23 16:15:00,2019-03-23 16:30:00
147,2,2,0,0.0027555635666627974,2019-03-23 16:15:00,2019-03-23 16:30:00
151,4,1,3,0.0029291759787800752,2019-03-23 16:15:00,2019-03-23 16:30:00
153,15,12,3,0.012965795132131476,2019-03-23 16:15:00,2019-03-23 16:30:00
154,6,4,2,0.0183901980659811,2019-03-23 16:15:00,2019-03-23 16:30:00
157,19,12,7,0.016638069592207923,2019-03-23 16:15:00,2019-03-23 16:30:00
158,1,0,1,0.0015833151112487763,2019-03-23 16:15:00,2019-03-23 16:30:00
159,4,0,4,0.0015833151112487763,2019-03-23 16:15:00,2019-03-23 16:30:00
160,1,1,0,0.0019197803281316012,2019-03-23 16:15:00,2019-03-23 16:30:00
161,2,1,1,0.010548120101160106,2019-03-23 16:15:00,2019-03-23 16:30:00
162,7,3,4,0.004368184762181614,2019-03-23 16:15:00,2019-03-23 16:30:00
164,33,25,8,0.02268269707019068,2019-03-23 16:15:00,2019-03-23 16:30:00
168,25,13,12,0.009959831903000248,2019-03-23 16:15:00,2019-03-23 16:30:00
169,26,7,19,0.009757399792644481,2019-03-23 16:15:00,2019-03-23 16:30:00
170,2,2,0,0.005857205584913719,2019-03-23 16:15:00,2019-03-23 16:30:00
171,10,6,4,0.010060972924477558,2019-03-23 16:15:00,2019-03-23 16:30:00
172,6,1,5,0.0038001116466809238,2019-03-23 16:15:00,2019-03-23 16:30:00
173,4,2,2,0.010548120101160106,2019-03-23 16:15:00,2019-03-23 16:30:00
175,8,5,3,0.027045955383790347,2019-03-23 16:15:00,2019-03-23 16:30:00
177,13,6,7,0.005834875890221931,2019-03-23 16:15:00,2019-03-23 16:30:00
189,14,7,7,0.008546659711410786,2019-03-23 16:15:00,2019-03-23 16:30:00
190,1,1,0,0.006544961038523488,2019-03-23 16:15:00,2019-03-23 16:30:00
191,16,5,11,0.004373532600038744,2019-03-23 16:15:00,2019-03-23 16:30:00
195,4,3,1,0.023624516595807048,2019-03-23 16:15:00,2019-03-23 16:30:00
196,9,6,3,0.006154375117186091,2019-03-23 16:15:00,2019-03-23 16:30:00
197,11,6,5,0.01382475813886135,2019-03-23 16:15:00,2019-03-23 16:30:00
199,6,3,3,0.0031525873033444265,2019-03-23 16:15:00,2019-03-23 16:30:00
200,1,0,1,0.0015833151112487763,2019-03-23 16:15:00,2019-03-23 16:30:00
201,4,3,1,0.003441817137164302,2019-03-23 16:15:00,2019-03-23 16:30:00
202,1,1,0,0.004509178741239047,2019-03-23 16:15:00,2019-03-23 16:30:00
203,26,14,12,0.012967909462178608,2019-03-23 16:15:00,2019-03-23 16:30:00
1,5,0,5,0.0016574229507218747,2019-03-23 16:30:00,2019-03-23 16:45:00
2,19,11,8,0.012367867019299976,2019-03-23 16:30:00,2019-03-23 16:45:00
5,15,8,7,0.005586091063728419,2019-03-23 16:30:00,2019-03-23 16:45:00
10,10,5,5,0.005737340827087219,2019-03-23 16:30:00,2019-03-23 16:45:00
11,5,3,2,0.013447926507476882,2019-03-23 16:30:00,2019-03-23 16:45:00
15,13,9,4,0.014236164406340197,2019-03-23 16:30:00,2019-03-23 16:45:00
16,37,20,17,0.015329063810950833,2019-03-23 16:30:00,2019-03-23 16:45:00
18,16,11,5,0.017901499946765573,2019-03-23 16:30:00,2019-03-23 16:45:00
19,2,1,1,0.0030095105169906295,2019-03-23 16:30:00,2019-03-23 16:45:00
20,6,4,2,0.005536209026784637,2019-03-23 16:30:00,2019-03-23 16:45:00
21,4,4,0,0.003062577140498024,2019-03-23 16:30:00,2019-03-23 16:45:00
23,20,7,13,0.005542798207208199,2019-03-23 16:30:00,2019-03-23 16:45:00
26,6,4,2,0.05507779509325136,2019-03-23 16:30:00,2019-03-23 16:45:00
27,5,1,4,0.0018544708057776976,2019-03-23 16:30:00,2019-03-23 16:45:00
28,15,10,5,0.014746693144278135,2019-03-23 16:30:00,2019-03-23 16:45:00
35,4,2,2,0.003689184572731251,2019-03-23 16:30:00,2019-03-23 16:45:00
37,5,3,2,0.0019585173341877373,2019-03-23 16:30:00,2019-03-23 16:45:00
40,3,2,1,0.004361598083259384,2019-03-23 16:30:00,2019-03-23 16:45:00
41,2,0,2,0.0016574229507218747,2019-03-23 16:30:00,2019-03-23 16:45:00
46,10,1,9,0.0027272554985581735,2019-03-23 16:30:00,2019-03-23 16:45:00
50,5,0,5,0.0016574229507218747,2019-03-23 16:30:00,2019-03-23 16:45:00
57,4,2,2,0.0030289473682974014,2019-03-23 16:30:00,2019-03-23 16:45:00
58,10,4,6,0.005733122500834911,2019-03-23 16:30:00,2019-03-23 16:45:00
61,9,2,7,0.0022072352427175072,2019-03-23 16:30:00,2019-03-23 16:45:00
62,29,13,16,0.014552041013688845,2019-03-23 16:30:00,2019-03-23 16:45:00
64,8,5,3,0.015865866238581886,2019-03-23 16:30:00,2019-03-23 16:45:00
66,6,2,4,0.0021373078235098182,2019-03-23 16:30:00,2019-03-23 16:45:00
67,13,6,7,0.007932013104122875,2019-03-23 16:30:00,2019-03-23 16:45:00
68,4,2,2,0.002382397342635814,2019-03-23 16:30:00,2019-03-23 16:45:00
69,27,15,12,0.022205871646183414,2019-03-23 16:30:00,2019-03-23 16:45:00
70,5,5,0,0.008723899742803963,2019-03-23 16:30:00,2019-03-23 16:45:00
71,4,2,2,0.011040767679904908,2019-03-23 16:30:00,2019-03-23 16:45:00
74,9,3,6,0.0034602235038340467,2019-03-23 16:30:00,2019-03-23 16:45:00
75,22,9,13,0.003426585076618842,2019-03-23 16:30:00,2019-03-23 16:45:00
79,5,2,3,0.0038251955624990057,2019-03-23 16:30:00,2019-03-23 16:45:00
80,7,4,3,0.011708827660224878,2019-03-23 16:30:00,2019-03-23 16:45:00
85,5,2,3,0.004278669852826296,2019-03-23 16:30:00,2019-03-23 16:45:00
86,5,2,3,0.0033507293672326477,2019-03-23 16:30:00,2019-03-23 16:45:00
87,13,9,4,0.012797143227551119,2019-03-23 16:30:00,2019-03-23 16:45:00
88,4,4,0,0.0037972740538484845,2019-03-23 16:30:00,2019-03-23 16:45:00
89,12,5,7,0.006959537063182104,2019-03-23 16:30:00,2019-03-23 16:45:00
90,5,3,2,0.005098392390459444,2019-03-23 16:30:00,2019-03-23 16:45:00
99,6,4,2,0.004352827519498389,2019-03-23 16:30:00,2019-03-23 16:45:00
101,6,3,3,0.011040767679904908,2019-03-23 16:30:00,2019-03-23 16:45:00
104,3,1,2,0.0030275848048859017,2019-03-23 16:30:00,2019-03-23 16:45:00
106,13,6,7,0.00697905842007483,2019-03-23 16:30:00,2019-03-23 16:45:00
108,20,11,9,0.015025297004351158,2019-03-23 16:30:00,2019-03-23 16:45:00
109,25,20,5,0.018514559014634648,2019-03-23 16:30:00,2019-03-23 16:45:00
110,24,5,19,0.002135019172461575,2019-03-23 16:30:00,2019-03-23 16:45:00
111,6,4,2,0.003223580894631809,2019-03-23 16:30:00,2019-03-23 16:45:00
112,16,10,6,0.0357878257123346,2019-03-23 16:30:00,2019-03-23 16:45:00
113,4,1,3,0.004164921802818975,2019-03-23 16:30:00,2019-03-23 16:45:00
114,9,1,8,0.0018544708057776976,2019-03-23 16:30:00,2019-03-23 16:45:00
115,13,4,9,0.004069222543175452,2019-03-23 16:30:00,2019-03-23 16:45:00
116,8,3,5,0.003682984092421816,2019-03-23 16:30:00,2019-03-23 16:45:00
118,1,0,1,0.0016574229507218747,2019-03-23 16:30:00,2019-03-23 16:45:00
119,15,8,7,0.006124785615687465,2019-03-23 16:30:00,2019-03-23 16:45:00
120,10,3,7,0.003572006089519765,2019-03-23 16:30:00,2019-03-23 16:45:00
122,3,1,2,0.0017577877452104955,2019-03-23 16:30:00,2019-03-23 16:45:00
126,16,8,8,0.01006747707992332,2019-03-23 16:30:00,2019-03-23 16:45:00
127,13,6,7,0.007492847514475447,2019-03-23 16:30:00,2019-03-23 16:45:00
133,4,1,3,0.0017529421950698149,2019-03-23 16:30:00,2019-03-23 16:45:00
135,2,2,0,0.0018581525396991164,2019-03-23 16:30:00,2019-03-23 16:45:00
137,28,10,18,0.007687503579477802,2019-03-23 16:30:00,2019-03-23 16:45:00
138,20,11,9,0.010226171574043418,2019-03-23 16:30:00,2019-03-23 16:45:00
140,5,4,1,0.023269344649165608,2019-03-23 16:30:00,2019-03-23 16:45:00
141,15,7,8,0.005491405675902683,2019-03-23 16:30:00,2019-03-23 16:45:00
147,3,3,0,0.005767328378518914,2019-03-23 16:30:00,2019-03-23 16:45:00
151,4,1,3,0.0030663042090653793,2019-03-23 16:30:00,2019-03-23 16:45:00
153,14,11,3,0.01040551406301816,2019-03-23 16:30:00,2019-03-23 16:45:00
154,7,5,2,0.028428624884429928,2019-03-23 16:30:00,2019-03-23 16:45:00
157,19,9,10,0.008067126975772911,2019-03-23 16:30:00,2019-03-23 16:45:00
158,1,0,1,0.0016574229507218747,2019-03-23 16:30:00,2019-03-23 16:45:00
159,6,1,5,0.0019969170370433414,2019-03-23 16:30:00,2019-03-23 16:45:00
160,1,1,0,0.0019969170370433414,2019-03-23 16:30:00,2019-03-23 16:45:00
161,2,1,1,0.011040767679904908,2019-03-23 16:30:00,2019-03-23 16:45:00
162,4,2,2,0.011040767679904908,2019-03-23 16:30:00,2019-03-23 16:45:00
164,39,26,13,0.020674620672900164,2019-03-23 16:30:00,2019-03-23 16:45:00
168,21,12,9,0.010754488569272838,2019-03-23 16:30:00,2019-03-23 16:45:00
169,27,3,24,0.002833600613985978,2019-03-23 16:30:00,2019-03-23 16:45:00
170,4,4,0,0.005598965178569482,2019-03-23 16:30:00,2019-03-23 16:45:00
171,12,8,4,0.013908593550635184,2019-03-23 16:30:00,2019-03-23 16:45:00
172,5,1,4,0.002620692109671977,2019-03-23 16:30:00,2019-03-23 16:45:00
173,5,3,2,0.02015723737781951,2019-03-23 16:30:00,2019-03-23 16:45:00
175,8,4,4,0.011040767679904908,2019-03-23 16:30:00,2019-03-23 16:45:00
177,11,5,6,0.005684368676908312,2019-03-23 16:30:00,2019-03-23 16:45:00
189,14,9,5,0.012445776861380316,2019-03-23 16:30:00,2019-03-23 16:45:00
190,1,0,1,0.0016574229507218747,2019-03-23 16:30:00,2019-03-23 16:45:00
191,11,2,9,0.0032820716354925276,2019-03-23 16:30:00,2019-03-23 16:45:00
195,3,3,0,0.010122793447378379,2019-03-23 16:30:00,2019-03-23 16:45:00
196,8,5,3,0.005320862647349409,2019-03-23 16:30:00,2019-03-23 16:45:00
197,12,8,4,0.03471674553620409,2019-03-23 16:30:00,2019-03-23 16:45:00
199,5,4,1,0.020108731928925972,2019-03-23 16:30:00,2019-03-23 16:45:00
200,1,0,1,0.0016574229507218747,2019-03-23 16:30:00,2019-03-23 16:45:00
203,26,14,12,0.011157776142561733,2019-03-23 16:30:00,2019-03-23 16:45:00
1,15,5,10,0.004320766975121729,2019-03-23 16:45:00,2019-03-23 17:00:00
2,17,11,6,0.01444959154485657,2019-03-23 16:45:00,2019-03-23 17:00:00
5,15,8,7,0.007555656465444521,2019-03-23 16:45:00,2019-03-23 17:00:00
10,4,0,4,0.0017042853931508847,2019-03-23 16:45:00,2019-03-23 17:00:00
11,5,3,2,0.01607900758347396,2019-03-23 16:45:00,2019-03-23 17:00:00
15,22,9,13,0.00939063840890825,2019-03-23 16:45:00,2019-03-23 17:00:00
16,31,15,16,0.014630202345105717,2019-03-23 16:45:00,2019-03-23 17:00:00
18,18,11,7,0.02087562504444927,2019-03-23 16:45:00,2019-03-23 17:00:00
19,3,0,3,0.0017042853931508847,2019-03-23 16:45:00,2019-03-23 17:00:00
20,6,1,5,0.0036562643760542158,2019-03-23 16:45:00,2019-03-23 17:00:00
21,6,4,2,0.0030732006513478497,2019-03-23 16:45:00,2019-03-23 17:00:00
23,23,10,13,0.010858363529527596,2019-03-23 16:45:00,2019-03-23 17:00:00
26,12,9,3,0.05987998319486819,2019-03-23 16:45:00,2019-03-23 17:00:00
27,4,1,3,0.00216420468083269,2019-03-23 16:45:00,2019-03-23 17:00:00
28,13,8,5,0.011228808067253387,2019-03-23 16:45:00,2019-03-23 17:00:00
35,2,2,0,0.004261956013912141,2019-03-23 16:45:00,2019-03-23 17:00:00
37,6,3,3,0.002326866026152479,2019-03-23 16:45:00,2019-03-23 17:00:00
41,2,0,2,0.0017042853931508847,2019-03-23 16:45:00,2019-03-23 17:00:00
46,11,6,5,0.00732439193806901,2019-03-23 16:45:00,2019-03-23 17:00:00
50,5,1,4,0.0020664648308469794,2019-03-23 16:45:00,2019-03-23 17:00:00
57,5,3,2,0.004162048827047257,2019-03-23 16:45:00,2019-03-23 17:00:00
58,17,8,9,0.010431861701960294,2019-03-23 16:45:00,2019-03-23 17:00:00
61,6,1,5,0.0020715810804568546,2019-03-23 16:45:00,2019-03-23 17:00:00
62,25,12,13,0.01608280152047835,2019-03-23 16:45:00,2019-03-23 17:00:00
64,6,3,3,0.011356066739517334,2019-03-23 16:45:00,2019-03-23 17:00:00
66,2,2,0,0.002061073963473695,2019-03-23 16:45:00,2019-03-23 17:00:00
67,14,6,8,0.0054861396621870805,2019-03-23 16:45:00,2019-03-23 17:00:00
68,9,4,5,0.003218641927709022,2019-03-23 16:45:00,2019-03-23 17:00:00
69,18,10,8,0.011579911087876829,2019-03-23 16:45:00,2019-03-23 17:00:00
70,1,1,0,0.0027560148519643357,2019-03-23 16:45:00,2019-03-23 17:00:00
71,4,2,2,0.011356066739517334,2019-03-23 16:45:00,2019-03-23 17:00:00
74,6,2,4,0.003994080467866824,2019-03-23 16:45:00,2019-03-23 17:00:00
75,30,10,20,0.0032112791430621845,2019-03-23 16:45:00,2019-03-23 17:00:00
79,6,3,3,0.005047936983279315,2019-03-23 16:45:00,2019-03-23 17:00:00
80,5,3,2,0.01273667301472057,2019-03-23 16:45:00,2019-03-23 17:00:00
85,5,3,2,0.03707329418852505,2019-03-23 16:45:00,2019-03-23 17:00:00
86,4,2,2,0.004912757169787034,2019-03-23 16:45:00,2019-03-23 17:00:00
87,18,6,12,0.002964117608548179,2019-03-23 16:45:00,2019-03-23 17:00:00
88,11,7,4,0.028189028905867147,2019-03-23 16:45:00,2019-03-23 17:00:00
89,13,4,9,0.002605564126343149,2019-03-23 16:45:00,2019-03-23 17:00:00
90,7,7,0,0.010440198214227935,2019-03-23 16:45:00,2019-03-23 17:00:00
99,8,4,4,0.0035634697150952613,2019-03-23 16:45:00,2019-03-23 17:00:00
101,4,2,2,0.011356066739517334,2019-03-23 16:45:00,2019-03-23 17:00:00
104,1,1,0,0.0032114647457618323,2019-03-23 16:45:00,2019-03-23 17:00:00
106,15,7,8,0.008649762474102839,2019-03-23 16:45:00,2019-03-23 17:00:00
108,20,10,10,0.011078508896221808,2019-03-23 16:45:00,2019-03-23 17:00:00
109,26,20,6,0.012625167149864914,2019-03-23 16:45:00,2019-03-23 17:00:00
110,11,2,9,0.00210120091499443,2019-03-23 16:45:00,2019-03-23 17:00:00
111,14,10,4,0.007091232128548173,2019-03-23 16:45:00,2019-03-23 17:00:00
112,15,9,6,0.01417840717874033,2019-03-23 16:45:00,2019-03-23 17:00:00
113,1,1,0,0.00361361482338984,2019-03-23 16:45:00,2019-03-23 17:00:00
114,5,1,4,0.00216420468083269,2019-03-23 16:45:00,2019-03-23 17:00:00
115,11,1,10,0.0018626162025519224,2019-03-23 16:45:00,2019-03-23 17:00:00
116,6,2,4,0.002964117608548179,2019-03-23 16:45:00,2019-03-23 17:00:00
118,4,2,2,0.0021242294649499826,2019-03-23 16:45:00,2019-03-23 17:00:00
119,16,9,7,0.00922375147692351,2019-03-23 16:45:00,2019-03-23 17:00:00
120,10,3,7,0.0023329780358277083,2019-03-23 16:45:00,2019-03-23 17:00:00
122,3,3,0,0.004766641242448638,2019-03-23 16:45:00,2019-03-23 17:00:00
126,23,12,11,0.011534905628803181,2019-03-23 16:45:00,2019-03-23 17:00:00
127,10,2,8,0.002904389513005274,2019-03-23 16:45:00,2019-03-23 17:00:00
133,4,1,3,0.002595764416043093,2019-03-23 16:45:00,2019-03-23 17:00:00
135,2,2,0,0.002119339148485281,2019-03-23 16:45:00,2019-03-23 17:00:00
137,26,10,16,0.003793604007930448,2019-03-23 16:45:00,2019-03-23 17:00:00
138,22,10,12,0.0056901716419924,2019-03-23 16:45:00,2019-03-23 17:00:00
140,8,6,2,0.006681287416264496,2019-03-23 16:45:00,2019-03-23 17:00:00
141,13,5,8,0.0052710122640100415,2019-03-23 16:45:00,2019-03-23 17:00:00
147,1,0,1,0.0017042853931508847,2019-03-23 16:45:00,2019-03-23 17:00:00
153,18,13,5,0.011480442754298704,2019-03-23 16:45:00,2019-03-23 17:00:00
154,9,7,2,0.008450940164248542,2019-03-23 16:45:00,2019-03-23 17:00:00
157,16,8,8,0.006927734705892972,2019-03-23 16:45:00,2019-03-23 17:00:00
158,2,1,1,0.0045441547187328735,2019-03-23 16:45:00,2019-03-23 17:00:00
159,3,0,3,0.0017042853931508847,2019-03-23 16:45:00,2019-03-23 17:00:00
160,3,1,2,0.002187191310079011,2019-03-23 16:45:00,2019-03-23 17:00:00
161,2,2,0,0.005799154099983765,2019-03-23 16:45:00,2019-03-23 17:00:00
162,2,1,1,0.011356066739517334,2019-03-23 16:45:00,2019-03-23 17:00:00
164,28,16,12,0.009082540130292673,2019-03-23 16:45:00,2019-03-23 17:00:00
168,23,16,7,0.010529648460647528,2019-03-23 16:45:00,2019-03-23 17:00:00
169,30,6,24,0.0058586229427966255,2019-03-23 16:45:00,2019-03-23 17:00:00
170,6,4,2,0.002717528943869784,2019-03-23 16:45:00,2019-03-23 17:00:00
171,12,9,3,0.03463353762190338,2019-03-23 16:45:00,2019-03-23 17:00:00
172,4,2,2,0.0025958600023454287,2019-03-23 16:45:00,2019-03-23 17:00:00
173,5,3,2,0.021379328709732942,2019-03-23 16:45:00,2019-03-23 17:00:00
175,6,3,3,0.011356066739517334,2019-03-23 16:45:00,2019-03-23 17:00:00
177,11,6,5,0.018353968592245126,2019-03-23 16:45:00,2019-03-23 17:00:00
189,14,11,3,0.049205578990366976,2019-03-23 16:45:00,2019-03-23 17:00:00
190,3,0,3,0.0017042853931508847,2019-03-23 16:45:00,2019-03-23 17:00:00
191,5,2,3,0.00367518275853711,2019-03-23 16:45:00,2019-03-23 17:00:00
195,1,1,0,0.0023184145265974154,2019-03-23 16:45:00,2019-03-23 17:00:00
196,8,6,2,0.007220695485584008,2019-03-23 16:45:00,2019-03-23 17:00:00
197,16,9,7,0.01073283567714524,2019-03-23 16:45:00,2019-03-23 17:00:00
199,3,2,1,0.01880731236451225,2019-03-23 16:45:00,2019-03-23 17:00:00
201,1,1,0,0.0023184145265974154,2019-03-23 16:45:00,2019-03-23 17:00:00
203,26,13,13,0.007986065527256645,2019-03-23 16:45:00,2019-03-23 17:00:00
1,15,5,10,0.0028034326726789666,2019-03-23 17:00:00,2019-03-23 17:15:00
2,17,10,7,0.00934733552291384,2019-03-23 17:00:00,2019-03-23 17:15:00
5,12,6,6,0.008804285236693842,2019-03-23 17:00:00,2019-03-23 17:15:00
10,4,0,4,0.0016362148579647051,2019-03-23 17:00:00,2019-03-23 17:15:00
11,5,3,2,0.019384851712234162,2019-03-23 17:00:00,2019-03-23 17:15:00
15,27,11,16,0.01290675298027272,2019-03-23 17:00:00,2019-03-23 17:15:00
16,36,14,22,0.01591031758647573,2019-03-23 17:00:00,2019-03-23 17:15:00
18,20,12,8,0.01738580665750604,2019-03-23 17:00:00,2019-03-23 17:15:00
19,3,0,3,0.0016362148579647051,2019-03-23 17:00:00,2019-03-23 17:15:00
20,8,5,3,0.008110955114326511,2019-03-23 17:00:00,2019-03-23 17:15:00
21,4,2,2,0.003207631089321511,2019-03-23 17:00:00,2019-03-23 17:15:00
23,22,12,10,0.015031588902109806,2019-03-23 17:00:00,2019-03-23 17:15:00
26,12,10,2,0.04775456135933531,2019-03-23 17:00:00,2019-03-23 17:15:00
27,5,1,4,0.0022398426647919356,2019-03-23 17:00:00,2019-03-23 17:15:00
28,13,8,5,0.008912091843014313,2019-03-23 17:00:00,2019-03-23 17:15:00
35,7,5,2,0.011269682718818187,2019-03-23 17:00:00,2019-03-23 17:15:00
37,4,1,3,0.0019487735225867582,2019-03-23 17:00:00,2019-03-23 17:15:00
41,4,2,2,0.004306216619236766,2019-03-23 17:00:00,2019-03-23 17:15:00
46,10,7,3,0.007843069364443202,2019-03-23 17:00:00,2019-03-23 17:15:00
50,3,1,2,0.0019839247252510235,2019-03-23 17:00:00,2019-03-23 17:15:00
57,5,3,2,0.004503067354782169,2019-03-23 17:00:00,2019-03-23 17:15:00
58,9,3,6,0.006496766115132298,2019-03-23 17:00:00,2019-03-23 17:15:00
61,6,1,5,0.0018745178686104293,2019-03-23 17:00:00,2019-03-23 17:15:00
62,19,13,6,0.02119325030248234,2019-03-23 17:00:00,2019-03-23 17:15:00
64,13,7,6,0.01813193228856396,2019-03-23 17:00:00,2019-03-23 17:15:00
66,3,3,0,0.00793422689813802,2019-03-23 17:00:00,2019-03-23 17:15:00
67,14,6,8,0.006449328750533837,2019-03-23 17:00:00,2019-03-23 17:15:00
68,6,2,4,0.0019654130357956282,2019-03-23 17:00:00,2019-03-23 17:15:00
69,9,4,5,0.004495781438131906,2019-03-23 17:00:00,2019-03-23 17:15:00
70,3,1,2,0.002845695242842408,2019-03-23 17:00:00,2019-03-23 17:15:00
71,4,2,2,0.010900121542528852,2019-03-23 17:00:00,2019-03-23 17:15:00
74,6,1,5,0.0038508771956147986,2019-03-23 17:00:00,2019-03-23 17:15:00
75,20,7,13,0.003468909368620604,2019-03-23 17:00:00,2019-03-23 17:15:00
79,8,3,5,0.003532870351176629,2019-03-23 17:00:00,2019-03-23 17:15:00
80,5,3,2,0.013221799660908822,2019-03-23 17:00:00,2019-03-23 17:15:00
85,5,3,2,0.03256961393683223,2019-03-23 17:00:00,2019-03-23 17:15:00
86,4,2,2,0.005210087875296102,2019-03-23 17:00:00,2019-03-23 17:15:00
87,14,3,11,0.0021300121247110897,2019-03-23 17:00:00,2019-03-23 17:15:00
88,10,3,7,0.002573890851830864,2019-03-23 17:00:00,2019-03-23 17:15:00
89,11,2,9,0.0020172715110705584,2019-03-23 17:00:00,2019-03-23 17:15:00
90,8,8,0,0.007667269774807532,2019-03-23 17:00:00,2019-03-23 17:15:00
99,8,1,7,0.0018623692493532496,2019-03-23 17:00:00,2019-03-23 17:15:00
101,9,7,2,0.03912545222478742,2019-03-23 17:00:00,2019-03-23 17:15:00
104,4,4,0,0.004837808167379778,2019-03-23 17:00:00,2019-03-23 17:15:00
106,15,8,7,0.014899856387073616,2019-03-23 17:00:00,2019-03-23 17:15:00
108,15,7,8,0.0063213369805199225,2019-03-23 17:00:00,2019-03-23 17:15:00
109,29,18,11,0.014099908821241004,2019-03-23 17:00:00,2019-03-23 17:15:00
110,15,7,8,0.01235266794137904,2019-03-23 17:00:00,2019-03-23 17:15:00
111,26,14,12,0.0133248237027801,2019-03-23 17:00:00,2019-03-23 17:15:00
112,13,7,6,0.011290780052853796,2019-03-23 17:00:00,2019-03-23 17:15:00
113,13,7,6,0.021119990404770788,2019-03-23 17:00:00,2019-03-23 17:15:00
114,6,2,4,0.002840460544111579,2019-03-23 17:00:00,2019-03-23 17:15:00
115,9,1,8,0.001830739062505549,2019-03-23 17:00:00,2019-03-23 17:15:00
116,5,2,3,0.0037761735847814696,2019-03-23 17:00:00,2019-03-23 17:15:00
118,6,4,2,0.003891502263257414,2019-03-23 17:00:00,2019-03-23 17:15:00
119,25,14,11,0.017586061121831,2019-03-23 17:00:00,2019-03-23 17:15:00
120,4,3,1,0.00224410472888733,2019-03-23 17:00:00,2019-03-23 17:15:00
122,5,5,0,0.006657783061387983,2019-03-23 17:00:00,2019-03-23 17:15:00
126,23,10,13,0.01103904638372915,2019-03-23 17:00:00,2019-03-23 17:15:00
127,17,8,9,0.009499627936386257,2019-03-23 17:00:00,2019-03-23 17:15:00
133,5,1,4,0.0023581218627746242,2019-03-23 17:00:00,2019-03-23 17:15:00
137,26,15,11,0.01016624431003795,2019-03-23 17:00:00,2019-03-23 17:15:00
138,27,13,14,0.010550098898685134,2019-03-23 17:00:00,2019-03-23 17:15:00
140,7,5,2,0.005161543004221914,2019-03-23 17:00:00,2019-03-23 17:15:00
141,13,4,9,0.002780218939582765,2019-03-23 17:00:00,2019-03-23 17:15:00
147,1,0,1,0.0016362148579647051,2019-03-23 17:00:00,2019-03-23 17:15:00
151,1,1,0,0.002236832737284349,2019-03-23 17:00:00,2019-03-23 17:15:00
153,18,13,5,0.015172093503610918,2019-03-23 17:00:00,2019-03-23 17:15:00
154,9,6,3,0.008933765988420894,2019-03-23 17:00:00,2019-03-23 17:15:00
157,16,8,8,0.009158131920751066,2019-03-23 17:00:00,2019-03-23 17:15:00
158,2,1,1,0.0038300498890191633,2019-03-23 17:00:00,2019-03-23 17:15:00
159,5,2,3,0.0037761735847814696,2019-03-23 17:00:00,2019-03-23 17:15:00
160,3,1,2,0.0027061942213730877,2019-03-23 17:00:00,2019-03-23 17:15:00
161,2,2,0,0.00390668203922156,2019-03-23 17:00:00,2019-03-23 17:15:00
162,4,1,3,0.0022831311900658523,2019-03-23 17:00:00,2019-03-23 17:15:00
164,23,14,9,0.012336633675020815,2019-03-23 17:00:00,2019-03-23 17:15:00
168,24,16,8,0.016331045460510046,2019-03-23 17:00:00,2019-03-23 17:15:00
169,18,6,12,0.004930135691114635,2019-03-23 17:00:00,2019-03-23 17:15:00
170,10,3,7,0.0024194424379361977,2019-03-23 17:00:00,2019-03-23 17:15:00
171,10,7,3,0.023493104867293748,2019-03-23 17:00:00,2019-03-23 17:15:00
172,5,3,2,0.00473419115263627,2019-03-23 17:00:00,2019-03-23 17:15:00
173,4,2,2,0.010900121542528852,2019-03-23 17:00:00,2019-03-23 17:15:00
175,6,3,3,0.010900121542528852,2019-03-23 17:00:00,2019-03-23 17:15:00
177,11,6,5,0.030824122228326988,2019-03-23 17:00:00,2019-03-23 17:15:00
189,15,9,6,0.012639766344119181,2019-03-23 17:00:00,2019-03-23 17:15:00
190,2,0,2,0.0016362148579647051,2019-03-23 17:00:00,2019-03-23 17:15:00
191,4,0,4,0.0016362148579647051,2019-03-23 17:00:00,2019-03-23 17:15:00
196,8,6,2,0.008573023638874805,2019-03-23 17:00:00,2019-03-23 17:15:00
197,17,10,7,0.010793017166492728,2019-03-23 17:00:00,2019-03-23 17:15:00
199,6,2,4,0.0038038687354054954,2019-03-23 17:00:00,2019-03-23 17:15:00
201,5,2,3,0.0036347079226526913,2019-03-23 17:00:00,2019-03-23 17:15:00
203,15,5,10,0.006809745865454799,2019-03-23 17:00:00,2019-03-23 17:15:00
1,15,5,10,0.002680767979378556,2019-03-23 17:15:00,2019-03-23 17:30:00
2,25,13,12,0.007716687006699887,2019-03-23 17:15:00,2019-03-23 17:30:00
5,12,8,4,0.04125859354432599,2019-03-23 17:15:00,2019-03-23 17:30:00
10,6,2,4,0.0038761480198024408,2019-03-23 17:15:00,2019-03-23 17:30:00
11,1,1,0,0.001963237760476089,2019-03-23 17:15:00,2019-03-23 17:30:00
15,22,7,15,0.007629544100182994,2019-03-23 17:15:00,2019-03-23 17:30:00
16,25,11,14,0.013840157258587714,2019-03-23 17:15:00,2019-03-23 17:30:00
18,20,10,10,0.01439087940177812,2019-03-23 17:15:00,2019-03-23 17:30:00
19,8,4,4,0.004918490999744818,2019-03-23 17:15:00,2019-03-23 17:30:00
20,7,3,4,0.00418123989491159,2019-03-23 17:15:00,2019-03-23 17:30:00
21,4,2,2,0.003001414639707162,2019-03-23 17:15:00,2019-03-23 17:30:00
23,20,6,14,0.005868563478421757,2019-03-23 17:15:00,2019-03-23 17:30:00
26,11,8,3,0.026822821041126387,2019-03-23 17:15:00,2019-03-23 17:30:00
27,3,0,3,0.001606889864364751,2019-03-23 17:15:00,2019-03-23 17:30:00
28,13,9,4,0.00812721772111203,2019-03-23 17:15:00,2019-03-23 17:30:00
35,3,2,1,0.002471717457651796,2019-03-23 17:15:00,2019-03-23 17:30:00
37,4,1,3,0.0019392630434095367,2019-03-23 17:15:00,2019-03-23 17:30:00
40,2,1,1,0.010707604708782372,2019-03-23 17:15:00,2019-03-23 17:30:00
41,4,3,1,0.005837684729036367,2019-03-23 17:15:00,2019-03-23 17:30:00
46,6,5,1,0.005692820512885453,2019-03-23 17:15:00,2019-03-23 17:30:00
50,4,1,3,0.002430707720142013,2019-03-23 17:15:00,2019-03-23 17:30:00
57,10,7,3,0.007461100331902918,2019-03-23 17:15:00,2019-03-23 17:30:00
58,5,2,3,0.004053855957893648,2019-03-23 17:15:00,2019-03-23 17:30:00
61,6,1,5,0.00183476350677428,2019-03-23 17:15:00,2019-03-23 17:30:00
62,23,15,8,0.021912788107580093,2019-03-23 17:15:00,2019-03-23 17:30:00
64,17,11,6,0.030502182343559427,2019-03-23 17:15:00,2019-03-23 17:30:00
66,3,1,2,0.0037080479667625024,2019-03-23 17:15:00,2019-03-23 17:30:00
67,19,13,6,0.023758040309051865,2019-03-23 17:15:00,2019-03-23 17:30:00
68,2,0,2,0.001606889864364751,2019-03-23 17:15:00,2019-03-23 17:30:00
69,6,5,1,0.020571043244594123,2019-03-23 17:15:00,2019-03-23 17:30:00
70,9,3,6,0.0031951736880656005,2019-03-23 17:15:00,2019-03-23 17:30:00
71,6,3,3,0.010707604708782372,2019-03-23 17:15:00,2019-03-23 17:30:00
74,6,0,6,0.001606889864364751,2019-03-23 17:15:00,2019-03-23 17:30:00
75,14,4,10,0.0026352707629511557,2019-03-23 17:15:00,2019-03-23 17:30:00
79,6,2,4,0.0027139872930724783,2019-03-23 17:15:00,2019-03-23 17:30:00
80,7,3,4,0.004433260526536115,2019-03-23 17:15:00,2019-03-23 17:30:00
85,5,3,2,0.02374538699447642,2019-03-23 17:15:00,2019-03-23 17:30:00
86,3,2,1,0.018839370027975793,2019-03-23 17:15:00,2019-03-23 17:30:00
87,11,3,8,0.002358777418361742,2019-03-23 17:15:00,2019-03-23 17:30:00
88,16,6,10,0.003909894129461052,2019-03-23 17:15:00,2019-03-23 17:30:00
89,9,2,7,0.005333841157838483,2019-03-23 17:15:00,2019-03-23 17:30:00
90,7,7,0,0.0060831701178541845,2019-03-23 17:15:00,2019-03-23 17:30:00
99,7,0,7,0.001606889864364751,2019-03-23 17:15:00,2019-03-23 17:30:00
101,12,8,4,0.008514344372186209,2019-03-23 17:15:00,2019-03-23 17:30:00
104,5,5,0,0.004757880115664875,2019-03-23 17:15:00,2019-03-23 17:30:00
106,17,10,7,0.019065800736360952,2019-03-23 17:15:00,2019-03-23 17:30:00
108,13,5,8,0.0031905995229992955,2019-03-23 17:15:00,2019-03-23 17:30:00
109,27,14,13,0.009788002810306357,2019-03-23 17:15:00,2019-03-23 17:30:00
110,13,5,8,0.006033291097690882,2019-03-23 17:15:00,2019-03-23 17:30:00
111,19,6,13,0.005840753743434698,2019-03-23 17:15:00,2019-03-23 17:30:00
112,16,6,10,0.004090529204154184,2019-03-23 17:15:00,2019-03-23 17:30:00
113,11,5,6,0.008973644278799944,2019-03-23 17:15:00,2019-03-23 17:30:00
114,4,3,1,0.05889282165821929,2019-03-23 17:15:00,2019-03-23 17:30:00
115,8,1,7,0.0018289887214281214,2019-03-23 17:15:00,2019-03-23 17:30:00
116,6,3,3,0.0047992094389282805,2019-03-23 17:15:00,2019-03-23 17:30:00
118,6,6,0,0.0073821169586700125,2019-03-23 17:15:00,2019-03-23 17:30:00
119,28,17,11,0.015830021587343625,2019-03-23 17:15:00,2019-03-23 17:30:00
120,5,4,1,0.003474245809548823,2019-03-23 17:15:00,2019-03-23 17:30:00
122,4,4,0,0.00415426408766407,2019-03-23 17:15:00,2019-03-23 17:30:00
126,27,12,15,0.011208218030069599,2019-03-23 17:15:00,2019-03-23 17:30:00
127,21,8,13,0.00785627589832054,2019-03-23 17:15:00,2019-03-23 17:30:00
133,5,1,4,0.0022421257568911238,2019-03-23 17:15:00,2019-03-23 17:30:00
137,27,16,11,0.009021896127084015,2019-03-23 17:15:00,2019-03-23 17:30:00
138,34,19,15,0.014267668359731818,2019-03-23 17:15:00,2019-03-23 17:30:00
140,10,7,3,0.007820337857603457,2019-03-23 17:15:00,2019-03-23 17:30:00
141,14,3,11,0.002883323681172149,2019-03-23 17:15:00,2019-03-23 17:30:00
147,1,0,1,0.001606889864364751,2019-03-23 17:15:00,2019-03-23 17:30:00
151,8,6,2,0.015695958736194227,2019-03-23 17:15:00,2019-03-23 17:30:00
153,19,12,7,0.015470218193151792,2019-03-23 17:15:00,2019-03-23 17:30:00
154,4,2,2,0.004570836230150126,2019-03-23 17:15:00,2019-03-23 17:30:00
157,22,10,12,0.009865842774792249,2019-03-23 17:15:00,2019-03-23 17:30:00
158,2,1,1,0.0023041522520359566,2019-03-23 17:15:00,2019-03-23 17:30:00
159,5,2,3,0.0037084384682809224,2019-03-23 17:15:00,2019-03-23 17:30:00
160,3,1,2,0.0026576641663228367,2019-03-23 17:15:00,2019-03-23 17:30:00
161,2,2,0,0.002700246165651793,2019-03-23 17:15:00,2019-03-23 17:30:00
162,4,1,3,0.002242203393845091,2019-03-23 17:15:00,2019-03-23 17:30:00
164,36,22,14,0.018684096869980862,2019-03-23 17:15:00,2019-03-23 17:30:00
168,25,15,10,0.010728207245783123,2019-03-23 17:15:00,2019-03-23 17:30:00
169,13,6,7,0.007733566668542058,2019-03-23 17:15:00,2019-03-23 17:30:00
170,4,1,3,0.0025189588213192847,2019-03-23 17:15:00,2019-03-23 17:30:00
171,8,6,2,0.023620800493308586,2019-03-23 17:15:00,2019-03-23 17:30:00
172,3,2,1,0.005487019066923646,2019-03-23 17:15:00,2019-03-23 17:30:00
173,4,2,2,0.010707604708782372,2019-03-23 17:15:00,2019-03-23 17:30:00
175,2,1,1,0.010707604708782372,2019-03-23 17:15:00,2019-03-23 17:30:00
177,12,6,6,0.013505802550230112,2019-03-23 17:15:00,2019-03-23 17:30:00
189,17,10,7,0.015342877386111162,2019-03-23 17:15:00,2019-03-23 17:30:00
190,5,1,4,0.0024955291769955474,2019-03-23 17:15:00,2019-03-23 17:30:00
191,1,1,0,0.00183476350677428,2019-03-23 17:15:00,2019-03-23 17:30:00
196,9,5,4,0.00793568911057341,2019-03-23 17:15:00,2019-03-23 17:30:00
197,20,12,8,0.014149443941661878,2019-03-23 17:15:00,2019-03-23 17:30:00
199,4,1,3,0.0028303209173198406,2019-03-23 17:15:00,2019-03-23 17:30:00
201,4,1,3,0.002248028234237124,2019-03-23 17:15:00,2019-03-23 17:30:00
202,1,1,0,0.003823024107449008,2019-03-23 17:15:00,2019-03-23 17:30:00
203,14,5,9,0.005002398372560326,2019-03-23 17:15:00,2019-03-23 17:30:00
1,17,9,8,0.013847826033125078,2019-03-23 17:30:00,2019-03-23 17:45:00
2,17,5,12,0.003352041346289021,2019-03-23 17:30:00,2019-03-23 17:45:00
5,9,8,1,0.06043422034842029,2019-03-23 17:30:00,2019-03-23 17:45:00
10,5,2,3,0.0036233092774609647,2019-03-23 17:30:00,2019-03-23 17:45:00
15,19,8,11,0.004778267868827852,2019-03-23 17:30:00,2019-03-23 17:45:00
16,27,12,15,0.009765209599620506,2019-03-23 17:30:00,2019-03-23 17:45:00
18,18,8,10,0.012297699948002486,2019-03-23 17:30:00,2019-03-23 17:45:00
19,9,5,4,0.007085727125846298,2019-03-23 17:30:00,2019-03-23 17:45:00
20,6,2,4,0.0025149573002695037,2019-03-23 17:30:00,2019-03-23 17:45:00
21,2,2,0,0.0047448794413354825,2019-03-23 17:30:00,2019-03-23 17:45:00
23,15,4,11,0.002322875704173215,2019-03-23 17:30:00,2019-03-23 17:45:00
26,9,6,3,0.04028711914848764,2019-03-23 17:30:00,2019-03-23 17:45:00
27,1,0,1,0.0014782058668878818,2019-03-23 17:30:00,2019-03-23 17:45:00
28,8,2,6,0.0029142171964862172,2019-03-23 17:30:00,2019-03-23 17:45:00
35,3,1,2,0.0020343411044711607,2019-03-23 17:30:00,2019-03-23 17:45:00
37,4,1,3,0.0028750279664584493,2019-03-23 17:30:00,2019-03-23 17:45:00
40,2,1,1,0.009852675165884672,2019-03-23 17:30:00,2019-03-23 17:45:00
41,5,3,2,0.008801385653617225,2019-03-23 17:30:00,2019-03-23 17:45:00
46,8,2,6,0.0032853868839110368,2019-03-23 17:30:00,2019-03-23 17:45:00
50,3,0,3,0.0014782058668878818,2019-03-23 17:30:00,2019-03-23 17:45:00
57,8,6,2,0.007706083456956973,2019-03-23 17:30:00,2019-03-23 17:45:00
58,5,3,2,0.006845128934680485,2019-03-23 17:30:00,2019-03-23 17:45:00
61,5,1,4,0.002949874618406707,2019-03-23 17:30:00,2019-03-23 17:45:00
62,25,14,11,0.017446904559047974,2019-03-23 17:30:00,2019-03-23 17:45:00
64,15,10,5,0.030661507142262377,2019-03-23 17:30:00,2019-03-23 17:45:00
66,3,1,2,0.002342894537914789,2019-03-23 17:30:00,2019-03-23 17:45:00
67,16,12,4,0.014967111873512457,2019-03-23 17:30:00,2019-03-23 17:45:00
68,4,0,4,0.0014782058668878818,2019-03-23 17:30:00,2019-03-23 17:45:00
69,7,6,1,0.022154695489871878,2019-03-23 17:30:00,2019-03-23 17:45:00
70,5,1,4,0.0017923321795473405,2019-03-23 17:30:00,2019-03-23 17:45:00
71,4,2,2,0.009852675165884672,2019-03-23 17:30:00,2019-03-23 17:45:00
74,9,3,6,0.004187223233645266,2019-03-23 17:30:00,2019-03-23 17:45:00
75,10,4,6,0.0028830596767445487,2019-03-23 17:30:00,2019-03-23 17:45:00
79,5,2,3,0.003411423598197759,2019-03-23 17:30:00,2019-03-23 17:45:00
80,7,3,4,0.004078216267012675,2019-03-23 17:30:00,2019-03-23 17:45:00
85,5,3,2,0.01822714446488146,2019-03-23 17:30:00,2019-03-23 17:45:00
86,2,1,1,0.009852675165884672,2019-03-23 17:30:00,2019-03-23 17:45:00
87,11,5,6,0.004015154273221537,2019-03-23 17:30:00,2019-03-23 17:45:00
88,7,3,4,0.004892131698035421,2019-03-23 17:30:00,2019-03-23 17:45:00
89,6,4,2,0.005958885113953415,2019-03-23 17:30:00,2019-03-23 17:45:00
90,16,10,6,0.009858251888555603,2019-03-23 17:30:00,2019-03-23 17:45:00
99,9,0,9,0.0014782058668878818,2019-03-23 17:30:00,2019-03-23 17:45:00
101,10,6,4,0.005851194701108621,2019-03-23 17:30:00,2019-03-23 17:45:00
104,6,4,2,0.007382396191302598,2019-03-23 17:30:00,2019-03-23 17:45:00
106,16,9,7,0.019430953594821082,2019-03-23 17:30:00,2019-03-23 17:45:00
108,9,4,5,0.004227577703361723,2019-03-23 17:30:00,2019-03-23 17:45:00
109,24,14,10,0.009197188219222897,2019-03-23 17:30:00,2019-03-23 17:45:00
110,15,4,11,0.003961309133966749,2019-03-23 17:30:00,2019-03-23 17:45:00
111,18,6,12,0.005859812202080547,2019-03-23 17:30:00,2019-03-23 17:45:00
112,12,4,8,0.002570851446829543,2019-03-23 17:30:00,2019-03-23 17:45:00
113,6,1,5,0.0028266996675720643,2019-03-23 17:30:00,2019-03-23 17:45:00
114,4,3,1,0.02597309130081615,2019-03-23 17:30:00,2019-03-23 17:45:00
115,9,2,7,0.0039827162101267605,2019-03-23 17:30:00,2019-03-23 17:45:00
116,6,3,3,0.006162144243479518,2019-03-23 17:30:00,2019-03-23 17:45:00
118,5,5,0,0.00683945111127141,2019-03-23 17:30:00,2019-03-23 17:45:00
119,18,14,4,0.011375840510833778,2019-03-23 17:30:00,2019-03-23 17:45:00
120,3,1,2,0.0017513672618732971,2019-03-23 17:30:00,2019-03-23 17:45:00
122,9,6,3,0.00713100504087732,2019-03-23 17:30:00,2019-03-23 17:45:00
126,30,16,14,0.012471396103374457,2019-03-23 17:30:00,2019-03-23 17:45:00
127,12,3,9,0.0027563675533302436,2019-03-23 17:30:00,2019-03-23 17:45:00
133,5,1,4,0.002235635119686401,2019-03-23 17:30:00,2019-03-23 17:45:00
135,1,1,0,0.002550757572174423,2019-03-23 17:30:00,2019-03-23 17:45:00
137,28,21,7,0.013448133362153116,2019-03-23 17:30:00,2019-03-23 17:45:00
138,38,18,20,0.013082166543884053,2019-03-23 17:30:00,2019-03-23 17:45:00
140,8,5,3,0.004730116683859672,2019-03-23 17:30:00,2019-03-23 17:45:00
141,8,2,6,0.0032910487330721832,2019-03-23 17:30:00,2019-03-23 17:45:00
147,3,1,2,0.002570851446829543,2019-03-23 17:30:00,2019-03-23 17:45:00
151,6,4,2,0.0034175392352206995,2019-03-23 17:30:00,2019-03-23 17:45:00
153,12,7,5,0.00875493994514991,2019-03-23 17:30:00,2019-03-23 17:45:00
154,7,3,4,0.004353431313793239,2019-03-23 17:30:00,2019-03-23 17:45:00
157,16,6,10,0.005832833886856197,2019-03-23 17:30:00,2019-03-23 17:45:00
158,1,0,1,0.0014782058668878818,2019-03-23 17:30:00,2019-03-23 17:45:00
159,5,2,3,0.003411423598197759,2019-03-23 17:30:00,2019-03-23 17:45:00
160,7,3,4,0.004251995749565975,2019-03-23 17:30:00,2019-03-23 17:45:00
161,2,2,0,0.0019531324249826947,2019-03-23 17:30:00,2019-03-23 17:45:00
162,4,1,3,0.0020626350816403283,2019-03-23 17:30:00,2019-03-23 17:45:00
164,31,17,14,0.017661913185410216,2019-03-23 17:30:00,2019-03-23 17:45:00
168,22,12,10,0.009048564343043276,2019-03-23 17:30:00,2019-03-23 17:45:00
169,12,4,8,0.00615122084535518,2019-03-23 17:30:00,2019-03-23 17:45:00
170,2,1,1,0.0022475082603105375,2019-03-23 17:30:00,2019-03-23 17:45:00
171,6,4,2,0.01611841680165531,2019-03-23 17:30:00,2019-03-23 17:45:00
172,4,3,1,0.005059193298861583,2019-03-23 17:30:00,2019-03-23 17:45:00
173,6,4,2,0.01605574825454442,2019-03-23 17:30:00,2019-03-23 17:45:00
175,6,4,2,0.013927232519827245,2019-03-23 17:30:00,2019-03-23 17:45:00
177,8,4,4,0.007802277836257843,2019-03-23 17:30:00,2019-03-23 17:45:00
189,14,7,7,0.006945501222212518,2019-03-23 17:30:00,2019-03-23 17:45:00
190,7,4,3,0.005082511444064302,2019-03-23 17:30:00,2019-03-23 17:45:00
191,8,7,1,0.0763199610988002,2019-03-23 17:30:00,2019-03-23 17:45:00
195,2,1,1,0.009852675165884672,2019-03-23 17:30:00,2019-03-23 17:45:00
196,6,3,3,0.004709214066752317,2019-03-23 17:30:00,2019-03-23 17:45:00
197,18,11,7,0.020190617703673898,2019-03-23 17:30:00,2019-03-23 17:45:00
199,7,4,3,0.009427499770261083,2019-03-23 17:30:00,2019-03-23 17:45:00
200,2,0,2,0.0014782058668878818,2019-03-23 17:30:00,2019-03-23 17:45:00
201,4,1,3,0.0017843574672917121,2019-03-23 17:30:00,2019-03-23 17:45:00
202,1,1,0,0.0028185942588778413,2019-03-23 17:30:00,2019-03-23 17:45:00
203,8,5,3,0.004204774420588367,2019-03-23 17:30:00,2019-03-23 17:45:00
1,12,8,4,0.01693404664056724,2019-03-23 17:45:00,2019-03-23 18:00:00
2,15,6,9,0.007907803576486953,2019-03-23 17:45:00,2019-03-23 18:00:00
5,16,12,4,0.0323104112430075,2019-03-23 17:45:00,2019-03-23 18:00:00
10,2,2,0,0.002857443800952274,2019-03-23 17:45:00,2019-03-23 18:00:00
15,19,10,9,0.009544678807143835,2019-03-23 17:45:00,2019-03-23 18:00:00
16,23,11,12,0.011738736019784632,2019-03-23 17:45:00,2019-03-23 18:00:00
18,16,7,9,0.01091468835709301,2019-03-23 17:45:00,2019-03-23 18:00:00
19,5,2,3,0.004036116496550866,2019-03-23 17:45:00,2019-03-23 18:00:00
20,5,2,3,0.0028787786330254526,2019-03-23 17:45:00,2019-03-23 18:00:00
21,1,0,1,0.0015205316793028508,2019-03-23 17:45:00,2019-03-23 18:00:00
23,15,6,9,0.004430596159950362,2019-03-23 17:45:00,2019-03-23 18:00:00
26,7,4,3,0.015278759708535618,2019-03-23 17:45:00,2019-03-23 18:00:00
27,5,1,4,0.0019308454063847,2019-03-23 17:45:00,2019-03-23 18:00:00
28,9,3,6,0.003959018727807915,2019-03-23 17:45:00,2019-03-23 18:00:00
30,1,1,0,0.003030251433913818,2019-03-23 17:45:00,2019-03-23 18:00:00
35,3,1,2,0.0026633654896701855,2019-03-23 17:45:00,2019-03-23 18:00:00
37,6,2,4,0.003043561136129787,2019-03-23 17:45:00,2019-03-23 18:00:00
41,7,2,5,0.002857443800952274,2019-03-23 17:45:00,2019-03-23 18:00:00
46,7,3,4,0.002759650536044109,2019-03-23 17:45:00,2019-03-23 18:00:00
50,2,0,2,0.0015205316793028508,2019-03-23 17:45:00,2019-03-23 18:00:00
57,9,7,2,0.011025689814451435,2019-03-23 17:45:00,2019-03-23 18:00:00
58,6,4,2,0.009403230680161176,2019-03-23 17:45:00,2019-03-23 18:00:00
61,5,1,4,0.005120212008973393,2019-03-23 17:45:00,2019-03-23 18:00:00
62,19,12,7,0.012430272407645505,2019-03-23 17:45:00,2019-03-23 18:00:00
64,16,10,6,0.01790694450757493,2019-03-23 17:45:00,2019-03-23 18:00:00
66,3,1,2,0.002652608510655418,2019-03-23 17:45:00,2019-03-23 18:00:00
67,31,15,16,0.021341766776068118,2019-03-23 17:45:00,2019-03-23 18:00:00
68,2,0,2,0.0015205316793028508,2019-03-23 17:45:00,2019-03-23 18:00:00
69,12,8,4,0.016816345497742465,2019-03-23 17:45:00,2019-03-23 18:00:00
70,10,6,4,0.013709741128715737,2019-03-23 17:45:00,2019-03-23 18:00:00
71,2,1,1,0.010131717788578203,2019-03-23 17:45:00,2019-03-23 18:00:00
74,8,3,5,0.006924201315374009,2019-03-23 17:45:00,2019-03-23 18:00:00
75,19,10,9,0.007799949029323705,2019-03-23 17:45:00,2019-03-23 18:00:00
79,2,1,1,0.010131717788578203,2019-03-23 17:45:00,2019-03-23 18:00:00
80,6,3,3,0.010131717788578203,2019-03-23 17:45:00,2019-03-23 18:00:00
85,7,4,3,0.018742903897853557,2019-03-23 17:45:00,2019-03-23 18:00:00
86,2,1,1,0.010131717788578203,2019-03-23 17:45:00,2019-03-23 18:00:00
87,11,5,6,0.004058400224839998,2019-03-23 17:45:00,2019-03-23 18:00:00
88,7,3,4,0.007923824427890656,2019-03-23 17:45:00,2019-03-23 18:00:00
89,10,5,5,0.0061773253385572205,2019-03-23 17:45:00,2019-03-23 18:00:00
90,19,11,8,0.010507527322582155,2019-03-23 17:45:00,2019-03-23 18:00:00
99,9,0,9,0.0015205316793028508,2019-03-23 17:45:00,2019-03-23 18:00:00
101,7,5,2,0.016590107370534717,2019-03-23 17:45:00,2019-03-23 18:00:00
104,5,3,2,0.01502510216059121,2019-03-23 17:45:00,2019-03-23 18:00:00
106,16,9,7,0.022369577522945796,2019-03-23 17:45:00,2019-03-23 18:00:00
108,9,4,5,0.005418073848607487,2019-03-23 17:45:00,2019-03-23 18:00:00
109,16,8,8,0.006422507661957575,2019-03-23 17:45:00,2019-03-23 18:00:00
110,12,3,9,0.0033605833942662506,2019-03-23 17:45:00,2019-03-23 18:00:00
111,17,6,11,0.005259331110029915,2019-03-23 17:45:00,2019-03-23 18:00:00
112,6,2,4,0.0037884669277904706,2019-03-23 17:45:00,2019-03-23 18:00:00
113,6,0,6,0.0015205316793028508,2019-03-23 17:45:00,2019-03-23 18:00:00
114,2,1,1,0.010131717788578203,2019-03-23 17:45:00,2019-03-23 18:00:00
115,9,3,6,0.003990415709215006,2019-03-23 17:45:00,2019-03-23 18:00:00
116,7,4,3,0.00839400073711496,2019-03-23 17:45:00,2019-03-23 18:00:00
118,4,4,0,0.004768136295096187,2019-03-23 17:45:00,2019-03-23 18:00:00
119,14,13,1,0.01516497005949682,2019-03-23 17:45:00,2019-03-23 18:00:00
120,1,0,1,0.0015205316793028508,2019-03-23 17:45:00,2019-03-23 18:00:00
122,3,1,2,0.0021611485701013558,2019-03-23 17:45:00,2019-03-23 18:00:00
126,34,19,15,0.015879779866563772,2019-03-23 17:45:00,2019-03-23 18:00:00
127,11,4,7,0.004386105126676928,2019-03-23 17:45:00,2019-03-23 18:00:00
133,1,1,0,0.0024206179717596635,2019-03-23 17:45:00,2019-03-23 18:00:00
135,3,3,0,0.003470221521724572,2019-03-23 17:45:00,2019-03-23 18:00:00
137,32,18,14,0.012773481378847824,2019-03-23 17:45:00,2019-03-23 18:00:00
138,34,14,20,0.026884157922753376,2019-03-23 17:45:00,2019-03-23 18:00:00
140,5,3,2,0.0033937312037070444,2019-03-23 17:45:00,2019-03-23 18:00:00
141,7,3,4,0.002959562301779374,2019-03-23 17:45:00,2019-03-23 18:00:00
147,5,1,4,0.0019308454063847,2019-03-23 17:45:00,2019-03-23 18:00:00
151,5,4,1,0.00483637978940837,2019-03-23 17:45:00,2019-03-23 18:00:00
153,24,10,14,0.010549141865236875,2019-03-23 17:45:00,2019-03-23 18:00:00
154,11,5,6,0.004719517070524675,2019-03-23 17:45:00,2019-03-23 18:00:00
157,15,6,9,0.010472365491981082,2019-03-23 17:45:00,2019-03-23 18:00:00
158,1,0,1,0.0015205316793028508,2019-03-23 17:45:00,2019-03-23 18:00:00
159,4,2,2,0.010131717788578203,2019-03-23 17:45:00,2019-03-23 18:00:00
160,4,2,2,0.010131717788578203,2019-03-23 17:45:00,2019-03-23 18:00:00
161,2,2,0,0.0030144740338811024,2019-03-23 17:45:00,2019-03-23 18:00:00
162,4,3,1,0.02518014937737195,2019-03-23 17:45:00,2019-03-23 18:00:00
164,28,13,15,0.011794707560443695,2019-03-23 17:45:00,2019-03-23 18:00:00
168,31,15,16,0.011450573769482199,2019-03-23 17:45:00,2019-03-23 18:00:00
169,10,2,8,0.0031215539852089127,2019-03-23 17:45:00,2019-03-23 18:00:00
170,2,0,2,0.0015205316793028508,2019-03-23 17:45:00,2019-03-23 18:00:00
171,6,4,2,0.024850310992192936,2019-03-23 17:45:00,2019-03-23 18:00:00
172,4,4,0,0.0049404904158593865,2019-03-23 17:45:00,2019-03-23 18:00:00
173,6,4,2,0.013002113158336652,2019-03-23 17:45:00,2019-03-23 18:00:00
175,6,4,2,0.014349587058690433,2019-03-23 17:45:00,2019-03-23 18:00:00
177,5,2,3,0.0035090540163464612,2019-03-23 17:45:00,2019-03-23 18:00:00
189,7,4,3,0.0034775366767261,2019-03-23 17:45:00,2019-03-23 18:00:00
190,5,4,1,0.004844859837511182,2019-03-23 17:45:00,2019-03-23 18:00:00
191,10,6,4,0.007573604334506044,2019-03-23 17:45:00,2019-03-23 18:00:00
195,2,1,1,0.010131717788578203,2019-03-23 17:45:00,2019-03-23 18:00:00
196,5,3,2,0.007141011771645358,2019-03-23 17:45:00,2019-03-23 18:00:00
197,10,7,3,0.04339161007245662,2019-03-23 17:45:00,2019-03-23 18:00:00
199,9,6,3,0.018683401920269734,2019-03-23 17:45:00,2019-03-23 18:00:00
200,2,0,2,0.0015205316793028508,2019-03-23 17:45:00,2019-03-23 18:00:00
201,4,0,4,0.0015205316793028508,2019-03-23 17:45:00,2019-03-23 18:00:00
202,1,0,1,0.0015205316793028508,2019-03-23 17:45:00,2019-03-23 18:00:00
203,12,7,5,0.0071519500465970515,2019-03-23 17:45:00,2019-03-23 18:00:00
1,10,5,5,0.01272431003316717,2019-03-23 18:00:00,2019-03-23 18:15:00
2,15,6,9,0.009195275577326453,2019-03-23 18:00:00,2019-03-23 18:15:00
5,12,8,4,0.011384863594171015,2019-03-23 18:00:00,2019-03-23 18:15:00
10,2,2,0,0.002561752224955779,2019-03-23 18:00:00,2019-03-23 18:15:00
15,23,13,10,0.010661395397345756,2019-03-23 18:00:00,2019-03-23 18:15:00
16,27,12,15,0.011631448642237389,2019-03-23 18:00:00,2019-03-23 18:15:00
18,12,6,6,0.014873901772959063,2019-03-23 18:00:00,2019-03-23 18:15:00
19,5,3,2,0.00315705490160956,2019-03-23 18:00:00,2019-03-23 18:15:00
20,7,4,3,0.0048051200373168765,2019-03-23 18:00:00,2019-03-23 18:15:00
21,1,0,1,0.0016292612449940454,2019-03-23 18:00:00,2019-03-23 18:15:00
23,12,6,6,0.006692974939159894,2019-03-23 18:00:00,2019-03-23 18:15:00
26,12,5,7,0.004147451477985233,2019-03-23 18:00:00,2019-03-23 18:15:00
27,3,0,3,0.0016292612449940454,2019-03-23 18:00:00,2019-03-23 18:15:00
28,11,3,8,0.003860175485201677,2019-03-23 18:00:00,2019-03-23 18:15:00
30,2,2,0,0.0044919788129016295,2019-03-23 18:00:00,2019-03-23 18:15:00
35,2,0,2,0.0016292612449940454,2019-03-23 18:00:00,2019-03-23 18:15:00
37,6,4,2,0.01841173298467284,2019-03-23 18:00:00,2019-03-23 18:15:00
41,11,5,6,0.007871906862993697,2019-03-23 18:00:00,2019-03-23 18:15:00
46,4,3,1,0.003080766156939053,2019-03-23 18:00:00,2019-03-23 18:15:00
50,5,2,3,0.004160543322337864,2019-03-23 18:00:00,2019-03-23 18:15:00
57,7,5,2,0.013328214493812798,2019-03-23 18:00:00,2019-03-23 18:15:00
58,6,4,2,0.012139229897576098,2019-03-23 18:00:00,2019-03-23 18:15:00
61,5,4,1,0.005141511039040538,2019-03-23 18:00:00,2019-03-23 18:15:00
62,18,11,7,0.01252281318497314,2019-03-23 18:00:00,2019-03-23 18:15:00
64,13,9,4,0.016318710172399078,2019-03-23 18:00:00,2019-03-23 18:15:00
66,1,1,0,0.002321713977400273,2019-03-23 18:00:00,2019-03-23 18:15:00
67,30,14,16,0.011835887635937738,2019-03-23 18:00:00,2019-03-23 18:15:00
68,1,0,1,0.0016292612449940454,2019-03-23 18:00:00,2019-03-23 18:15:00
69,17,10,7,0.014081219862686166,2019-03-23 18:00:00,2019-03-23 18:15:00
70,7,6,1,0.009133204125816292,2019-03-23 18:00:00,2019-03-23 18:15:00
71,2,1,1,0.010853352627826544,2019-03-23 18:00:00,2019-03-23 18:15:00
74,6,2,4,0.0030141667098065013,2019-03-23 18:00:00,2019-03-23 18:15:00
75,18,9,9,0.0067686862608262,2019-03-23 18:00:00,2019-03-23 18:15:00
79,1,1,0,0.0021602322223181225,2019-03-23 18:00:00,2019-03-23 18:15:00
80,4,2,2,0.010853352627826544,2019-03-23 18:00:00,2019-03-23 18:15:00
85,3,2,1,0.02007744401065904,2019-03-23 18:00:00,2019-03-23 18:15:00
86,2,1,1,0.010853352627826544,2019-03-23 18:00:00,2019-03-23 18:15:00
87,8,4,4,0.0037508727671622384,2019-03-23 18:00:00,2019-03-23 18:15:00
88,10,5,5,0.0046928110597351325,2019-03-23 18:00:00,2019-03-23 18:15:00
89,13,6,7,0.007063908625574954,2019-03-23 18:00:00,2019-03-23 18:15:00
90,16,8,8,0.008229363774082649,2019-03-23 18:00:00,2019-03-23 18:15:00
99,6,2,4,0.004671021874038769,2019-03-23 18:00:00,2019-03-23 18:15:00
101,15,9,6,0.021469405760405985,2019-03-23 18:00:00,2019-03-23 18:15:00
104,5,3,2,0.02128813347327669,2019-03-23 18:00:00,2019-03-23 18:15:00
106,16,9,7,0.02127407566048193,2019-03-23 18:00:00,2019-03-23 18:15:00
108,9,4,5,0.004608698441286056,2019-03-23 18:00:00,2019-03-23 18:15:00
109,11,5,6,0.00540750008789046,2019-03-23 18:00:00,2019-03-23 18:15:00
110,14,5,9,0.004350071326629674,2019-03-23 18:00:00,2019-03-23 18:15:00
111,14,4,10,0.0031022333099586658,2019-03-23 18:00:00,2019-03-23 18:15:00
112,12,7,5,0.005609947528568238,2019-03-23 18:00:00,2019-03-23 18:15:00
113,2,0,2,0.0016292612449940454,2019-03-23 18:00:00,2019-03-23 18:15:00
114,4,2,2,0.006565363704123256,2019-03-23 18:00:00,2019-03-23 18:15:00
115,9,4,5,0.0044251419343513745,2019-03-23 18:00:00,2019-03-23 18:15:00
116,9,5,4,0.017807107062007468,2019-03-23 18:00:00,2019-03-23 18:15:00
118,7,7,0,0.007346818434959968,2019-03-23 18:00:00,2019-03-23 18:15:00
119,15,9,6,0.009449238434427163,2019-03-23 18:00:00,2019-03-23 18:15:00
120,1,0,1,0.0016292612449940454,2019-03-23 18:00:00,2019-03-23 18:15:00
122,9,3,6,0.003730186165533817,2019-03-23 18:00:00,2019-03-23 18:15:00
126,33,14,19,0.01262838023063137,2019-03-23 18:00:00,2019-03-23 18:15:00
127,12,6,6,0.006849813312215335,2019-03-23 18:00:00,2019-03-23 18:15:00
133,1,1,0,0.002194303637813348,2019-03-23 18:00:00,2019-03-23 18:15:00
135,2,2,0,0.003058412135688745,2019-03-23 18:00:00,2019-03-23 18:15:00
137,33,17,16,0.012808410998451838,2019-03-23 18:00:00,2019-03-23 18:15:00
138,38,15,23,0.014291166349924618,2019-03-23 18:00:00,2019-03-23 18:15:00
140,5,3,2,0.005875523197379396,2019-03-23 18:00:00,2019-03-23 18:15:00
141,11,5,6,0.004918794135662075,2019-03-23 18:00:00,2019-03-23 18:15:00
147,2,0,2,0.0016292612449940454,2019-03-23 18:00:00,2019-03-23 18:15:00
151,4,4,0,0.0047408406235136345,2019-03-23 18:00:00,2019-03-23 18:15:00
153,26,13,13,0.010926958183872642,2019-03-23 18:00:00,2019-03-23 18:15:00
154,16,6,10,0.004699949721170094,2019-03-23 18:00:00,2019-03-23 18:15:00
157,16,9,7,0.021314072327687478,2019-03-23 18:00:00,2019-03-23 18:15:00
158,1,0,1,0.0016292612449940454,2019-03-23 18:00:00,2019-03-23 18:15:00
159,10,4,6,0.0037476724037822737,2019-03-23 18:00:00,2019-03-23 18:15:00
160,4,2,2,0.010853352627826544,2019-03-23 18:00:00,2019-03-23 18:15:00
161,2,2,0,0.003366425371836068,2019-03-23 18:00:00,2019-03-23 18:15:00
162,4,3,1,0.019205490320056338,2019-03-23 18:00:00,2019-03-23 18:15:00
164,38,15,23,0.012614441581824155,2019-03-23 18:00:00,2019-03-23 18:15:00
168,30,14,16,0.01010442734762043,2019-03-23 18:00:00,2019-03-23 18:15:00
169,10,1,9,0.00215775590252401,2019-03-23 18:00:00,2019-03-23 18:15:00
170,3,1,2,0.0023261710479578488,2019-03-23 18:00:00,2019-03-23 18:15:00
171,2,2,0,0.0066291122225944615,2019-03-23 18:00:00,2019-03-23 18:15:00
172,4,3,1,0.004494254737793365,2019-03-23 18:00:00,2019-03-23 18:15:00
173,9,5,4,0.010095826285668182,2019-03-23 18:00:00,2019-03-23 18:15:00
175,4,3,1,0.016310333574744568,2019-03-23 18:00:00,2019-03-23 18:15:00
177,13,7,6,0.016026120506876507,2019-03-23 18:00:00,2019-03-23 18:15:00
189,13,6,7,0.004108512625569821,2019-03-23 18:00:00,2019-03-23 18:15:00
190,4,1,3,0.0037929313213274658,2019-03-23 18:00:00,2019-03-23 18:15:00
191,13,7,6,0.008932787029907944,2019-03-23 18:00:00,2019-03-23 18:15:00
195,2,1,1,0.010853352627826544,2019-03-23 18:00:00,2019-03-23 18:15:00
196,7,3,4,0.006800386859544141,2019-03-23 18:00:00,2019-03-23 18:15:00
197,13,11,2,0.05886254041587079,2019-03-23 18:00:00,2019-03-23 18:15:00
199,7,4,3,0.02098585421680924,2019-03-23 18:00:00,2019-03-23 18:15:00
200,2,0,2,0.0016292612449940454,2019-03-23 18:00:00,2019-03-23 18:15:00
201,5,1,4,0.002503725273312927,2019-03-23 18:00:00,2019-03-23 18:15:00
202,1,0,1,0.0016292612449940454,2019-03-23 18:00:00,2019-03-23 18:15:00
203,14,8,6,0.0070821695659182525,2019-03-23 18:00:00,2019-03-23 18:15:00
1,8,3,5,0.005257089568704393,2019-03-23 18:15:00,2019-03-23 18:30:00
2,12,5,7,0.005781239832003746,2019-03-23 18:15:00,2019-03-23 18:30:00
5,2,0,2,0.0018560291925168908,2019-03-23 18:15:00,2019-03-23 18:30:00
10,3,3,0,0.007514170159062842,2019-03-23 18:15:00,2019-03-23 18:30:00
15,27,14,13,0.01079720991794583,2019-03-23 18:15:00,2019-03-23 18:30:00
16,18,8,10,0.011073407948093552,2019-03-23 18:15:00,2019-03-23 18:30:00
18,15,7,8,0.007135474870983702,2019-03-23 18:15:00,2019-03-23 18:30:00
19,8,5,3,0.008147228728775577,2019-03-23 18:15:00,2019-03-23 18:30:00
20,6,3,3,0.00714814904426844,2019-03-23 18:15:00,2019-03-23 18:30:00
23,11,6,5,0.009852305104013588,2019-03-23 18:15:00,2019-03-23 18:30:00
26,10,5,5,0.007436864037741009,2019-03-23 18:15:00,2019-03-23 18:30:00
27,2,0,2,0.0018560291925168908,2019-03-23 18:15:00,2019-03-23 18:30:00
28,5,1,4,0.003120440378006525,2019-03-23 18:15:00,2019-03-23 18:30:00
30,6,4,2,0.03408701721034501,2019-03-23 18:15:00,2019-03-23 18:30:00
35,7,3,4,0.004531184270987652,2019-03-23 18:15:00,2019-03-23 18:30:00
41,11,8,3,0.012573697724759636,2019-03-23 18:15:00,2019-03-23 18:30:00
46,9,5,4,0.00839626241669364,2019-03-23 18:15:00,2019-03-23 18:30:00
50,3,2,1,0.00804713852994776,2019-03-23 18:15:00,2019-03-23 18:30:00
57,3,2,1,0.0042816071058641965,2019-03-23 18:15:00,2019-03-23 18:30:00
58,6,6,0,0.0093144442311131,2019-03-23 18:15:00,2019-03-23 18:30:00
61,5,4,1,0.010286257475794371,2019-03-23 18:15:00,2019-03-23 18:30:00
62,10,4,6,0.006803205485985288,2019-03-23 18:15:00,2019-03-23 18:30:00
64,11,8,3,0.042633689608735155,2019-03-23 18:15:00,2019-03-23 18:30:00
66,2,2,0,0.0033635274294071434,2019-03-23 18:15:00,2019-03-23 18:30:00
67,28,14,14,0.011629090893640481,2019-03-23 18:15:00,2019-03-23 18:30:00
68,6,5,1,0.010169029661589536,2019-03-23 18:15:00,2019-03-23 18:30:00
69,15,10,5,0.014315242816802494,2019-03-23 18:15:00,2019-03-23 18:30:00
70,3,3,0,0.004202226926093757,2019-03-23 18:15:00,2019-03-23 18:30:00
74,5,1,4,0.002356893567090922,2019-03-23 18:15:00,2019-03-23 18:30:00
75,14,8,6,0.00878011812763636,2019-03-23 18:15:00,2019-03-23 18:30:00
79,3,1,2,0.0028223247195015826,2019-03-23 18:15:00,2019-03-23 18:30:00
80,4,2,2,0.012361452067237318,2019-03-23 18:15:00,2019-03-23 18:30:00
85,9,6,3,0.007509645514004828,2019-03-23 18:15:00,2019-03-23 18:30:00
86,2,1,1,0.012361452067237318,2019-03-23 18:15:00,2019-03-23 18:30:00
87,10,4,6,0.0032056663193146357,2019-03-23 18:15:00,2019-03-23 18:30:00
88,9,4,5,0.005780982857098164,2019-03-23 18:15:00,2019-03-23 18:30:00
89,12,5,7,0.009023578021021402,2019-03-23 18:15:00,2019-03-23 18:30:00
90,13,8,5,0.010520620591343165,2019-03-23 18:15:00,2019-03-23 18:30:00
99,5,2,3,0.0037839127876286567,2019-03-23 18:15:00,2019-03-23 18:30:00
101,10,5,5,0.012361452067237318,2019-03-23 18:15:00,2019-03-23 18:30:00
104,8,6,2,0.00846964837643192,2019-03-23 18:15:00,2019-03-23 18:30:00
106,10,6,4,0.01960654216851053,2019-03-23 18:15:00,2019-03-23 18:30:00
108,5,1,4,0.0025621778264412354,2019-03-23 18:15:00,2019-03-23 18:30:00
109,21,10,11,0.011185580820648341,2019-03-23 18:15:00,2019-03-23 18:30:00
110,15,6,9,0.006262303347430187,2019-03-23 18:15:00,2019-03-23 18:30:00
111,9,1,8,0.002076687673885691,2019-03-23 18:15:00,2019-03-23 18:30:00
112,20,8,12,0.007369840323203005,2019-03-23 18:15:00,2019-03-23 18:30:00
114,3,0,3,0.0018560291925168908,2019-03-23 18:15:00,2019-03-23 18:30:00
115,5,2,3,0.003428678933660657,2019-03-23 18:15:00,2019-03-23 18:30:00
116,16,8,8,0.014792132586237709,2019-03-23 18:15:00,2019-03-23 18:30:00
118,9,8,1,0.043613066345464434,2019-03-23 18:15:00,2019-03-23 18:30:00
119,9,4,5,0.004712733906778309,2019-03-23 18:15:00,2019-03-23 18:30:00
120,1,0,1,0.0018560291925168908,2019-03-23 18:15:00,2019-03-23 18:30:00
122,7,2,5,0.005096711981362388,2019-03-23 18:15:00,2019-03-23 18:30:00
126,25,9,16,0.009867832191548834,2019-03-23 18:15:00,2019-03-23 18:30:00
127,14,5,9,0.01397944391423549,2019-03-23 18:15:00,2019-03-23 18:30:00
133,1,1,0,0.002380337621333756,2019-03-23 18:15:00,2019-03-23 18:30:00
135,2,2,0,0.006145581725223081,2019-03-23 18:15:00,2019-03-23 18:30:00
137,32,17,15,0.016027200492131244,2019-03-23 18:15:00,2019-03-23 18:30:00
138,33,16,17,0.026902100023157672,2019-03-23 18:15:00,2019-03-23 18:30:00
140,9,2,7,0.002451398232800879,2019-03-23 18:15:00,2019-03-23 18:30:00
141,16,8,8,0.008056017881785052,2019-03-23 18:15:00,2019-03-23 18:30:00
147,2,0,2,0.0018560291925168908,2019-03-23 18:15:00,2019-03-23 18:30:00
151,4,2,2,0.004255211915092158,2019-03-23 18:15:00,2019-03-23 18:30:00
153,21,14,7,0.017659853851700158,2019-03-23 18:15:00,2019-03-23 18:30:00
154,11,3,8,0.00257047237370551,2019-03-23 18:15:00,2019-03-23 18:30:00
157,6,3,3,0.00427997883488738,2019-03-23 18:15:00,2019-03-23 18:30:00
158,1,0,1,0.0018560291925168908,2019-03-23 18:15:00,2019-03-23 18:30:00
159,6,2,4,0.0045466657954548965,2019-03-23 18:15:00,2019-03-23 18:30:00
161,2,2,0,0.0032602201845132674,2019-03-23 18:15:00,2019-03-23 18:30:00
162,2,2,0,0.00326832646036558,2019-03-23 18:15:00,2019-03-23 18:30:00
164,26,11,15,0.014081257444891946,2019-03-23 18:15:00,2019-03-23 18:30:00
168,21,9,12,0.006874370553746744,2019-03-23 18:15:00,2019-03-23 18:30:00
169,8,1,7,0.002722599502315125,2019-03-23 18:15:00,2019-03-23 18:30:00
170,4,1,3,0.0027121106375077395,2019-03-23 18:15:00,2019-03-23 18:30:00
171,2,2,0,0.01238520573471276,2019-03-23 18:15:00,2019-03-23 18:30:00
172,3,2,1,0.0038827236351821853,2019-03-23 18:15:00,2019-03-23 18:30:00
173,12,7,5,0.011139758633966317,2019-03-23 18:15:00,2019-03-23 18:30:00
175,4,3,1,0.020219133420214284,2019-03-23 18:15:00,2019-03-23 18:30:00
177,12,7,5,0.02516052701932891,2019-03-23 18:15:00,2019-03-23 18:30:00
189,9,5,4,0.0057639687501984576,2019-03-23 18:15:00,2019-03-23 18:30:00
190,4,2,2,0.0063129669118037555,2019-03-23 18:15:00,2019-03-23 18:30:00
191,12,8,4,0.014564847157925134,2019-03-23 18:15:00,2019-03-23 18:30:00
196,7,3,4,0.00529759964140707,2019-03-23 18:15:00,2019-03-23 18:30:00
197,12,7,5,0.011092613166572621,2019-03-23 18:15:00,2019-03-23 18:30:00
199,7,3,4,0.009762280200596034,2019-03-23 18:15:00,2019-03-23 18:30:00
201,1,1,0,0.002153713712658885,2019-03-23 18:15:00,2019-03-23 18:30:00
203,9,4,5,0.003990687325694386,2019-03-23 18:15:00,2019-03-23 18:30:00
1,5,1,4,0.0061360786585973985,2019-03-23 18:30:00,2019-03-23 18:45:00
2,7,1,6,0.0024496024824827065,2019-03-23 18:30:00,2019-03-23 18:45:00
5,1,0,1,0.0019087592945990104,2019-03-23 18:30:00,2019-03-23 18:45:00
10,2,2,0,0.006688664505546013,2019-03-23 18:30:00,2019-03-23 18:45:00
15,28,15,13,0.022208331834659454,2019-03-23 18:30:00,2019-03-23 18:45:00
16,11,6,5,0.005930633214724345,2019-03-23 18:30:00,2019-03-23 18:45:00
18,14,6,8,0.008553762610257564,2019-03-23 18:30:00,2019-03-23 18:45:00
19,9,4,5,0.010893330537270669,2019-03-23 18:30:00,2019-03-23 18:45:00
20,3,0,3,0.0019087592945990104,2019-03-23 18:30:00,2019-03-23 18:45:00
23,8,3,5,0.006265848391219112,2019-03-23 18:30:00,2019-03-23 18:45:00
26,10,4,6,0.006303157097187546,2019-03-23 18:30:00,2019-03-23 18:45:00
28,1,0,1,0.0019087592945990104,2019-03-23 18:30:00,2019-03-23 18:45:00
30,4,2,2,0.012709711212776118,2019-03-23 18:30:00,2019-03-23 18:45:00
35,6,2,4,0.0034711209313314385,2019-03-23 18:30:00,2019-03-23 18:45:00
41,8,6,2,0.018056960074455234,2019-03-23 18:30:00,2019-03-23 18:45:00
46,4,2,2,0.004229042731914641,2019-03-23 18:30:00,2019-03-23 18:45:00
50,1,1,0,0.003361122326805711,2019-03-23 18:30:00,2019-03-23 18:45:00
57,2,2,0,0.004299025199440146,2019-03-23 18:30:00,2019-03-23 18:45:00
58,8,7,1,0.05975066336753514,2019-03-23 18:30:00,2019-03-23 18:45:00
61,6,3,3,0.0074772509656984495,2019-03-23 18:30:00,2019-03-23 18:45:00
62,7,4,3,0.009477316557184232,2019-03-23 18:30:00,2019-03-23 18:45:00
64,8,8,0,0.006714981040416966,2019-03-23 18:30:00,2019-03-23 18:45:00
66,1,1,0,0.0023143916855117826,2019-03-23 18:30:00,2019-03-23 18:45:00
67,23,13,10,0.015530578589151852,2019-03-23 18:30:00,2019-03-23 18:45:00
68,3,2,1,0.005286873690461666,2019-03-23 18:30:00,2019-03-23 18:45:00
69,12,8,4,0.013349486317754775,2019-03-23 18:30:00,2019-03-23 18:45:00
70,6,3,3,0.004172816602336074,2019-03-23 18:30:00,2019-03-23 18:45:00
71,2,1,1,0.012709711212776118,2019-03-23 18:30:00,2019-03-23 18:45:00
74,7,3,4,0.0053703631115044025,2019-03-23 18:30:00,2019-03-23 18:45:00
75,26,12,14,0.025767436615797345,2019-03-23 18:30:00,2019-03-23 18:45:00
79,2,0,2,0.0019087592945990104,2019-03-23 18:30:00,2019-03-23 18:45:00
80,2,1,1,0.012709711212776118,2019-03-23 18:30:00,2019-03-23 18:45:00
85,12,4,8,0.004717336363406127,2019-03-23 18:30:00,2019-03-23 18:45:00
86,2,1,1,0.012709711212776118,2019-03-23 18:30:00,2019-03-23 18:45:00
87,7,2,5,0.0028921470544785556,2019-03-23 18:30:00,2019-03-23 18:45:00
88,3,0,3,0.0019087592945990104,2019-03-23 18:30:00,2019-03-23 18:45:00
89,9,5,4,0.008677244645631224,2019-03-23 18:30:00,2019-03-23 18:45:00
90,21,14,7,0.014266418992126856,2019-03-23 18:30:00,2019-03-23 18:45:00
99,2,2,0,0.00728021267793424,2019-03-23 18:30:00,2019-03-23 18:45:00
101,10,5,5,0.012709711212776118,2019-03-23 18:30:00,2019-03-23 18:45:00
104,9,7,2,0.009452896829268486,2019-03-23 18:30:00,2019-03-23 18:45:00
106,4,3,1,0.018110187171864675,2019-03-23 18:30:00,2019-03-23 18:45:00
108,4,0,4,0.0019087592945990104,2019-03-23 18:30:00,2019-03-23 18:45:00
109,21,12,9,0.017686943936119148,2019-03-23 18:30:00,2019-03-23 18:45:00
110,13,5,8,0.0051456500577040645,2019-03-23 18:30:00,2019-03-23 18:45:00
111,4,2,2,0.005597310976503716,2019-03-23 18:30:00,2019-03-23 18:45:00
112,16,6,10,0.0067028732708805765,2019-03-23 18:30:00,2019-03-23 18:45:00
114,3,0,3,0.0019087592945990104,2019-03-23 18:30:00,2019-03-23 18:45:00
115,3,1,2,0.003191387949024238,2019-03-23 18:30:00,2019-03-23 18:45:00
116,8,4,4,0.0055371181427152655,2019-03-23 18:30:00,2019-03-23 18:45:00
118,14,11,3,0.04982286408058358,2019-03-23 18:30:00,2019-03-23 18:45:00
119,11,4,7,0.004340288891250762,2019-03-23 18:30:00,2019-03-23 18:45:00
120,1,0,1,0.0019087592945990104,2019-03-23 18:30:00,2019-03-23 18:45:00
122,5,2,3,0.004526314797074435,2019-03-23 18:30:00,2019-03-23 18:45:00
126,13,3,10,0.0025621423316268643,2019-03-23 18:30:00,2019-03-23 18:45:00
127,12,5,7,0.007537404626743492,2019-03-23 18:30:00,2019-03-23 18:45:00
135,2,2,0,0.0045786129906994055,2019-03-23 18:30:00,2019-03-23 18:45:00
137,21,9,12,0.00858079861953064,2019-03-23 18:30:00,2019-03-23 18:45:00
138,25,13,12,0.017982020383100355,2019-03-23 18:30:00,2019-03-23 18:45:00
140,3,0,3,0.0019087592945990104,2019-03-23 18:30:00,2019-03-23 18:45:00
141,6,1,5,0.004594485986266625,2019-03-23 18:30:00,2019-03-23 18:45:00
147,3,0,3,0.0019087592945990104,2019-03-23 18:30:00,2019-03-23 18:45:00
151,9,4,5,0.006823615978573205,2019-03-23 18:30:00,2019-03-23 18:45:00
153,17,8,9,0.014131930905891255,2019-03-23 18:30:00,2019-03-23 18:45:00
154,9,3,6,0.007767950952239218,2019-03-23 18:30:00,2019-03-23 18:45:00
157,3,1,2,0.0028117520534552097,2019-03-23 18:30:00,2019-03-23 18:45:00
159,5,2,3,0.004456655597429231,2019-03-23 18:30:00,2019-03-23 18:45:00
161,1,1,0,0.00225580521398757,2019-03-23 18:30:00,2019-03-23 18:45:00
162,2,2,0,0.004549365999255762,2019-03-23 18:30:00,2019-03-23 18:45:00
164,25,10,15,0.015931837772736678,2019-03-23 18:30:00,2019-03-23 18:45:00
168,14,9,5,0.01666918222408494,2019-03-23 18:30:00,2019-03-23 18:45:00
169,8,4,4,0.005467927651534067,2019-03-23 18:30:00,2019-03-23 18:45:00
170,1,1,0,0.002817677289508077,2019-03-23 18:30:00,2019-03-23 18:45:00
171,4,3,1,0.006365994301570705,2019-03-23 18:30:00,2019-03-23 18:45:00
172,5,5,0,0.008149263808180814,2019-03-23 18:30:00,2019-03-23 18:45:00
173,6,4,2,0.02027928006659858,2019-03-23 18:30:00,2019-03-23 18:45:00
175,2,1,1,0.012709711212776118,2019-03-23 18:30:00,2019-03-23 18:45:00
177,8,4,4,0.012709711212776118,2019-03-23 18:30:00,2019-03-23 18:45:00
189,7,3,4,0.0035491169160255394,2019-03-23 18:30:00,2019-03-23 18:45:00
190,6,3,3,0.011954083610700272,2019-03-23 18:30:00,2019-03-23 18:45:00
191,14,9,5,0.012540403360310193,2019-03-23 18:30:00,2019-03-23 18:45:00
196,8,5,3,0.009325983346420836,2019-03-23 18:30:00,2019-03-23 18:45:00
197,9,5,4,0.011244428186184922,2019-03-23 18:30:00,2019-03-23 18:45:00
199,4,2,2,0.009944984150875396,2019-03-23 18:30:00,2019-03-23 18:45:00
202,1,1,0,0.00370627713099004,2019-03-23 18:30:00,2019-03-23 18:45:00
203,10,5,5,0.006217056076964315,2019-03-23 18:30:00,2019-03-23 18:45:00
1,3,0,3,0.002316043407901906,2019-03-23 18:45:00,2019-03-23 19:00:00
2,4,1,3,0.002972298978215749,2019-03-23 18:45:00,2019-03-23 19:00:00
5,2,1,1,0.004387026765788213,2019-03-23 18:45:00,2019-03-23 19:00:00
10,3,2,1,0.007886917281691979,2019-03-23 18:45:00,2019-03-23 19:00:00
15,20,10,10,0.01350812740154102,2019-03-23 18:45:00,2019-03-23 19:00:00
16,15,9,6,0.01258915835390741,2019-03-23 18:45:00,2019-03-23 19:00:00
18,12,3,9,0.011121987024610473,2019-03-23 18:45:00,2019-03-23 19:00:00
19,8,4,4,0.01054687747519182,2019-03-23 18:45:00,2019-03-23 19:00:00
20,1,0,1,0.002316043407901906,2019-03-23 18:45:00,2019-03-23 19:00:00
23,9,5,4,0.008602329433045373,2019-03-23 18:45:00,2019-03-23 19:00:00
26,8,3,5,0.010184791456487482,2019-03-23 18:45:00,2019-03-23 19:00:00
28,1,0,1,0.002316043407901906,2019-03-23 18:45:00,2019-03-23 19:00:00
30,4,2,2,0.015409500392736145,2019-03-23 18:45:00,2019-03-23 19:00:00
35,5,2,3,0.00461274572643597,2019-03-23 18:45:00,2019-03-23 19:00:00
41,7,3,4,0.00974458008905628,2019-03-23 18:45:00,2019-03-23 19:00:00
46,3,2,1,0.003560883934551779,2019-03-23 18:45:00,2019-03-23 19:00:00
50,5,3,2,0.02302607452718828,2019-03-23 18:45:00,2019-03-23 19:00:00
57,4,2,2,0.005439194329779887,2019-03-23 18:45:00,2019-03-23 19:00:00
58,8,8,0,0.015212163196724842,2019-03-23 18:45:00,2019-03-23 19:00:00
61,5,2,3,0.005757735915110785,2019-03-23 18:45:00,2019-03-23 19:00:00
62,15,10,5,0.016382630845532355,2019-03-23 18:45:00,2019-03-23 19:00:00
64,9,9,0,0.014363650013567455,2019-03-23 18:45:00,2019-03-23 19:00:00
66,2,2,0,0.006939834850480615,2019-03-23 18:45:00,2019-03-23 19:00:00
67,18,7,11,0.009195725390454768,2019-03-23 18:45:00,2019-03-23 19:00:00
69,7,4,3,0.02151249283026754,2019-03-23 18:45:00,2019-03-23 19:00:00
70,4,2,2,0.004284810118843435,2019-03-23 18:45:00,2019-03-23 19:00:00
71,1,0,1,0.002316043407901906,2019-03-23 18:45:00,2019-03-23 19:00:00
74,2,2,0,0.003560883934551779,2019-03-23 18:45:00,2019-03-23 19:00:00
75,12,3,9,0.00323178033460606,2019-03-23 18:45:00,2019-03-23 19:00:00
85,18,6,12,0.00702143725518204,2019-03-23 18:45:00,2019-03-23 19:00:00
86,3,2,1,0.02850295737757039,2019-03-23 18:45:00,2019-03-23 19:00:00
87,7,3,4,0.006390264073251366,2019-03-23 18:45:00,2019-03-23 19:00:00
88,3,0,3,0.002316043407901906,2019-03-23 18:45:00,2019-03-23 19:00:00
89,11,6,5,0.007654714316577868,2019-03-23 18:45:00,2019-03-23 19:00:00
90,13,9,4,0.01375721462911991,2019-03-23 18:45:00,2019-03-23 19:00:00
99,2,2,0,0.007886917281691979,2019-03-23 18:45:00,2019-03-23 19:00:00
101,13,5,8,0.004941376935943522,2019-03-23 18:45:00,2019-03-23 19:00:00
104,7,5,2,0.007219011533375662,2019-03-23 18:45:00,2019-03-23 19:00:00
106,3,2,1,0.004284810118843435,2019-03-23 18:45:00,2019-03-23 19:00:00
108,2,0,2,0.002316043407901906,2019-03-23 18:45:00,2019-03-23 19:00:00
109,20,8,12,0.016923041120541625,2019-03-23 18:45:00,2019-03-23 19:00:00
110,8,1,7,0.0026361717102091928,2019-03-23 18:45:00,2019-03-23 19:00:00
111,3,3,0,0.0063914815285663765,2019-03-23 18:45:00,2019-03-23 19:00:00
112,9,3,6,0.0064922687524807,2019-03-23 18:45:00,2019-03-23 19:00:00
113,1,1,0,0.0036738987444032436,2019-03-23 18:45:00,2019-03-23 19:00:00
114,1,1,0,0.0036738987444032436,2019-03-23 18:45:00,2019-03-23 19:00:00
115,4,1,3,0.004600598382835883,2019-03-23 18:45:00,2019-03-23 19:00:00
116,8,6,2,0.04214585807140685,2019-03-23 18:45:00,2019-03-23 19:00:00
118,4,4,0,0.006272177441788671,2019-03-23 18:45:00,2019-03-23 19:00:00
119,9,4,5,0.0065628233845135405,2019-03-23 18:45:00,2019-03-23 19:00:00
120,2,2,0,0.005883583714132412,2019-03-23 18:45:00,2019-03-23 19:00:00
122,5,2,3,0.008061883725553616,2019-03-23 18:45:00,2019-03-23 19:00:00
126,14,6,8,0.015321929409559332,2019-03-23 18:45:00,2019-03-23 19:00:00
127,12,5,7,0.00837982496574774,2019-03-23 18:45:00,2019-03-23 19:00:00
137,18,8,10,0.012488932758960904,2019-03-23 18:45:00,2019-03-23 19:00:00
138,26,12,14,0.019111675623610932,2019-03-23 18:45:00,2019-03-23 19:00:00
140,2,0,2,0.002316043407901906,2019-03-23 18:45:00,2019-03-23 19:00:00
141,3,2,1,0.0033108849950406354,2019-03-23 18:45:00,2019-03-23 19:00:00
147,2,0,2,0.002316043407901906,2019-03-23 18:45:00,2019-03-23 19:00:00
151,7,2,5,0.0036609597171644507,2019-03-23 18:45:00,2019-03-23 19:00:00
153,16,11,5,0.020357244082528796,2019-03-23 18:45:00,2019-03-23 19:00:00
154,3,1,2,0.0034643945671689385,2019-03-23 18:45:00,2019-03-23 19:00:00
157,3,1,2,0.0036738987444032436,2019-03-23 18:45:00,2019-03-23 19:00:00
158,1,1,0,0.003476591091876706,2019-03-23 18:45:00,2019-03-23 19:00:00
159,8,4,4,0.015409500392736145,2019-03-23 18:45:00,2019-03-23 19:00:00
160,4,2,2,0.015409500392736145,2019-03-23 18:45:00,2019-03-23 19:00:00
164,25,12,13,0.02076411721101121,2019-03-23 18:45:00,2019-03-23 19:00:00
168,10,7,3,0.007898608077969355,2019-03-23 18:45:00,2019-03-23 19:00:00
169,8,6,2,0.009220202998270477,2019-03-23 18:45:00,2019-03-23 19:00:00
170,1,1,0,0.003366609835240719,2019-03-23 18:45:00,2019-03-23 19:00:00
171,4,3,1,0.005368918634277332,2019-03-23 18:45:00,2019-03-23 19:00:00
172,2,2,0,0.006487991287394318,2019-03-23 18:45:00,2019-03-23 19:00:00
173,7,3,4,0.006390264073251365,2019-03-23 18:45:00,2019-03-23 19:00:00
175,2,1,1,0.015409500392736145,2019-03-23 18:45:00,2019-03-23 19:00:00
177,8,4,4,0.015409500392736145,2019-03-23 18:45:00,2019-03-23 19:00:00
189,5,3,2,0.003276428314823766,2019-03-23 18:45:00,2019-03-23 19:00:00
190,4,3,1,0.006871547022640627,2019-03-23 18:45:00,2019-03-23 19:00:00
191,10,2,8,0.006799074498312615,2019-03-23 18:45:00,2019-03-23 19:00:00
196,9,4,5,0.006686651078093789,2019-03-23 18:45:00,2019-03-23 19:00:00
201,1,1,0,0.003366609835240719,2019-03-23 18:45:00,2019-03-23 19:00:00
202,2,2,0,0.006644503549287838,2019-03-23 18:45:00,2019-03-23 19:00:00
203,8,3,5,0.0035618601792708547,2019-03-23 18:45:00,2019-03-23 19:00:00
1,8,4,4,0.00764500514265971,2019-03-23 19:00:00,2019-03-23 19:15:00
5,3,1,2,0.004105105489930367,2019-03-23 19:00:00,2019-03-23 19:15:00
10,3,2,1,0.0051455153779157315,2019-03-23 19:00:00,2019-03-23 19:15:00
15,20,13,7,0.022186120963443884,2019-03-23 19:00:00,2019-03-23 19:15:00
16,2,0,2,0.00236028130321006,2019-03-23 19:00:00,2019-03-23 19:15:00
18,8,3,5,0.01006682902038009,2019-03-23 19:00:00,2019-03-23 19:15:00
19,5,5,0,0.013528335565079217,2019-03-23 19:00:00,2019-03-23 19:15:00
20,3,2,1,0.0031536661932368526,2019-03-23 19:00:00,2019-03-23 19:15:00
23,8,5,3,0.011241315570075,2019-03-23 19:00:00,2019-03-23 19:15:00
26,9,4,5,0.008423417176083867,2019-03-23 19:00:00,2019-03-23 19:15:00
28,3,2,1,0.005609913957656809,2019-03-23 19:00:00,2019-03-23 19:15:00
30,6,2,4,0.004105105489930367,2019-03-23 19:00:00,2019-03-23 19:15:00
35,7,2,5,0.007749266423216091,2019-03-23 19:00:00,2019-03-23 19:15:00
40,1,1,0,0.0030467537659900597,2019-03-23 19:00:00,2019-03-23 19:15:00
41,10,5,5,0.01488152621190501,2019-03-23 19:00:00,2019-03-23 19:15:00
46,2,1,1,0.002835753998138004,2019-03-23 19:00:00,2019-03-23 19:15:00
50,2,2,0,0.00466332187427849,2019-03-23 19:00:00,2019-03-23 19:15:00
57,12,7,5,0.015233144106912839,2019-03-23 19:00:00,2019-03-23 19:15:00
58,13,12,1,0.01818713623666697,2019-03-23 19:00:00,2019-03-23 19:15:00
61,5,2,3,0.00537771466778627,2019-03-23 19:00:00,2019-03-23 19:15:00
62,14,9,5,0.008190875683015832,2019-03-23 19:00:00,2019-03-23 19:15:00
64,4,4,0,0.007055465222071921,2019-03-23 19:00:00,2019-03-23 19:15:00
66,1,1,0,0.004950249921455098,2019-03-23 19:00:00,2019-03-23 19:15:00
67,15,5,10,0.004105105489930367,2019-03-23 19:00:00,2019-03-23 19:15:00
68,4,1,3,0.0032935217447528017,2019-03-23 19:00:00,2019-03-23 19:15:00
69,7,5,2,0.05109819281335345,2019-03-23 19:00:00,2019-03-23 19:15:00
70,9,4,5,0.011521865901810785,2019-03-23 19:00:00,2019-03-23 19:15:00
74,2,1,1,0.01570343121190535,2019-03-23 19:00:00,2019-03-23 19:15:00
75,12,3,9,0.0032935217447528017,2019-03-23 19:00:00,2019-03-23 19:15:00
79,3,3,0,0.007230943969157548,2019-03-23 19:00:00,2019-03-23 19:15:00
85,2,0,2,0.00236028130321006,2019-03-23 19:00:00,2019-03-23 19:15:00
87,7,5,2,0.05138778401089375,2019-03-23 19:00:00,2019-03-23 19:15:00
89,10,7,3,0.019351046631533225,2019-03-23 19:00:00,2019-03-23 19:15:00
90,12,8,4,0.009451103030484888,2019-03-23 19:00:00,2019-03-23 19:15:00
99,4,2,2,0.0051455153779157315,2019-03-23 19:00:00,2019-03-23 19:15:00
101,3,0,3,0.00236028130321006,2019-03-23 19:00:00,2019-03-23 19:15:00
104,3,1,2,0.004950245393501337,2019-03-23 19:00:00,2019-03-23 19:15:00
106,3,2,1,0.004366669923685444,2019-03-23 19:00:00,2019-03-23 19:15:00
108,2,0,2,0.00236028130321006,2019-03-23 19:00:00,2019-03-23 19:15:00
109,17,4,13,0.005066463280168412,2019-03-23 19:00:00,2019-03-23 19:15:00
110,13,4,9,0.005033930343490545,2019-03-23 19:00:00,2019-03-23 19:15:00
111,1,1,0,0.0046497051205783,2019-03-23 19:00:00,2019-03-23 19:15:00
112,10,4,6,0.010011848172721695,2019-03-23 19:00:00,2019-03-23 19:15:00
113,1,1,0,0.0040725233742834295,2019-03-23 19:00:00,2019-03-23 19:15:00
114,1,1,0,0.0040725233742834295,2019-03-23 19:00:00,2019-03-23 19:15:00
115,3,0,3,0.00236028130321006,2019-03-23 19:00:00,2019-03-23 19:15:00
116,4,4,0,0.009541625421264426,2019-03-23 19:00:00,2019-03-23 19:15:00
118,4,2,2,0.004127803382014886,2019-03-23 19:00:00,2019-03-23 19:15:00
119,10,2,8,0.00373322622877006,2019-03-23 19:00:00,2019-03-23 19:15:00
120,2,2,0,0.0067344657722839185,2019-03-23 19:00:00,2019-03-23 19:15:00
122,1,0,1,0.00236028130321006,2019-03-23 19:00:00,2019-03-23 19:15:00
126,15,7,8,0.014339263226246951,2019-03-23 19:00:00,2019-03-23 19:15:00
127,13,4,9,0.006667644816714693,2019-03-23 19:00:00,2019-03-23 19:15:00
137,18,8,10,0.008391748180511287,2019-03-23 19:00:00,2019-03-23 19:15:00
138,24,14,10,0.034295687951653074,2019-03-23 19:00:00,2019-03-23 19:15:00
140,2,0,2,0.00236028130321006,2019-03-23 19:00:00,2019-03-23 19:15:00
141,7,2,5,0.004366669923685444,2019-03-23 19:00:00,2019-03-23 19:15:00
151,3,2,1,0.01737132495049226,2019-03-23 19:00:00,2019-03-23 19:15:00
153,14,7,7,0.010878594105758008,2019-03-23 19:00:00,2019-03-23 19:15:00
154,4,2,2,0.005386087165174736,2019-03-23 19:00:00,2019-03-23 19:15:00
157,4,2,2,0.007540218539700137,2019-03-23 19:00:00,2019-03-23 19:15:00
158,2,1,1,0.0030467537659900597,2019-03-23 19:00:00,2019-03-23 19:15:00
159,8,4,4,0.01570343121190535,2019-03-23 19:00:00,2019-03-23 19:15:00
160,1,0,1,0.00236028130321006,2019-03-23 19:00:00,2019-03-23 19:15:00
162,1,1,0,0.0029900827041741277,2019-03-23 19:00:00,2019-03-23 19:15:00
164,22,11,11,0.022154765300093877,2019-03-23 19:00:00,2019-03-23 19:15:00
168,16,8,8,0.006460243155865396,2019-03-23 19:00:00,2019-03-23 19:15:00
169,8,5,3,0.011553138375431888,2019-03-23 19:00:00,2019-03-23 19:15:00
171,8,6,2,0.012553360246646014,2019-03-23 19:00:00,2019-03-23 19:15:00
172,3,1,2,0.0027092461405541215,2019-03-23 19:00:00,2019-03-23 19:15:00
173,4,2,2,0.0031536661932368526,2019-03-23 19:00:00,2019-03-23 19:15:00
175,2,1,1,0.01570343121190535,2019-03-23 19:00:00,2019-03-23 19:15:00
177,3,1,2,0.004105105489930367,2019-03-23 19:00:00,2019-03-23 19:15:00
189,5,5,0,0.007536024982909555,2019-03-23 19:00:00,2019-03-23 19:15:00
190,2,2,0,0.008076115862020216,2019-03-23 19:00:00,2019-03-23 19:15:00
191,8,0,8,0.00236028130321006,2019-03-23 19:00:00,2019-03-23 19:15:00
196,6,2,4,0.006361279818479103,2019-03-23 19:00:00,2019-03-23 19:15:00
197,4,1,3,0.0032935217447528017,2019-03-23 19:00:00,2019-03-23 19:15:00
201,1,1,0,0.004071856001110864,2019-03-23 19:00:00,2019-03-23 19:15:00
202,1,1,0,0.007843889037666404,2019-03-23 19:00:00,2019-03-23 19:15:00
203,7,3,4,0.00420483679908827,2019-03-23 19:00:00,2019-03-23 19:15:00
1,12,5,7,0.006252463609371437,2019-03-23 19:15:00,2019-03-23 19:30:00
2,8,3,5,0.004069016729348308,2019-03-23 19:15:00,2019-03-23 19:30:00
5,2,1,1,0.013283262030056243,2019-03-23 19:15:00,2019-03-23 19:30:00
15,12,8,4,0.019927021440867422,2019-03-23 19:15:00,2019-03-23 19:30:00
16,6,4,2,0.009804337542720629,2019-03-23 19:15:00,2019-03-23 19:30:00
18,8,4,4,0.004807138828559745,2019-03-23 19:15:00,2019-03-23 19:30:00
19,8,7,1,0.10778289899039589,2019-03-23 19:15:00,2019-03-23 19:30:00
20,3,2,1,0.004408073113963068,2019-03-23 19:15:00,2019-03-23 19:30:00
23,3,1,2,0.0044340380615482825,2019-03-23 19:15:00,2019-03-23 19:30:00
26,6,2,4,0.004626620377796592,2019-03-23 19:15:00,2019-03-23 19:30:00
28,3,2,1,0.003512405139822702,2019-03-23 19:15:00,2019-03-23 19:30:00
30,8,3,5,0.004069016729348308,2019-03-23 19:15:00,2019-03-23 19:30:00
35,8,2,6,0.002852649865025615,2019-03-23 19:15:00,2019-03-23 19:30:00
37,2,2,0,0.003502853724816058,2019-03-23 19:15:00,2019-03-23 19:30:00
40,2,2,0,0.004442947856258356,2019-03-23 19:15:00,2019-03-23 19:30:00
41,8,2,6,0.0027819033096099606,2019-03-23 19:15:00,2019-03-23 19:30:00
46,2,1,1,0.0023863324577241855,2019-03-23 19:15:00,2019-03-23 19:30:00
50,2,2,0,0.008019336874814159,2019-03-23 19:15:00,2019-03-23 19:30:00
57,8,6,2,0.015641117543352276,2019-03-23 19:15:00,2019-03-23 19:30:00
58,11,9,2,0.019674588746859976,2019-03-23 19:15:00,2019-03-23 19:30:00
61,2,1,1,0.0027530250228792463,2019-03-23 19:15:00,2019-03-23 19:30:00
62,9,6,3,0.009106378033014206,2019-03-23 19:15:00,2019-03-23 19:30:00
64,5,5,0,0.004589685853544242,2019-03-23 19:15:00,2019-03-23 19:30:00
67,12,3,9,0.004547348405908046,2019-03-23 19:15:00,2019-03-23 19:30:00
68,6,3,3,0.007448579467454707,2019-03-23 19:15:00,2019-03-23 19:30:00
69,10,8,2,0.06206514922144267,2019-03-23 19:15:00,2019-03-23 19:30:00
70,11,6,5,0.014131696177391384,2019-03-23 19:15:00,2019-03-23 19:30:00
74,2,2,0,0.0053376436440510594,2019-03-23 19:15:00,2019-03-23 19:30:00
75,10,3,7,0.006259297997895756,2019-03-23 19:15:00,2019-03-23 19:30:00
79,3,3,0,0.005655022887890921,2019-03-23 19:15:00,2019-03-23 19:30:00
87,7,5,2,0.06639239673667538,2019-03-23 19:15:00,2019-03-23 19:30:00
88,1,0,1,0.00199364490593579,2019-03-23 19:15:00,2019-03-23 19:30:00
89,7,5,2,0.007193734175214522,2019-03-23 19:15:00,2019-03-23 19:30:00
90,11,5,6,0.012368356929965688,2019-03-23 19:15:00,2019-03-23 19:30:00
99,2,0,2,0.00199364490593579,2019-03-23 19:15:00,2019-03-23 19:30:00
101,3,0,3,0.00199364490593579,2019-03-23 19:15:00,2019-03-23 19:30:00
104,1,1,0,0.0031617943805937404,2019-03-23 19:15:00,2019-03-23 19:30:00
106,2,2,0,0.0035701617132841315,2019-03-23 19:15:00,2019-03-23 19:30:00
108,4,1,3,0.0027819033096099606,2019-03-23 19:15:00,2019-03-23 19:30:00
109,17,8,9,0.01072356739927186,2019-03-23 19:15:00,2019-03-23 19:30:00
110,10,3,7,0.0032336817281654016,2019-03-23 19:15:00,2019-03-23 19:30:00
111,2,0,2,0.00199364490593579,2019-03-23 19:15:00,2019-03-23 19:30:00
112,11,5,6,0.008764245220079188,2019-03-23 19:15:00,2019-03-23 19:30:00
114,1,1,0,0.004021673380947062,2019-03-23 19:15:00,2019-03-23 19:30:00
115,2,1,1,0.007014830285987891,2019-03-23 19:15:00,2019-03-23 19:30:00
116,3,1,2,0.005741154732567637,2019-03-23 19:15:00,2019-03-23 19:30:00
118,3,1,2,0.003235476828157825,2019-03-23 19:15:00,2019-03-23 19:30:00
119,14,6,8,0.01135964746122298,2019-03-23 19:15:00,2019-03-23 19:30:00
120,2,2,0,0.003688343446818222,2019-03-23 19:15:00,2019-03-23 19:30:00
122,1,0,1,0.00199364490593579,2019-03-23 19:15:00,2019-03-23 19:30:00
126,10,5,5,0.009527141816464092,2019-03-23 19:15:00,2019-03-23 19:30:00
127,9,2,7,0.0026331708497359476,2019-03-23 19:15:00,2019-03-23 19:30:00
137,19,11,8,0.03131049775050285,2019-03-23 19:15:00,2019-03-23 19:30:00
138,24,13,11,0.021632491851574506,2019-03-23 19:15:00,2019-03-23 19:30:00
141,4,0,4,0.00199364490593579,2019-03-23 19:15:00,2019-03-23 19:30:00
147,1,0,1,0.00199364490593579,2019-03-23 19:15:00,2019-03-23 19:30:00
151,2,1,1,0.013283262030056243,2019-03-23 19:15:00,2019-03-23 19:30:00
153,11,4,7,0.007203211174738875,2019-03-23 19:15:00,2019-03-23 19:30:00
154,1,0,1,0.00199364490593579,2019-03-23 19:15:00,2019-03-23 19:30:00
157,6,3,3,0.0164592766750411,2019-03-23 19:15:00,2019-03-23 19:30:00
158,3,1,2,0.002748249315375924,2019-03-23 19:15:00,2019-03-23 19:30:00
159,1,0,1,0.00199364490593579,2019-03-23 19:15:00,2019-03-23 19:30:00
162,2,2,0,0.004893891708720872,2019-03-23 19:15:00,2019-03-23 19:30:00
164,19,11,8,0.01908303495423746,2019-03-23 19:15:00,2019-03-23 19:30:00
168,13,6,7,0.006212973404851199,2019-03-23 19:15:00,2019-03-23 19:30:00
169,5,2,3,0.009651629249642378,2019-03-23 19:15:00,2019-03-23 19:30:00
170,1,0,1,0.00199364490593579,2019-03-23 19:15:00,2019-03-23 19:30:00
171,6,3,3,0.005142289089343613,2019-03-23 19:15:00,2019-03-23 19:30:00
172,4,2,2,0.007087611484564963,2019-03-23 19:15:00,2019-03-23 19:30:00
173,4,2,2,0.004408073113963068,2019-03-23 19:15:00,2019-03-23 19:30:00
175,2,1,1,0.013283262030056243,2019-03-23 19:15:00,2019-03-23 19:30:00
177,1,0,1,0.00199364490593579,2019-03-23 19:15:00,2019-03-23 19:30:00
189,5,4,1,0.0059066517176312216,2019-03-23 19:15:00,2019-03-23 19:30:00
190,1,1,0,0.0023877741077728753,2019-03-23 19:15:00,2019-03-23 19:30:00
191,2,0,2,0.00199364490593579,2019-03-23 19:15:00,2019-03-23 19:30:00
196,8,2,6,0.004297148832019936,2019-03-23 19:15:00,2019-03-23 19:30:00
197,5,2,3,0.006382850947808002,2019-03-23 19:15:00,2019-03-23 19:30:00
199,2,2,0,0.003844282213359539,2019-03-23 19:15:00,2019-03-23 19:30:00
201,5,2,3,0.004191239066997995,2019-03-23 19:15:00,2019-03-23 19:30:00
202,2,0,2,0.00199364490593579,2019-03-23 19:15:00,2019-03-23 19:30:00
203,6,3,3,0.003877817090043684,2019-03-23 19:15:00,2019-03-23 19:30:00
1,10,2,8,0.0035031646350581866,2019-03-23 19:30:00,2019-03-23 19:45:00
2,5,1,4,0.0035031646350581866,2019-03-23 19:30:00,2019-03-23 19:45:00
5,4,2,2,0.0051037438910274575,2019-03-23 19:30:00,2019-03-23 19:45:00
15,16,9,7,0.02026823363651037,2019-03-23 19:30:00,2019-03-23 19:45:00
16,9,7,2,0.01570287000331099,2019-03-23 19:30:00,2019-03-23 19:45:00
18,7,3,4,0.005361018011934717,2019-03-23 19:30:00,2019-03-23 19:45:00
19,2,1,1,0.0031309218605138685,2019-03-23 19:30:00,2019-03-23 19:45:00
20,2,2,0,0.004662993654273785,2019-03-23 19:30:00,2019-03-23 19:45:00
23,7,3,4,0.0064747278600945975,2019-03-23 19:30:00,2019-03-23 19:45:00
26,3,1,2,0.004873767332560354,2019-03-23 19:30:00,2019-03-23 19:45:00
28,2,1,1,0.0031309218605138685,2019-03-23 19:30:00,2019-03-23 19:45:00
35,8,2,6,0.003428697601700381,2019-03-23 19:30:00,2019-03-23 19:45:00
37,2,2,0,0.004816108718328185,2019-03-23 19:30:00,2019-03-23 19:45:00
41,7,2,5,0.004180009555201156,2019-03-23 19:30:00,2019-03-23 19:45:00
46,3,2,1,0.007573365121538361,2019-03-23 19:30:00,2019-03-23 19:45:00
57,4,4,0,0.01129359535073,2019-03-23 19:30:00,2019-03-23 19:45:00
58,10,10,0,0.0265737988726027,2019-03-23 19:30:00,2019-03-23 19:45:00
61,3,2,1,0.0052255432008857065,2019-03-23 19:30:00,2019-03-23 19:45:00
62,4,3,1,0.006556013441733575,2019-03-23 19:30:00,2019-03-23 19:45:00
64,6,6,0,0.01237949730372772,2019-03-23 19:30:00,2019-03-23 19:45:00
67,7,0,7,0.0027586790859695505,2019-03-23 19:30:00,2019-03-23 19:45:00
69,5,3,2,0.030558863166690084,2019-03-23 19:30:00,2019-03-23 19:45:00
70,4,4,0,0.012669135809651452,2019-03-23 19:30:00,2019-03-23 19:45:00
74,2,2,0,0.005699095730041416,2019-03-23 19:30:00,2019-03-23 19:45:00
75,6,3,3,0.013923837244148137,2019-03-23 19:30:00,2019-03-23 19:45:00
86,2,1,1,0.018342218157793317,2019-03-23 19:30:00,2019-03-23 19:45:00
87,7,5,2,0.06285471327148341,2019-03-23 19:30:00,2019-03-23 19:45:00
89,2,0,2,0.0027586790859695505,2019-03-23 19:30:00,2019-03-23 19:45:00
90,8,4,4,0.0169846099629403,2019-03-23 19:30:00,2019-03-23 19:45:00
99,2,0,2,0.0027586790859695505,2019-03-23 19:30:00,2019-03-23 19:45:00
106,2,2,0,0.004940225351202205,2019-03-23 19:30:00,2019-03-23 19:45:00
108,4,1,3,0.0038494522185858774,2019-03-23 19:30:00,2019-03-23 19:45:00
109,20,11,9,0.022391343937750705,2019-03-23 19:30:00,2019-03-23 19:45:00
110,9,3,6,0.00850475454531257,2019-03-23 19:30:00,2019-03-23 19:45:00
111,4,0,4,0.0027586790859695505,2019-03-23 19:30:00,2019-03-23 19:45:00
112,11,6,5,0.010837360093385576,2019-03-23 19:30:00,2019-03-23 19:45:00
114,1,1,0,0.003487998900693291,2019-03-23 19:30:00,2019-03-23 19:45:00
115,3,1,2,0.0035031646350581866,2019-03-23 19:30:00,2019-03-23 19:45:00
116,2,0,2,0.0027586790859695505,2019-03-23 19:30:00,2019-03-23 19:45:00
118,4,3,1,0.007541698575441538,2019-03-23 19:30:00,2019-03-23 19:45:00
119,10,4,6,0.00672042328663242,2019-03-23 19:30:00,2019-03-23 19:45:00
120,2,2,0,0.0051037438910274575,2019-03-23 19:30:00,2019-03-23 19:45:00
122,1,0,1,0.0027586790859695505,2019-03-23 19:30:00,2019-03-23 19:45:00
126,8,3,5,0.006866579929824852,2019-03-23 19:30:00,2019-03-23 19:45:00
127,9,4,5,0.010058278970271535,2019-03-23 19:30:00,2019-03-23 19:45:00
137,15,9,6,0.02642035709663181,2019-03-23 19:30:00,2019-03-23 19:45:00
138,16,7,9,0.015564482094349765,2019-03-23 19:30:00,2019-03-23 19:45:00
141,4,1,3,0.0038494522185858774,2019-03-23 19:30:00,2019-03-23 19:45:00
151,2,1,1,0.018342218157793317,2019-03-23 19:30:00,2019-03-23 19:45:00
153,5,3,2,0.004927983950032835,2019-03-23 19:30:00,2019-03-23 19:45:00
154,1,0,1,0.0027586790859695505,2019-03-23 19:30:00,2019-03-23 19:45:00
157,4,1,3,0.003931211488498504,2019-03-23 19:30:00,2019-03-23 19:45:00
158,2,0,2,0.0027586790859695505,2019-03-23 19:30:00,2019-03-23 19:45:00
164,16,6,10,0.008579065828720504,2019-03-23 19:30:00,2019-03-23 19:45:00
168,8,3,5,0.0060506994372941485,2019-03-23 19:30:00,2019-03-23 19:45:00
169,2,2,0,0.00659271498920473,2019-03-23 19:30:00,2019-03-23 19:45:00
171,4,1,3,0.007200844714618031,2019-03-23 19:30:00,2019-03-23 19:45:00
172,4,2,2,0.004207626188264064,2019-03-23 19:30:00,2019-03-23 19:45:00
173,5,3,2,0.0049921357332354584,2019-03-23 19:30:00,2019-03-23 19:45:00
175,2,1,1,0.018342218157793317,2019-03-23 19:30:00,2019-03-23 19:45:00
177,2,0,2,0.0027586790859695505,2019-03-23 19:30:00,2019-03-23 19:45:00
189,3,3,0,0.006373550991790405,2019-03-23 19:30:00,2019-03-23 19:45:00
191,3,1,2,0.003093688343834966,2019-03-23 19:30:00,2019-03-23 19:45:00
196,1,0,1,0.0027586790859695505,2019-03-23 19:30:00,2019-03-23 19:45:00
197,10,5,5,0.018202911881495896,2019-03-23 19:30:00,2019-03-23 19:45:00
199,3,3,0,0.009040968076799417,2019-03-23 19:30:00,2019-03-23 19:45:00
201,3,2,1,0.007614394314974557,2019-03-23 19:30:00,2019-03-23 19:45:00
202,2,0,2,0.0027586790859695505,2019-03-23 19:30:00,2019-03-23 19:45:00
203,8,5,3,0.00856799647332038,2019-03-23 19:30:00,2019-03-23 19:45:00
1,4,2,2,0.005764711738536451,2019-03-23 19:45:00,2019-03-23 20:00:00
2,2,1,1,0.014474966643141749,2019-03-23 19:45:00,2019-03-23 20:00:00
5,4,2,2,0.0040194761676829545,2019-03-23 19:45:00,2019-03-23 20:00:00
10,2,2,0,0.0029113541569610233,2019-03-23 19:45:00,2019-03-23 20:00:00
15,10,5,5,0.01044919777993187,2019-03-23 19:45:00,2019-03-23 20:00:00
16,5,2,3,0.004934103656949894,2019-03-23 19:45:00,2019-03-23 20:00:00
18,5,0,5,0.0021726061498130687,2019-03-23 19:45:00,2019-03-23 20:00:00
23,10,5,5,0.00812042494695361,2019-03-23 19:45:00,2019-03-23 20:00:00
26,1,1,0,0.003912939626475189,2019-03-23 19:45:00,2019-03-23 20:00:00
28,1,0,1,0.0021726061498130687,2019-03-23 19:45:00,2019-03-23 20:00:00
35,2,0,2,0.0021726061498130687,2019-03-23 19:45:00,2019-03-23 20:00:00
37,3,1,2,0.003778749231557731,2019-03-23 19:45:00,2019-03-23 20:00:00
41,5,0,5,0.0021726061498130687,2019-03-23 19:45:00,2019-03-23 20:00:00
46,2,1,1,0.0031696273540925014,2019-03-23 19:45:00,2019-03-23 20:00:00
50,2,0,2,0.0021726061498130687,2019-03-23 19:45:00,2019-03-23 20:00:00
57,5,5,0,0.0075851605731378545,2019-03-23 19:45:00,2019-03-23 20:00:00
58,9,8,1,0.010847644468399987,2019-03-23 19:45:00,2019-03-23 20:00:00
61,2,1,1,0.003619796793261741,2019-03-23 19:45:00,2019-03-23 20:00:00
62,3,3,0,0.006523779741801619,2019-03-23 19:45:00,2019-03-23 20:00:00
64,1,1,0,0.003570859084560629,2019-03-23 19:45:00,2019-03-23 20:00:00
67,5,1,4,0.003416234252999251,2019-03-23 19:45:00,2019-03-23 20:00:00
68,1,0,1,0.0021726061498130687,2019-03-23 19:45:00,2019-03-23 20:00:00
69,1,1,0,0.004915104034269586,2019-03-23 19:45:00,2019-03-23 20:00:00
70,6,4,2,0.026512904774906927,2019-03-23 19:45:00,2019-03-23 20:00:00
74,2,2,0,0.0047718731425337784,2019-03-23 19:45:00,2019-03-23 20:00:00
75,6,5,1,0.061172197624557424,2019-03-23 19:45:00,2019-03-23 20:00:00
86,2,1,1,0.014474966643141749,2019-03-23 19:45:00,2019-03-23 20:00:00
87,5,3,2,0.026300846362255426,2019-03-23 19:45:00,2019-03-23 20:00:00
88,1,0,1,0.0021726061498130687,2019-03-23 19:45:00,2019-03-23 20:00:00
89,2,0,2,0.0021726061498130687,2019-03-23 19:45:00,2019-03-23 20:00:00
90,7,2,5,0.005864103139386848,2019-03-23 19:45:00,2019-03-23 20:00:00
99,2,0,2,0.0021726061498130687,2019-03-23 19:45:00,2019-03-23 20:00:00
104,3,3,0,0.004249797269555766,2019-03-23 19:45:00,2019-03-23 20:00:00
106,2,2,0,0.0038907097896636244,2019-03-23 19:45:00,2019-03-23 20:00:00
108,4,1,3,0.0030316579697383466,2019-03-23 19:45:00,2019-03-23 20:00:00
109,20,11,9,0.018422409869881556,2019-03-23 19:45:00,2019-03-23 20:00:00
110,13,5,8,0.02363311814357534,2019-03-23 19:45:00,2019-03-23 20:00:00
111,4,2,2,0.005058991487693353,2019-03-23 19:45:00,2019-03-23 20:00:00
112,5,3,2,0.0064519198627318915,2019-03-23 19:45:00,2019-03-23 20:00:00
113,1,0,1,0.0021726061498130687,2019-03-23 19:45:00,2019-03-23 20:00:00
115,3,0,3,0.0021726061498130687,2019-03-23 19:45:00,2019-03-23 20:00:00
116,3,1,2,0.003619796793261741,2019-03-23 19:45:00,2019-03-23 20:00:00
118,6,5,1,0.011977403395486832,2019-03-23 19:45:00,2019-03-23 20:00:00
119,12,4,8,0.006876492530187799,2019-03-23 19:45:00,2019-03-23 20:00:00
120,2,2,0,0.0040194761676829545,2019-03-23 19:45:00,2019-03-23 20:00:00
122,1,0,1,0.0021726061498130687,2019-03-23 19:45:00,2019-03-23 20:00:00
126,6,3,3,0.006658977497506707,2019-03-23 19:45:00,2019-03-23 20:00:00
127,10,5,5,0.010563650823397736,2019-03-23 19:45:00,2019-03-23 20:00:00
137,16,5,11,0.005312260751313607,2019-03-23 19:45:00,2019-03-23 20:00:00
138,14,5,9,0.013758027581188166,2019-03-23 19:45:00,2019-03-23 20:00:00
141,5,2,3,0.004388850171256932,2019-03-23 19:45:00,2019-03-23 20:00:00
147,2,1,1,0.014474966643141749,2019-03-23 19:45:00,2019-03-23 20:00:00
151,3,2,1,0.08940746686621903,2019-03-23 19:45:00,2019-03-23 20:00:00
153,8,4,4,0.0068091142448357435,2019-03-23 19:45:00,2019-03-23 20:00:00
154,1,0,1,0.0021726061498130687,2019-03-23 19:45:00,2019-03-23 20:00:00
157,1,0,1,0.0021726061498130687,2019-03-23 19:45:00,2019-03-23 20:00:00
158,1,0,1,0.0021726061498130687,2019-03-23 19:45:00,2019-03-23 20:00:00
164,18,11,7,0.01188320002820077,2019-03-23 19:45:00,2019-03-23 20:00:00
168,6,5,1,0.040526921162844634,2019-03-23 19:45:00,2019-03-23 20:00:00
169,2,2,0,0.004635099506972917,2019-03-23 19:45:00,2019-03-23 20:00:00
170,1,0,1,0.0021726061498130687,2019-03-23 19:45:00,2019-03-23 20:00:00
171,3,1,2,0.005249870947005008,2019-03-23 19:45:00,2019-03-23 20:00:00
172,9,6,3,0.01574506160698526,2019-03-23 19:45:00,2019-03-23 20:00:00
173,7,5,2,0.010766171177867202,2019-03-23 19:45:00,2019-03-23 20:00:00
175,2,1,1,0.014474966643141749,2019-03-23 19:45:00,2019-03-23 20:00:00
177,2,0,2,0.0021726061498130687,2019-03-23 19:45:00,2019-03-23 20:00:00
189,3,3,0,0.009707210278899949,2019-03-23 19:45:00,2019-03-23 20:00:00
191,3,1,2,0.002898628192578758,2019-03-23 19:45:00,2019-03-23 20:00:00
197,7,3,4,0.007519324451024083,2019-03-23 19:45:00,2019-03-23 20:00:00
199,3,1,2,0.003619796793261741,2019-03-23 19:45:00,2019-03-23 20:00:00
201,2,1,1,0.0031696273540925014,2019-03-23 19:45:00,2019-03-23 20:00:00
202,2,0,2,0.0021726061498130687,2019-03-23 19:45:00,2019-03-23 20:00:00
203,6,5,1,0.06019708958935001,2019-03-23 19:45:00,2019-03-23 20:00:00
1,2,2,0,0.0041217679937010036,2019-03-23 20:00:00,2019-03-23 20:15:00
5,4,2,2,0.006461557045533556,2019-03-23 20:00:00,2019-03-23 20:15:00
10,2,2,0,0.0042744689585611315,2019-03-23 20:00:00,2019-03-23 20:15:00
15,10,6,4,0.0215022366144896,2019-03-23 20:00:00,2019-03-23 20:15:00
16,12,7,5,0.012136163248679993,2019-03-23 20:00:00,2019-03-23 20:15:00
18,3,0,3,0.002310461003620718,2019-03-23 20:00:00,2019-03-23 20:15:00
19,1,0,1,0.002310461003620718,2019-03-23 20:00:00,2019-03-23 20:15:00
20,3,0,3,0.002310461003620718,2019-03-23 20:00:00,2019-03-23 20:15:00
23,9,2,7,0.00354134292051579,2019-03-23 20:00:00,2019-03-23 20:15:00
26,1,1,0,0.003216114498660861,2019-03-23 20:00:00,2019-03-23 20:15:00
28,3,1,2,0.0040184064188741936,2019-03-23 20:00:00,2019-03-23 20:15:00
35,2,1,1,0.0062779895323123525,2019-03-23 20:00:00,2019-03-23 20:15:00
37,3,0,3,0.002310461003620718,2019-03-23 20:00:00,2019-03-23 20:15:00
41,2,0,2,0.002310461003620718,2019-03-23 20:00:00,2019-03-23 20:15:00
46,3,2,1,0.006437184048745764,2019-03-23 20:00:00,2019-03-23 20:15:00
50,3,1,2,0.006442061600138519,2019-03-23 20:00:00,2019-03-23 20:15:00
57,5,2,3,0.004137503605567174,2019-03-23 20:00:00,2019-03-23 20:15:00
58,8,5,3,0.01472156080525552,2019-03-23 20:00:00,2019-03-23 20:15:00
61,1,0,1,0.002310461003620718,2019-03-23 20:00:00,2019-03-23 20:15:00
62,1,1,0,0.006121504253365396,2019-03-23 20:00:00,2019-03-23 20:15:00
64,1,1,0,0.0043738225261832405,2019-03-23 20:00:00,2019-03-23 20:15:00
67,7,3,4,0.011996701422330867,2019-03-23 20:00:00,2019-03-23 20:15:00
68,1,0,1,0.002310461003620718,2019-03-23 20:00:00,2019-03-23 20:15:00
69,1,1,0,0.0062779895323123525,2019-03-23 20:00:00,2019-03-23 20:15:00
70,4,1,3,0.0032239823045939462,2019-03-23 20:00:00,2019-03-23 20:15:00
74,4,2,2,0.0153885447889256,2019-03-23 20:00:00,2019-03-23 20:15:00
75,6,5,1,0.06809710191276437,2019-03-23 20:00:00,2019-03-23 20:15:00
85,2,2,0,0.004904275930223693,2019-03-23 20:00:00,2019-03-23 20:15:00
86,2,1,1,0.0153885447889256,2019-03-23 20:00:00,2019-03-23 20:15:00
87,6,3,3,0.006843421538513197,2019-03-23 20:00:00,2019-03-23 20:15:00
88,2,2,0,0.007385771664420776,2019-03-23 20:00:00,2019-03-23 20:15:00
89,6,2,4,0.0040184064188741936,2019-03-23 20:00:00,2019-03-23 20:15:00
90,5,2,3,0.008542400672707666,2019-03-23 20:00:00,2019-03-23 20:15:00
99,2,0,2,0.002310461003620718,2019-03-23 20:00:00,2019-03-23 20:15:00
104,5,4,1,0.005898381867362238,2019-03-23 20:00:00,2019-03-23 20:15:00
106,6,4,2,0.028466628574230483,2019-03-23 20:00:00,2019-03-23 20:15:00
108,2,0,2,0.002310461003620718,2019-03-23 20:00:00,2019-03-23 20:15:00
109,18,10,8,0.03306908321040812,2019-03-23 20:00:00,2019-03-23 20:15:00
110,13,5,8,0.014564884760773684,2019-03-23 20:00:00,2019-03-23 20:15:00
111,8,2,6,0.0032239823045939462,2019-03-23 20:00:00,2019-03-23 20:15:00
112,6,3,3,0.01400030660282096,2019-03-23 20:00:00,2019-03-23 20:15:00
114,1,1,0,0.004848116334020747,2019-03-23 20:00:00,2019-03-23 20:15:00
115,3,1,2,0.003164433711247456,2019-03-23 20:00:00,2019-03-23 20:15:00
116,3,1,2,0.005973479261581578,2019-03-23 20:00:00,2019-03-23 20:15:00
118,5,3,2,0.009911526560322188,2019-03-23 20:00:00,2019-03-23 20:15:00
119,8,2,6,0.006397411941942613,2019-03-23 20:00:00,2019-03-23 20:15:00
120,2,2,0,0.0042744689585611315,2019-03-23 20:00:00,2019-03-23 20:15:00
122,1,0,1,0.002310461003620718,2019-03-23 20:00:00,2019-03-23 20:15:00
126,6,3,3,0.013447540769287118,2019-03-23 20:00:00,2019-03-23 20:15:00
127,11,4,7,0.007457574837639199,2019-03-23 20:00:00,2019-03-23 20:15:00
137,13,5,8,0.007536032721933715,2019-03-23 20:00:00,2019-03-23 20:15:00
138,14,8,6,0.01790959448822952,2019-03-23 20:00:00,2019-03-23 20:15:00
141,3,1,2,0.0029651303219341892,2019-03-23 20:00:00,2019-03-23 20:15:00
147,2,1,1,0.0153885447889256,2019-03-23 20:00:00,2019-03-23 20:15:00
151,2,2,0,0.004137503605567174,2019-03-23 20:00:00,2019-03-23 20:15:00
153,7,3,4,0.017234045311331193,2019-03-23 20:00:00,2019-03-23 20:15:00
164,14,11,3,0.02557181815370011,2019-03-23 20:00:00,2019-03-23 20:15:00
168,6,5,1,0.04164542337726451,2019-03-23 20:00:00,2019-03-23 20:15:00
169,2,2,0,0.005619443654922973,2019-03-23 20:00:00,2019-03-23 20:15:00
170,1,0,1,0.002310461003620718,2019-03-23 20:00:00,2019-03-23 20:15:00
171,3,1,2,0.0042744689585611315,2019-03-23 20:00:00,2019-03-23 20:15:00
172,8,5,3,0.012300522002809395,2019-03-23 20:00:00,2019-03-23 20:15:00
173,2,0,2,0.002310461003620718,2019-03-23 20:00:00,2019-03-23 20:15:00
175,2,1,1,0.0153885447889256,2019-03-23 20:00:00,2019-03-23 20:15:00
177,4,1,3,0.0073246400403092484,2019-03-23 20:00:00,2019-03-23 20:15:00
189,3,3,0,0.0069537163363985076,2019-03-23 20:00:00,2019-03-23 20:15:00
191,2,1,1,0.004860121671021921,2019-03-23 20:00:00,2019-03-23 20:15:00
197,5,3,2,0.01842968541000851,2019-03-23 20:00:00,2019-03-23 20:15:00
203,4,3,1,0.035963891092323785,2019-03-23 20:00:00,2019-03-23 20:15:00
1,1,1,0,0.004045532758029994,2019-03-23 20:15:00,2019-03-23 20:30:00
2,3,3,0,0.005825235129645143,2019-03-23 20:15:00,2019-03-23 20:30:00
5,4,2,2,0.006266232918262496,2019-03-23 20:15:00,2019-03-23 20:30:00
10,1,0,1,0.0025941977391217004,2019-03-23 20:15:00,2019-03-23 20:30:00
15,8,4,4,0.00776287876326172,2019-03-23 20:15:00,2019-03-23 20:30:00
16,11,6,5,0.013324336850025698,2019-03-23 20:15:00,2019-03-23 20:30:00
18,2,0,2,0.0025941977391217004,2019-03-23 20:15:00,2019-03-23 20:30:00
19,1,0,1,0.0025941977391217004,2019-03-23 20:15:00,2019-03-23 20:30:00
20,3,0,3,0.0025941977391217004,2019-03-23 20:15:00,2019-03-23 20:30:00
23,8,2,6,0.003619959918562461,2019-03-23 20:15:00,2019-03-23 20:30:00
26,1,1,0,0.00785142612586073,2019-03-23 20:15:00,2019-03-23 20:30:00
27,2,2,0,0.009294193685001572,2019-03-23 20:15:00,2019-03-23 20:30:00
28,3,1,2,0.007881273222215747,2019-03-23 20:15:00,2019-03-23 20:30:00
35,2,1,1,0.00342926166894355,2019-03-23 20:15:00,2019-03-23 20:30:00
37,2,1,1,0.0029347114962644644,2019-03-23 20:15:00,2019-03-23 20:30:00
40,1,0,1,0.0025941977391217004,2019-03-23 20:15:00,2019-03-23 20:30:00
46,2,2,0,0.0038370745119253114,2019-03-23 20:15:00,2019-03-23 20:30:00
50,1,1,0,0.005509389484949648,2019-03-23 20:15:00,2019-03-23 20:30:00
57,3,1,2,0.0031256028130109592,2019-03-23 20:15:00,2019-03-23 20:30:00
58,4,2,2,0.005688475316764022,2019-03-23 20:15:00,2019-03-23 20:30:00
61,3,2,1,0.0042643255987654,2019-03-23 20:15:00,2019-03-23 20:30:00
62,1,1,0,0.005249222399016993,2019-03-23 20:15:00,2019-03-23 20:30:00
64,1,1,0,0.0048596664821763495,2019-03-23 20:15:00,2019-03-23 20:30:00
67,6,2,4,0.005847015330234007,2019-03-23 20:15:00,2019-03-23 20:30:00
69,3,3,0,0.004531899274484891,2019-03-23 20:15:00,2019-03-23 20:30:00
70,4,0,4,0.0025941977391217004,2019-03-23 20:15:00,2019-03-23 20:30:00
74,1,0,1,0.0025941977391217004,2019-03-23 20:15:00,2019-03-23 20:30:00
75,4,3,1,0.021804263675425633,2019-03-23 20:15:00,2019-03-23 20:30:00
85,2,2,0,0.006785699904218685,2019-03-23 20:15:00,2019-03-23 20:30:00
87,5,2,3,0.0059877023767076105,2019-03-23 20:15:00,2019-03-23 20:30:00
88,2,2,0,0.006544992063294916,2019-03-23 20:15:00,2019-03-23 20:30:00
89,6,1,5,0.0031256028130109592,2019-03-23 20:15:00,2019-03-23 20:30:00
90,3,2,1,0.034897885795954105,2019-03-23 20:15:00,2019-03-23 20:30:00
101,1,0,1,0.0025941977391217004,2019-03-23 20:15:00,2019-03-23 20:30:00
104,2,1,1,0.004569594901208308,2019-03-23 20:15:00,2019-03-23 20:30:00
106,8,5,3,0.050602142610611585,2019-03-23 20:15:00,2019-03-23 20:30:00
108,4,2,2,0.005893823128633072,2019-03-23 20:15:00,2019-03-23 20:30:00
109,18,10,8,0.024604218868339404,2019-03-23 20:15:00,2019-03-23 20:30:00
110,11,2,9,0.003605061436815587,2019-03-23 20:15:00,2019-03-23 20:30:00
111,12,4,8,0.0045120322343402105,2019-03-23 20:15:00,2019-03-23 20:30:00
112,8,2,6,0.005893823128633072,2019-03-23 20:15:00,2019-03-23 20:30:00
114,2,2,0,0.006774870112290991,2019-03-23 20:15:00,2019-03-23 20:30:00
115,2,1,1,0.0031256028130109592,2019-03-23 20:15:00,2019-03-23 20:30:00
116,4,1,3,0.005121542379553859,2019-03-23 20:15:00,2019-03-23 20:30:00
118,3,1,2,0.00342926166894355,2019-03-23 20:15:00,2019-03-23 20:30:00
119,8,2,6,0.004386046515172758,2019-03-23 20:15:00,2019-03-23 20:30:00
120,1,1,0,0.004799472950204383,2019-03-23 20:15:00,2019-03-23 20:30:00
122,1,0,1,0.0025941977391217004,2019-03-23 20:15:00,2019-03-23 20:30:00
126,10,5,5,0.015613960999671894,2019-03-23 20:15:00,2019-03-23 20:30:00
127,10,6,4,0.024732837975018483,2019-03-23 20:15:00,2019-03-23 20:30:00
135,4,3,1,0.03667026832501271,2019-03-23 20:15:00,2019-03-23 20:30:00
137,8,6,2,0.03864018897144269,2019-03-23 20:15:00,2019-03-23 20:30:00
138,8,4,4,0.00929401912085221,2019-03-23 20:15:00,2019-03-23 20:30:00
140,1,0,1,0.0025941977391217004,2019-03-23 20:15:00,2019-03-23 20:30:00
141,4,1,3,0.0036968353446630415,2019-03-23 20:15:00,2019-03-23 20:30:00
147,2,1,1,0.017272276123011455,2019-03-23 20:15:00,2019-03-23 20:30:00
151,2,2,0,0.0036968353446630415,2019-03-23 20:15:00,2019-03-23 20:30:00
153,5,2,3,0.008918421941354353,2019-03-23 20:15:00,2019-03-23 20:30:00
154,3,0,3,0.0025941977391217004,2019-03-23 20:15:00,2019-03-23 20:30:00
164,9,6,3,0.011158454761710698,2019-03-23 20:15:00,2019-03-23 20:30:00
168,4,3,1,0.03495561776051208,2019-03-23 20:15:00,2019-03-23 20:30:00
169,2,2,0,0.007456498319650676,2019-03-23 20:15:00,2019-03-23 20:30:00
170,1,1,0,0.004799472950204383,2019-03-23 20:15:00,2019-03-23 20:30:00
171,2,1,1,0.006219306019694913,2019-03-23 20:15:00,2019-03-23 20:30:00
172,1,1,0,0.0038368233197398865,2019-03-23 20:15:00,2019-03-23 20:30:00
175,2,1,1,0.017272276123011455,2019-03-23 20:15:00,2019-03-23 20:30:00
177,4,1,3,0.006479004642186726,2019-03-23 20:15:00,2019-03-23 20:30:00
189,3,3,0,0.003615739010549993,2019-03-23 20:15:00,2019-03-23 20:30:00
191,2,1,1,0.00342926166894355,2019-03-23 20:15:00,2019-03-23 20:30:00
197,5,3,2,0.020462337095179264,2019-03-23 20:15:00,2019-03-23 20:30:00
201,3,3,0,0.004799472950204383,2019-03-23 20:15:00,2019-03-23 20:30:00
203,4,3,1,0.021804263675425633,2019-03-23 20:15:00,2019-03-23 20:30:00
1,4,3,1,0.006905260795888752,2019-03-23 20:30:00,2019-03-23 20:45:00
2,4,4,0,0.008103766191829096,2019-03-23 20:30:00,2019-03-23 20:45:00
10,1,0,1,0.0023915504482663647,2019-03-23 20:30:00,2019-03-23 20:45:00
15,9,4,5,0.005418483729027802,2019-03-23 20:30:00,2019-03-23 20:45:00
16,6,3,3,0.007318972719980625,2019-03-23 20:30:00,2019-03-23 20:45:00
18,1,0,1,0.0023915504482663647,2019-03-23 20:30:00,2019-03-23 20:45:00
19,1,0,1,0.0023915504482663647,2019-03-23 20:30:00,2019-03-23 20:45:00
20,1,0,1,0.0023915504482663647,2019-03-23 20:30:00,2019-03-23 20:45:00
21,2,2,0,0.004159595342913233,2019-03-23 20:30:00,2019-03-23 20:45:00
23,7,2,5,0.004720668484843896,2019-03-23 20:30:00,2019-03-23 20:45:00
26,1,1,0,0.015469588033929355,2019-03-23 20:30:00,2019-03-23 20:45:00
28,4,3,1,0.04259955198935708,2019-03-23 20:30:00,2019-03-23 20:45:00
37,1,0,1,0.0023915504482663647,2019-03-23 20:30:00,2019-03-23 20:45:00
40,1,0,1,0.0023915504482663647,2019-03-23 20:30:00,2019-03-23 20:45:00
41,1,0,1,0.0023915504482663647,2019-03-23 20:30:00,2019-03-23 20:45:00
46,3,1,2,0.004424570101896544,2019-03-23 20:30:00,2019-03-23 20:45:00
57,3,1,2,0.003069223666143091,2019-03-23 20:30:00,2019-03-23 20:45:00
58,4,1,3,0.0032529334127202646,2019-03-23 20:30:00,2019-03-23 20:45:00
61,4,2,2,0.00359134992338026,2019-03-23 20:30:00,2019-03-23 20:45:00
62,1,1,0,0.0033344219052640115,2019-03-23 20:30:00,2019-03-23 20:45:00
67,5,0,5,0.0023915504482663647,2019-03-23 20:30:00,2019-03-23 20:45:00
69,6,4,2,0.022622515140455674,2019-03-23 20:30:00,2019-03-23 20:45:00
75,3,2,1,0.03520683741716911,2019-03-23 20:30:00,2019-03-23 20:45:00
85,2,0,2,0.0023915504482663647,2019-03-23 20:30:00,2019-03-23 20:45:00
87,2,1,1,0.015924269166553498,2019-03-23 20:30:00,2019-03-23 20:45:00
89,3,0,3,0.0023915504482663647,2019-03-23 20:30:00,2019-03-23 20:45:00
90,3,2,1,0.022192115948314543,2019-03-23 20:30:00,2019-03-23 20:45:00
101,1,0,1,0.0023915504482663647,2019-03-23 20:30:00,2019-03-23 20:45:00
104,4,2,2,0.019984304167559256,2019-03-23 20:30:00,2019-03-23 20:45:00
106,8,5,3,0.03987448254802198,2019-03-23 20:30:00,2019-03-23 20:45:00
108,4,2,2,0.004234062542901363,2019-03-23 20:30:00,2019-03-23 20:45:00
109,18,8,10,0.010132337386464773,2019-03-23 20:30:00,2019-03-23 20:45:00
110,6,0,6,0.0023915504482663647,2019-03-23 20:30:00,2019-03-23 20:45:00
111,10,4,6,0.005520041447759442,2019-03-23 20:30:00,2019-03-23 20:45:00
112,8,2,6,0.004234062542901363,2019-03-23 20:30:00,2019-03-23 20:45:00
114,7,5,2,0.018112659473672583,2019-03-23 20:30:00,2019-03-23 20:45:00
115,2,1,1,0.003069223666143091,2019-03-23 20:30:00,2019-03-23 20:45:00
116,3,1,2,0.006806434893640996,2019-03-23 20:30:00,2019-03-23 20:45:00
118,2,2,0,0.0048721013454602925,2019-03-23 20:30:00,2019-03-23 20:45:00
119,3,1,2,0.002730387057204728,2019-03-23 20:30:00,2019-03-23 20:45:00
120,1,1,0,0.005207759487752298,2019-03-23 20:30:00,2019-03-23 20:45:00
122,1,0,1,0.0023915504482663647,2019-03-23 20:30:00,2019-03-23 20:45:00
126,14,4,10,0.011090556442629235,2019-03-23 20:30:00,2019-03-23 20:45:00
127,8,6,2,0.03076074878524364,2019-03-23 20:30:00,2019-03-23 20:45:00
135,6,2,4,0.004159595342913233,2019-03-23 20:30:00,2019-03-23 20:45:00
137,11,9,2,0.08574404876918523,2019-03-23 20:30:00,2019-03-23 20:45:00
138,8,6,2,0.02139905043366201,2019-03-23 20:30:00,2019-03-23 20:45:00
140,2,1,1,0.0033128064955838636,2019-03-23 20:30:00,2019-03-23 20:45:00
151,2,2,0,0.0034080602750814542,2019-03-23 20:30:00,2019-03-23 20:45:00
153,3,2,1,0.005193255372863824,2019-03-23 20:30:00,2019-03-23 20:45:00
154,3,0,3,0.0023915504482663647,2019-03-23 20:30:00,2019-03-23 20:45:00
159,4,0,4,0.0023915504482663647,2019-03-23 20:30:00,2019-03-23 20:45:00
160,2,2,0,0.0034080602750814542,2019-03-23 20:30:00,2019-03-23 20:45:00
164,11,6,5,0.008239165222428567,2019-03-23 20:30:00,2019-03-23 20:45:00
168,5,4,1,0.03901895687071755,2019-03-23 20:30:00,2019-03-23 20:45:00
169,2,2,0,0.007033683977407983,2019-03-23 20:30:00,2019-03-23 20:45:00
170,2,2,0,0.005024469839453492,2019-03-23 20:30:00,2019-03-23 20:45:00
171,2,1,1,0.003918054435010337,2019-03-23 20:30:00,2019-03-23 20:45:00
172,1,1,0,0.0027981543789924006,2019-03-23 20:30:00,2019-03-23 20:45:00
175,2,1,1,0.015924269166553498,2019-03-23 20:30:00,2019-03-23 20:45:00
177,2,1,1,0.010887558826927103,2019-03-23 20:30:00,2019-03-23 20:45:00
189,4,3,1,0.0034080602750814542,2019-03-23 20:30:00,2019-03-23 20:45:00
191,1,1,0,0.0029914501858233126,2019-03-23 20:30:00,2019-03-23 20:45:00
197,5,3,2,0.021126383025950518,2019-03-23 20:30:00,2019-03-23 20:45:00
199,3,0,3,0.0023915504482663647,2019-03-23 20:30:00,2019-03-23 20:45:00
201,3,3,0,0.004424570101896544,2019-03-23 20:30:00,2019-03-23 20:45:00
203,5,3,2,0.005338291939344478,2019-03-23 20:30:00,2019-03-23 20:45:00
1,3,2,1,0.010041227662270174,2019-03-23 20:45:00,2019-03-23 21:00:00
2,4,4,0,0.011967722888269385,2019-03-23 20:45:00,2019-03-23 21:00:00
10,1,0,1,0.0027678422957097878,2019-03-23 20:45:00,2019-03-23 21:00:00
15,10,4,6,0.006535967482413171,2019-03-23 20:45:00,2019-03-23 21:00:00
16,5,1,4,0.004015003626193989,2019-03-23 20:45:00,2019-03-23 21:00:00
18,1,1,0,0.004015003626193989,2019-03-23 20:45:00,2019-03-23 21:00:00
20,2,2,0,0.010459446057534781,2019-03-23 20:45:00,2019-03-23 21:00:00
21,4,2,2,0.005120724650252151,2019-03-23 20:45:00,2019-03-23 21:00:00
23,7,3,4,0.014100275244363247,2019-03-23 20:45:00,2019-03-23 21:00:00
28,5,2,3,0.004956678035222082,2019-03-23 20:45:00,2019-03-23 21:00:00
35,1,1,0,0.003749677423108653,2019-03-23 20:45:00,2019-03-23 21:00:00
37,1,0,1,0.0027678422957097878,2019-03-23 20:45:00,2019-03-23 21:00:00
40,1,0,1,0.0027678422957097878,2019-03-23 20:45:00,2019-03-23 21:00:00
41,2,0,2,0.0027678422957097878,2019-03-23 20:45:00,2019-03-23 21:00:00
46,5,4,1,0.013185283654412669,2019-03-23 20:45:00,2019-03-23 21:00:00
57,6,2,4,0.004814033841851041,2019-03-23 20:45:00,2019-03-23 21:00:00
58,4,1,3,0.004015003626193989,2019-03-23 20:45:00,2019-03-23 21:00:00
61,3,0,3,0.0027678422957097878,2019-03-23 20:45:00,2019-03-23 21:00:00
62,1,1,0,0.004330613920893981,2019-03-23 20:45:00,2019-03-23 21:00:00
67,1,0,1,0.0027678422957097878,2019-03-23 20:45:00,2019-03-23 21:00:00
68,2,0,2,0.0027678422957097878,2019-03-23 20:45:00,2019-03-23 21:00:00
69,3,2,1,0.02495135604724535,2019-03-23 20:45:00,2019-03-23 21:00:00
74,2,0,2,0.0027678422957097878,2019-03-23 20:45:00,2019-03-23 21:00:00
75,3,2,1,0.04277339764517703,2019-03-23 20:45:00,2019-03-23 21:00:00
85,2,0,2,0.0027678422957097878,2019-03-23 20:45:00,2019-03-23 21:00:00
87,2,1,1,0.01842159086773927,2019-03-23 20:45:00,2019-03-23 21:00:00
89,2,1,1,0.0032808888064977376,2019-03-23 20:45:00,2019-03-23 21:00:00
90,3,1,2,0.004330613920893981,2019-03-23 20:45:00,2019-03-23 21:00:00
101,1,0,1,0.0027678422957097878,2019-03-23 20:45:00,2019-03-23 21:00:00
104,2,1,1,0.01842159086773927,2019-03-23 20:45:00,2019-03-23 21:00:00
106,4,2,2,0.01842159086773927,2019-03-23 20:45:00,2019-03-23 21:00:00
108,2,2,0,0.004619899671594256,2019-03-23 20:45:00,2019-03-23 21:00:00
109,10,4,6,0.008802295373087738,2019-03-23 20:45:00,2019-03-23 21:00:00
110,7,1,6,0.0036211289923561915,2019-03-23 20:45:00,2019-03-23 21:00:00
111,6,2,4,0.004814033841851041,2019-03-23 20:45:00,2019-03-23 21:00:00
112,6,2,4,0.004619899671594256,2019-03-23 20:45:00,2019-03-23 21:00:00
114,6,4,2,0.019466777955666557,2019-03-23 20:45:00,2019-03-23 21:00:00
115,2,1,1,0.005556869925708021,2019-03-23 20:45:00,2019-03-23 21:00:00
116,3,0,3,0.0027678422957097878,2019-03-23 20:45:00,2019-03-23 21:00:00
118,4,3,1,0.008102736409857564,2019-03-23 20:45:00,2019-03-23 21:00:00
119,2,0,2,0.0027678422957097878,2019-03-23 20:45:00,2019-03-23 21:00:00
120,1,1,0,0.00669518280530525,2019-03-23 20:45:00,2019-03-23 21:00:00
122,5,2,3,0.006388432190801674,2019-03-23 20:45:00,2019-03-23 21:00:00
126,9,2,7,0.012867263488661638,2019-03-23 20:45:00,2019-03-23 21:00:00
127,8,6,2,0.015265491365021764,2019-03-23 20:45:00,2019-03-23 21:00:00
135,2,0,2,0.0027678422957097878,2019-03-23 20:45:00,2019-03-23 21:00:00
137,8,6,2,0.0675985057035555,2019-03-23 20:45:00,2019-03-23 21:00:00
138,9,9,0,0.030098631671024,2019-03-23 20:45:00,2019-03-23 21:00:00
140,3,2,1,0.004619899671594256,2019-03-23 20:45:00,2019-03-23 21:00:00
147,1,0,1,0.0027678422957097878,2019-03-23 20:45:00,2019-03-23 21:00:00
151,2,2,0,0.004336430532071363,2019-03-23 20:45:00,2019-03-23 21:00:00
153,5,3,2,0.012559840518468911,2019-03-23 20:45:00,2019-03-23 21:00:00
154,3,0,3,0.0027678422957097878,2019-03-23 20:45:00,2019-03-23 21:00:00
159,3,0,3,0.0027678422957097878,2019-03-23 20:45:00,2019-03-23 21:00:00
160,1,1,0,0.0035521364138905755,2019-03-23 20:45:00,2019-03-23 21:00:00
162,2,2,0,0.004336430532071363,2019-03-23 20:45:00,2019-03-23 21:00:00
164,8,4,4,0.012795486015398354,2019-03-23 20:45:00,2019-03-23 21:00:00
168,5,3,2,0.006061195172335242,2019-03-23 20:45:00,2019-03-23 21:00:00
169,2,2,0,0.009301978078771693,2019-03-23 20:45:00,2019-03-23 21:00:00
170,2,2,0,0.006102559777651016,2019-03-23 20:45:00,2019-03-23 21:00:00
171,1,1,0,0.0035521364138905755,2019-03-23 20:45:00,2019-03-23 21:00:00
172,2,1,1,0.005120724650252151,2019-03-23 20:45:00,2019-03-23 21:00:00
173,2,2,0,0.005120724650252151,2019-03-23 20:45:00,2019-03-23 21:00:00
175,2,1,1,0.01842159086773927,2019-03-23 20:45:00,2019-03-23 21:00:00
189,4,3,1,0.004306981828073637,2019-03-23 20:45:00,2019-03-23 21:00:00
191,1,0,1,0.0027678422957097878,2019-03-23 20:45:00,2019-03-23 21:00:00
197,5,3,2,0.025225369380683392,2019-03-23 20:45:00,2019-03-23 21:00:00
199,3,0,3,0.0027678422957097878,2019-03-23 20:45:00,2019-03-23 21:00:00
201,3,3,0,0.005120724650252151,2019-03-23 20:45:00,2019-03-23 21:00:00
203,7,5,2,0.015561079774714397,2019-03-23 20:45:00,2019-03-23 21:00:00
1,1,1,0,0.004144548107274577,2019-03-23 21:00:00,2019-03-23 21:15:00
2,1,1,0,0.0036041859542349907,2019-03-23 21:00:00,2019-03-23 21:15:00
15,9,7,2,0.016472660646184,2019-03-23 21:00:00,2019-03-23 21:15:00
16,9,1,8,0.005572528772265373,2019-03-23 21:00:00,2019-03-23 21:15:00
18,1,1,0,0.004472753164539796,2019-03-23 21:00:00,2019-03-23 21:15:00
19,2,0,2,0.0030120406580527877,2019-03-23 21:00:00,2019-03-23 21:15:00
20,2,1,1,0.00429228471515908,2019-03-23 21:00:00,2019-03-23 21:15:00
23,5,2,3,0.0069520893989994635,2019-03-23 21:00:00,2019-03-23 21:15:00
27,1,0,1,0.0030120406580527877,2019-03-23 21:00:00,2019-03-23 21:15:00
28,8,6,2,0.01361493001366456,2019-03-23 21:00:00,2019-03-23 21:15:00
30,2,1,1,0.018724575653815776,2019-03-23 21:00:00,2019-03-23 21:15:00
35,1,1,0,0.007834020179240089,2019-03-23 21:00:00,2019-03-23 21:15:00
41,2,1,1,0.005694407910973557,2019-03-23 21:00:00,2019-03-23 21:15:00
46,7,6,1,0.01616901562370286,2019-03-23 21:00:00,2019-03-23 21:15:00
57,1,0,1,0.0030120406580527877,2019-03-23 21:00:00,2019-03-23 21:15:00
58,4,4,0,0.012519854923302104,2019-03-23 21:00:00,2019-03-23 21:15:00
61,5,2,3,0.005277055556496366,2019-03-23 21:00:00,2019-03-23 21:15:00
62,1,1,0,0.0052387828723898956,2019-03-23 21:00:00,2019-03-23 21:15:00
66,1,1,0,0.006660865899887893,2019-03-23 21:00:00,2019-03-23 21:15:00
67,2,0,2,0.0030120406580527877,2019-03-23 21:00:00,2019-03-23 21:15:00
68,2,0,2,0.0030120406580527877,2019-03-23 21:00:00,2019-03-23 21:15:00
69,1,1,0,0.007834020179240089,2019-03-23 21:00:00,2019-03-23 21:15:00
74,2,0,2,0.0030120406580527877,2019-03-23 21:00:00,2019-03-23 21:15:00
75,2,1,1,0.020006381840862987,2019-03-23 21:00:00,2019-03-23 21:15:00
87,2,1,1,0.020006381840862987,2019-03-23 21:00:00,2019-03-23 21:15:00
88,1,0,1,0.0030120406580527877,2019-03-23 21:00:00,2019-03-23 21:15:00
89,1,0,1,0.0030120406580527877,2019-03-23 21:00:00,2019-03-23 21:15:00
90,3,1,2,0.005572528772265373,2019-03-23 21:00:00,2019-03-23 21:15:00
106,4,2,2,0.020006381840862987,2019-03-23 21:00:00,2019-03-23 21:15:00
109,9,3,6,0.010309691141722999,2019-03-23 21:00:00,2019-03-23 21:15:00
110,3,1,2,0.0036041859542349907,2019-03-23 21:00:00,2019-03-23 21:15:00
111,4,0,4,0.0030120406580527877,2019-03-23 21:00:00,2019-03-23 21:15:00
112,5,2,3,0.017015913011307903,2019-03-23 21:00:00,2019-03-23 21:15:00
114,2,0,2,0.0030120406580527877,2019-03-23 21:00:00,2019-03-23 21:15:00
115,4,3,1,0.007889326813851568,2019-03-23 21:00:00,2019-03-23 21:15:00
116,3,0,3,0.0030120406580527877,2019-03-23 21:00:00,2019-03-23 21:15:00
118,5,2,3,0.010782192824884762,2019-03-23 21:00:00,2019-03-23 21:15:00
119,7,3,4,0.005450683735952178,2019-03-23 21:00:00,2019-03-23 21:15:00
120,1,0,1,0.0030120406580527877,2019-03-23 21:00:00,2019-03-23 21:15:00
122,5,2,3,0.0069520893989994635,2019-03-23 21:00:00,2019-03-23 21:15:00
126,3,1,2,0.0052387828723898956,2019-03-23 21:00:00,2019-03-23 21:15:00
127,7,3,4,0.005328838699638983,2019-03-23 21:00:00,2019-03-23 21:15:00
133,1,1,0,0.016757873927344763,2019-03-23 21:00:00,2019-03-23 21:15:00
137,6,3,3,0.008922113769472802,2019-03-23 21:00:00,2019-03-23 21:15:00
138,10,8,2,0.03696485528883661,2019-03-23 21:00:00,2019-03-23 21:15:00
141,1,0,1,0.0030120406580527877,2019-03-23 21:00:00,2019-03-23 21:15:00
147,1,0,1,0.0030120406580527877,2019-03-23 21:00:00,2019-03-23 21:15:00
153,2,2,0,0.008376775163894326,2019-03-23 21:00:00,2019-03-23 21:15:00
154,1,1,0,0.004982065028526125,2019-03-23 21:00:00,2019-03-23 21:15:00
157,1,1,0,0.005540329194727364,2019-03-23 21:00:00,2019-03-23 21:15:00
159,2,2,0,0.005394012095069263,2019-03-23 21:00:00,2019-03-23 21:15:00
162,2,2,0,0.004719032734194511,2019-03-23 21:00:00,2019-03-23 21:15:00
164,7,1,6,0.018930711541578642,2019-03-23 21:00:00,2019-03-23 21:15:00
168,2,0,2,0.0030120406580527877,2019-03-23 21:00:00,2019-03-23 21:15:00
169,2,2,0,0.011688769080658324,2019-03-23 21:00:00,2019-03-23 21:15:00
170,4,1,3,0.004203026376561026,2019-03-23 21:00:00,2019-03-23 21:15:00
171,6,3,3,0.010403724330951974,2019-03-23 21:00:00,2019-03-23 21:15:00
172,1,1,0,0.00429228471515908,2019-03-23 21:00:00,2019-03-23 21:15:00
173,2,2,0,0.005572528772265373,2019-03-23 21:00:00,2019-03-23 21:15:00
175,2,1,1,0.020006381840862987,2019-03-23 21:00:00,2019-03-23 21:15:00
189,1,1,0,0.00429228471515908,2019-03-23 21:00:00,2019-03-23 21:15:00
195,1,1,0,0.00429228471515908,2019-03-23 21:00:00,2019-03-23 21:15:00
197,7,3,4,0.006352153979558449,2019-03-23 21:00:00,2019-03-23 21:15:00
199,1,0,1,0.0030120406580527877,2019-03-23 21:00:00,2019-03-23 21:15:00
203,8,7,1,0.06518849175457911,2019-03-23 21:00:00,2019-03-23 21:15:00
2,1,1,0,0.004664315447833047,2019-03-23 21:15:00,2019-03-23 21:30:00
15,7,6,1,0.015898256157349255,2019-03-23 21:15:00,2019-03-23 21:30:00
16,7,2,5,0.008479447616086225,2019-03-23 21:15:00,2019-03-23 21:30:00
19,3,1,2,0.005604991492537093,2019-03-23 21:15:00,2019-03-23 21:30:00
20,1,0,1,0.003222581300146324,2019-03-23 21:15:00,2019-03-23 21:30:00
23,4,2,2,0.02143024508313347,2019-03-23 21:15:00,2019-03-23 21:30:00
27,2,0,2,0.003222581300146324,2019-03-23 21:15:00,2019-03-23 21:30:00
28,6,6,0,0.015369808774079365,2019-03-23 21:15:00,2019-03-23 21:30:00
30,4,2,2,0.010795884361000149,2019-03-23 21:15:00,2019-03-23 21:30:00
35,2,1,1,0.02143024508313347,2019-03-23 21:15:00,2019-03-23 21:30:00
40,2,1,1,0.02143024508313347,2019-03-23 21:15:00,2019-03-23 21:30:00
41,1,1,0,0.0040526765963286,2019-03-23 21:15:00,2019-03-23 21:30:00
46,3,2,1,0.006111328362789466,2019-03-23 21:15:00,2019-03-23 21:30:00
57,1,0,1,0.003222581300146324,2019-03-23 21:15:00,2019-03-23 21:30:00
58,4,4,0,0.008341300346663102,2019-03-23 21:15:00,2019-03-23 21:30:00
61,5,2,3,0.005962054203918371,2019-03-23 21:15:00,2019-03-23 21:30:00
62,1,1,0,0.005604991492537093,2019-03-23 21:15:00,2019-03-23 21:30:00
66,2,1,1,0.005962054203918371,2019-03-23 21:15:00,2019-03-23 21:30:00
67,2,0,2,0.003222581300146324,2019-03-23 21:15:00,2019-03-23 21:30:00
68,1,1,0,0.008290894633188193,2019-03-23 21:15:00,2019-03-23 21:30:00
69,2,2,0,0.005866559462601685,2019-03-23 21:15:00,2019-03-23 21:30:00
74,2,0,2,0.003222581300146324,2019-03-23 21:15:00,2019-03-23 21:30:00
75,2,1,1,0.02143024508313347,2019-03-23 21:15:00,2019-03-23 21:30:00
87,2,1,1,0.02143024508313347,2019-03-23 21:15:00,2019-03-23 21:30:00
88,1,0,1,0.003222581300146324,2019-03-23 21:15:00,2019-03-23 21:30:00
89,1,0,1,0.003222581300146324,2019-03-23 21:15:00,2019-03-23 21:30:00
90,3,1,2,0.005962054203918371,2019-03-23 21:15:00,2019-03-23 21:30:00
104,3,1,2,0.005604991492537093,2019-03-23 21:15:00,2019-03-23 21:30:00
109,12,4,8,0.024734276265059925,2019-03-23 21:15:00,2019-03-23 21:30:00
111,4,0,4,0.003222581300146324,2019-03-23 21:15:00,2019-03-23 21:30:00
112,4,1,3,0.0044968230107156615,2019-03-23 21:15:00,2019-03-23 21:30:00
114,4,2,2,0.004882771892510876,2019-03-23 21:15:00,2019-03-23 21:30:00
115,4,3,1,0.008440810216834686,2019-03-23 21:15:00,2019-03-23 21:30:00
116,3,0,3,0.003222581300146324,2019-03-23 21:15:00,2019-03-23 21:30:00
118,4,2,2,0.008672513665340317,2019-03-23 21:15:00,2019-03-23 21:30:00
119,7,3,4,0.005831695758490504,2019-03-23 21:15:00,2019-03-23 21:30:00
122,5,2,3,0.007438108562147916,2019-03-23 21:15:00,2019-03-23 21:30:00
126,3,1,2,0.005604991492537093,2019-03-23 21:15:00,2019-03-23 21:30:00
127,2,0,2,0.003222581300146324,2019-03-23 21:15:00,2019-03-23 21:30:00
133,1,1,0,0.008417865318115152,2019-03-23 21:15:00,2019-03-23 21:30:00
137,7,3,4,0.00719326495413094,2019-03-23 21:15:00,2019-03-23 21:30:00
138,3,2,1,0.00610604959551977,2019-03-23 21:15:00,2019-03-23 21:30:00
153,4,4,0,0.012100133077213679,2019-03-23 21:15:00,2019-03-23 21:30:00
157,1,1,0,0.00475134430984329,2019-03-23 21:15:00,2019-03-23 21:30:00
158,1,1,0,0.00475134430984329,2019-03-23 21:15:00,2019-03-23 21:30:00
159,2,2,0,0.005962054203918371,2019-03-23 21:15:00,2019-03-23 21:30:00
162,2,2,0,0.005048896569327689,2019-03-23 21:15:00,2019-03-23 21:30:00
164,9,1,8,0.007811509326879175,2019-03-23 21:15:00,2019-03-23 21:30:00
168,2,0,2,0.003222581300146324,2019-03-23 21:15:00,2019-03-23 21:30:00
169,2,2,0,0.012505896079040329,2019-03-23 21:15:00,2019-03-23 21:30:00
170,2,0,2,0.003222581300146324,2019-03-23 21:15:00,2019-03-23 21:30:00
171,2,1,1,0.004912019077826946,2019-03-23 21:15:00,2019-03-23 21:30:00
172,1,1,0,0.004592317752032348,2019-03-23 21:15:00,2019-03-23 21:30:00
173,2,2,0,0.005962054203918371,2019-03-23 21:15:00,2019-03-23 21:30:00
175,2,1,1,0.02143024508313347,2019-03-23 21:15:00,2019-03-23 21:30:00
189,1,1,0,0.005604991492537093,2019-03-23 21:15:00,2019-03-23 21:30:00
197,7,3,4,0.006796196588732478,2019-03-23 21:15:00,2019-03-23 21:30:00
201,2,2,0,0.008290894633188193,2019-03-23 21:15:00,2019-03-23 21:30:00
203,6,5,1,0.05877025287509257,2019-03-23 21:15:00,2019-03-23 21:30:00
2,1,1,0,0.005055009436941265,2019-03-23 21:30:00,2019-03-23 21:45:00
5,1,1,0,0.008445503700654914,2019-03-23 21:30:00,2019-03-23 21:45:00
15,6,6,0,0.013131445316247404,2019-03-23 21:30:00,2019-03-23 21:45:00
16,4,1,3,0.006135609379522974,2019-03-23 21:30:00,2019-03-23 21:45:00
20,1,0,1,0.0033163850983154533,2019-03-23 21:30:00,2019-03-23 21:45:00
23,4,2,2,0.022056502336598963,2019-03-23 21:30:00,2019-03-23 21:45:00
28,4,4,0,0.007731878888819906,2019-03-23 21:30:00,2019-03-23 21:45:00
35,2,1,1,0.022056502336598963,2019-03-23 21:30:00,2019-03-23 21:45:00
40,2,1,1,0.022056502336598963,2019-03-23 21:30:00,2019-03-23 21:45:00
46,5,1,4,0.0042114099494935334,2019-03-23 21:30:00,2019-03-23 21:45:00
50,1,1,0,0.00401855045195171,2019-03-23 21:30:00,2019-03-23 21:45:00
57,1,1,0,0.006690260907514332,2019-03-23 21:30:00,2019-03-23 21:45:00
58,4,4,0,0.0067356032032983675,2019-03-23 21:30:00,2019-03-23 21:45:00
61,3,2,1,0.0072504054833998095,2019-03-23 21:30:00,2019-03-23 21:45:00
62,1,1,0,0.004627725226676906,2019-03-23 21:30:00,2019-03-23 21:45:00
66,2,1,1,0.006135609379522974,2019-03-23 21:30:00,2019-03-23 21:45:00
67,2,0,2,0.0033163850983154533,2019-03-23 21:30:00,2019-03-23 21:45:00
68,2,1,1,0.008532258114192889,2019-03-23 21:30:00,2019-03-23 21:45:00
69,8,4,4,0.010671718301461573,2019-03-23 21:30:00,2019-03-23 21:45:00
75,2,1,1,0.022056502336598963,2019-03-23 21:30:00,2019-03-23 21:45:00
85,1,1,0,0.006690260907514332,2019-03-23 21:30:00,2019-03-23 21:45:00
87,4,1,3,0.004627725226676906,2019-03-23 21:30:00,2019-03-23 21:45:00
89,3,0,3,0.0033163850983154533,2019-03-23 21:30:00,2019-03-23 21:45:00
90,4,2,2,0.012061272426499278,2019-03-23 21:30:00,2019-03-23 21:45:00
108,2,2,0,0.007852494020254052,2019-03-23 21:30:00,2019-03-23 21:45:00
109,13,4,9,0.013897338642612864,2019-03-23 21:30:00,2019-03-23 21:45:00
110,1,0,1,0.0033163850983154533,2019-03-23 21:30:00,2019-03-23 21:45:00
111,4,2,2,0.004720715805587966,2019-03-23 21:30:00,2019-03-23 21:45:00
112,2,0,2,0.0033163850983154533,2019-03-23 21:30:00,2019-03-23 21:45:00
114,4,2,2,0.004720715805587966,2019-03-23 21:30:00,2019-03-23 21:45:00
115,2,1,1,0.004256126525384627,2019-03-23 21:30:00,2019-03-23 21:45:00
116,3,0,3,0.0033163850983154533,2019-03-23 21:30:00,2019-03-23 21:45:00
118,2,2,0,0.016196737599747137,2019-03-23 21:30:00,2019-03-23 21:45:00
119,3,1,2,0.005768162832697493,2019-03-23 21:30:00,2019-03-23 21:45:00
122,4,2,2,0.022056502336598963,2019-03-23 21:30:00,2019-03-23 21:45:00
126,4,1,3,0.004627725226676906,2019-03-23 21:30:00,2019-03-23 21:45:00
127,3,1,2,0.004627725226676906,2019-03-23 21:30:00,2019-03-23 21:45:00
133,1,1,0,0.0042114099494935334,2019-03-23 21:30:00,2019-03-23 21:45:00
137,7,3,4,0.007402681322285519,2019-03-23 21:30:00,2019-03-23 21:45:00
153,4,3,1,0.006033437849662111,2019-03-23 21:30:00,2019-03-23 21:45:00
159,2,2,0,0.006135609379522974,2019-03-23 21:30:00,2019-03-23 21:45:00
162,2,2,0,0.005195867952453801,2019-03-23 21:30:00,2019-03-23 21:45:00
164,15,4,11,0.00908562015193925,2019-03-23 21:30:00,2019-03-23 21:45:00
168,3,1,2,0.006135609379522974,2019-03-23 21:30:00,2019-03-23 21:45:00
170,2,0,2,0.0033163850983154533,2019-03-23 21:30:00,2019-03-23 21:45:00
171,4,3,1,0.013493099595473358,2019-03-23 21:30:00,2019-03-23 21:45:00
172,1,1,0,0.004725997238919213,2019-03-23 21:30:00,2019-03-23 21:45:00
175,2,1,1,0.022056502336598963,2019-03-23 21:30:00,2019-03-23 21:45:00
197,8,6,2,0.06153436518960707,2019-03-23 21:30:00,2019-03-23 21:45:00
201,1,1,0,0.008443165233735119,2019-03-23 21:30:00,2019-03-23 21:45:00
202,1,0,1,0.0033163850983154533,2019-03-23 21:30:00,2019-03-23 21:45:00
203,6,3,3,0.011906133923391767,2019-03-23 21:30:00,2019-03-23 21:45:00
1,1,0,1,0.0031323912562298667,2019-03-23 21:45:00,2019-03-23 22:00:00
2,1,1,0,0.004838998997644549,2019-03-23 21:45:00,2019-03-23 22:00:00
5,7,4,3,0.014263298467829078,2019-03-23 21:45:00,2019-03-23 22:00:00
10,1,1,0,0.013243803574177123,2019-03-23 21:45:00,2019-03-23 22:00:00
15,8,6,2,0.011435862491700923,2019-03-23 21:45:00,2019-03-23 22:00:00
16,10,5,5,0.01003781009208477,2019-03-23 21:45:00,2019-03-23 22:00:00
19,1,1,0,0.004838998997644549,2019-03-23 21:45:00,2019-03-23 22:00:00
20,3,1,2,0.0071742817332908024,2019-03-23 21:45:00,2019-03-23 22:00:00
28,4,4,0,0.007139824955687482,2019-03-23 21:45:00,2019-03-23 22:00:00
37,5,1,4,0.003977739503544436,2019-03-23 21:45:00,2019-03-23 22:00:00
40,2,1,1,0.020822065584181655,2019-03-23 21:45:00,2019-03-23 22:00:00
41,4,3,1,0.01189416942167798,2019-03-23 21:45:00,2019-03-23 22:00:00
46,2,0,2,0.0031323912562298667,2019-03-23 21:45:00,2019-03-23 22:00:00
50,1,1,0,0.0036644468755577253,2019-03-23 21:45:00,2019-03-23 22:00:00
57,3,2,1,0.04196875235101039,2019-03-23 21:45:00,2019-03-23 22:00:00
58,4,4,0,0.005400891787693995,2019-03-23 21:45:00,2019-03-23 22:00:00
61,1,0,1,0.0031323912562298667,2019-03-23 21:45:00,2019-03-23 22:00:00
62,1,1,0,0.008211079357027999,2019-03-23 21:45:00,2019-03-23 22:00:00
67,3,2,1,0.014632345480774007,2019-03-23 21:45:00,2019-03-23 22:00:00
68,1,0,1,0.0031323912562298667,2019-03-23 21:45:00,2019-03-23 22:00:00
69,7,3,4,0.02445428523166232,2019-03-23 21:45:00,2019-03-23 22:00:00
79,1,1,0,0.005289862607332424,2019-03-23 21:45:00,2019-03-23 22:00:00
85,1,1,0,0.006318916797901015,2019-03-23 21:45:00,2019-03-23 22:00:00
87,4,1,3,0.004370943729706092,2019-03-23 21:45:00,2019-03-23 22:00:00
88,1,0,1,0.0031323912562298667,2019-03-23 21:45:00,2019-03-23 22:00:00
89,3,0,3,0.0031323912562298667,2019-03-23 21:45:00,2019-03-23 22:00:00
90,3,3,0,0.007139824955687482,2019-03-23 21:45:00,2019-03-23 22:00:00
108,4,2,2,0.01352710306402109,2019-03-23 21:45:00,2019-03-23 22:00:00
109,10,2,8,0.006327213228054238,2019-03-23 21:45:00,2019-03-23 22:00:00
110,1,0,1,0.0031323912562298667,2019-03-23 21:45:00,2019-03-23 22:00:00
111,4,2,2,0.004196502494885584,2019-03-23 21:45:00,2019-03-23 22:00:00
112,3,2,1,0.012853943370690261,2019-03-23 21:45:00,2019-03-23 22:00:00
114,6,3,3,0.007613799248560005,2019-03-23 21:45:00,2019-03-23 22:00:00
115,2,1,1,0.0040199800403953705,2019-03-23 21:45:00,2019-03-23 22:00:00
116,1,0,1,0.0031323912562298667,2019-03-23 21:45:00,2019-03-23 22:00:00
118,1,1,0,0.007429654789446386,2019-03-23 21:45:00,2019-03-23 22:00:00
119,2,0,2,0.0031323912562298667,2019-03-23 21:45:00,2019-03-23 22:00:00
120,1,0,1,0.0031323912562298667,2019-03-23 21:45:00,2019-03-23 22:00:00
122,4,2,2,0.020822065584181655,2019-03-23 21:45:00,2019-03-23 22:00:00
126,5,2,3,0.017922389542671842,2019-03-23 21:45:00,2019-03-23 22:00:00
127,1,1,0,0.008211079357027999,2019-03-23 21:45:00,2019-03-23 22:00:00
137,16,7,9,0.013375745105215858,2019-03-23 21:45:00,2019-03-23 22:00:00
138,4,3,1,0.011423804318191153,2019-03-23 21:45:00,2019-03-23 22:00:00
153,4,2,2,0.004196502494885584,2019-03-23 21:45:00,2019-03-23 22:00:00
159,2,2,0,0.005795157608726379,2019-03-23 21:45:00,2019-03-23 22:00:00
164,17,4,13,0.008136358702012143,2019-03-23 21:45:00,2019-03-23 22:00:00
168,3,1,2,0.005795157608726379,2019-03-23 21:45:00,2019-03-23 22:00:00
170,2,0,2,0.0031323912562298667,2019-03-23 21:45:00,2019-03-23 22:00:00
171,5,3,2,0.010110100310931494,2019-03-23 21:45:00,2019-03-23 22:00:00
172,2,2,0,0.017355779707202923,2019-03-23 21:45:00,2019-03-23 22:00:00
175,2,1,1,0.020822065584181655,2019-03-23 21:45:00,2019-03-23 22:00:00
197,8,6,2,0.04605823448812053,2019-03-23 21:45:00,2019-03-23 22:00:00
199,2,2,0,0.004196502494885584,2019-03-23 21:45:00,2019-03-23 22:00:00
202,1,0,1,0.0031323912562298667,2019-03-23 21:45:00,2019-03-23 22:00:00
203,6,3,3,0.011245274353931254,2019-03-23 21:45:00,2019-03-23 22:00:00
1,2,0,2,0.0031406161004606126,2019-03-23 22:00:00,2019-03-23 22:15:00
2,1,1,0,0.006745108965268013,2019-03-23 22:00:00,2019-03-23 22:15:00
5,5,3,2,0.019886335438020063,2019-03-23 22:00:00,2019-03-23 22:15:00
10,1,1,0,0.0050429104040695255,2019-03-23 22:00:00,2019-03-23 22:15:00
15,4,2,2,0.007145300450088864,2019-03-23 22:00:00,2019-03-23 22:15:00
16,6,4,2,0.008480195233298281,2019-03-23 22:00:00,2019-03-23 22:15:00
19,1,1,0,0.006745108965268013,2019-03-23 22:00:00,2019-03-23 22:15:00
20,2,1,1,0.011594107976720777,2019-03-23 22:00:00,2019-03-23 22:15:00
23,2,1,1,0.020894861687380285,2019-03-23 22:00:00,2019-03-23 22:15:00
37,3,0,3,0.0031406161004606126,2019-03-23 22:00:00,2019-03-23 22:15:00
40,2,1,1,0.020894861687380285,2019-03-23 22:00:00,2019-03-23 22:15:00
41,3,1,2,0.00447551088367003,2019-03-23 22:00:00,2019-03-23 22:15:00
46,1,0,1,0.0031406161004606126,2019-03-23 22:00:00,2019-03-23 22:15:00
57,3,2,1,0.0363272998424079,2019-03-23 22:00:00,2019-03-23 22:15:00
58,4,4,0,0.0051793079032423596,2019-03-23 22:00:00,2019-03-23 22:15:00
61,1,0,1,0.0031406161004606126,2019-03-23 22:00:00,2019-03-23 22:15:00
62,1,1,0,0.005438139995078216,2019-03-23 22:00:00,2019-03-23 22:15:00
67,5,4,1,0.010784311325005848,2019-03-23 22:00:00,2019-03-23 22:15:00
68,1,1,0,0.0050429104040695255,2019-03-23 22:00:00,2019-03-23 22:15:00
69,6,4,2,0.05517378583653714,2019-03-23 22:00:00,2019-03-23 22:15:00
79,1,1,0,0.010912689508081965,2019-03-23 22:00:00,2019-03-23 22:15:00
86,1,0,1,0.0031406161004606126,2019-03-23 22:00:00,2019-03-23 22:15:00
87,4,1,3,0.004382444465719722,2019-03-23 22:00:00,2019-03-23 22:15:00
89,1,0,1,0.0031406161004606126,2019-03-23 22:00:00,2019-03-23 22:15:00
90,2,2,0,0.004030545955933558,2019-03-23 22:00:00,2019-03-23 22:15:00
104,1,1,0,0.00447551088367003,2019-03-23 22:00:00,2019-03-23 22:15:00
108,2,0,2,0.0031406161004606126,2019-03-23 22:00:00,2019-03-23 22:15:00
109,6,0,6,0.0031406161004606126,2019-03-23 22:00:00,2019-03-23 22:15:00
111,2,0,2,0.0031406161004606126,2019-03-23 22:00:00,2019-03-23 22:15:00
112,7,3,4,0.011701755618339622,2019-03-23 22:00:00,2019-03-23 22:15:00
114,4,3,1,0.009142488331840946,2019-03-23 22:00:00,2019-03-23 22:15:00
115,2,1,1,0.005810405666879447,2019-03-23 22:00:00,2019-03-23 22:15:00
116,4,3,1,0.007217999706024106,2019-03-23 22:00:00,2019-03-23 22:15:00
118,1,1,0,0.00808000374847743,2019-03-23 22:00:00,2019-03-23 22:15:00
119,1,0,1,0.0031406161004606126,2019-03-23 22:00:00,2019-03-23 22:15:00
122,4,2,2,0.020894861687380285,2019-03-23 22:00:00,2019-03-23 22:15:00
126,5,2,3,0.00810792956149705,2019-03-23 22:00:00,2019-03-23 22:15:00
127,3,0,3,0.0031406161004606126,2019-03-23 22:00:00,2019-03-23 22:15:00
133,1,1,0,0.00546242353235267,2019-03-23 22:00:00,2019-03-23 22:15:00
137,11,6,5,0.024384785848815198,2019-03-23 22:00:00,2019-03-23 22:15:00
138,1,0,1,0.0031406161004606126,2019-03-23 22:00:00,2019-03-23 22:15:00
153,2,2,0,0.004203100683824129,2019-03-23 22:00:00,2019-03-23 22:15:00
158,1,1,0,0.012997747954564466,2019-03-23 22:00:00,2019-03-23 22:15:00
159,2,2,0,0.005810405666879447,2019-03-23 22:00:00,2019-03-23 22:15:00
164,11,2,9,0.005624272830978831,2019-03-23 22:00:00,2019-03-23 22:15:00
168,3,1,2,0.00546242353235267,2019-03-23 22:00:00,2019-03-23 22:15:00
170,2,0,2,0.0031406161004606126,2019-03-23 22:00:00,2019-03-23 22:15:00
171,2,1,1,0.005810405666879447,2019-03-23 22:00:00,2019-03-23 22:15:00
172,1,1,0,0.012308510535837777,2019-03-23 22:00:00,2019-03-23 22:15:00
175,2,1,1,0.020894861687380285,2019-03-23 22:00:00,2019-03-23 22:15:00
197,9,7,2,0.04456718913660652,2019-03-23 22:00:00,2019-03-23 22:15:00
199,2,2,0,0.004203100683824129,2019-03-23 22:00:00,2019-03-23 22:15:00
201,2,0,2,0.0031406161004606126,2019-03-23 22:00:00,2019-03-23 22:15:00
203,3,1,2,0.00546242353235267,2019-03-23 22:00:00,2019-03-23 22:15:00
1,2,0,2,0.0031445479470152684,2019-03-23 22:15:00,2019-03-23 22:30:00
2,1,1,0,0.011498790173168301,2019-03-23 22:15:00,2019-03-23 22:30:00
5,2,2,0,0.007400875960359407,2019-03-23 22:15:00,2019-03-23 22:30:00
15,2,2,0,0.007546891527317407,2019-03-23 22:15:00,2019-03-23 22:30:00
16,5,4,1,0.009827379226911397,2019-03-23 22:15:00,2019-03-23 22:30:00
18,4,2,2,0.006781520415002107,2019-03-23 22:15:00,2019-03-23 22:30:00
19,1,0,1,0.0031445479470152684,2019-03-23 22:15:00,2019-03-23 22:30:00
20,1,0,1,0.0031445479470152684,2019-03-23 22:15:00,2019-03-23 22:30:00
41,2,1,1,0.005272711953687338,2019-03-23 22:15:00,2019-03-23 22:30:00
46,2,0,2,0.0031445479470152684,2019-03-23 22:15:00,2019-03-23 22:30:00
57,4,2,2,0.009512810778413686,2019-03-23 22:15:00,2019-03-23 22:30:00
58,4,4,0,0.006300154698953604,2019-03-23 22:15:00,2019-03-23 22:30:00
61,2,0,2,0.0031445479470152684,2019-03-23 22:15:00,2019-03-23 22:30:00
62,1,1,0,0.008451491875631087,2019-03-23 22:15:00,2019-03-23 22:30:00
67,6,3,3,0.0051493973309841064,2019-03-23 22:15:00,2019-03-23 22:30:00
68,3,2,1,0.008963541300691229,2019-03-23 22:15:00,2019-03-23 22:30:00
69,7,5,2,0.09382684350339347,2019-03-23 22:15:00,2019-03-23 22:30:00
70,2,2,0,0.0060628582311598195,2019-03-23 22:15:00,2019-03-23 22:30:00
86,1,0,1,0.0031445479470152684,2019-03-23 22:15:00,2019-03-23 22:30:00
87,2,1,1,0.020930921440643336,2019-03-23 22:15:00,2019-03-23 22:30:00
89,1,0,1,0.0031445479470152684,2019-03-23 22:15:00,2019-03-23 22:30:00
104,1,1,0,0.004481114202994494,2019-03-23 22:15:00,2019-03-23 22:30:00
109,4,1,3,0.0071777548121388125,2019-03-23 22:15:00,2019-03-23 22:30:00
111,4,2,2,0.007212539348878627,2019-03-23 22:15:00,2019-03-23 22:30:00
112,4,0,4,0.0031445479470152684,2019-03-23 22:15:00,2019-03-23 22:30:00
114,5,5,0,0.014602861738506579,2019-03-23 22:15:00,2019-03-23 22:30:00
115,2,1,1,0.00581768045897372,2019-03-23 22:15:00,2019-03-23 22:30:00
116,4,2,2,0.007100584914405619,2019-03-23 22:15:00,2019-03-23 22:30:00
118,1,1,0,0.006953902401812637,2019-03-23 22:15:00,2019-03-23 22:30:00
119,2,0,2,0.0031445479470152684,2019-03-23 22:15:00,2019-03-23 22:30:00
122,4,2,2,0.020930921440643336,2019-03-23 22:15:00,2019-03-23 22:30:00
126,4,2,2,0.01248469874075463,2019-03-23 22:15:00,2019-03-23 22:30:00
127,3,1,2,0.006162675991795985,2019-03-23 22:15:00,2019-03-23 22:30:00
137,12,6,6,0.015019956210630337,2019-03-23 22:15:00,2019-03-23 22:30:00
138,4,2,2,0.009488495319697612,2019-03-23 22:15:00,2019-03-23 22:30:00
140,1,1,0,0.004380942046424339,2019-03-23 22:15:00,2019-03-23 22:30:00
141,2,0,2,0.0031445479470152684,2019-03-23 22:15:00,2019-03-23 22:30:00
151,1,1,0,0.006453341040425649,2019-03-23 22:15:00,2019-03-23 22:30:00
153,3,2,1,0.0038922886476863722,2019-03-23 22:15:00,2019-03-23 22:30:00
158,5,2,3,0.008118086670981333,2019-03-23 22:15:00,2019-03-23 22:30:00
164,9,1,8,0.0035184182973508203,2019-03-23 22:15:00,2019-03-23 22:30:00
168,2,0,2,0.0031445479470152684,2019-03-23 22:15:00,2019-03-23 22:30:00
171,2,1,1,0.004481114202994494,2019-03-23 22:15:00,2019-03-23 22:30:00
172,1,1,0,0.0046037030890875436,2019-03-23 22:15:00,2019-03-23 22:30:00
175,2,1,1,0.020930921440643336,2019-03-23 22:15:00,2019-03-23 22:30:00
177,3,1,2,0.005469269617738958,2019-03-23 22:15:00,2019-03-23 22:30:00
191,1,1,0,0.004481114202994494,2019-03-23 22:15:00,2019-03-23 22:30:00
197,7,5,2,0.07419312336546785,2019-03-23 22:15:00,2019-03-23 22:30:00
201,6,2,4,0.00581768045897372,2019-03-23 22:15:00,2019-03-23 22:30:00
202,1,1,0,0.004380942046424339,2019-03-23 22:15:00,2019-03-23 22:30:00
203,3,1,2,0.005469269617738958,2019-03-23 22:15:00,2019-03-23 22:30:00
1,1,0,1,0.0031021359252343876,2019-03-23 22:30:00,2019-03-23 22:45:00
2,2,1,1,0.006662417503395515,2019-03-23 22:30:00,2019-03-23 22:45:00
10,1,1,0,0.004420664889747776,2019-03-23 22:30:00,2019-03-23 22:45:00
15,2,1,1,0.0050417165931790405,2019-03-23 22:30:00,2019-03-23 22:45:00
16,5,3,2,0.00837625178328794,2019-03-23 22:30:00,2019-03-23 22:45:00
18,1,1,0,0.00432873478182543,2019-03-23 22:30:00,2019-03-23 22:45:00
19,1,0,1,0.0031021359252343876,2019-03-23 22:30:00,2019-03-23 22:45:00
23,1,1,0,0.005863099054403001,2019-03-23 22:30:00,2019-03-23 22:45:00
41,1,1,0,0.007027104416829298,2019-03-23 22:30:00,2019-03-23 22:45:00
46,4,1,3,0.00432873478182543,2019-03-23 22:30:00,2019-03-23 22:45:00
57,4,2,2,0.016668110331255936,2019-03-23 22:30:00,2019-03-23 22:45:00
58,2,2,0,0.007340219487379675,2019-03-23 22:30:00,2019-03-23 22:45:00
61,1,0,1,0.0031021359252343876,2019-03-23 22:30:00,2019-03-23 22:45:00
62,1,1,0,0.005395460515561572,2019-03-23 22:30:00,2019-03-23 22:45:00
67,1,0,1,0.0031021359252343876,2019-03-23 22:30:00,2019-03-23 22:45:00
68,2,1,1,0.005863099054403001,2019-03-23 22:30:00,2019-03-23 22:45:00
69,4,3,1,0.07127801333825405,2019-03-23 22:30:00,2019-03-23 22:45:00
86,1,1,0,0.005739193854261164,2019-03-23 22:30:00,2019-03-23 22:45:00
87,2,1,1,0.02064549284732367,2019-03-23 22:30:00,2019-03-23 22:45:00
89,1,0,1,0.0031021359252343876,2019-03-23 22:30:00,2019-03-23 22:45:00
109,4,1,3,0.010625836391640003,2019-03-23 22:30:00,2019-03-23 22:45:00
110,1,1,0,0.007027104416829298,2019-03-23 22:30:00,2019-03-23 22:45:00
111,6,2,4,0.009125105336342879,2019-03-23 22:30:00,2019-03-23 22:45:00
112,1,0,1,0.0031021359252343876,2019-03-23 22:30:00,2019-03-23 22:45:00
114,4,2,2,0.004420664889747776,2019-03-23 22:30:00,2019-03-23 22:45:00
115,1,1,0,0.005739193854261164,2019-03-23 22:30:00,2019-03-23 22:45:00
116,2,1,1,0.005739193854261164,2019-03-23 22:30:00,2019-03-23 22:45:00
118,1,1,0,0.007980946467908904,2019-03-23 22:30:00,2019-03-23 22:45:00
119,6,3,3,0.009742260390292306,2019-03-23 22:30:00,2019-03-23 22:45:00
122,4,2,2,0.02064549284732367,2019-03-23 22:30:00,2019-03-23 22:45:00
126,3,1,2,0.005395460515561572,2019-03-23 22:30:00,2019-03-23 22:45:00
127,1,0,1,0.0031021359252343876,2019-03-23 22:30:00,2019-03-23 22:45:00
137,8,4,4,0.018467941380125502,2019-03-23 22:30:00,2019-03-23 22:45:00
138,9,5,4,0.03539553364150737,2019-03-23 22:30:00,2019-03-23 22:45:00
140,2,2,0,0.010948638292852322,2019-03-23 22:30:00,2019-03-23 22:45:00
141,2,0,2,0.0031021359252343876,2019-03-23 22:30:00,2019-03-23 22:45:00
151,1,1,0,0.0068600701610850336,2019-03-23 22:30:00,2019-03-23 22:45:00
153,3,2,1,0.004420664889747776,2019-03-23 22:30:00,2019-03-23 22:45:00
154,1,0,1,0.0031021359252343876,2019-03-23 22:30:00,2019-03-23 22:45:00
158,1,0,1,0.0031021359252343876,2019-03-23 22:30:00,2019-03-23 22:45:00
164,4,0,4,0.0031021359252343876,2019-03-23 22:30:00,2019-03-23 22:45:00
168,2,0,2,0.0031021359252343876,2019-03-23 22:30:00,2019-03-23 22:45:00
171,2,1,1,0.005739193854261164,2019-03-23 22:30:00,2019-03-23 22:45:00
172,3,2,1,0.038188849769412954,2019-03-23 22:30:00,2019-03-23 22:45:00
175,2,1,1,0.02064549284732367,2019-03-23 22:30:00,2019-03-23 22:45:00
177,2,0,2,0.0031021359252343876,2019-03-23 22:30:00,2019-03-23 22:45:00
191,1,1,0,0.005739193854261164,2019-03-23 22:30:00,2019-03-23 22:45:00
195,1,0,1,0.0031021359252343876,2019-03-23 22:30:00,2019-03-23 22:45:00
197,6,4,2,0.042272324855773084,2019-03-23 22:30:00,2019-03-23 22:45:00
199,2,2,0,0.0068600701610850336,2019-03-23 22:30:00,2019-03-23 22:45:00
201,2,2,0,0.005739193854261164,2019-03-23 22:30:00,2019-03-23 22:45:00
203,4,2,2,0.015246560727058434,2019-03-23 22:30:00,2019-03-23 22:45:00
2,1,0,1,0.003087780074956928,2019-03-23 22:45:00,2019-03-23 23:00:00
10,4,2,2,0.034246785473535296,2019-03-23 22:45:00,2019-03-23 23:00:00
15,6,2,4,0.004754463730154375,2019-03-23 22:45:00,2019-03-23 23:00:00
16,3,2,1,0.005712696647690122,2019-03-23 22:45:00,2019-03-23 23:00:00
18,2,1,1,0.008119881958269962,2019-03-23 22:45:00,2019-03-23 23:00:00
19,1,1,0,0.005712696647690122,2019-03-23 22:45:00,2019-03-23 23:00:00
23,4,2,2,0.008684424893681037,2019-03-23 22:45:00,2019-03-23 23:00:00
41,4,3,1,0.03511714347113543,2019-03-23 22:45:00,2019-03-23 23:00:00
46,1,0,1,0.003087780074956928,2019-03-23 22:45:00,2019-03-23 23:00:00
57,3,2,1,0.048638649083247706,2019-03-23 22:45:00,2019-03-23 23:00:00
58,2,2,0,0.009957261432374954,2019-03-23 22:45:00,2019-03-23 23:00:00
61,1,0,1,0.003087780074956928,2019-03-23 22:45:00,2019-03-23 23:00:00
62,1,1,0,0.0053706170696287536,2019-03-23 22:45:00,2019-03-23 23:00:00
67,1,0,1,0.003087780074956928,2019-03-23 22:45:00,2019-03-23 23:00:00
69,5,4,1,0.05146496096422564,2019-03-23 22:45:00,2019-03-23 23:00:00
71,1,1,0,0.005712696647690122,2019-03-23 22:45:00,2019-03-23 23:00:00
86,1,1,0,0.005712696647690122,2019-03-23 22:45:00,2019-03-23 23:00:00
87,2,1,1,0.020554240072392344,2019-03-23 22:45:00,2019-03-23 23:00:00
88,1,1,0,0.00450343170906637,2019-03-23 22:45:00,2019-03-23 23:00:00
89,2,1,1,0.004992928366570323,2019-03-23 22:45:00,2019-03-23 23:00:00
108,1,0,1,0.003087780074956928,2019-03-23 22:45:00,2019-03-23 23:00:00
109,2,1,1,0.004992928366570323,2019-03-23 22:45:00,2019-03-23 23:00:00
110,1,1,0,0.0060245834793528005,2019-03-23 22:45:00,2019-03-23 23:00:00
111,4,0,4,0.003087780074956928,2019-03-23 22:45:00,2019-03-23 23:00:00
112,1,0,1,0.003087780074956928,2019-03-23 22:45:00,2019-03-23 23:00:00
114,3,2,1,0.005919083343175814,2019-03-23 22:45:00,2019-03-23 23:00:00
115,1,1,0,0.00733234485964176,2019-03-23 22:45:00,2019-03-23 23:00:00
116,2,1,1,0.005712696647690122,2019-03-23 22:45:00,2019-03-23 23:00:00
118,1,1,0,0.007944199083401576,2019-03-23 22:45:00,2019-03-23 23:00:00
119,2,2,0,0.004400238361323525,2019-03-23 22:45:00,2019-03-23 23:00:00
122,4,2,2,0.020554240072392344,2019-03-23 22:45:00,2019-03-23 23:00:00
126,3,1,2,0.0053706170696287536,2019-03-23 22:45:00,2019-03-23 23:00:00
127,1,0,1,0.003087780074956928,2019-03-23 22:45:00,2019-03-23 23:00:00
137,7,3,4,0.013817805892193322,2019-03-23 22:45:00,2019-03-23 23:00:00
138,5,2,3,0.006723151159704271,2019-03-23 22:45:00,2019-03-23 23:00:00
140,1,1,0,0.007944199083401576,2019-03-23 22:45:00,2019-03-23 23:00:00
141,1,0,1,0.003087780074956928,2019-03-23 22:45:00,2019-03-23 23:00:00
151,1,1,0,0.008119881958269962,2019-03-23 22:45:00,2019-03-23 23:00:00
153,3,2,1,0.005919083343175814,2019-03-23 22:45:00,2019-03-23 23:00:00
154,1,0,1,0.003087780074956928,2019-03-23 22:45:00,2019-03-23 23:00:00
158,1,1,0,0.006779276602067641,2019-03-23 22:45:00,2019-03-23 23:00:00
164,7,1,6,0.009990922141446206,2019-03-23 22:45:00,2019-03-23 23:00:00
168,2,0,2,0.003087780074956928,2019-03-23 22:45:00,2019-03-23 23:00:00
170,1,1,0,0.00450343170906637,2019-03-23 22:45:00,2019-03-23 23:00:00
171,2,1,1,0.005712696647690122,2019-03-23 22:45:00,2019-03-23 23:00:00
172,1,1,0,0.005712696647690122,2019-03-23 22:45:00,2019-03-23 23:00:00
175,2,1,1,0.020554240072392344,2019-03-23 22:45:00,2019-03-23 23:00:00
177,2,0,2,0.003087780074956928,2019-03-23 22:45:00,2019-03-23 23:00:00
189,2,1,1,0.020554240072392344,2019-03-23 22:45:00,2019-03-23 23:00:00
195,1,0,1,0.003087780074956928,2019-03-23 22:45:00,2019-03-23 23:00:00
197,6,4,2,0.03365408507046891,2019-03-23 22:45:00,2019-03-23 23:00:00
203,4,2,2,0.009936291058972405,2019-03-23 22:45:00,2019-03-23 23:00:00
1,1,1,0,0.008605843747472015,2019-03-23 23:00:00,2019-03-23 23:15:00
10,2,0,2,0.0033449069126466236,2019-03-23 23:00:00,2019-03-23 23:15:00
15,4,1,3,0.004766676592312879,2019-03-23 23:00:00,2019-03-23 23:15:00
16,1,0,1,0.0033449069126466236,2019-03-23 23:00:00,2019-03-23 23:15:00
18,2,2,0,0.006188446271979136,2019-03-23 23:00:00,2019-03-23 23:15:00
19,1,1,0,0.006188446271979136,2019-03-23 23:00:00,2019-03-23 23:15:00
20,1,1,0,0.004766676592312879,2019-03-23 23:00:00,2019-03-23 23:15:00
23,2,0,2,0.0033449069126466236,2019-03-23 23:00:00,2019-03-23 23:15:00
40,1,1,0,0.004766676592312879,2019-03-23 23:00:00,2019-03-23 23:15:00
41,3,2,1,0.006188446271979136,2019-03-23 23:00:00,2019-03-23 23:15:00
57,3,2,1,0.03869269532517544,2019-03-23 23:00:00,2019-03-23 23:15:00
58,1,1,0,0.007096594206907001,2019-03-23 23:00:00,2019-03-23 23:15:00
61,1,0,1,0.0033449069126466236,2019-03-23 23:00:00,2019-03-23 23:15:00
62,1,1,0,0.005817908077887712,2019-03-23 23:00:00,2019-03-23 23:15:00
64,2,1,1,0.02225530170153158,2019-03-23 23:00:00,2019-03-23 23:15:00
67,3,2,1,0.005481329941268416,2019-03-23 23:00:00,2019-03-23 23:15:00
69,4,3,1,0.04021785003730569,2019-03-23 23:00:00,2019-03-23 23:15:00
71,1,1,0,0.006188446271979136,2019-03-23 23:00:00,2019-03-23 23:15:00
87,2,1,1,0.02225530170153158,2019-03-23 23:00:00,2019-03-23 23:15:00
88,3,3,0,0.006700685839615009,2019-03-23 23:00:00,2019-03-23 23:15:00
89,3,2,1,0.005632474325304114,2019-03-23 23:00:00,2019-03-23 23:15:00
90,2,0,2,0.0033449069126466236,2019-03-23 23:00:00,2019-03-23 23:15:00
104,2,1,1,0.02225530170153158,2019-03-23 23:00:00,2019-03-23 23:15:00
108,1,0,1,0.0033449069126466236,2019-03-23 23:00:00,2019-03-23 23:15:00
109,2,1,1,0.00441311842695752,2019-03-23 23:00:00,2019-03-23 23:15:00
110,1,1,0,0.004766676592312879,2019-03-23 23:00:00,2019-03-23 23:15:00
111,2,0,2,0.0033449069126466236,2019-03-23 23:00:00,2019-03-23 23:15:00
114,2,2,0,0.00578361870933981,2019-03-23 23:00:00,2019-03-23 23:15:00
115,1,1,0,0.008133252272433607,2019-03-23 23:00:00,2019-03-23 23:15:00
116,3,2,1,0.007610215951645391,2019-03-23 23:00:00,2019-03-23 23:15:00
118,1,1,0,0.008605843747472015,2019-03-23 23:00:00,2019-03-23 23:15:00
122,4,2,2,0.02225530170153158,2019-03-23 23:00:00,2019-03-23 23:15:00
126,3,1,2,0.005817908077887712,2019-03-23 23:00:00,2019-03-23 23:15:00
127,1,0,1,0.0033449069126466236,2019-03-23 23:00:00,2019-03-23 23:15:00
135,1,1,0,0.006188446271979136,2019-03-23 23:00:00,2019-03-23 23:15:00
137,5,3,2,0.06526597963474519,2019-03-23 23:00:00,2019-03-23 23:15:00
138,9,3,6,0.007539192304338787,2019-03-23 23:00:00,2019-03-23 23:15:00
140,2,1,1,0.006188446271979136,2019-03-23 23:00:00,2019-03-23 23:15:00
141,2,0,2,0.0033449069126466236,2019-03-23 23:00:00,2019-03-23 23:15:00
153,2,2,0,0.00578361870933981,2019-03-23 23:00:00,2019-03-23 23:15:00
154,1,0,1,0.0033449069126466236,2019-03-23 23:00:00,2019-03-23 23:15:00
158,1,1,0,0.004766676592312879,2019-03-23 23:00:00,2019-03-23 23:15:00
164,7,1,6,0.008605843747472015,2019-03-23 23:00:00,2019-03-23 23:15:00
168,1,0,1,0.0033449069126466236,2019-03-23 23:00:00,2019-03-23 23:15:00
171,2,1,1,0.006188446271979136,2019-03-23 23:00:00,2019-03-23 23:15:00
172,1,1,0,0.008004742141834869,2019-03-23 23:00:00,2019-03-23 23:15:00
173,2,0,2,0.0033449069126466236,2019-03-23 23:00:00,2019-03-23 23:15:00
175,2,1,1,0.02225530170153158,2019-03-23 23:00:00,2019-03-23 23:15:00
203,3,1,2,0.005817908077887712,2019-03-23 23:00:00,2019-03-23 23:15:00
1,1,1,0,0.013759452683168215,2019-03-23 23:15:00,2019-03-23 23:30:00
2,2,1,1,0.02074487593706393,2019-03-23 23:15:00,2019-03-23 23:30:00
15,1,1,0,0.009638361324433931,2019-03-23 23:15:00,2019-03-23 23:30:00
18,5,3,2,0.011064088487719679,2019-03-23 23:15:00,2019-03-23 23:30:00
19,2,1,1,0.005763545535531073,2019-03-23 23:15:00,2019-03-23 23:30:00
20,1,1,0,0.004439421885134617,2019-03-23 23:15:00,2019-03-23 23:30:00
40,1,0,1,0.0031152982347381624,2019-03-23 23:15:00,2019-03-23 23:30:00
41,3,2,1,0.012520869814907827,2019-03-23 23:15:00,2019-03-23 23:30:00
57,3,2,1,0.03607138679076733,2019-03-23 23:15:00,2019-03-23 23:30:00
58,1,1,0,0.004439421885134617,2019-03-23 23:15:00,2019-03-23 23:30:00
61,1,0,1,0.0031152982347381624,2019-03-23 23:15:00,2019-03-23 23:30:00
62,1,1,0,0.005418365083360532,2019-03-23 23:15:00,2019-03-23 23:30:00
64,2,1,1,0.02074487593706393,2019-03-23 23:15:00,2019-03-23 23:30:00
67,3,2,1,0.0040587688938446805,2019-03-23 23:15:00,2019-03-23 23:30:00
69,2,1,1,0.02074487593706393,2019-03-23 23:15:00,2019-03-23 23:30:00
71,1,1,0,0.005763545535531073,2019-03-23 23:15:00,2019-03-23 23:30:00
87,2,1,1,0.02074487593706393,2019-03-23 23:15:00,2019-03-23 23:30:00
88,3,3,0,0.005382892544241135,2019-03-23 23:15:00,2019-03-23 23:30:00
89,4,3,1,0.005691941551197758,2019-03-23 23:15:00,2019-03-23 23:30:00
90,3,1,2,0.003587033564291421,2019-03-23 23:15:00,2019-03-23 23:30:00
104,2,1,1,0.02074487593706393,2019-03-23 23:15:00,2019-03-23 23:30:00
108,1,0,1,0.0031152982347381624,2019-03-23 23:15:00,2019-03-23 23:30:00
109,2,0,2,0.0031152982347381624,2019-03-23 23:15:00,2019-03-23 23:30:00
110,1,1,0,0.005763545535531073,2019-03-23 23:15:00,2019-03-23 23:30:00
111,3,2,1,0.007673248812411939,2019-03-23 23:15:00,2019-03-23 23:30:00
112,2,0,2,0.0031152982347381624,2019-03-23 23:15:00,2019-03-23 23:30:00
114,2,2,0,0.006381643549444318,2019-03-23 23:15:00,2019-03-23 23:30:00
115,1,1,0,0.007953971832724366,2019-03-23 23:15:00,2019-03-23 23:30:00
116,2,1,1,0.005763545535531073,2019-03-23 23:15:00,2019-03-23 23:30:00
118,3,1,2,0.030296664048602342,2019-03-23 23:15:00,2019-03-23 23:30:00
119,5,2,3,0.00804252082436796,2019-03-23 23:15:00,2019-03-23 23:30:00
122,4,2,2,0.02074487593706393,2019-03-23 23:15:00,2019-03-23 23:30:00
126,3,1,2,0.005418365083360532,2019-03-23 23:15:00,2019-03-23 23:30:00
127,1,0,1,0.0031152982347381624,2019-03-23 23:15:00,2019-03-23 23:30:00
135,1,1,0,0.004439421885134617,2019-03-23 23:15:00,2019-03-23 23:30:00
137,6,4,2,0.062170572892085454,2019-03-23 23:15:00,2019-03-23 23:30:00
138,9,1,8,0.004439421885134617,2019-03-23 23:15:00,2019-03-23 23:30:00
140,1,0,1,0.0031152982347381624,2019-03-23 23:15:00,2019-03-23 23:30:00
141,1,0,1,0.0031152982347381624,2019-03-23 23:15:00,2019-03-23 23:30:00
147,2,2,0,0.005763545535531073,2019-03-23 23:15:00,2019-03-23 23:30:00
154,1,0,1,0.0031152982347381624,2019-03-23 23:15:00,2019-03-23 23:30:00
164,4,1,3,0.005763545535531073,2019-03-23 23:15:00,2019-03-23 23:30:00
168,2,0,2,0.0031152982347381624,2019-03-23 23:15:00,2019-03-23 23:30:00
171,5,4,1,0.03196269589073782,2019-03-23 23:15:00,2019-03-23 23:30:00
172,1,1,0,0.0065655954957898185,2019-03-23 23:15:00,2019-03-23 23:30:00
173,2,0,2,0.0031152982347381624,2019-03-23 23:15:00,2019-03-23 23:30:00
175,2,1,1,0.02074487593706393,2019-03-23 23:15:00,2019-03-23 23:30:00
203,3,1,2,0.005418365083360532,2019-03-23 23:15:00,2019-03-23 23:30:00
2,2,1,1,0.023306889570774994,2019-03-23 23:30:00,2019-03-23 23:45:00
15,3,1,2,0.00901455585226438,2019-03-23 23:30:00,2019-03-23 23:45:00
18,7,1,6,0.006482416809134656,2019-03-23 23:30:00,2019-03-23 23:45:00
19,1,0,1,0.003503831795705079,2019-03-23 23:30:00,2019-03-23 23:45:00
27,1,1,0,0.006482416809134656,2019-03-23 23:30:00,2019-03-23 23:45:00
28,2,2,0,0.007177647833411279,2019-03-23 23:30:00,2019-03-23 23:45:00
35,2,2,0,0.0053407398145581784,2019-03-23 23:30:00,2019-03-23 23:45:00
41,5,4,1,0.0073264631568445635,2019-03-23 23:30:00,2019-03-23 23:45:00
46,3,3,0,0.013004138214307959,2019-03-23 23:30:00,2019-03-23 23:45:00
57,3,2,1,0.0405195631710024,2019-03-23 23:30:00,2019-03-23 23:45:00
58,1,1,0,0.007640555050186756,2019-03-23 23:30:00,2019-03-23 23:45:00
61,1,0,1,0.003503831795705079,2019-03-23 23:30:00,2019-03-23 23:45:00
62,1,1,0,0.006094215970547585,2019-03-23 23:30:00,2019-03-23 23:45:00
67,3,2,1,0.00469526580107691,2019-03-23 23:30:00,2019-03-23 23:45:00
69,2,1,1,0.023306889570774994,2019-03-23 23:30:00,2019-03-23 23:45:00
85,1,1,0,0.004496693466848271,2019-03-23 23:30:00,2019-03-23 23:45:00
87,2,1,1,0.023306889570774994,2019-03-23 23:30:00,2019-03-23 23:45:00
88,1,1,0,0.007640555050186756,2019-03-23 23:30:00,2019-03-23 23:45:00
89,3,2,1,0.00469526580107691,2019-03-23 23:30:00,2019-03-23 23:45:00
90,1,1,0,0.0040995487983909945,2019-03-23 23:30:00,2019-03-23 23:45:00
104,2,1,1,0.023306889570774994,2019-03-23 23:30:00,2019-03-23 23:45:00
106,1,1,0,0.006482416809134656,2019-03-23 23:30:00,2019-03-23 23:45:00
108,1,0,1,0.003503831795705079,2019-03-23 23:30:00,2019-03-23 23:45:00
109,3,1,2,0.009732113966661207,2019-03-23 23:30:00,2019-03-23 23:45:00
110,2,0,2,0.003503831795705079,2019-03-23 23:30:00,2019-03-23 23:45:00
111,3,2,1,0.006482416809134656,2019-03-23 23:30:00,2019-03-23 23:45:00
112,2,0,2,0.003503831795705079,2019-03-23 23:30:00,2019-03-23 23:45:00
114,5,2,3,0.006482416809134656,2019-03-23 23:30:00,2019-03-23 23:45:00
115,1,1,0,0.007495272426386546,2019-03-23 23:30:00,2019-03-23 23:45:00
116,1,1,0,0.006482416809134656,2019-03-23 23:30:00,2019-03-23 23:45:00
118,1,1,0,0.00901455585226438,2019-03-23 23:30:00,2019-03-23 23:45:00
119,2,0,2,0.003503831795705079,2019-03-23 23:30:00,2019-03-23 23:45:00
122,6,4,2,0.035516066416345075,2019-03-23 23:30:00,2019-03-23 23:45:00
126,3,1,2,0.006094215970547585,2019-03-23 23:30:00,2019-03-23 23:45:00
127,1,0,1,0.003503831795705079,2019-03-23 23:30:00,2019-03-23 23:45:00
135,1,1,0,0.006482416809134656,2019-03-23 23:30:00,2019-03-23 23:45:00
137,4,2,2,0.023306889570774994,2019-03-23 23:30:00,2019-03-23 23:45:00
138,5,0,5,0.003503831795705079,2019-03-23 23:30:00,2019-03-23 23:45:00
147,2,2,0,0.006482416809134656,2019-03-23 23:30:00,2019-03-23 23:45:00
154,3,0,3,0.003503831795705079,2019-03-23 23:30:00,2019-03-23 23:45:00
164,2,0,2,0.003503831795705079,2019-03-23 23:30:00,2019-03-23 23:45:00
168,1,0,1,0.003503831795705079,2019-03-23 23:30:00,2019-03-23 23:45:00
171,2,1,1,0.006482416809134656,2019-03-23 23:30:00,2019-03-23 23:45:00
172,3,3,0,0.010473857439816124,2019-03-23 23:30:00,2019-03-23 23:45:00
175,2,1,1,0.023306889570774994,2019-03-23 23:30:00,2019-03-23 23:45:00
190,1,0,1,0.003503831795705079,2019-03-23 23:30:00,2019-03-23 23:45:00
203,3,1,2,0.006094215970547585,2019-03-23 23:30:00,2019-03-23 23:45:00
2,3,2,1,0.040177625287414934,2019-03-23 23:45:00,2019-03-24 00:00:00
15,7,2,5,0.007478391084171312,2019-03-23 23:45:00,2019-03-24 00:00:00
16,1,0,1,0.0032649395383345975,2019-03-23 23:45:00,2019-03-24 00:00:00
18,5,1,4,0.004536425418605592,2019-03-23 23:45:00,2019-03-24 00:00:00
27,1,1,0,0.006040428386802695,2019-03-23 23:45:00,2019-03-24 00:00:00
28,3,2,1,0.006688244268826882,2019-03-23 23:45:00,2019-03-24 00:00:00
30,2,2,0,0.00502721968127152,2019-03-23 23:45:00,2019-03-24 00:00:00
35,2,2,0,0.005193148588004423,2019-03-23 23:45:00,2019-03-24 00:00:00
37,1,1,0,0.005074472112428071,2019-03-23 23:45:00,2019-03-24 00:00:00
41,5,2,3,0.0051152654373133296,2019-03-23 23:45:00,2019-03-24 00:00:00
46,5,3,2,0.00751956366412273,2019-03-23 23:45:00,2019-03-24 00:00:00
57,5,4,1,0.06823325218398349,2019-03-23 23:45:00,2019-03-24 00:00:00
58,2,2,0,0.011008625020018654,2019-03-23 23:45:00,2019-03-24 00:00:00
61,2,1,1,0.008950649723990883,2019-03-23 23:45:00,2019-03-24 00:00:00
62,1,1,0,0.005678683174987576,2019-03-23 23:45:00,2019-03-24 00:00:00
67,1,0,1,0.0032649395383345975,2019-03-23 23:45:00,2019-03-24 00:00:00
69,3,2,1,0.027579683347232,2019-03-23 23:45:00,2019-03-24 00:00:00
85,1,1,0,0.004190102487823964,2019-03-23 23:45:00,2019-03-24 00:00:00
87,2,1,1,0.021721282412874767,2019-03-23 23:45:00,2019-03-24 00:00:00
88,1,1,0,0.01032179178084177,2019-03-23 23:45:00,2019-03-24 00:00:00
89,5,4,1,0.010503069834708494,2019-03-23 23:45:00,2019-03-24 00:00:00
90,4,1,3,0.00455593653304628,2019-03-23 23:45:00,2019-03-24 00:00:00
104,5,1,4,0.004146079609803059,2019-03-23 23:45:00,2019-03-24 00:00:00
109,4,3,1,0.007613407218316248,2019-03-23 23:45:00,2019-03-24 00:00:00
110,4,2,2,0.006140864933071831,2019-03-23 23:45:00,2019-03-24 00:00:00
111,4,1,3,0.005074472112428071,2019-03-23 23:45:00,2019-03-24 00:00:00
114,5,2,3,0.006040428386802695,2019-03-23 23:45:00,2019-03-24 00:00:00
115,1,1,0,0.012194025361353708,2019-03-23 23:45:00,2019-03-24 00:00:00
116,2,1,1,0.008301091761309413,2019-03-23 23:45:00,2019-03-24 00:00:00
118,1,1,0,0.01250920940568239,2019-03-23 23:45:00,2019-03-24 00:00:00
122,6,4,2,0.034539114362412714,2019-03-23 23:45:00,2019-03-24 00:00:00
126,3,1,2,0.005678683174987576,2019-03-23 23:45:00,2019-03-24 00:00:00
127,3,2,1,0.005924169842839641,2019-03-23 23:45:00,2019-03-24 00:00:00
137,15,6,9,0.01915674616736852,2019-03-23 23:45:00,2019-03-24 00:00:00
138,2,0,2,0.0032649395383345975,2019-03-23 23:45:00,2019-03-24 00:00:00
154,3,0,3,0.0032649395383345975,2019-03-23 23:45:00,2019-03-24 00:00:00
158,3,2,1,0.005846933527757963,2019-03-23 23:45:00,2019-03-24 00:00:00
164,2,0,2,0.0032649395383345975,2019-03-23 23:45:00,2019-03-24 00:00:00
168,3,1,2,0.006461168547737245,2019-03-23 23:45:00,2019-03-24 00:00:00
171,2,1,1,0.010874014823414921,2019-03-23 23:45:00,2019-03-24 00:00:00
172,3,3,0,0.011260861846503885,2019-03-23 23:45:00,2019-03-24 00:00:00
175,2,1,1,0.021721282412874767,2019-03-23 23:45:00,2019-03-24 00:00:00
190,1,0,1,0.0032649395383345975,2019-03-23 23:45:00,2019-03-24 00:00:00
202,1,0,1,0.0032649395383345975,2019-03-23 23:45:00,2019-03-24 00:00:00
203,3,1,2,0.005678683174987576,2019-03-23 23:45:00,2019-03-24 00:00:00
1,1,1,0,0.0058722091395329275,2019-03-24 00:00:00,2019-03-24 00:15:00
2,3,2,1,0.0415589536379303,2019-03-24 00:00:00,2019-03-24 00:15:00
15,6,2,4,0.009116345936858032,2019-03-24 00:00:00,2019-03-24 00:15:00
16,1,0,1,0.003376197291329017,2019-03-24 00:00:00,2019-03-24 00:15:00
18,3,1,2,0.005313658527859982,2019-03-24 00:00:00,2019-03-24 00:15:00
30,2,2,0,0.005198536049238307,2019-03-24 00:00:00,2019-03-24 00:15:00
37,1,1,0,0.004021214247360492,2019-03-24 00:00:00,2019-03-24 00:15:00
41,3,0,3,0.003376197291329017,2019-03-24 00:00:00,2019-03-24 00:15:00
46,2,0,2,0.003376197291329017,2019-03-24 00:00:00,2019-03-24 00:15:00
57,5,4,1,0.06256126780317754,2019-03-24 00:00:00,2019-03-24 00:15:00
58,3,3,0,0.010866054474330738,2019-03-24 00:00:00,2019-03-24 00:15:00
61,1,0,1,0.003376197291329017,2019-03-24 00:00:00,2019-03-24 00:15:00
67,1,0,1,0.003376197291329017,2019-03-24 00:00:00,2019-03-24 00:15:00
69,3,2,1,0.02852764506274499,2019-03-24 00:00:00,2019-03-24 00:15:00
85,2,1,1,0.006246271614093525,2019-03-24 00:00:00,2019-03-24 00:15:00
87,2,1,1,0.022467575464629658,2019-03-24 00:00:00,2019-03-24 00:15:00
88,1,1,0,0.010086447344349925,2019-03-24 00:00:00,2019-03-24 00:15:00
89,1,0,1,0.003376197291329017,2019-03-24 00:00:00,2019-03-24 00:15:00
90,3,3,0,0.006356236810273997,2019-03-24 00:00:00,2019-03-24 00:15:00
104,5,1,4,0.004287366670283662,2019-03-24 00:00:00,2019-03-24 00:15:00
109,17,8,9,0.010516345045101454,2019-03-24 00:00:00,2019-03-24 00:15:00
110,4,2,2,0.006246271614093525,2019-03-24 00:00:00,2019-03-24 00:15:00
111,2,0,2,0.003376197291329017,2019-03-24 00:00:00,2019-03-24 00:15:00
112,1,0,1,0.003376197291329017,2019-03-24 00:00:00,2019-03-24 00:15:00
115,2,2,0,0.01155623124853771,2019-03-24 00:00:00,2019-03-24 00:15:00
116,2,1,1,0.007893363416621484,2019-03-24 00:00:00,2019-03-24 00:15:00
118,2,2,0,0.011556231248537708,2019-03-24 00:00:00,2019-03-24 00:15:00
119,1,1,0,0.004021214247360492,2019-03-24 00:00:00,2019-03-24 00:15:00
122,6,4,2,0.05250498886999256,2019-03-24 00:00:00,2019-03-24 00:15:00
126,3,1,2,0.0058722091395329275,2019-03-24 00:00:00,2019-03-24 00:15:00
127,2,1,1,0.005313658527859982,2019-03-24 00:00:00,2019-03-24 00:15:00
137,10,3,7,0.005311248159423441,2019-03-24 00:00:00,2019-03-24 00:15:00
138,8,2,6,0.004711192440818182,2019-03-24 00:00:00,2019-03-24 00:15:00
151,1,0,1,0.003376197291329017,2019-03-24 00:00:00,2019-03-24 00:15:00
154,1,0,1,0.003376197291329017,2019-03-24 00:00:00,2019-03-24 00:15:00
158,3,2,1,0.005362890303959004,2019-03-24 00:00:00,2019-03-24 00:15:00
168,1,1,0,0.0048112344527112706,2019-03-24 00:00:00,2019-03-24 00:15:00
171,2,1,1,0.006246271614093525,2019-03-24 00:00:00,2019-03-24 00:15:00
172,3,3,0,0.01155623124853771,2019-03-24 00:00:00,2019-03-24 00:15:00
175,2,1,1,0.022467575464629658,2019-03-24 00:00:00,2019-03-24 00:15:00
190,2,2,0,0.006246271614093525,2019-03-24 00:00:00,2019-03-24 00:15:00
191,2,0,2,0.003376197291329017,2019-03-24 00:00:00,2019-03-24 00:15:00
197,3,3,0,0.005378690015562765,2019-03-24 00:00:00,2019-03-24 00:15:00
202,1,0,1,0.003376197291329017,2019-03-24 00:00:00,2019-03-24 00:15:00
203,4,2,2,0.009242164437278193,2019-03-24 00:00:00,2019-03-24 00:15:00
2,2,1,1,0.02232210416773149,2019-03-24 00:15:00,2019-03-24 00:30:00
15,4,1,3,0.006206025348038038,2019-03-24 00:15:00,2019-03-24 00:30:00
18,3,3,0,0.007001812701913339,2019-03-24 00:15:00,2019-03-24 00:30:00
26,1,0,1,0.0033544439224419955,2019-03-24 00:15:00,2019-03-24 00:30:00
37,1,1,0,0.004197446141156124,2019-03-24 00:15:00,2019-03-24 00:30:00
40,1,1,0,0.011916304186873276,2019-03-24 00:15:00,2019-03-24 00:30:00
46,1,0,1,0.0033544439224419955,2019-03-24 00:15:00,2019-03-24 00:30:00
50,2,0,2,0.0033544439224419955,2019-03-24 00:15:00,2019-03-24 00:30:00
57,3,2,1,0.03180593429037624,2019-03-24 00:15:00,2019-03-24 00:30:00
58,8,7,1,0.010071421734988482,2019-03-24 00:15:00,2019-03-24 00:30:00
61,2,1,1,0.008630188740604684,2019-03-24 00:15:00,2019-03-24 00:30:00
67,1,0,1,0.0033544439224419955,2019-03-24 00:15:00,2019-03-24 00:30:00
68,1,0,1,0.0033544439224419955,2019-03-24 00:15:00,2019-03-24 00:30:00
69,3,2,1,0.03880983635097598,2019-03-24 00:15:00,2019-03-24 00:30:00
85,2,1,1,0.003817440383061088,2019-03-24 00:15:00,2019-03-24 00:30:00
87,2,1,1,0.02232210416773149,2019-03-24 00:15:00,2019-03-24 00:30:00
88,2,2,0,0.010364174655372385,2019-03-24 00:15:00,2019-03-24 00:30:00
89,3,0,3,0.0033544439224419955,2019-03-24 00:15:00,2019-03-24 00:30:00
90,4,3,1,0.004743433304299273,2019-03-24 00:15:00,2019-03-24 00:30:00
104,3,1,2,0.005834371984486998,2019-03-24 00:15:00,2019-03-24 00:30:00
109,14,3,11,0.005990975501735601,2019-03-24 00:15:00,2019-03-24 00:30:00
110,3,3,0,0.00609850042488682,2019-03-24 00:15:00,2019-03-24 00:30:00
111,3,0,3,0.0033544439224419955,2019-03-24 00:15:00,2019-03-24 00:30:00
114,4,3,1,0.006206025348038038,2019-03-24 00:15:00,2019-03-24 00:30:00
115,2,2,0,0.0075501597764560625,2019-03-24 00:15:00,2019-03-24 00:30:00
116,2,1,1,0.007701037779735311,2019-03-24 00:15:00,2019-03-24 00:30:00
118,1,1,0,0.012443157103050505,2019-03-24 00:15:00,2019-03-24 00:30:00
119,1,1,0,0.004197446141156124,2019-03-24 00:15:00,2019-03-24 00:30:00
122,6,4,2,0.05758951080184403,2019-03-24 00:15:00,2019-03-24 00:30:00
126,2,1,1,0.02232210416773149,2019-03-24 00:15:00,2019-03-24 00:30:00
127,2,1,1,0.005113025528496224,2019-03-24 00:15:00,2019-03-24 00:30:00
137,11,4,7,0.006941502643600948,2019-03-24 00:15:00,2019-03-24 00:30:00
138,7,2,5,0.007477329064287098,2019-03-24 00:15:00,2019-03-24 00:30:00
151,1,0,1,0.0033544439224419955,2019-03-24 00:15:00,2019-03-24 00:30:00
153,2,2,0,0.006206025348038039,2019-03-24 00:15:00,2019-03-24 00:30:00
158,7,3,4,0.004743433304299273,2019-03-24 00:15:00,2019-03-24 00:30:00
164,3,0,3,0.0033544439224419955,2019-03-24 00:15:00,2019-03-24 00:30:00
168,1,1,0,0.006206025348038038,2019-03-24 00:15:00,2019-03-24 00:30:00
171,2,1,1,0.010691062643129856,2019-03-24 00:15:00,2019-03-24 00:30:00
172,1,1,0,0.006206025348038038,2019-03-24 00:15:00,2019-03-24 00:30:00
173,1,1,0,0.006206025348038038,2019-03-24 00:15:00,2019-03-24 00:30:00
175,2,1,1,0.02232210416773149,2019-03-24 00:15:00,2019-03-24 00:30:00
191,2,0,2,0.0033544439224419955,2019-03-24 00:15:00,2019-03-24 00:30:00
197,3,3,0,0.007168355071189172,2019-03-24 00:15:00,2019-03-24 00:30:00
203,2,1,1,0.02232210416773149,2019-03-24 00:15:00,2019-03-24 00:30:00
2,2,1,1,0.021967725766553637,2019-03-24 00:30:00,2019-03-24 00:45:00
5,1,0,1,0.00330137167513313,2019-03-24 00:30:00,2019-03-24 00:45:00
10,1,1,0,0.004942766939857013,2019-03-24 00:30:00,2019-03-24 00:45:00
15,2,0,2,0.00330137167513313,2019-03-24 00:30:00,2019-03-24 00:45:00
18,2,2,0,0.005265892840203052,2019-03-24 00:30:00,2019-03-24 00:45:00
37,1,1,0,0.004521711097280812,2019-03-24 00:30:00,2019-03-24 00:45:00
50,2,0,2,0.00330137167513313,2019-03-24 00:30:00,2019-03-24 00:45:00
57,5,3,2,0.015504765896609953,2019-03-24 00:30:00,2019-03-24 00:45:00
58,1,1,0,0.0038626634365816793,2019-03-24 00:30:00,2019-03-24 00:45:00
61,2,1,1,0.007897177989830716,2019-03-24 00:30:00,2019-03-24 00:45:00
67,1,0,1,0.00330137167513313,2019-03-24 00:30:00,2019-03-24 00:45:00
68,2,1,1,0.004942766939857013,2019-03-24 00:30:00,2019-03-24 00:45:00
69,2,1,1,0.021967725766553637,2019-03-24 00:30:00,2019-03-24 00:45:00
79,1,0,1,0.00330137167513313,2019-03-24 00:30:00,2019-03-24 00:45:00
85,1,0,1,0.00330137167513313,2019-03-24 00:30:00,2019-03-24 00:45:00
86,2,1,1,0.021967725766553637,2019-03-24 00:30:00,2019-03-24 00:45:00
87,2,1,1,0.021967725766553637,2019-03-24 00:30:00,2019-03-24 00:45:00
88,3,3,0,0.00999871750404674,2019-03-24 00:30:00,2019-03-24 00:45:00
89,1,0,1,0.00330137167513313,2019-03-24 00:30:00,2019-03-24 00:45:00
90,4,2,2,0.004423955198030229,2019-03-24 00:30:00,2019-03-24 00:45:00
104,2,1,1,0.021967725766553637,2019-03-24 00:30:00,2019-03-24 00:45:00
109,5,0,5,0.00330137167513313,2019-03-24 00:30:00,2019-03-24 00:45:00
110,4,3,1,0.006392683635442643,2019-03-24 00:30:00,2019-03-24 00:45:00
111,3,0,3,0.00330137167513313,2019-03-24 00:30:00,2019-03-24 00:45:00
114,4,3,1,0.0054062157805651895,2019-03-24 00:30:00,2019-03-24 00:45:00
115,2,2,0,0.008914289289618623,2019-03-24 00:30:00,2019-03-24 00:45:00
116,1,1,0,0.007300728820679103,2019-03-24 00:30:00,2019-03-24 00:45:00
118,1,1,0,0.01181513600474143,2019-03-24 00:30:00,2019-03-24 00:45:00
122,6,4,2,0.045374845444535204,2019-03-24 00:30:00,2019-03-24 00:45:00
126,2,1,1,0.021967725766553637,2019-03-24 00:30:00,2019-03-24 00:45:00
127,2,1,1,0.004704601078754503,2019-03-24 00:30:00,2019-03-24 00:45:00
137,6,2,4,0.005742050519428495,2019-03-24 00:30:00,2019-03-24 00:45:00
138,13,4,9,0.017376571193420422,2019-03-24 00:30:00,2019-03-24 00:45:00
141,2,1,1,0.021967725766553637,2019-03-24 00:30:00,2019-03-24 00:45:00
153,2,2,0,0.006107830482375877,2019-03-24 00:30:00,2019-03-24 00:45:00
160,1,1,0,0.006107830482375877,2019-03-24 00:30:00,2019-03-24 00:45:00
164,4,0,4,0.00330137167513313,2019-03-24 00:30:00,2019-03-24 00:45:00
170,1,1,0,0.004236857944214046,2019-03-24 00:30:00,2019-03-24 00:45:00
171,2,1,1,0.010014813401631482,2019-03-24 00:30:00,2019-03-24 00:45:00
172,2,2,0,0.00774922574709976,2019-03-24 00:30:00,2019-03-24 00:45:00
173,4,2,2,0.010294251206192219,2019-03-24 00:30:00,2019-03-24 00:45:00
175,2,1,1,0.021967725766553637,2019-03-24 00:30:00,2019-03-24 00:45:00
191,1,0,1,0.00330137167513313,2019-03-24 00:30:00,2019-03-24 00:45:00
197,5,3,2,0.00822555746930478,2019-03-24 00:30:00,2019-03-24 00:45:00
199,2,2,0,0.012052988246765876,2019-03-24 00:30:00,2019-03-24 00:45:00
202,1,1,0,0.005181760414075793,2019-03-24 00:30:00,2019-03-24 00:45:00
203,2,1,1,0.021967725766553637,2019-03-24 00:30:00,2019-03-24 00:45:00
2,4,2,2,0.009779401014706498,2019-03-24 00:45:00,2019-03-24 01:00:00
5,3,1,2,0.005622388828328955,2019-03-24 00:45:00,2019-03-24 01:00:00
10,1,1,0,0.0047463803631281765,2019-03-24 00:45:00,2019-03-24 01:00:00
15,3,0,3,0.003232511701405053,2019-03-24 00:45:00,2019-03-24 01:00:00
16,1,1,0,0.004148503876449486,2019-03-24 00:45:00,2019-03-24 01:00:00
18,3,2,1,0.006412583520088915,2019-03-24 00:45:00,2019-03-24 01:00:00
21,2,1,1,0.02150947455311272,2019-03-24 00:45:00,2019-03-24 01:00:00
37,1,1,0,0.005346964763916887,2019-03-24 00:45:00,2019-03-24 01:00:00
57,4,2,2,0.009779401014706498,2019-03-24 00:45:00,2019-03-24 01:00:00
61,1,0,1,0.003232511701405053,2019-03-24 00:45:00,2019-03-24 01:00:00
67,1,0,1,0.003232511701405053,2019-03-24 00:45:00,2019-03-24 01:00:00
68,1,1,0,0.0047463803631281765,2019-03-24 00:45:00,2019-03-24 01:00:00
69,3,2,1,0.05531542373139475,2019-03-24 00:45:00,2019-03-24 01:00:00
79,1,0,1,0.003232511701405053,2019-03-24 00:45:00,2019-03-24 01:00:00
85,1,0,1,0.003232511701405053,2019-03-24 00:45:00,2019-03-24 01:00:00
86,1,1,0,0.0047463803631281765,2019-03-24 00:45:00,2019-03-24 01:00:00
87,2,1,1,0.02150947455311272,2019-03-24 00:45:00,2019-03-24 01:00:00
88,1,1,0,0.005980488226538353,2019-03-24 00:45:00,2019-03-24 01:00:00
89,1,0,1,0.003232511701405053,2019-03-24 00:45:00,2019-03-24 01:00:00
90,3,2,1,0.00776067098868391,2019-03-24 00:45:00,2019-03-24 01:00:00
104,2,1,1,0.02150947455311272,2019-03-24 00:45:00,2019-03-24 01:00:00
109,5,1,4,0.01065276979179013,2019-03-24 00:45:00,2019-03-24 01:00:00
110,2,2,0,0.009514758345445636,2019-03-24 00:45:00,2019-03-24 01:00:00
111,3,1,2,0.007389523887782596,2019-03-24 00:45:00,2019-03-24 01:00:00
112,2,1,1,0.005980488226538353,2019-03-24 00:45:00,2019-03-24 01:00:00
115,3,2,1,0.008728464751671654,2019-03-24 00:45:00,2019-03-24 01:00:00
116,1,1,0,0.006759201820746984,2019-03-24 00:45:00,2019-03-24 01:00:00
118,1,1,0,0.008316629009164241,2019-03-24 00:45:00,2019-03-24 01:00:00
119,1,0,1,0.003232511701405053,2019-03-24 00:45:00,2019-03-24 01:00:00
122,4,2,2,0.02150947455311272,2019-03-24 00:45:00,2019-03-24 01:00:00
126,3,2,1,0.05774659660325051,2019-03-24 00:45:00,2019-03-24 01:00:00
127,2,1,1,0.004148503876449486,2019-03-24 00:45:00,2019-03-24 01:00:00
137,5,2,3,0.007461417826428722,2019-03-24 00:45:00,2019-03-24 01:00:00
138,7,2,5,0.00890339254950572,2019-03-24 00:45:00,2019-03-24 01:00:00
160,1,1,0,0.005980488226538353,2019-03-24 00:45:00,2019-03-24 01:00:00
164,1,0,1,0.003232511701405053,2019-03-24 00:45:00,2019-03-24 01:00:00
168,1,1,0,0.005496591345044481,2019-03-24 00:45:00,2019-03-24 01:00:00
171,2,1,1,0.005980488226538353,2019-03-24 00:45:00,2019-03-24 01:00:00
172,2,2,0,0.007494356888261477,2019-03-24 00:45:00,2019-03-24 01:00:00
173,2,2,0,0.005980488226538353,2019-03-24 00:45:00,2019-03-24 01:00:00
175,2,1,1,0.02150947455311272,2019-03-24 00:45:00,2019-03-24 01:00:00
189,3,1,2,0.005622388828328955,2019-03-24 00:45:00,2019-03-24 01:00:00
197,2,0,2,0.003232511701405053,2019-03-24 00:45:00,2019-03-24 01:00:00
200,2,1,1,0.02150947455311272,2019-03-24 00:45:00,2019-03-24 01:00:00
202,1,1,0,0.00983019680794036,2019-03-24 00:45:00,2019-03-24 01:00:00
203,2,1,1,0.02150947455311272,2019-03-24 00:45:00,2019-03-24 01:00:00
2,4,1,3,0.004597855198621383,2019-03-24 01:00:00,2019-03-24 01:15:00
15,1,0,1,0.0032264490453546854,2019-03-24 01:00:00,2019-03-24 01:15:00
16,7,1,6,0.0037590477920997623,2019-03-24 01:00:00,2019-03-24 01:15:00
20,2,0,2,0.0032264490453546854,2019-03-24 01:00:00,2019-03-24 01:15:00
21,2,1,1,0.021475030396576507,2019-03-24 01:00:00,2019-03-24 01:15:00
26,1,1,0,0.00763977901855252,2019-03-24 01:00:00,2019-03-24 01:15:00
37,1,1,0,0.0053369244358227414,2019-03-24 01:00:00,2019-03-24 01:15:00
46,2,2,0,0.004291646538844839,2019-03-24 01:00:00,2019-03-24 01:15:00
57,4,3,1,0.03972361174779832,2019-03-24 01:00:00,2019-03-24 01:15:00
61,1,0,1,0.0032264490453546854,2019-03-24 01:00:00,2019-03-24 01:15:00
67,1,0,1,0.0032264490453546854,2019-03-24 01:00:00,2019-03-24 01:15:00
69,3,2,1,0.037171989499259254,2019-03-24 01:00:00,2019-03-24 01:15:00
86,1,1,0,0.009363935322957057,2019-03-24 01:00:00,2019-03-24 01:15:00
87,4,3,1,0.028561423438367206,2019-03-24 01:00:00,2019-03-24 01:15:00
89,1,0,1,0.0032264490453546854,2019-03-24 01:00:00,2019-03-24 01:15:00
104,3,2,1,0.03972361174779833,2019-03-24 01:00:00,2019-03-24 01:15:00
109,1,0,1,0.0032264490453546854,2019-03-24 01:00:00,2019-03-24 01:15:00
110,3,3,0,0.007341124443707407,2019-03-24 01:00:00,2019-03-24 01:15:00
111,5,2,3,0.006320381827031357,2019-03-24 01:00:00,2019-03-24 01:15:00
112,5,2,3,0.00832969354243282,2019-03-24 01:00:00,2019-03-24 01:15:00
114,1,0,1,0.0032264490453546854,2019-03-24 01:00:00,2019-03-24 01:15:00
115,2,1,1,0.0059692613518880795,2019-03-24 01:00:00,2019-03-24 01:15:00
116,1,1,0,0.008301003474058391,2019-03-24 01:00:00,2019-03-24 01:15:00
118,1,1,0,0.008301003474058391,2019-03-24 01:00:00,2019-03-24 01:15:00
119,1,0,1,0.0032264490453546854,2019-03-24 01:00:00,2019-03-24 01:15:00
122,4,2,2,0.021475030396576507,2019-03-24 01:00:00,2019-03-24 01:15:00
126,2,1,1,0.021475030396576507,2019-03-24 01:00:00,2019-03-24 01:15:00
127,2,1,1,0.0059692613518880795,2019-03-24 01:00:00,2019-03-24 01:15:00
137,5,2,3,0.0074473998262907974,2019-03-24 01:00:00,2019-03-24 01:15:00
138,4,2,2,0.01443848975166076,2019-03-24 01:00:00,2019-03-24 01:15:00
140,2,2,0,0.005832237957100385,2019-03-24 01:00:00,2019-03-24 01:15:00
158,1,1,0,0.0059692613518880795,2019-03-24 01:00:00,2019-03-24 01:15:00
164,1,0,1,0.0032264490453546854,2019-03-24 01:00:00,2019-03-24 01:15:00
168,2,2,0,0.007340667505154776,2019-03-24 01:00:00,2019-03-24 01:15:00
171,2,1,1,0.0059692613518880795,2019-03-24 01:00:00,2019-03-24 01:15:00
172,1,1,0,0.0059692613518880795,2019-03-24 01:00:00,2019-03-24 01:15:00
173,5,3,2,0.010382591325085913,2019-03-24 01:00:00,2019-03-24 01:15:00
175,2,1,1,0.021475030396576507,2019-03-24 01:00:00,2019-03-24 01:15:00
189,2,0,2,0.0032264490453546854,2019-03-24 01:00:00,2019-03-24 01:15:00
197,2,0,2,0.0032264490453546854,2019-03-24 01:00:00,2019-03-24 01:15:00
200,2,1,1,0.021475030396576507,2019-03-24 01:00:00,2019-03-24 01:15:00
203,3,2,1,0.03717198949925925,2019-03-24 01:00:00,2019-03-24 01:15:00
2,5,2,3,0.005883830872431569,2019-03-24 01:15:00,2019-03-24 01:30:00
15,1,0,1,0.0034714402673669997,2019-03-24 01:15:00,2019-03-24 01:30:00
16,15,3,12,0.009767964129007399,2019-03-24 01:15:00,2019-03-24 01:30:00
26,1,1,0,0.006037852585463669,2019-03-24 01:15:00,2019-03-24 01:30:00
35,1,0,1,0.0034714402673669997,2019-03-24 01:15:00,2019-03-24 01:30:00
37,1,1,0,0.0074779698241651035,2019-03-24 01:15:00,2019-03-24 01:30:00
46,6,5,1,0.006931398629170998,2019-03-24 01:15:00,2019-03-24 01:30:00
57,2,1,1,0.023086222362834495,2019-03-24 01:15:00,2019-03-24 01:30:00
58,2,2,0,0.007676830594833322,2019-03-24 01:15:00,2019-03-24 01:30:00
61,1,0,1,0.0034714402673669997,2019-03-24 01:15:00,2019-03-24 01:30:00
67,1,0,1,0.0034714402673669997,2019-03-24 01:15:00,2019-03-24 01:30:00
69,2,1,1,0.023086222362834495,2019-03-24 01:15:00,2019-03-24 01:30:00
86,1,1,0,0.008219639984189795,2019-03-24 01:15:00,2019-03-24 01:30:00
87,6,3,3,0.006775371017929804,2019-03-24 01:15:00,2019-03-24 01:30:00
89,4,1,3,0.009363930515028672,2019-03-24 01:15:00,2019-03-24 01:30:00
104,2,1,1,0.023086222362834495,2019-03-24 01:15:00,2019-03-24 01:30:00
109,1,1,0,0.005138720612474653,2019-03-24 01:15:00,2019-03-24 01:30:00
110,8,4,4,0.008767047621122442,2019-03-24 01:15:00,2019-03-24 01:30:00
111,5,1,4,0.004408312253697963,2019-03-24 01:15:00,2019-03-24 01:30:00
112,1,0,1,0.0034714402673669997,2019-03-24 01:15:00,2019-03-24 01:30:00
115,5,5,0,0.01357788592608478,2019-03-24 01:15:00,2019-03-24 01:30:00
116,2,1,1,0.006201311976099716,2019-03-24 01:15:00,2019-03-24 01:30:00
118,1,1,0,0.008931183684832431,2019-03-24 01:15:00,2019-03-24 01:30:00
122,4,2,2,0.023086222362834495,2019-03-24 01:15:00,2019-03-24 01:30:00
126,4,3,1,0.04270100445830199,2019-03-24 01:15:00,2019-03-24 01:30:00
127,3,1,2,0.006422477504834213,2019-03-24 01:15:00,2019-03-24 01:30:00
137,6,3,3,0.014137994332775594,2019-03-24 01:15:00,2019-03-24 01:30:00
138,4,2,2,0.011170677221657007,2019-03-24 01:15:00,2019-03-24 01:30:00
140,2,2,0,0.006806000957582306,2019-03-24 01:15:00,2019-03-24 01:30:00
153,2,0,2,0.0034714402673669997,2019-03-24 01:15:00,2019-03-24 01:30:00
154,3,1,2,0.0049469588861006065,2019-03-24 01:15:00,2019-03-24 01:30:00
158,1,1,0,0.0049469588861006065,2019-03-24 01:15:00,2019-03-24 01:30:00
164,2,0,2,0.0034714402673669997,2019-03-24 01:15:00,2019-03-24 01:30:00
168,3,3,0,0.008786853697783018,2019-03-24 01:15:00,2019-03-24 01:30:00
170,1,0,1,0.0034714402673669997,2019-03-24 01:15:00,2019-03-24 01:30:00
171,2,1,1,0.006422477504834213,2019-03-24 01:15:00,2019-03-24 01:30:00
172,1,1,0,0.006422477504834213,2019-03-24 01:15:00,2019-03-24 01:30:00
173,3,1,2,0.006037852585463669,2019-03-24 01:15:00,2019-03-24 01:30:00
175,2,1,1,0.023086222362834495,2019-03-24 01:15:00,2019-03-24 01:30:00
189,2,0,2,0.0034714402673669997,2019-03-24 01:15:00,2019-03-24 01:30:00
196,1,1,0,0.008743198956520225,2019-03-24 01:15:00,2019-03-24 01:30:00
201,3,3,0,0.005547415284449399,2019-03-24 01:15:00,2019-03-24 01:30:00
203,3,2,1,0.042701004458301994,2019-03-24 01:15:00,2019-03-24 01:30:00
2,4,2,2,0.008791360564217959,2019-03-24 01:30:00,2019-03-24 01:45:00
15,2,0,2,0.0036243806440113702,2019-03-24 01:30:00,2019-03-24 01:45:00
16,8,2,6,0.011289810710980983,2019-03-24 01:30:00,2019-03-24 01:45:00
18,1,0,1,0.0036243806440113702,2019-03-24 01:30:00,2019-03-24 01:45:00
26,1,1,0,0.007442796099323908,2019-03-24 01:30:00,2019-03-24 01:45:00
35,1,0,1,0.0036243806440113702,2019-03-24 01:30:00,2019-03-24 01:45:00
37,1,1,0,0.005994962216831338,2019-03-24 01:30:00,2019-03-24 01:45:00
46,4,3,1,0.00842323452108178,2019-03-24 01:30:00,2019-03-24 01:45:00
57,3,2,1,0.03432869969230841,2019-03-24 01:30:00,2019-03-24 01:45:00
58,2,2,0,0.00670542680566126,2019-03-24 01:30:00,2019-03-24 01:45:00
61,1,0,1,0.0036243806440113702,2019-03-24 01:30:00,2019-03-24 01:45:00
67,1,0,1,0.0036243806440113702,2019-03-24 01:30:00,2019-03-24 01:45:00
68,1,1,0,0.005164903724836315,2019-03-24 01:30:00,2019-03-24 01:45:00
87,4,1,3,0.005057503981097893,2019-03-24 01:30:00,2019-03-24 01:45:00
89,3,1,2,0.010785158376926684,2019-03-24 01:30:00,2019-03-24 01:45:00
90,2,0,2,0.0036243806440113702,2019-03-24 01:30:00,2019-03-24 01:45:00
104,2,1,1,0.02409392667620939,2019-03-24 01:30:00,2019-03-24 01:45:00
109,1,1,0,0.007361174565608496,2019-03-24 01:30:00,2019-03-24 01:45:00
110,7,3,4,0.009991576733222905,2019-03-24 01:30:00,2019-03-24 01:45:00
111,4,1,3,0.007361174565608496,2019-03-24 01:30:00,2019-03-24 01:45:00
115,5,5,0,0.01670273158364375,2019-03-24 01:30:00,2019-03-24 01:45:00
116,1,1,0,0.005819709216109509,2019-03-24 01:30:00,2019-03-24 01:45:00
118,1,1,0,0.009324648770754035,2019-03-24 01:30:00,2019-03-24 01:45:00
119,1,1,0,0.00670542680566126,2019-03-24 01:30:00,2019-03-24 01:45:00
122,4,2,2,0.02409392667620939,2019-03-24 01:30:00,2019-03-24 01:45:00
126,3,2,1,0.04456347270840743,2019-03-24 01:30:00,2019-03-24 01:45:00
127,3,1,2,0.005164903724836315,2019-03-24 01:30:00,2019-03-24 01:45:00
137,5,2,3,0.008365543789651306,2019-03-24 01:30:00,2019-03-24 01:45:00
138,1,1,0,0.00670542680566126,2019-03-24 01:30:00,2019-03-24 01:45:00
154,2,0,2,0.0036243806440113702,2019-03-24 01:30:00,2019-03-24 01:45:00
168,2,2,0,0.006490627318184415,2019-03-24 01:30:00,2019-03-24 01:45:00
170,1,0,1,0.0036243806440113702,2019-03-24 01:30:00,2019-03-24 01:45:00
171,2,1,1,0.00670542680566126,2019-03-24 01:30:00,2019-03-24 01:45:00
172,1,1,0,0.00670542680566126,2019-03-24 01:30:00,2019-03-24 01:45:00
173,4,2,2,0.008983319180148854,2019-03-24 01:30:00,2019-03-24 01:45:00
175,2,1,1,0.02409392667620939,2019-03-24 01:30:00,2019-03-24 01:45:00
189,1,0,1,0.0036243806440113702,2019-03-24 01:30:00,2019-03-24 01:45:00
191,1,0,1,0.0036243806440113702,2019-03-24 01:30:00,2019-03-24 01:45:00
201,3,3,0,0.00842323452108178,2019-03-24 01:30:00,2019-03-24 01:45:00
203,2,1,1,0.02409392667620939,2019-03-24 01:30:00,2019-03-24 01:45:00
2,4,1,3,0.006787478068551615,2019-03-24 01:45:00,2019-03-24 02:00:00
15,2,0,2,0.0036687206041632306,2019-03-24 01:45:00,2019-03-24 02:00:00
18,1,0,1,0.0036687206041632306,2019-03-24 01:45:00,2019-03-24 02:00:00
23,1,1,0,0.006381009164985548,2019-03-24 01:45:00,2019-03-24 02:00:00
35,2,1,1,0.024401921491942778,2019-03-24 01:45:00,2019-03-24 02:00:00
37,1,1,0,0.008108456253228261,2019-03-24 01:45:00,2019-03-24 02:00:00
46,2,0,2,0.0036687206041632306,2019-03-24 01:45:00,2019-03-24 02:00:00
57,3,2,1,0.03476852193583256,2019-03-24 01:45:00,2019-03-24 02:00:00
61,1,0,1,0.0036687206041632306,2019-03-24 01:45:00,2019-03-24 02:00:00
67,1,0,1,0.0036687206041632306,2019-03-24 01:45:00,2019-03-24 02:00:00
68,1,1,0,0.005228099336357423,2019-03-24 01:45:00,2019-03-24 02:00:00
87,2,1,1,0.024401921491942778,2019-03-24 01:45:00,2019-03-24 02:00:00
89,1,0,1,0.0036687206041632306,2019-03-24 01:45:00,2019-03-24 02:00:00
90,2,0,2,0.0036687206041632306,2019-03-24 01:45:00,2019-03-24 02:00:00
104,2,1,1,0.024401921491942778,2019-03-24 01:45:00,2019-03-24 02:00:00
109,1,1,0,0.005592074061479538,2019-03-24 01:45:00,2019-03-24 02:00:00
110,2,2,0,0.008422572779060907,2019-03-24 01:45:00,2019-03-24 02:00:00
111,3,1,2,0.005592074061479538,2019-03-24 01:45:00,2019-03-24 02:00:00
115,1,1,0,0.006787478068551615,2019-03-24 01:45:00,2019-03-24 02:00:00
116,1,1,0,0.008113129522331885,2019-03-24 01:45:00,2019-03-24 02:00:00
118,1,1,0,0.009438780976112154,2019-03-24 01:45:00,2019-03-24 02:00:00
119,1,1,0,0.006787478068551615,2019-03-24 01:45:00,2019-03-24 02:00:00
122,4,2,2,0.024401921491942778,2019-03-24 01:45:00,2019-03-24 02:00:00
126,3,1,2,0.006381009164985548,2019-03-24 01:45:00,2019-03-24 02:00:00
127,2,1,1,0.005228099336357423,2019-03-24 01:45:00,2019-03-24 02:00:00
137,7,4,3,0.015666949366681678,2019-03-24 01:45:00,2019-03-24 02:00:00
169,1,1,0,0.005592074061479538,2019-03-24 01:45:00,2019-03-24 02:00:00
171,2,1,1,0.006787478068551615,2019-03-24 01:45:00,2019-03-24 02:00:00
172,1,1,0,0.006787478068551615,2019-03-24 01:45:00,2019-03-24 02:00:00
173,3,2,1,0.03476852193583256,2019-03-24 01:45:00,2019-03-24 02:00:00
175,2,1,1,0.024401921491942778,2019-03-24 01:45:00,2019-03-24 02:00:00
189,1,0,1,0.0036687206041632306,2019-03-24 01:45:00,2019-03-24 02:00:00
203,2,1,1,0.024401921491942778,2019-03-24 01:45:00,2019-03-24 02:00:00
2,1,0,1,0.0036609213470973085,2019-03-24 02:00:00,2019-03-24 02:15:00
5,2,1,1,0.02434983705011682,2019-03-24 02:00:00,2019-03-24 02:15:00
15,2,1,1,0.005108509337500133,2019-03-24 02:00:00,2019-03-24 02:15:00
16,1,1,0,0.00677305124753067,2019-03-24 02:00:00,2019-03-24 02:15:00
18,2,0,2,0.0036609213470973085,2019-03-24 02:00:00,2019-03-24 02:15:00
35,4,1,3,0.005108509337500133,2019-03-24 02:00:00,2019-03-24 02:15:00
37,1,1,0,0.005074413681933161,2019-03-24 02:00:00,2019-03-24 02:15:00
46,3,0,3,0.0036609213470973085,2019-03-24 02:00:00,2019-03-24 02:15:00
57,2,1,1,0.02434983705011682,2019-03-24 02:00:00,2019-03-24 02:15:00
61,1,0,1,0.0036609213470973085,2019-03-24 02:00:00,2019-03-24 02:15:00
67,1,0,1,0.0036609213470973085,2019-03-24 02:00:00,2019-03-24 02:15:00
69,2,2,0,0.00677305124753067,2019-03-24 02:00:00,2019-03-24 02:15:00
74,1,1,0,0.00677305124753067,2019-03-24 02:00:00,2019-03-24 02:15:00
75,1,1,0,0.005074413681933161,2019-03-24 02:00:00,2019-03-24 02:15:00
87,2,1,1,0.02434983705011682,2019-03-24 02:00:00,2019-03-24 02:15:00
89,2,1,1,0.005108509337500133,2019-03-24 02:00:00,2019-03-24 02:15:00
90,1,1,0,0.005074413681933161,2019-03-24 02:00:00,2019-03-24 02:15:00
101,1,0,1,0.0036609213470973085,2019-03-24 02:00:00,2019-03-24 02:15:00
104,2,1,1,0.02434983705011682,2019-03-24 02:00:00,2019-03-24 02:15:00
110,2,2,0,0.00677305124753067,2019-03-24 02:00:00,2019-03-24 02:15:00
111,2,0,2,0.0036609213470973085,2019-03-24 02:00:00,2019-03-24 02:15:00
115,2,2,0,0.009451273308708603,2019-03-24 02:00:00,2019-03-24 02:15:00
116,1,1,0,0.010464953459856001,2019-03-24 02:00:00,2019-03-24 02:15:00
118,1,1,0,0.009418722654897557,2019-03-24 02:00:00,2019-03-24 02:15:00
122,4,2,2,0.02434983705011682,2019-03-24 02:00:00,2019-03-24 02:15:00
126,2,1,1,0.02434983705011682,2019-03-24 02:00:00,2019-03-24 02:15:00
127,2,1,1,0.008003685318305781,2019-03-24 02:00:00,2019-03-24 02:15:00
137,11,5,6,0.00997615161856044,2019-03-24 02:00:00,2019-03-24 02:15:00
138,1,0,1,0.0036609213470973085,2019-03-24 02:00:00,2019-03-24 02:15:00
147,1,1,0,0.004698297980575096,2019-03-24 02:00:00,2019-03-24 02:15:00
154,4,1,3,0.005108509337500133,2019-03-24 02:00:00,2019-03-24 02:15:00
169,1,1,0,0.00677305124753067,2019-03-24 02:00:00,2019-03-24 02:15:00
170,1,1,0,0.005108509337500133,2019-03-24 02:00:00,2019-03-24 02:15:00
171,2,1,1,0.00677305124753067,2019-03-24 02:00:00,2019-03-24 02:15:00
172,1,1,0,0.00677305124753067,2019-03-24 02:00:00,2019-03-24 02:15:00
173,2,1,1,0.02434983705011682,2019-03-24 02:00:00,2019-03-24 02:15:00
175,2,1,1,0.02434983705011682,2019-03-24 02:00:00,2019-03-24 02:15:00
203,2,1,1,0.02434983705011682,2019-03-24 02:00:00,2019-03-24 02:15:00
2,1,0,1,0.0037311125316325665,2019-03-24 02:15:00,2019-03-24 02:30:00
15,4,3,1,0.008378227911227745,2019-03-24 02:15:00,2019-03-24 02:30:00
16,1,0,1,0.0037311125316325665,2019-03-24 02:15:00,2019-03-24 02:30:00
18,2,0,2,0.0037311125316325665,2019-03-24 02:15:00,2019-03-24 02:30:00
26,1,1,0,0.009599262734837041,2019-03-24 02:15:00,2019-03-24 02:30:00
35,4,2,2,0.006902896915128435,2019-03-24 02:15:00,2019-03-24 02:30:00
37,1,1,0,0.004468778029682222,2019-03-24 02:15:00,2019-03-24 02:30:00
46,1,0,1,0.0037311125316325665,2019-03-24 02:15:00,2019-03-24 02:30:00
57,2,1,1,0.024800264026629597,2019-03-24 02:15:00,2019-03-24 02:30:00
58,1,0,1,0.0037311125316325665,2019-03-24 02:15:00,2019-03-24 02:30:00
61,1,0,1,0.0037311125316325665,2019-03-24 02:15:00,2019-03-24 02:30:00
66,2,0,2,0.0037311125316325665,2019-03-24 02:15:00,2019-03-24 02:30:00
67,1,0,1,0.0037311125316325665,2019-03-24 02:15:00,2019-03-24 02:30:00
69,2,2,0,0.006902896915128435,2019-03-24 02:15:00,2019-03-24 02:30:00
74,2,1,1,0.006902896915128435,2019-03-24 02:15:00,2019-03-24 02:30:00
75,1,1,0,0.004468778029682222,2019-03-24 02:15:00,2019-03-24 02:30:00
87,2,1,1,0.024800264026629597,2019-03-24 02:15:00,2019-03-24 02:30:00
89,2,1,1,0.005206443527731876,2019-03-24 02:15:00,2019-03-24 02:30:00
90,1,1,0,0.004468778029682222,2019-03-24 02:15:00,2019-03-24 02:30:00
101,1,0,1,0.0037311125316325665,2019-03-24 02:15:00,2019-03-24 02:30:00
104,3,1,2,0.0064894990475676175,2019-03-24 02:15:00,2019-03-24 02:30:00
109,1,1,0,0.006902896915128435,2019-03-24 02:15:00,2019-03-24 02:30:00
110,2,2,0,0.006902896915128435,2019-03-24 02:15:00,2019-03-24 02:30:00
111,2,0,2,0.0037311125316325665,2019-03-24 02:15:00,2019-03-24 02:30:00
114,1,1,0,0.0064894990475676175,2019-03-24 02:15:00,2019-03-24 02:30:00
115,2,2,0,0.011091180621532732,2019-03-24 02:15:00,2019-03-24 02:30:00
116,1,1,0,0.012957793449140666,2019-03-24 02:15:00,2019-03-24 02:30:00
118,1,1,0,0.009599262734837041,2019-03-24 02:15:00,2019-03-24 02:30:00
119,2,0,2,0.0037311125316325665,2019-03-24 02:15:00,2019-03-24 02:30:00
122,4,2,2,0.024800264026629597,2019-03-24 02:15:00,2019-03-24 02:30:00
126,2,1,1,0.024800264026629597,2019-03-24 02:15:00,2019-03-24 02:30:00
127,2,1,1,0.010853471339639102,2019-03-24 02:15:00,2019-03-24 02:30:00
137,8,2,6,0.005206443527731876,2019-03-24 02:15:00,2019-03-24 02:30:00
138,1,1,0,0.006902896915128435,2019-03-24 02:15:00,2019-03-24 02:30:00
147,1,1,0,0.006902896915128435,2019-03-24 02:15:00,2019-03-24 02:30:00
154,4,1,3,0.005206443527731876,2019-03-24 02:15:00,2019-03-24 02:30:00
168,1,1,0,0.004468778029682222,2019-03-24 02:15:00,2019-03-24 02:30:00
169,1,1,0,0.006902896915128435,2019-03-24 02:15:00,2019-03-24 02:30:00
170,1,1,0,0.006665187633234804,2019-03-24 02:15:00,2019-03-24 02:30:00
171,2,1,1,0.006902896915128435,2019-03-24 02:15:00,2019-03-24 02:30:00
172,1,1,0,0.006902896915128435,2019-03-24 02:15:00,2019-03-24 02:30:00
173,2,1,1,0.024800264026629597,2019-03-24 02:15:00,2019-03-24 02:30:00
175,2,1,1,0.024800264026629597,2019-03-24 02:15:00,2019-03-24 02:30:00
203,2,1,1,0.024800264026629597,2019-03-24 02:15:00,2019-03-24 02:30:00
2,3,1,2,0.006094158206814446,2019-03-24 02:30:00,2019-03-24 02:45:00
15,1,0,1,0.0035038026527801835,2019-03-24 02:30:00,2019-03-24 02:45:00
16,1,0,1,0.0035038026527801835,2019-03-24 02:30:00,2019-03-24 02:45:00
18,2,0,2,0.0035038026527801835,2019-03-24 02:30:00,2019-03-24 02:45:00
19,1,1,0,0.0064823580982508655,2019-03-24 02:30:00,2019-03-24 02:45:00
23,5,0,5,0.0035038026527801835,2019-03-24 02:30:00,2019-03-24 02:45:00
26,1,1,0,0.0064823580982508655,2019-03-24 02:30:00,2019-03-24 02:45:00
37,1,1,0,0.004331312144686966,2019-03-24 02:30:00,2019-03-24 02:45:00
41,1,0,1,0.0035038026527801835,2019-03-24 02:30:00,2019-03-24 02:45:00
46,2,1,1,0.00409951374187432,2019-03-24 02:30:00,2019-03-24 02:45:00
57,3,2,1,0.05994530233484254,2019-03-24 02:30:00,2019-03-24 02:45:00
61,1,0,1,0.0035038026527801835,2019-03-24 02:30:00,2019-03-24 02:45:00
67,1,0,1,0.0035038026527801835,2019-03-24 02:30:00,2019-03-24 02:45:00
68,1,1,0,0.0064823580982508655,2019-03-24 02:30:00,2019-03-24 02:45:00
69,2,2,0,0.0064823580982508655,2019-03-24 02:30:00,2019-03-24 02:45:00
74,1,0,1,0.0035038026527801835,2019-03-24 02:30:00,2019-03-24 02:45:00
87,2,1,1,0.023310487695291197,2019-03-24 02:30:00,2019-03-24 02:45:00
89,1,0,1,0.0035038026527801835,2019-03-24 02:30:00,2019-03-24 02:45:00
104,3,1,2,0.006094158206814446,2019-03-24 02:30:00,2019-03-24 02:45:00
109,2,1,1,0.0064823580982508655,2019-03-24 02:30:00,2019-03-24 02:45:00
110,2,2,0,0.005489506283093972,2019-03-24 02:30:00,2019-03-24 02:45:00
111,3,0,3,0.0035038026527801835,2019-03-24 02:30:00,2019-03-24 02:45:00
112,1,0,1,0.0035038026527801835,2019-03-24 02:30:00,2019-03-24 02:45:00
114,1,1,0,0.006094158206814446,2019-03-24 02:30:00,2019-03-24 02:45:00
115,1,1,0,0.0064823580982508655,2019-03-24 02:30:00,2019-03-24 02:45:00
116,2,2,0,0.013254607332797779,2019-03-24 02:30:00,2019-03-24 02:45:00
118,2,2,0,0.011993023311604541,2019-03-24 02:30:00,2019-03-24 02:45:00
119,5,3,2,0.00897288786118591,2019-03-24 02:30:00,2019-03-24 02:45:00
122,4,2,2,0.023310487695291197,2019-03-24 02:30:00,2019-03-24 02:45:00
126,3,2,1,0.04648279865721028,2019-03-24 02:30:00,2019-03-24 02:45:00
127,2,1,1,0.0064823580982508655,2019-03-24 02:30:00,2019-03-24 02:45:00
137,11,4,7,0.006813840620407311,2019-03-24 02:30:00,2019-03-24 02:45:00
138,1,0,1,0.0035038026527801835,2019-03-24 02:30:00,2019-03-24 02:45:00
153,5,5,0,0.009700713233748891,2019-03-24 02:30:00,2019-03-24 02:45:00
168,1,1,0,0.004496654467937077,2019-03-24 02:30:00,2019-03-24 02:45:00
169,1,1,0,0.006094158206814446,2019-03-24 02:30:00,2019-03-24 02:45:00
171,2,1,1,0.0064823580982508655,2019-03-24 02:30:00,2019-03-24 02:45:00
172,6,3,3,0.014962637031578706,2019-03-24 02:30:00,2019-03-24 02:45:00
173,2,1,1,0.023310487695291197,2019-03-24 02:30:00,2019-03-24 02:45:00
175,2,1,1,0.023310487695291197,2019-03-24 02:30:00,2019-03-24 02:45:00
203,2,1,1,0.023310487695291197,2019-03-24 02:30:00,2019-03-24 02:45:00
1,1,1,0,0.006512448934196519,2019-03-24 02:45:00,2019-03-24 03:00:00
2,1,0,1,0.0035200675054939353,2019-03-24 02:45:00,2019-03-24 03:00:00
15,1,0,1,0.0035200675054939353,2019-03-24 02:45:00,2019-03-24 03:00:00
16,1,0,1,0.0035200675054939353,2019-03-24 02:45:00,2019-03-24 03:00:00
23,4,0,4,0.0035200675054939353,2019-03-24 02:45:00,2019-03-24 03:00:00
26,3,2,1,0.006303840919277553,2019-03-24 02:45:00,2019-03-24 03:00:00
37,1,1,0,0.004426921094437477,2019-03-24 02:45:00,2019-03-24 03:00:00
46,3,2,1,0.008208359002870976,2019-03-24 02:45:00,2019-03-24 03:00:00
57,3,2,1,0.03337828359215256,2019-03-24 02:45:00,2019-03-24 03:00:00
61,1,0,1,0.0035200675054939353,2019-03-24 02:45:00,2019-03-24 03:00:00
67,1,0,1,0.0035200675054939353,2019-03-24 02:45:00,2019-03-24 03:00:00
87,2,1,1,0.023425544896599683,2019-03-24 02:45:00,2019-03-24 03:00:00
88,3,3,0,0.006512448934196519,2019-03-24 02:45:00,2019-03-24 03:00:00
89,1,0,1,0.0035200675054939353,2019-03-24 02:45:00,2019-03-24 03:00:00
104,2,1,1,0.023425544896599683,2019-03-24 02:45:00,2019-03-24 03:00:00
109,2,0,2,0.0035200675054939353,2019-03-24 02:45:00,2019-03-24 03:00:00
110,4,2,2,0.0055149884579623245,2019-03-24 02:45:00,2019-03-24 03:00:00
111,3,0,3,0.0035200675054939353,2019-03-24 02:45:00,2019-03-24 03:00:00
115,4,4,0,0.011031484945026284,2019-03-24 02:45:00,2019-03-24 03:00:00
116,1,1,0,0.009056314037208206,2019-03-24 02:45:00,2019-03-24 03:00:00
118,1,1,0,0.009056314037208206,2019-03-24 02:45:00,2019-03-24 03:00:00
119,5,2,3,0.00533377468338102,2019-03-24 02:45:00,2019-03-24 03:00:00
122,4,2,2,0.023425544896599683,2019-03-24 02:45:00,2019-03-24 03:00:00
126,3,2,1,0.06982360548970291,2019-03-24 02:45:00,2019-03-24 03:00:00
127,2,1,1,0.006512448934196519,2019-03-24 02:45:00,2019-03-24 03:00:00
137,7,2,5,0.00533377468338102,2019-03-24 02:45:00,2019-03-24 03:00:00
138,3,0,3,0.0035200675054939353,2019-03-24 02:45:00,2019-03-24 03:00:00
153,5,5,0,0.008023871582435756,2019-03-24 02:45:00,2019-03-24 03:00:00
168,2,2,0,0.007509909410430712,2019-03-24 02:45:00,2019-03-24 03:00:00
171,2,1,1,0.006512448934196519,2019-03-24 02:45:00,2019-03-24 03:00:00
172,1,1,0,0.006512448934196519,2019-03-24 02:45:00,2019-03-24 03:00:00
173,4,1,3,0.004911954212385744,2019-03-24 02:45:00,2019-03-24 03:00:00
175,2,1,1,0.023425544896599683,2019-03-24 02:45:00,2019-03-24 03:00:00
196,1,0,1,0.0035200675054939353,2019-03-24 02:45:00,2019-03-24 03:00:00
199,1,1,0,0.008879006318142205,2019-03-24 02:45:00,2019-03-24 03:00:00
203,3,2,1,0.043331022287705426,2019-03-24 02:45:00,2019-03-24 03:00:00
1,1,1,0,0.006805093715151001,2019-03-24 03:00:00,2019-03-24 03:15:00
2,1,0,1,0.00367824126096049,2019-03-24 03:00:00,2019-03-24 03:15:00
15,1,0,1,0.00367824126096049,2019-03-24 03:00:00,2019-03-24 03:15:00
26,2,2,0,0.0065871125027464564,2019-03-24 03:00:00,2019-03-24 03:15:00
37,1,1,0,0.006084115062726079,2019-03-24 03:00:00,2019-03-24 03:15:00
46,2,2,0,0.010083772779678507,2019-03-24 03:00:00,2019-03-24 03:15:00
57,3,2,1,0.03727664064203364,2019-03-24 03:00:00,2019-03-24 03:15:00
61,1,0,1,0.00367824126096049,2019-03-24 03:00:00,2019-03-24 03:15:00
67,1,0,1,0.00367824126096049,2019-03-24 03:00:00,2019-03-24 03:15:00
87,2,1,1,0.024462651380442485,2019-03-24 03:00:00,2019-03-24 03:15:00
88,3,3,0,0.006805093715151001,2019-03-24 03:00:00,2019-03-24 03:15:00
89,1,0,1,0.00367824126096049,2019-03-24 03:00:00,2019-03-24 03:15:00
90,2,2,0,0.01212146494375117,2019-03-24 03:00:00,2019-03-24 03:15:00
104,2,1,1,0.024462651380442485,2019-03-24 03:00:00,2019-03-24 03:15:00
110,4,2,2,0.007534933306620886,2019-03-24 03:00:00,2019-03-24 03:15:00
111,5,2,3,0.006805093715151001,2019-03-24 03:00:00,2019-03-24 03:15:00
115,5,3,2,0.009931946169341512,2019-03-24 03:00:00,2019-03-24 03:15:00
116,1,1,0,0.009463279329451086,2019-03-24 03:00:00,2019-03-24 03:15:00
118,1,1,0,0.009463279329451086,2019-03-24 03:00:00,2019-03-24 03:15:00
119,2,0,2,0.00367824126096049,2019-03-24 03:00:00,2019-03-24 03:15:00
122,4,2,2,0.024462651380442485,2019-03-24 03:00:00,2019-03-24 03:15:00
126,2,1,1,0.024462651380442485,2019-03-24 03:00:00,2019-03-24 03:15:00
127,2,1,1,0.006805093715151001,2019-03-24 03:00:00,2019-03-24 03:15:00
137,5,2,3,0.008489988864491668,2019-03-24 03:00:00,2019-03-24 03:15:00
138,3,0,3,0.00367824126096049,2019-03-24 03:00:00,2019-03-24 03:15:00
154,2,0,2,0.00367824126096049,2019-03-24 03:00:00,2019-03-24 03:15:00
171,2,1,1,0.006805093715151001,2019-03-24 03:00:00,2019-03-24 03:15:00
172,1,1,0,0.006805093715151001,2019-03-24 03:00:00,2019-03-24 03:15:00
173,4,1,3,0.005132676881853473,2019-03-24 03:00:00,2019-03-24 03:15:00
175,2,1,1,0.024462651380442485,2019-03-24 03:00:00,2019-03-24 03:15:00
196,1,0,1,0.00367824126096049,2019-03-24 03:00:00,2019-03-24 03:15:00
203,3,2,1,0.04524706149992448,2019-03-24 03:00:00,2019-03-24 03:15:00
15,1,0,1,0.0037067025541880796,2019-03-24 03:15:00,2019-03-24 03:30:00
16,2,2,0,0.013749875201504013,2019-03-24 03:15:00,2019-03-24 03:30:00
20,1,1,0,0.011813787094716106,2019-03-24 03:15:00,2019-03-24 03:30:00
37,1,1,0,0.0061311717647781535,2019-03-24 03:15:00,2019-03-24 03:30:00
46,3,1,2,0.011813787094716106,2019-03-24 03:15:00,2019-03-24 03:30:00
57,2,1,1,0.024646812824113823,2019-03-24 03:15:00,2019-03-24 03:30:00
61,1,0,1,0.0037067025541880796,2019-03-24 03:15:00,2019-03-24 03:30:00
67,1,0,1,0.0037067025541880796,2019-03-24 03:15:00,2019-03-24 03:30:00
87,2,1,1,0.024646812824113823,2019-03-24 03:15:00,2019-03-24 03:30:00
89,1,0,1,0.0037067025541880796,2019-03-24 03:15:00,2019-03-24 03:30:00
90,2,2,0,0.009536486600091898,2019-03-24 03:15:00,2019-03-24 03:30:00
104,2,1,1,0.024646812824113823,2019-03-24 03:15:00,2019-03-24 03:30:00
110,3,2,1,0.009536486600091898,2019-03-24 03:15:00,2019-03-24 03:30:00
111,4,2,2,0.006857744291844063,2019-03-24 03:15:00,2019-03-24 03:30:00
115,3,1,2,0.006857744291844063,2019-03-24 03:15:00,2019-03-24 03:30:00
116,2,1,1,0.009536486600091898,2019-03-24 03:15:00,2019-03-24 03:30:00
118,1,1,0,0.009536486600091898,2019-03-24 03:15:00,2019-03-24 03:30:00
122,4,2,2,0.024646812824113823,2019-03-24 03:15:00,2019-03-24 03:30:00
126,2,1,1,0.024646812824113823,2019-03-24 03:15:00,2019-03-24 03:30:00
127,2,1,1,0.006857744291844063,2019-03-24 03:15:00,2019-03-24 03:30:00
137,5,2,3,0.008555640975368227,2019-03-24 03:15:00,2019-03-24 03:30:00
154,2,0,2,0.0037067025541880796,2019-03-24 03:15:00,2019-03-24 03:30:00
171,2,1,1,0.006857744291844063,2019-03-24 03:15:00,2019-03-24 03:30:00
172,1,1,0,0.006857744291844063,2019-03-24 03:15:00,2019-03-24 03:30:00
173,2,1,1,0.024646812824113823,2019-03-24 03:15:00,2019-03-24 03:30:00
175,2,1,1,0.024646812824113823,2019-03-24 03:15:00,2019-03-24 03:30:00
203,2,1,1,0.024646812824113823,2019-03-24 03:15:00,2019-03-24 03:30:00
15,1,0,1,0.0037977221443767405,2019-03-24 03:30:00,2019-03-24 03:45:00
16,3,2,1,0.0070261455610966216,2019-03-24 03:30:00,2019-03-24 03:45:00
37,1,1,0,0.006281744572849011,2019-03-24 03:30:00,2019-03-24 03:45:00
46,2,0,2,0.0037977221443767405,2019-03-24 03:30:00,2019-03-24 03:45:00
57,2,1,1,0.02525368603191107,2019-03-24 03:30:00,2019-03-24 03:45:00
61,1,0,1,0.0037977221443767405,2019-03-24 03:30:00,2019-03-24 03:45:00
67,1,0,1,0.0037977221443767405,2019-03-24 03:30:00,2019-03-24 03:45:00
87,2,1,1,0.02525368603191107,2019-03-24 03:30:00,2019-03-24 03:45:00
89,2,1,1,0.009770678432840336,2019-03-24 03:30:00,2019-03-24 03:45:00
104,2,1,1,0.02525368603191107,2019-03-24 03:30:00,2019-03-24 03:45:00
110,2,2,0,0.0070261455610966216,2019-03-24 03:30:00,2019-03-24 03:45:00
111,2,0,2,0.0037977221443767405,2019-03-24 03:30:00,2019-03-24 03:45:00
115,1,1,0,0.012103918212470324,2019-03-24 03:30:00,2019-03-24 03:45:00
116,1,1,0,0.009770678432840336,2019-03-24 03:30:00,2019-03-24 03:45:00
118,1,1,0,0.009770678432840336,2019-03-24 03:30:00,2019-03-24 03:45:00
122,4,2,2,0.02525368603191107,2019-03-24 03:30:00,2019-03-24 03:45:00
126,2,1,1,0.02525368603191107,2019-03-24 03:30:00,2019-03-24 03:45:00
127,2,1,1,0.0070261455610966216,2019-03-24 03:30:00,2019-03-24 03:45:00
137,5,2,3,0.00876576700132128,2019-03-24 03:30:00,2019-03-24 03:45:00
171,2,1,1,0.0070261455610966216,2019-03-24 03:30:00,2019-03-24 03:45:00
172,1,1,0,0.0070261455610966216,2019-03-24 03:30:00,2019-03-24 03:45:00
173,2,1,1,0.02525368603191107,2019-03-24 03:30:00,2019-03-24 03:45:00
175,2,1,1,0.02525368603191107,2019-03-24 03:30:00,2019-03-24 03:45:00
203,2,1,1,0.02525368603191107,2019-03-24 03:30:00,2019-03-24 03:45:00
15,1,1,0,0.00721712091977558,2019-03-24 03:45:00,2019-03-24 04:00:00
37,1,1,0,0.006452470060932275,2019-03-24 03:45:00,2019-03-24 04:00:00
57,3,1,2,0.006784915162940044,2019-03-24 03:45:00,2019-03-24 04:00:00
61,1,0,1,0.0039009494551736704,2019-03-24 03:45:00,2019-03-24 04:00:00
67,1,0,1,0.0039009494551736704,2019-03-24 03:45:00,2019-03-24 04:00:00
69,1,0,1,0.0039009494551736704,2019-03-24 03:45:00,2019-03-24 04:00:00
87,2,1,1,0.02593212133675659,2019-03-24 03:45:00,2019-03-24 04:00:00
89,1,0,1,0.0039009494551736704,2019-03-24 03:45:00,2019-03-24 04:00:00
104,2,1,1,0.02593212133675659,2019-03-24 03:45:00,2019-03-24 04:00:00
110,2,2,0,0.00721712091977558,2019-03-24 03:45:00,2019-03-24 04:00:00
111,2,0,2,0.0039009494551736704,2019-03-24 03:45:00,2019-03-24 04:00:00
112,1,1,0,0.00721712091977558,2019-03-24 03:45:00,2019-03-24 04:00:00
115,1,1,0,0.00721712091977558,2019-03-24 03:45:00,2019-03-24 04:00:00
116,1,1,0,0.00721712091977558,2019-03-24 03:45:00,2019-03-24 04:00:00
118,1,1,0,0.010036243023871641,2019-03-24 03:45:00,2019-03-24 04:00:00
119,1,0,1,0.0039009494551736704,2019-03-24 03:45:00,2019-03-24 04:00:00
122,4,2,2,0.02593212133675659,2019-03-24 03:45:00,2019-03-24 04:00:00
126,2,1,1,0.02593212133675659,2019-03-24 03:45:00,2019-03-24 04:00:00
127,1,0,1,0.0039009494551736704,2019-03-24 03:45:00,2019-03-24 04:00:00
137,5,2,3,0.00900399066669088,2019-03-24 03:45:00,2019-03-24 04:00:00
151,1,1,0,0.00721712091977558,2019-03-24 03:45:00,2019-03-24 04:00:00
171,2,1,1,0.00721712091977558,2019-03-24 03:45:00,2019-03-24 04:00:00
172,1,1,0,0.00721712091977558,2019-03-24 03:45:00,2019-03-24 04:00:00
173,2,1,1,0.02593212133675659,2019-03-24 03:45:00,2019-03-24 04:00:00
175,2,1,1,0.02593212133675659,2019-03-24 03:45:00,2019-03-24 04:00:00
191,1,1,0,0.006784915162940044,2019-03-24 03:45:00,2019-03-24 04:00:00
199,1,0,1,0.0039009494551736704,2019-03-24 03:45:00,2019-03-24 04:00:00
203,2,1,1,0.02593212133675659,2019-03-24 03:45:00,2019-03-24 04:00:00
23,1,0,1,0.003799417792290027,2019-03-24 04:00:00,2019-03-24 04:15:00
37,1,1,0,0.0062845517479786644,2019-03-24 04:00:00,2019-03-24 04:15:00
41,4,1,3,0.00530176959594229,2019-03-24 04:00:00,2019-03-24 04:15:00
57,3,1,2,0.006608334633142367,2019-03-24 04:00:00,2019-03-24 04:15:00
61,1,0,1,0.003799417792290027,2019-03-24 04:00:00,2019-03-24 04:15:00
67,1,0,1,0.003799417792290027,2019-03-24 04:00:00,2019-03-24 04:15:00
69,1,0,1,0.003799417792290027,2019-03-24 04:00:00,2019-03-24 04:15:00
87,2,1,1,0.02526498149892699,2019-03-24 04:00:00,2019-03-24 04:15:00
89,1,0,1,0.003799417792290027,2019-03-24 04:00:00,2019-03-24 04:15:00
104,2,1,1,0.02526498149892699,2019-03-24 04:00:00,2019-03-24 04:15:00
109,1,0,1,0.003799417792290027,2019-03-24 04:00:00,2019-03-24 04:15:00
110,2,2,0,0.007029283565638318,2019-03-24 04:00:00,2019-03-24 04:15:00
111,2,0,2,0.003799417792290027,2019-03-24 04:00:00,2019-03-24 04:15:00
112,1,1,0,0.007029283565638318,2019-03-24 04:00:00,2019-03-24 04:15:00
114,1,1,0,0.007029283565638318,2019-03-24 04:00:00,2019-03-24 04:15:00
115,1,1,0,0.007029283565638318,2019-03-24 04:00:00,2019-03-24 04:15:00
116,1,1,0,0.007029283565638318,2019-03-24 04:00:00,2019-03-24 04:15:00
118,1,1,0,0.009775043573227284,2019-03-24 04:00:00,2019-03-24 04:15:00
122,5,3,2,0.04673054520556395,2019-03-24 04:00:00,2019-03-24 04:15:00
126,2,1,1,0.02526498149892699,2019-03-24 04:00:00,2019-03-24 04:15:00
127,1,0,1,0.003799417792290027,2019-03-24 04:00:00,2019-03-24 04:15:00
137,5,2,3,0.0087696857036673,2019-03-24 04:00:00,2019-03-24 04:15:00
151,1,1,0,0.007029283565638318,2019-03-24 04:00:00,2019-03-24 04:15:00
171,2,1,1,0.007029283565638318,2019-03-24 04:00:00,2019-03-24 04:15:00
172,1,1,0,0.007029283565638318,2019-03-24 04:00:00,2019-03-24 04:15:00
173,2,1,1,0.02526498149892699,2019-03-24 04:00:00,2019-03-24 04:15:00
175,2,1,1,0.02526498149892699,2019-03-24 04:00:00,2019-03-24 04:15:00
191,1,1,0,0.006608334633142367,2019-03-24 04:00:00,2019-03-24 04:15:00
197,2,2,0,0.006804121399594553,2019-03-24 04:00:00,2019-03-24 04:15:00
199,1,0,1,0.003799417792290027,2019-03-24 04:00:00,2019-03-24 04:15:00
203,2,1,1,0.02526498149892699,2019-03-24 04:00:00,2019-03-24 04:15:00
1,1,1,0,0.00651839192476762,2019-03-24 04:15:00,2019-03-24 04:30:00
37,1,1,0,0.006199024114827773,2019-03-24 04:15:00,2019-03-24 04:30:00
41,2,0,2,0.0037477021046372645,2019-03-24 04:15:00,2019-03-24 04:30:00
57,2,1,1,0.02492882419708465,2019-03-24 04:15:00,2019-03-24 04:30:00
61,1,0,1,0.0037477021046372645,2019-03-24 04:15:00,2019-03-24 04:30:00
67,2,0,2,0.0037477021046372645,2019-03-24 04:15:00,2019-03-24 04:30:00
87,2,1,1,0.02492882419708465,2019-03-24 04:15:00,2019-03-24 04:30:00
89,1,0,1,0.0037477021046372645,2019-03-24 04:15:00,2019-03-24 04:30:00
104,2,1,1,0.02492882419708465,2019-03-24 04:15:00,2019-03-24 04:30:00
109,1,0,1,0.0037477021046372645,2019-03-24 04:15:00,2019-03-24 04:30:00
110,2,2,0,0.006933606225975831,2019-03-24 04:15:00,2019-03-24 04:30:00
111,2,0,2,0.0037477021046372645,2019-03-24 04:15:00,2019-03-24 04:30:00
112,1,1,0,0.005340654165306548,2019-03-24 04:15:00,2019-03-24 04:30:00
113,1,0,1,0.0037477021046372645,2019-03-24 04:15:00,2019-03-24 04:30:00
114,2,0,2,0.0037477021046372645,2019-03-24 04:15:00,2019-03-24 04:30:00
115,1,1,0,0.006933606225975831,2019-03-24 04:15:00,2019-03-24 04:30:00
116,2,2,0,0.010119510347314398,2019-03-24 04:15:00,2019-03-24 04:30:00
118,1,1,0,0.009641997301770117,2019-03-24 04:15:00,2019-03-24 04:30:00
122,5,3,2,0.04610994628953205,2019-03-24 04:15:00,2019-03-24 04:30:00
126,3,1,2,0.00651839192476762,2019-03-24 04:15:00,2019-03-24 04:30:00
127,1,0,1,0.0037477021046372645,2019-03-24 04:15:00,2019-03-24 04:30:00
137,5,2,3,0.008650346125018284,2019-03-24 04:15:00,2019-03-24 04:30:00
171,2,1,1,0.006933606225975831,2019-03-24 04:15:00,2019-03-24 04:30:00
172,1,1,0,0.005340654165306548,2019-03-24 04:15:00,2019-03-24 04:30:00
173,4,3,1,0.04610994628953205,2019-03-24 04:15:00,2019-03-24 04:30:00
175,2,1,1,0.02492882419708465,2019-03-24 04:15:00,2019-03-24 04:30:00
197,2,2,0,0.006933606225975831,2019-03-24 04:15:00,2019-03-24 04:30:00
203,2,1,1,0.02492882419708465,2019-03-24 04:15:00,2019-03-24 04:30:00
37,1,1,0,0.006411528887230054,2019-03-24 04:30:00,2019-03-24 04:45:00
57,2,1,1,0.02577689089390137,2019-03-24 04:30:00,2019-03-24 04:45:00
61,1,0,1,0.003876176886673882,2019-03-24 04:30:00,2019-03-24 04:45:00
67,2,0,2,0.003876176886673882,2019-03-24 04:30:00,2019-03-24 04:45:00
87,2,1,1,0.02577689089390137,2019-03-24 04:30:00,2019-03-24 04:45:00
89,1,0,1,0.003876176886673882,2019-03-24 04:30:00,2019-03-24 04:45:00
104,2,1,1,0.02577689089390137,2019-03-24 04:30:00,2019-03-24 04:45:00
110,2,2,0,0.007171298697762859,2019-03-24 04:30:00,2019-03-24 04:45:00
111,2,0,2,0.003876176886673882,2019-03-24 04:30:00,2019-03-24 04:45:00
112,1,1,0,0.005523737792218371,2019-03-24 04:30:00,2019-03-24 04:45:00
115,1,1,0,0.007171298697762859,2019-03-24 04:30:00,2019-03-24 04:45:00
116,1,1,0,0.007171298697762859,2019-03-24 04:30:00,2019-03-24 04:45:00
118,1,1,0,0.009972538003593864,2019-03-24 04:30:00,2019-03-24 04:45:00
122,4,2,2,0.02577689089390137,2019-03-24 04:30:00,2019-03-24 04:45:00
126,2,1,1,0.02577689089390137,2019-03-24 04:30:00,2019-03-24 04:45:00
127,1,0,1,0.003876176886673882,2019-03-24 04:30:00,2019-03-24 04:45:00
137,5,2,3,0.008946880887786226,2019-03-24 04:30:00,2019-03-24 04:45:00
171,2,1,1,0.007171298697762859,2019-03-24 04:30:00,2019-03-24 04:45:00
172,1,1,0,0.005523737792218371,2019-03-24 04:30:00,2019-03-24 04:45:00
173,2,1,1,0.02577689089390137,2019-03-24 04:30:00,2019-03-24 04:45:00
175,2,1,1,0.02577689089390137,2019-03-24 04:30:00,2019-03-24 04:45:00
203,2,1,1,0.02577689089390137,2019-03-24 04:30:00,2019-03-24 04:45:00
37,1,1,0,0.006324946026944488,2019-03-24 04:45:00,2019-03-24 05:00:00
57,3,2,1,0.03083168785224266,2019-03-24 04:45:00,2019-03-24 05:00:00
61,1,0,1,0.0038238329598493286,2019-03-24 04:45:00,2019-03-24 05:00:00
67,1,0,1,0.0038238329598493286,2019-03-24 04:45:00,2019-03-24 05:00:00
87,2,1,1,0.025430116873763998,2019-03-24 04:45:00,2019-03-24 05:00:00
89,3,1,2,0.0066508054845586945,2019-03-24 04:45:00,2019-03-24 05:00:00
104,2,1,1,0.025430116873763998,2019-03-24 04:45:00,2019-03-24 05:00:00
110,2,2,0,0.007074456260079258,2019-03-24 04:45:00,2019-03-24 05:00:00
111,2,0,2,0.0038238329598493286,2019-03-24 04:45:00,2019-03-24 05:00:00
113,4,0,4,0.0038238329598493286,2019-03-24 04:45:00,2019-03-24 05:00:00
115,1,1,0,0.0066508054845586945,2019-03-24 04:45:00,2019-03-24 05:00:00
116,1,1,0,0.007074456260079258,2019-03-24 04:45:00,2019-03-24 05:00:00
118,1,1,0,0.009837865673913503,2019-03-24 04:45:00,2019-03-24 05:00:00
119,1,0,1,0.0038238329598493286,2019-03-24 04:45:00,2019-03-24 05:00:00
122,4,2,2,0.025430116873763998,2019-03-24 04:45:00,2019-03-24 05:00:00
126,2,1,1,0.025430116873763998,2019-03-24 04:45:00,2019-03-24 05:00:00
127,1,0,1,0.0038238329598493286,2019-03-24 04:45:00,2019-03-24 05:00:00
137,5,2,3,0.008826059094039647,2019-03-24 04:45:00,2019-03-24 05:00:00
153,3,3,0,0.006261800435021776,2019-03-24 04:45:00,2019-03-24 05:00:00
171,2,1,1,0.007074456260079258,2019-03-24 04:45:00,2019-03-24 05:00:00
172,1,1,0,0.007074456260079258,2019-03-24 04:45:00,2019-03-24 05:00:00
173,2,1,1,0.025430116873763998,2019-03-24 04:45:00,2019-03-24 05:00:00
175,2,1,1,0.025430116873763998,2019-03-24 04:45:00,2019-03-24 05:00:00
196,1,1,0,0.007074456260079258,2019-03-24 04:45:00,2019-03-24 05:00:00
203,2,1,1,0.025430116873763998,2019-03-24 04:45:00,2019-03-24 05:00:00
22,2,2,0,0.00659953238551061,2019-03-24 05:00:00,2019-03-24 05:15:00
26,1,0,1,0.0036851758146911537,2019-03-24 05:00:00,2019-03-24 05:15:00
37,1,1,0,0.006095600427951134,2019-03-24 05:00:00,2019-03-24 05:15:00
57,3,2,1,0.04535392035473488,2019-03-24 05:00:00,2019-03-24 05:15:00
61,1,0,1,0.0036851758146911537,2019-03-24 05:00:00,2019-03-24 05:15:00
67,1,0,1,0.0036851758146911537,2019-03-24 05:00:00,2019-03-24 05:15:00
87,2,1,1,0.024519548084713013,2019-03-24 05:00:00,2019-03-24 05:15:00
89,1,0,1,0.0036851758146911537,2019-03-24 05:00:00,2019-03-24 05:15:00
104,2,1,1,0.024519548084713013,2019-03-24 05:00:00,2019-03-24 05:15:00
110,2,2,0,0.006817922636716227,2019-03-24 05:00:00,2019-03-24 05:15:00
111,2,0,2,0.0036851758146911537,2019-03-24 05:00:00,2019-03-24 05:15:00
113,1,0,1,0.0036851758146911537,2019-03-24 05:00:00,2019-03-24 05:15:00
115,1,1,0,0.006817922636716227,2019-03-24 05:00:00,2019-03-24 05:15:00
116,1,1,0,0.006817922636716227,2019-03-24 05:00:00,2019-03-24 05:15:00
118,1,1,0,0.009481121474627426,2019-03-24 05:00:00,2019-03-24 05:15:00
119,1,0,1,0.0036851758146911537,2019-03-24 05:00:00,2019-03-24 05:15:00
122,4,2,2,0.024519548084713013,2019-03-24 05:00:00,2019-03-24 05:15:00
126,3,2,1,0.04535392035473488,2019-03-24 05:00:00,2019-03-24 05:15:00
127,1,0,1,0.0036851758146911537,2019-03-24 05:00:00,2019-03-24 05:15:00
137,5,2,3,0.008506025041211115,2019-03-24 05:00:00,2019-03-24 05:15:00
159,4,1,3,0.0051423541001008825,2019-03-24 05:00:00,2019-03-24 05:15:00
171,2,1,1,0.006817922636716227,2019-03-24 05:00:00,2019-03-24 05:15:00
172,1,1,0,0.006817922636716227,2019-03-24 05:00:00,2019-03-24 05:15:00
173,2,1,1,0.024519548084713013,2019-03-24 05:00:00,2019-03-24 05:15:00
175,2,1,1,0.024519548084713013,2019-03-24 05:00:00,2019-03-24 05:15:00
196,1,1,0,0.006817922636716227,2019-03-24 05:00:00,2019-03-24 05:15:00
203,2,1,1,0.024519548084713013,2019-03-24 05:00:00,2019-03-24 05:15:00
22,2,2,0,0.006972216220294602,2019-03-24 05:15:00,2019-03-24 05:30:00
26,1,0,1,0.003768570765276797,2019-03-24 05:15:00,2019-03-24 05:30:00
37,1,1,0,0.006233546045690937,2019-03-24 05:15:00,2019-03-24 05:30:00
57,2,1,1,0.0250680628951601,2019-03-24 05:15:00,2019-03-24 05:30:00
61,1,0,1,0.003768570765276797,2019-03-24 05:15:00,2019-03-24 05:30:00
67,1,0,1,0.003768570765276797,2019-03-24 05:15:00,2019-03-24 05:30:00
87,2,1,1,0.0250680628951601,2019-03-24 05:15:00,2019-03-24 05:30:00
89,1,0,1,0.003768570765276797,2019-03-24 05:15:00,2019-03-24 05:30:00
104,2,1,1,0.0250680628951601,2019-03-24 05:15:00,2019-03-24 05:30:00
110,2,2,0,0.006972216220294602,2019-03-24 05:15:00,2019-03-24 05:30:00
111,2,0,2,0.003768570765276797,2019-03-24 05:15:00,2019-03-24 05:30:00
112,2,0,2,0.003768570765276797,2019-03-24 05:15:00,2019-03-24 05:30:00
115,1,1,0,0.006972216220294602,2019-03-24 05:15:00,2019-03-24 05:30:00
116,1,1,0,0.006972216220294602,2019-03-24 05:15:00,2019-03-24 05:30:00
118,1,1,0,0.009695690688217287,2019-03-24 05:15:00,2019-03-24 05:30:00
122,4,2,2,0.0250680628951601,2019-03-24 05:15:00,2019-03-24 05:30:00
126,3,2,1,0.046367555025043396,2019-03-24 05:15:00,2019-03-24 05:30:00
127,1,0,1,0.003768570765276797,2019-03-24 05:15:00,2019-03-24 05:30:00
137,5,2,3,0.008698521326105076,2019-03-24 05:15:00,2019-03-24 05:30:00
147,2,2,0,0.006972216220294602,2019-03-24 05:15:00,2019-03-24 05:30:00
159,2,0,2,0.003768570765276797,2019-03-24 05:15:00,2019-03-24 05:30:00
171,2,1,1,0.006972216220294602,2019-03-24 05:15:00,2019-03-24 05:30:00
172,1,1,0,0.006972216220294602,2019-03-24 05:15:00,2019-03-24 05:30:00
173,2,1,1,0.0250680628951601,2019-03-24 05:15:00,2019-03-24 05:30:00
175,2,1,1,0.0250680628951601,2019-03-24 05:15:00,2019-03-24 05:30:00
203,2,1,1,0.0250680628951601,2019-03-24 05:15:00,2019-03-24 05:30:00
37,1,1,0,0.006233546045690935,2019-03-24 05:30:00,2019-03-24 05:45:00
46,1,0,1,0.003768570765276797,2019-03-24 05:30:00,2019-03-24 05:45:00
57,3,2,1,0.046367555025043396,2019-03-24 05:30:00,2019-03-24 05:45:00
61,1,0,1,0.003768570765276797,2019-03-24 05:30:00,2019-03-24 05:45:00
62,1,0,1,0.003768570765276797,2019-03-24 05:30:00,2019-03-24 05:45:00
67,1,0,1,0.003768570765276797,2019-03-24 05:30:00,2019-03-24 05:45:00
87,2,1,1,0.025068062895160097,2019-03-24 05:30:00,2019-03-24 05:45:00
89,1,0,1,0.003768570765276797,2019-03-24 05:30:00,2019-03-24 05:45:00
104,2,1,1,0.025068062895160097,2019-03-24 05:30:00,2019-03-24 05:45:00
110,2,2,0,0.006972216220294602,2019-03-24 05:30:00,2019-03-24 05:45:00
111,2,0,2,0.003768570765276797,2019-03-24 05:30:00,2019-03-24 05:45:00
112,2,0,2,0.003768570765276797,2019-03-24 05:30:00,2019-03-24 05:45:00
115,1,1,0,0.006972216220294602,2019-03-24 05:30:00,2019-03-24 05:45:00
116,1,1,0,0.006972216220294602,2019-03-24 05:30:00,2019-03-24 05:45:00
118,1,1,0,0.009695690688217287,2019-03-24 05:30:00,2019-03-24 05:45:00
122,4,2,2,0.025068062895160097,2019-03-24 05:30:00,2019-03-24 05:45:00
126,2,1,1,0.025068062895160097,2019-03-24 05:30:00,2019-03-24 05:45:00
127,1,0,1,0.003768570765276797,2019-03-24 05:30:00,2019-03-24 05:45:00
137,5,2,3,0.008698521326105074,2019-03-24 05:30:00,2019-03-24 05:45:00
147,2,2,0,0.006972216220294602,2019-03-24 05:30:00,2019-03-24 05:45:00
153,1,1,0,0.006972216220294602,2019-03-24 05:30:00,2019-03-24 05:45:00
171,2,1,1,0.006972216220294602,2019-03-24 05:30:00,2019-03-24 05:45:00
172,1,1,0,0.006972216220294602,2019-03-24 05:30:00,2019-03-24 05:45:00
173,2,1,1,0.025068062895160097,2019-03-24 05:30:00,2019-03-24 05:45:00
175,2,1,1,0.025068062895160097,2019-03-24 05:30:00,2019-03-24 05:45:00
203,2,1,1,0.025068062895160097,2019-03-24 05:30:00,2019-03-24 05:45:00
37,1,1,0,0.006411528887230053,2019-03-24 05:45:00,2019-03-24 06:00:00
57,2,1,1,0.025776890893901366,2019-03-24 05:45:00,2019-03-24 06:00:00
61,1,0,1,0.0038761768866738817,2019-03-24 05:45:00,2019-03-24 06:00:00
67,1,0,1,0.0038761768866738817,2019-03-24 05:45:00,2019-03-24 06:00:00
87,2,1,1,0.025776890893901366,2019-03-24 05:45:00,2019-03-24 06:00:00
89,1,0,1,0.0038761768866738817,2019-03-24 05:45:00,2019-03-24 06:00:00
104,2,1,1,0.025776890893901366,2019-03-24 05:45:00,2019-03-24 06:00:00
110,2,2,0,0.007171298697762859,2019-03-24 05:45:00,2019-03-24 06:00:00
111,2,0,2,0.0038761768866738817,2019-03-24 05:45:00,2019-03-24 06:00:00
115,1,1,0,0.007171298697762859,2019-03-24 05:45:00,2019-03-24 06:00:00
116,1,1,0,0.007171298697762859,2019-03-24 05:45:00,2019-03-24 06:00:00
118,1,1,0,0.009972538003593863,2019-03-24 05:45:00,2019-03-24 06:00:00
122,4,2,2,0.025776890893901366,2019-03-24 05:45:00,2019-03-24 06:00:00
126,2,1,1,0.025776890893901366,2019-03-24 05:45:00,2019-03-24 06:00:00
127,1,0,1,0.0038761768866738817,2019-03-24 05:45:00,2019-03-24 06:00:00
137,5,2,3,0.008946880887786226,2019-03-24 05:45:00,2019-03-24 06:00:00
171,2,1,1,0.007171298697762859,2019-03-24 05:45:00,2019-03-24 06:00:00
172,1,1,0,0.007171298697762859,2019-03-24 05:45:00,2019-03-24 06:00:00
173,2,1,1,0.025776890893901366,2019-03-24 05:45:00,2019-03-24 06:00:00
175,2,1,1,0.025776890893901366,2019-03-24 05:45:00,2019-03-24 06:00:00
203,2,1,1,0.025776890893901366,2019-03-24 05:45:00,2019-03-24 06:00:00
37,1,1,0,0.006390482863840593,2019-03-24 06:00:00,2019-03-24 06:15:00
57,2,1,1,0.02569203459759902,2019-03-24 06:00:00,2019-03-24 06:15:00
61,1,0,1,0.00386345407288904,2019-03-24 06:00:00,2019-03-24 06:15:00
67,1,0,1,0.00386345407288904,2019-03-24 06:00:00,2019-03-24 06:15:00
87,2,1,1,0.02569203459759902,2019-03-24 06:00:00,2019-03-24 06:15:00
89,1,0,1,0.00386345407288904,2019-03-24 06:00:00,2019-03-24 06:15:00
104,2,1,1,0.02569203459759902,2019-03-24 06:00:00,2019-03-24 06:15:00
110,2,2,0,0.0071477598664977295,2019-03-24 06:00:00,2019-03-24 06:15:00
111,2,0,2,0.00386345407288904,2019-03-24 06:00:00,2019-03-24 06:15:00
115,1,1,0,0.0071477598664977295,2019-03-24 06:00:00,2019-03-24 06:15:00
116,1,1,0,0.0071477598664977295,2019-03-24 06:00:00,2019-03-24 06:15:00
118,1,1,0,0.009939803798449698,2019-03-24 06:00:00,2019-03-24 06:15:00
119,1,0,1,0.00386345407288904,2019-03-24 06:00:00,2019-03-24 06:15:00
122,4,2,2,0.02569203459759902,2019-03-24 06:00:00,2019-03-24 06:15:00
126,2,1,1,0.02569203459759902,2019-03-24 06:00:00,2019-03-24 06:15:00
127,1,0,1,0.00386345407288904,2019-03-24 06:00:00,2019-03-24 06:15:00
137,5,2,3,0.008917511654792147,2019-03-24 06:00:00,2019-03-24 06:15:00
170,1,1,0,0.0071477598664977295,2019-03-24 06:00:00,2019-03-24 06:15:00
171,2,1,1,0.0071477598664977295,2019-03-24 06:00:00,2019-03-24 06:15:00
172,1,1,0,0.0071477598664977295,2019-03-24 06:00:00,2019-03-24 06:15:00
173,2,1,1,0.02569203459759902,2019-03-24 06:00:00,2019-03-24 06:15:00
175,2,1,1,0.02569203459759902,2019-03-24 06:00:00,2019-03-24 06:15:00
203,2,1,1,0.02569203459759902,2019-03-24 06:00:00,2019-03-24 06:15:00
37,1,1,0,0.006390482863840593,2019-03-24 06:15:00,2019-03-24 06:30:00
57,2,1,1,0.02569203459759902,2019-03-24 06:15:00,2019-03-24 06:30:00
61,1,0,1,0.00386345407288904,2019-03-24 06:15:00,2019-03-24 06:30:00
67,1,0,1,0.00386345407288904,2019-03-24 06:15:00,2019-03-24 06:30:00
87,2,1,1,0.02569203459759902,2019-03-24 06:15:00,2019-03-24 06:30:00
89,1,0,1,0.00386345407288904,2019-03-24 06:15:00,2019-03-24 06:30:00
104,2,1,1,0.02569203459759902,2019-03-24 06:15:00,2019-03-24 06:30:00
110,2,2,0,0.0071477598664977295,2019-03-24 06:15:00,2019-03-24 06:30:00
111,2,0,2,0.00386345407288904,2019-03-24 06:15:00,2019-03-24 06:30:00
115,1,1,0,0.0071477598664977295,2019-03-24 06:15:00,2019-03-24 06:30:00
116,1,1,0,0.0071477598664977295,2019-03-24 06:15:00,2019-03-24 06:30:00
118,1,1,0,0.009939803798449698,2019-03-24 06:15:00,2019-03-24 06:30:00
119,1,0,1,0.00386345407288904,2019-03-24 06:15:00,2019-03-24 06:30:00
122,4,2,2,0.02569203459759902,2019-03-24 06:15:00,2019-03-24 06:30:00
126,2,1,1,0.02569203459759902,2019-03-24 06:15:00,2019-03-24 06:30:00
127,1,0,1,0.00386345407288904,2019-03-24 06:15:00,2019-03-24 06:30:00
137,5,2,3,0.008917511654792147,2019-03-24 06:15:00,2019-03-24 06:30:00
170,1,1,0,0.0071477598664977295,2019-03-24 06:15:00,2019-03-24 06:30:00
171,2,1,1,0.0071477598664977295,2019-03-24 06:15:00,2019-03-24 06:30:00
172,1,1,0,0.0071477598664977295,2019-03-24 06:15:00,2019-03-24 06:30:00
173,2,1,1,0.02569203459759902,2019-03-24 06:15:00,2019-03-24 06:30:00
175,2,1,1,0.02569203459759902,2019-03-24 06:15:00,2019-03-24 06:30:00
203,2,1,1,0.02569203459759902,2019-03-24 06:15:00,2019-03-24 06:30:00
15,5,1,4,0.00453607594859508,2019-03-24 06:30:00,2019-03-24 06:45:00
37,1,1,0,0.005908617990977879,2019-03-24 06:30:00,2019-03-24 06:45:00
41,1,1,0,0.006608644074876125,2019-03-24 06:30:00,2019-03-24 06:45:00
57,2,1,1,0.023766480799782407,2019-03-24 06:30:00,2019-03-24 06:45:00
61,1,0,1,0.0035720240531353755,2019-03-24 06:30:00,2019-03-24 06:45:00
67,1,0,1,0.0035720240531353755,2019-03-24 06:30:00,2019-03-24 06:45:00
68,1,0,1,0.0035720240531353755,2019-03-24 06:30:00,2019-03-24 06:45:00
87,2,1,1,0.023766480799782407,2019-03-24 06:30:00,2019-03-24 06:45:00
88,1,0,1,0.0035720240531353755,2019-03-24 06:30:00,2019-03-24 06:45:00
89,1,0,1,0.0035720240531353755,2019-03-24 06:30:00,2019-03-24 06:45:00
90,1,1,0,0.006608644074876125,2019-03-24 06:30:00,2019-03-24 06:45:00
104,2,1,1,0.023766480799782407,2019-03-24 06:30:00,2019-03-24 06:45:00
110,2,2,0,0.006608644074876125,2019-03-24 06:30:00,2019-03-24 06:45:00
111,2,0,2,0.0035720240531353755,2019-03-24 06:30:00,2019-03-24 06:45:00
115,1,1,0,0.006608644074876125,2019-03-24 06:30:00,2019-03-24 06:45:00
116,3,2,1,0.04396093754642944,2019-03-24 06:30:00,2019-03-24 06:45:00
118,1,1,0,0.009190193311582965,2019-03-24 06:30:00,2019-03-24 06:45:00
120,1,1,0,0.00453607594859508,2019-03-24 06:30:00,2019-03-24 06:45:00
122,4,2,2,0.023766480799782407,2019-03-24 06:30:00,2019-03-24 06:45:00
126,2,1,1,0.023766480799782407,2019-03-24 06:30:00,2019-03-24 06:45:00
127,1,0,1,0.0035720240531353755,2019-03-24 06:30:00,2019-03-24 06:45:00
135,2,1,1,0.023766480799782407,2019-03-24 06:30:00,2019-03-24 06:45:00
137,5,2,3,0.008245211928820384,2019-03-24 06:30:00,2019-03-24 06:45:00
171,2,1,1,0.006608644074876125,2019-03-24 06:30:00,2019-03-24 06:45:00
172,1,1,0,0.006608644074876125,2019-03-24 06:30:00,2019-03-24 06:45:00
173,2,1,1,0.023766480799782407,2019-03-24 06:30:00,2019-03-24 06:45:00
175,2,1,1,0.023766480799782407,2019-03-24 06:30:00,2019-03-24 06:45:00
203,4,3,1,0.03658675070057396,2019-03-24 06:30:00,2019-03-24 06:45:00
10,1,0,1,0.0037193444669280117,2019-03-24 06:45:00,2019-03-24 07:00:00
15,2,0,2,0.0037193444669280117,2019-03-24 06:45:00,2019-03-24 07:00:00
18,1,1,0,0.008806668877754407,2019-03-24 06:45:00,2019-03-24 07:00:00
20,1,1,0,0.011206114874420598,2019-03-24 06:45:00,2019-03-24 07:00:00
37,1,1,0,0.006152082817757146,2019-03-24 06:45:00,2019-03-24 07:00:00
41,1,1,0,0.006881133035576489,2019-03-24 06:45:00,2019-03-24 07:00:00
57,2,1,1,0.024731136601405947,2019-03-24 06:45:00,2019-03-24 07:00:00
61,1,0,1,0.0037193444669280117,2019-03-24 06:45:00,2019-03-24 07:00:00
67,1,0,1,0.0037193444669280117,2019-03-24 06:45:00,2019-03-24 07:00:00
68,1,0,1,0.0037193444669280117,2019-03-24 06:45:00,2019-03-24 07:00:00
87,2,1,1,0.024731136601405947,2019-03-24 06:45:00,2019-03-24 07:00:00
88,1,0,1,0.0037193444669280117,2019-03-24 06:45:00,2019-03-24 07:00:00
89,1,0,1,0.0037193444669280117,2019-03-24 06:45:00,2019-03-24 07:00:00
90,1,1,0,0.006881133035576489,2019-03-24 06:45:00,2019-03-24 07:00:00
104,2,1,1,0.024731136601405947,2019-03-24 06:45:00,2019-03-24 07:00:00
110,2,2,0,0.006881133035576489,2019-03-24 06:45:00,2019-03-24 07:00:00
111,2,0,2,0.0037193444669280117,2019-03-24 06:45:00,2019-03-24 07:00:00
115,1,1,0,0.006881133035576489,2019-03-24 06:45:00,2019-03-24 07:00:00
116,4,2,2,0.011968457446402885,2019-03-24 06:45:00,2019-03-24 07:00:00
118,1,1,0,0.009569011449736695,2019-03-24 06:45:00,2019-03-24 07:00:00
122,4,2,2,0.024731136601405947,2019-03-24 06:45:00,2019-03-24 07:00:00
126,2,1,1,0.024731136601405947,2019-03-24 06:45:00,2019-03-24 07:00:00
127,1,0,1,0.0037193444669280117,2019-03-24 06:45:00,2019-03-24 07:00:00
135,2,1,1,0.024731136601405947,2019-03-24 06:45:00,2019-03-24 07:00:00
137,5,2,3,0.00858482116858628,2019-03-24 06:45:00,2019-03-24 07:00:00
153,1,1,0,0.006881133035576489,2019-03-24 06:45:00,2019-03-24 07:00:00
171,2,1,1,0.006881133035576489,2019-03-24 06:45:00,2019-03-24 07:00:00
172,1,1,0,0.006881133035576489,2019-03-24 06:45:00,2019-03-24 07:00:00
173,2,1,1,0.024731136601405947,2019-03-24 06:45:00,2019-03-24 07:00:00
175,2,1,1,0.024731136601405947,2019-03-24 06:45:00,2019-03-24 07:00:00
191,2,1,1,0.008806668877754407,2019-03-24 06:45:00,2019-03-24 07:00:00
203,5,3,2,0.011968457446402883,2019-03-24 06:45:00,2019-03-24 07:00:00
10,1,0,1,0.003781660269597051,2019-03-24 07:00:00,2019-03-24 07:15:00
15,1,1,0,0.00972935534256396,2019-03-24 07:00:00,2019-03-24 07:15:00
18,1,1,0,0.006577447482658263,2019-03-24 07:00:00,2019-03-24 07:15:00
20,2,1,1,0.0069964297563638285,2019-03-24 07:00:00,2019-03-24 07:15:00
37,1,1,0,0.006255177054068152,2019-03-24 07:00:00,2019-03-24 07:15:00
41,1,1,0,0.0069964297563638285,2019-03-24 07:00:00,2019-03-24 07:15:00
57,2,1,1,0.025146560822876488,2019-03-24 07:00:00,2019-03-24 07:15:00
61,1,0,1,0.003781660269597051,2019-03-24 07:00:00,2019-03-24 07:15:00
67,1,0,1,0.003781660269597051,2019-03-24 07:00:00,2019-03-24 07:15:00
68,1,0,1,0.003781660269597051,2019-03-24 07:00:00,2019-03-24 07:15:00
87,2,1,1,0.025146560822876488,2019-03-24 07:00:00,2019-03-24 07:15:00
89,1,0,1,0.003781660269597051,2019-03-24 07:00:00,2019-03-24 07:15:00
90,1,1,0,0.0069964297563638285,2019-03-24 07:00:00,2019-03-24 07:15:00
104,2,1,1,0.025146560822876488,2019-03-24 07:00:00,2019-03-24 07:15:00
110,2,2,0,0.0069964297563638285,2019-03-24 07:00:00,2019-03-24 07:15:00
111,2,0,2,0.003781660269597051,2019-03-24 07:00:00,2019-03-24 07:15:00
115,1,1,0,0.0069964297563638285,2019-03-24 07:00:00,2019-03-24 07:15:00
116,1,1,0,0.0069964297563638285,2019-03-24 07:00:00,2019-03-24 07:15:00
118,1,1,0,0.00972935534256396,2019-03-24 07:00:00,2019-03-24 07:15:00
122,4,2,2,0.025146560822876488,2019-03-24 07:00:00,2019-03-24 07:15:00
126,2,1,1,0.025146560822876488,2019-03-24 07:00:00,2019-03-24 07:15:00
127,1,0,1,0.003781660269597051,2019-03-24 07:00:00,2019-03-24 07:15:00
135,2,1,1,0.025146560822876488,2019-03-24 07:00:00,2019-03-24 07:15:00
137,5,2,3,0.008728693838539251,2019-03-24 07:00:00,2019-03-24 07:15:00
140,1,0,1,0.003781660269597051,2019-03-24 07:00:00,2019-03-24 07:15:00
153,1,1,0,0.0069964297563638285,2019-03-24 07:00:00,2019-03-24 07:15:00
171,2,1,1,0.0069964297563638285,2019-03-24 07:00:00,2019-03-24 07:15:00
172,1,1,0,0.0069964297563638285,2019-03-24 07:00:00,2019-03-24 07:15:00
173,2,1,1,0.025146560822876488,2019-03-24 07:00:00,2019-03-24 07:15:00
175,2,1,1,0.025146560822876488,2019-03-24 07:00:00,2019-03-24 07:15:00
191,1,0,1,0.003781660269597051,2019-03-24 07:00:00,2019-03-24 07:15:00
203,3,1,2,0.006577447482658263,2019-03-24 07:00:00,2019-03-24 07:15:00
15,2,1,1,0.006741219285142751,2019-03-24 07:15:00,2019-03-24 07:30:00
18,2,0,2,0.0036437167116188146,2019-03-24 07:15:00,2019-03-24 07:30:00
20,1,0,1,0.0036437167116188146,2019-03-24 07:15:00,2019-03-24 07:30:00
37,1,1,0,0.007109167269232943,2019-03-24 07:15:00,2019-03-24 07:30:00
41,1,1,0,0.006741219285142751,2019-03-24 07:15:00,2019-03-24 07:30:00
57,2,1,1,0.024239009938231946,2019-03-24 07:15:00,2019-03-24 07:30:00
61,1,0,1,0.0036437167116188146,2019-03-24 07:15:00,2019-03-24 07:30:00
67,1,0,1,0.0036437167116188146,2019-03-24 07:15:00,2019-03-24 07:30:00
68,1,0,1,0.0036437167116188146,2019-03-24 07:15:00,2019-03-24 07:30:00
87,3,2,1,0.03453665655153851,2019-03-24 07:15:00,2019-03-24 07:30:00
89,1,0,1,0.0036437167116188146,2019-03-24 07:15:00,2019-03-24 07:30:00
104,2,1,1,0.024239009938231946,2019-03-24 07:15:00,2019-03-24 07:30:00
110,3,2,1,0.006741219285142751,2019-03-24 07:15:00,2019-03-24 07:30:00
111,2,0,2,0.0036437167116188146,2019-03-24 07:15:00,2019-03-24 07:30:00
112,1,1,0,0.006741219285142751,2019-03-24 07:15:00,2019-03-24 07:30:00
115,1,1,0,0.006741219285142751,2019-03-24 07:15:00,2019-03-24 07:30:00
116,2,2,0,0.012471957405111249,2019-03-24 07:15:00,2019-03-24 07:30:00
118,1,1,0,0.009374454831587312,2019-03-24 07:15:00,2019-03-24 07:30:00
119,1,1,0,0.005192467998380783,2019-03-24 07:15:00,2019-03-24 07:30:00
122,4,2,2,0.024239009938231946,2019-03-24 07:15:00,2019-03-24 07:30:00
126,2,1,1,0.024239009938231946,2019-03-24 07:15:00,2019-03-24 07:30:00
127,1,0,1,0.0036437167116188146,2019-03-24 07:15:00,2019-03-24 07:30:00
135,2,1,1,0.024239009938231946,2019-03-24 07:15:00,2019-03-24 07:30:00
137,7,3,4,0.016305355946815567,2019-03-24 07:15:00,2019-03-24 07:30:00
171,2,1,1,0.006741219285142751,2019-03-24 07:15:00,2019-03-24 07:30:00
172,1,1,0,0.006741219285142751,2019-03-24 07:15:00,2019-03-24 07:30:00
173,2,1,1,0.024239009938231946,2019-03-24 07:15:00,2019-03-24 07:30:00
175,2,1,1,0.024239009938231946,2019-03-24 07:15:00,2019-03-24 07:30:00
177,1,0,1,0.0036437167116188146,2019-03-24 07:15:00,2019-03-24 07:30:00
189,1,1,0,0.007109167269232943,2019-03-24 07:15:00,2019-03-24 07:30:00
203,2,1,1,0.024239009938231946,2019-03-24 07:15:00,2019-03-24 07:30:00
1,1,0,1,0.003462329926768021,2019-03-24 07:30:00,2019-03-24 07:45:00
10,2,1,1,0.006405698316145873,2019-03-24 07:30:00,2019-03-24 07:45:00
15,2,1,1,0.006405698316145873,2019-03-24 07:30:00,2019-03-24 07:45:00
18,2,0,2,0.003462329926768021,2019-03-24 07:30:00,2019-03-24 07:45:00
20,1,1,0,0.008907969646773537,2019-03-24 07:30:00,2019-03-24 07:45:00
37,1,1,0,0.005493234847034175,2019-03-24 07:30:00,2019-03-24 07:45:00
40,1,0,1,0.003462329926768021,2019-03-24 07:30:00,2019-03-24 07:45:00
57,3,2,1,0.04260289583735285,2019-03-24 07:30:00,2019-03-24 07:45:00
61,1,0,1,0.003462329926768021,2019-03-24 07:30:00,2019-03-24 07:45:00
67,1,0,1,0.003462329926768021,2019-03-24 07:30:00,2019-03-24 07:45:00
87,3,2,1,0.032817754359706644,2019-03-24 07:30:00,2019-03-24 07:45:00
89,1,0,1,0.003462329926768021,2019-03-24 07:30:00,2019-03-24 07:45:00
90,3,1,2,0.006022155215741801,2019-03-24 07:30:00,2019-03-24 07:45:00
104,3,1,2,0.006022155215741801,2019-03-24 07:30:00,2019-03-24 07:45:00
110,2,2,0,0.008907969646773537,2019-03-24 07:30:00,2019-03-24 07:45:00
111,3,1,2,0.006405698316145873,2019-03-24 07:30:00,2019-03-24 07:45:00
112,1,1,0,0.006405698316145873,2019-03-24 07:30:00,2019-03-24 07:45:00
115,1,1,0,0.006405698316145873,2019-03-24 07:30:00,2019-03-24 07:45:00
116,2,2,0,0.014027620224721097,2019-03-24 07:30:00,2019-03-24 07:45:00
118,1,1,0,0.008907969646773537,2019-03-24 07:30:00,2019-03-24 07:45:00
119,1,1,0,0.004934014121456947,2019-03-24 07:30:00,2019-03-24 07:45:00
120,1,0,1,0.003462329926768021,2019-03-24 07:30:00,2019-03-24 07:45:00
122,4,2,2,0.023032612882060436,2019-03-24 07:30:00,2019-03-24 07:45:00
126,3,2,1,0.04004307054837907,2019-03-24 07:30:00,2019-03-24 07:45:00
127,2,1,1,0.006022155215741801,2019-03-24 07:30:00,2019-03-24 07:45:00
135,2,1,1,0.023032612882060436,2019-03-24 07:30:00,2019-03-24 07:45:00
137,7,3,4,0.009555044687566483,2019-03-24 07:30:00,2019-03-24 07:45:00
161,2,1,1,0.023032612882060436,2019-03-24 07:30:00,2019-03-24 07:45:00
171,2,1,1,0.006405698316145873,2019-03-24 07:30:00,2019-03-24 07:45:00
172,1,1,0,0.006405698316145873,2019-03-24 07:30:00,2019-03-24 07:45:00
173,2,1,1,0.023032612882060436,2019-03-24 07:30:00,2019-03-24 07:45:00
175,2,1,1,0.023032612882060436,2019-03-24 07:30:00,2019-03-24 07:45:00
177,1,0,1,0.003462329926768021,2019-03-24 07:30:00,2019-03-24 07:45:00
190,1,0,1,0.003462329926768021,2019-03-24 07:30:00,2019-03-24 07:45:00
191,1,1,0,0.006405698316145873,2019-03-24 07:30:00,2019-03-24 07:45:00
199,1,0,1,0.003462329926768021,2019-03-24 07:30:00,2019-03-24 07:45:00
203,2,1,1,0.023032612882060436,2019-03-24 07:30:00,2019-03-24 07:45:00
1,1,0,1,0.0035238963746336252,2019-03-24 07:45:00,2019-03-24 08:00:00
10,2,1,1,0.0065195362859292606,2019-03-24 07:45:00,2019-03-24 08:00:00
15,1,1,0,0.0065195362859292606,2019-03-24 07:45:00,2019-03-24 08:00:00
18,1,0,1,0.0035238963746336252,2019-03-24 07:45:00,2019-03-24 08:00:00
20,1,1,0,0.009066173797502861,2019-03-24 07:45:00,2019-03-24 08:00:00
26,1,0,1,0.0035238963746336252,2019-03-24 07:45:00,2019-03-24 08:00:00
37,1,1,0,0.005828818805858485,2019-03-24 07:45:00,2019-03-24 08:00:00
40,1,0,1,0.0035238963746336252,2019-03-24 07:45:00,2019-03-24 08:00:00
46,1,0,1,0.0035238963746336252,2019-03-24 07:45:00,2019-03-24 08:00:00
57,3,2,1,0.043369403580658376,2019-03-24 07:45:00,2019-03-24 08:00:00
61,1,0,1,0.0035238963746336252,2019-03-24 07:45:00,2019-03-24 08:00:00
67,1,0,1,0.0035238963746336252,2019-03-24 07:45:00,2019-03-24 08:00:00
87,2,1,1,0.023446649977645995,2019-03-24 07:45:00,2019-03-24 08:00:00
88,1,1,0,0.005021716330281443,2019-03-24 07:45:00,2019-03-24 08:00:00
89,1,0,1,0.0035238963746336252,2019-03-24 07:45:00,2019-03-24 08:00:00
90,2,0,2,0.0035238963746336252,2019-03-24 07:45:00,2019-03-24 08:00:00
104,3,1,2,0.006129114331208108,2019-03-24 07:45:00,2019-03-24 08:00:00
110,2,2,0,0.009066173797502861,2019-03-24 07:45:00,2019-03-24 08:00:00
111,3,1,2,0.0065195362859292606,2019-03-24 07:45:00,2019-03-24 08:00:00
112,1,1,0,0.0065195362859292606,2019-03-24 07:45:00,2019-03-24 08:00:00
115,1,1,0,0.0065195362859292606,2019-03-24 07:45:00,2019-03-24 08:00:00
116,1,1,0,0.008734332287782592,2019-03-24 07:45:00,2019-03-24 08:00:00
118,1,1,0,0.009066173797502861,2019-03-24 07:45:00,2019-03-24 08:00:00
120,1,0,1,0.0035238963746336252,2019-03-24 07:45:00,2019-03-24 08:00:00
122,4,2,2,0.023446649977645995,2019-03-24 07:45:00,2019-03-24 08:00:00
126,3,2,1,0.03340802677915219,2019-03-24 07:45:00,2019-03-24 08:00:00
127,2,1,1,0.006129114331208108,2019-03-24 07:45:00,2019-03-24 08:00:00
135,2,1,1,0.023446649977645995,2019-03-24 07:45:00,2019-03-24 08:00:00
137,5,2,3,0.008133741237083346,2019-03-24 07:45:00,2019-03-24 08:00:00
157,1,1,0,0.0065195362859292606,2019-03-24 07:45:00,2019-03-24 08:00:00
161,2,1,1,0.023446649977645995,2019-03-24 07:45:00,2019-03-24 08:00:00
171,2,1,1,0.0065195362859292606,2019-03-24 07:45:00,2019-03-24 08:00:00
172,1,1,0,0.0065195362859292606,2019-03-24 07:45:00,2019-03-24 08:00:00
173,2,1,1,0.023446649977645995,2019-03-24 07:45:00,2019-03-24 08:00:00
175,2,1,1,0.023446649977645995,2019-03-24 07:45:00,2019-03-24 08:00:00
177,1,0,1,0.0035238963746336252,2019-03-24 07:45:00,2019-03-24 08:00:00
190,1,0,1,0.0035238963746336252,2019-03-24 07:45:00,2019-03-24 08:00:00
191,2,2,0,0.009515176197224895,2019-03-24 07:45:00,2019-03-24 08:00:00
199,1,0,1,0.0035238963746336252,2019-03-24 07:45:00,2019-03-24 08:00:00
200,1,1,0,0.0065195362859292606,2019-03-24 07:45:00,2019-03-24 08:00:00
203,2,1,1,0.023446649977645995,2019-03-24 07:45:00,2019-03-24 08:00:00
1,1,0,1,0.0035479424705117954,2019-03-24 08:00:00,2019-03-24 08:15:00
10,4,2,2,0.02360362766419729,2019-03-24 08:00:00,2019-03-24 08:15:00
15,1,1,0,0.011307819502251404,2019-03-24 08:00:00,2019-03-24 08:15:00
16,1,1,0,0.006564025402053933,2019-03-24 08:00:00,2019-03-24 08:15:00
18,1,0,1,0.0035479424705117954,2019-03-24 08:00:00,2019-03-24 08:15:00
22,4,2,2,0.02360362766419729,2019-03-24 08:00:00,2019-03-24 08:15:00
26,1,0,1,0.0035479424705117954,2019-03-24 08:00:00,2019-03-24 08:15:00
37,1,1,0,0.00586859213839536,2019-03-24 08:00:00,2019-03-24 08:15:00
40,2,1,1,0.009128042609237268,2019-03-24 08:00:00,2019-03-24 08:15:00
46,1,0,1,0.0035479424705117954,2019-03-24 08:00:00,2019-03-24 08:15:00
57,2,1,1,0.02360362766419729,2019-03-24 08:00:00,2019-03-24 08:15:00
61,1,0,1,0.0035479424705117954,2019-03-24 08:00:00,2019-03-24 08:15:00
66,1,0,1,0.0035479424705117954,2019-03-24 08:00:00,2019-03-24 08:15:00
67,1,0,1,0.0035479424705117954,2019-03-24 08:00:00,2019-03-24 08:15:00
69,1,1,0,0.006564025402053933,2019-03-24 08:00:00,2019-03-24 08:15:00
87,2,1,1,0.02360362766419729,2019-03-24 08:00:00,2019-03-24 08:15:00
88,1,1,0,0.006564025402053933,2019-03-24 08:00:00,2019-03-24 08:15:00
89,1,0,1,0.0035479424705117954,2019-03-24 08:00:00,2019-03-24 08:15:00
90,1,0,1,0.0035479424705117954,2019-03-24 08:00:00,2019-03-24 08:15:00
104,2,1,1,0.02360362766419729,2019-03-24 08:00:00,2019-03-24 08:15:00
110,2,2,0,0.011357952598315308,2019-03-24 08:00:00,2019-03-24 08:15:00
111,4,2,2,0.009187021862364022,2019-03-24 08:00:00,2019-03-24 08:15:00
115,1,1,0,0.006564025402053933,2019-03-24 08:00:00,2019-03-24 08:15:00
116,1,1,0,0.006564025402053933,2019-03-24 08:00:00,2019-03-24 08:15:00
118,1,1,0,0.009128042609237268,2019-03-24 08:00:00,2019-03-24 08:15:00
122,4,2,2,0.02360362766419729,2019-03-24 08:00:00,2019-03-24 08:15:00
126,2,1,1,0.02360362766419729,2019-03-24 08:00:00,2019-03-24 08:15:00
127,1,0,1,0.0035479424705117954,2019-03-24 08:00:00,2019-03-24 08:15:00
135,2,1,1,0.02360362766419729,2019-03-24 08:00:00,2019-03-24 08:15:00
137,5,2,3,0.008189241806278924,2019-03-24 08:00:00,2019-03-24 08:15:00
141,1,1,0,0.006564025402053933,2019-03-24 08:00:00,2019-03-24 08:15:00
153,1,0,1,0.0035479424705117954,2019-03-24 08:00:00,2019-03-24 08:15:00
157,2,1,1,0.006564025402053933,2019-03-24 08:00:00,2019-03-24 08:15:00
171,2,1,1,0.006564025402053933,2019-03-24 08:00:00,2019-03-24 08:15:00
172,1,1,0,0.006564025402053933,2019-03-24 08:00:00,2019-03-24 08:15:00
173,3,1,2,0.006170938930821884,2019-03-24 08:00:00,2019-03-24 08:15:00
175,2,1,1,0.02360362766419729,2019-03-24 08:00:00,2019-03-24 08:15:00
200,1,1,0,0.006564025402053933,2019-03-24 08:00:00,2019-03-24 08:15:00
203,2,1,1,0.02360362766419729,2019-03-24 08:00:00,2019-03-24 08:15:00
10,5,3,2,0.04289149508153758,2019-03-24 08:15:00,2019-03-24 08:30:00
16,2,0,2,0.0034850995836862436,2019-03-24 08:15:00,2019-03-24 08:30:00
18,1,0,1,0.0034850995836862436,2019-03-24 08:15:00,2019-03-24 08:30:00
22,5,3,2,0.04013527980792611,2019-03-24 08:15:00,2019-03-24 08:30:00
26,1,0,1,0.0034850995836862436,2019-03-24 08:15:00,2019-03-24 08:30:00
37,1,1,0,0.005764824014125277,2019-03-24 08:15:00,2019-03-24 08:30:00
40,1,1,0,0.006447820858429942,2019-03-24 08:15:00,2019-03-24 08:30:00
41,1,0,1,0.0034850995836862436,2019-03-24 08:15:00,2019-03-24 08:30:00
57,2,1,1,0.023188297332611903,2019-03-24 08:15:00,2019-03-24 08:30:00
61,1,0,1,0.0034850995836862436,2019-03-24 08:15:00,2019-03-24 08:30:00
67,1,0,1,0.0034850995836862436,2019-03-24 08:15:00,2019-03-24 08:30:00
69,1,1,0,0.006447820858429942,2019-03-24 08:15:00,2019-03-24 08:30:00
79,1,0,1,0.0034850995836862436,2019-03-24 08:15:00,2019-03-24 08:30:00
87,2,1,1,0.023188297332611903,2019-03-24 08:15:00,2019-03-24 08:30:00
89,1,0,1,0.0034850995836862436,2019-03-24 08:15:00,2019-03-24 08:30:00
104,2,1,1,0.023188297332611903,2019-03-24 08:15:00,2019-03-24 08:30:00
110,2,2,0,0.008638411107243855,2019-03-24 08:15:00,2019-03-24 08:30:00
111,3,1,2,0.006061755345465049,2019-03-24 08:15:00,2019-03-24 08:30:00
115,1,1,0,0.006447820858429942,2019-03-24 08:15:00,2019-03-24 08:30:00
116,1,1,0,0.006447820858429942,2019-03-24 08:15:00,2019-03-24 08:30:00
118,1,1,0,0.00603480885616546,2019-03-24 08:15:00,2019-03-24 08:30:00
122,4,2,2,0.023188297332611903,2019-03-24 08:15:00,2019-03-24 08:30:00
126,2,1,1,0.023188297332611903,2019-03-24 08:15:00,2019-03-24 08:30:00
127,1,0,1,0.0034850995836862436,2019-03-24 08:15:00,2019-03-24 08:30:00
135,2,1,1,0.023188297332611903,2019-03-24 08:15:00,2019-03-24 08:30:00
137,5,2,3,0.008044548444564311,2019-03-24 08:15:00,2019-03-24 08:30:00
141,1,1,0,0.006447820858429942,2019-03-24 08:15:00,2019-03-24 08:30:00
153,1,0,1,0.0034850995836862436,2019-03-24 08:15:00,2019-03-24 08:30:00
157,1,0,1,0.0034850995836862436,2019-03-24 08:15:00,2019-03-24 08:30:00
164,2,2,0,0.006447820858429942,2019-03-24 08:15:00,2019-03-24 08:30:00
171,5,2,3,0.008997530130909159,2019-03-24 08:15:00,2019-03-24 08:30:00
172,1,1,0,0.006447820858429942,2019-03-24 08:15:00,2019-03-24 08:30:00
173,3,1,2,0.006061755345465049,2019-03-24 08:15:00,2019-03-24 08:30:00
175,2,1,1,0.023188297332611903,2019-03-24 08:15:00,2019-03-24 08:30:00
190,1,1,0,0.006447820858429942,2019-03-24 08:15:00,2019-03-24 08:30:00
200,1,1,0,0.006447820858429942,2019-03-24 08:15:00,2019-03-24 08:30:00
203,2,1,1,0.023188297332611903,2019-03-24 08:15:00,2019-03-24 08:30:00
5,1,1,0,0.004359317797570193,2019-03-24 08:30:00,2019-03-24 08:45:00
10,5,3,2,0.04181331353500837,2019-03-24 08:30:00,2019-03-24 08:45:00
15,2,1,1,0.022605044774922492,2019-03-24 08:30:00,2019-03-24 08:45:00
18,1,0,1,0.0033967760148365996,2019-03-24 08:30:00,2019-03-24 08:45:00
22,3,3,0,0.014114234195505908,2019-03-24 08:30:00,2019-03-24 08:45:00
26,1,1,0,0.006284401363037378,2019-03-24 08:30:00,2019-03-24 08:45:00
28,3,1,2,0.005908113759932833,2019-03-24 08:30:00,2019-03-24 08:45:00
37,1,1,0,0.0056187055142114944,2019-03-24 08:30:00,2019-03-24 08:45:00
40,1,1,0,0.006284401363037378,2019-03-24 08:30:00,2019-03-24 08:45:00
41,2,2,0,0.005321859580303785,2019-03-24 08:30:00,2019-03-24 08:45:00
57,2,1,1,0.022605044774922492,2019-03-24 08:30:00,2019-03-24 08:45:00
61,1,0,1,0.0033967760148365996,2019-03-24 08:30:00,2019-03-24 08:45:00
67,1,0,1,0.0033967760148365996,2019-03-24 08:30:00,2019-03-24 08:45:00
69,1,0,1,0.0033967760148365996,2019-03-24 08:30:00,2019-03-24 08:45:00
79,1,0,1,0.0033967760148365996,2019-03-24 08:30:00,2019-03-24 08:45:00
87,2,1,1,0.022605044774922492,2019-03-24 08:30:00,2019-03-24 08:45:00
89,1,0,1,0.0033967760148365996,2019-03-24 08:30:00,2019-03-24 08:45:00
104,2,1,1,0.022605044774922492,2019-03-24 08:30:00,2019-03-24 08:45:00
110,2,2,0,0.006284401363037378,2019-03-24 08:30:00,2019-03-24 08:45:00
111,2,0,2,0.0033967760148365996,2019-03-24 08:30:00,2019-03-24 08:45:00
112,1,1,0,0.006284401363037378,2019-03-24 08:30:00,2019-03-24 08:45:00
114,1,1,0,0.005908113759932833,2019-03-24 08:30:00,2019-03-24 08:45:00
115,1,1,0,0.006284401363037378,2019-03-24 08:30:00,2019-03-24 08:45:00
116,1,1,0,0.006284401363037378,2019-03-24 08:30:00,2019-03-24 08:45:00
118,2,1,1,0.006068023441222044,2019-03-24 08:30:00,2019-03-24 08:45:00
122,4,2,2,0.022605044774922492,2019-03-24 08:30:00,2019-03-24 08:45:00
126,3,2,1,0.04181331353500837,2019-03-24 08:30:00,2019-03-24 08:45:00
127,1,0,1,0.0033967760148365996,2019-03-24 08:30:00,2019-03-24 08:45:00
135,2,1,1,0.022605044774922492,2019-03-24 08:30:00,2019-03-24 08:45:00
137,5,2,3,0.00784063501358639,2019-03-24 08:30:00,2019-03-24 08:45:00
141,1,1,0,0.006284401363037378,2019-03-24 08:30:00,2019-03-24 08:45:00
147,1,0,1,0.0033967760148365996,2019-03-24 08:30:00,2019-03-24 08:45:00
157,1,0,1,0.0033967760148365996,2019-03-24 08:30:00,2019-03-24 08:45:00
162,1,0,1,0.0033967760148365996,2019-03-24 08:30:00,2019-03-24 08:45:00
171,3,1,2,0.006284401363037378,2019-03-24 08:30:00,2019-03-24 08:45:00
172,1,1,0,0.006284401363037378,2019-03-24 08:30:00,2019-03-24 08:45:00
173,2,1,1,0.022605044774922492,2019-03-24 08:30:00,2019-03-24 08:45:00
175,2,1,1,0.022605044774922492,2019-03-24 08:30:00,2019-03-24 08:45:00
197,3,0,3,0.0033967760148365996,2019-03-24 08:30:00,2019-03-24 08:45:00
200,1,0,1,0.0033967760148365996,2019-03-24 08:30:00,2019-03-24 08:45:00
203,2,1,1,0.022605044774922492,2019-03-24 08:30:00,2019-03-24 08:45:00
5,1,1,0,0.0045157621746973785,2019-03-24 08:45:00,2019-03-24 09:00:00
10,5,3,2,0.04329817218149107,2019-03-24 08:45:00,2019-03-24 09:00:00
15,1,1,0,0.004266494176251132,2019-03-24 08:45:00,2019-03-24 09:00:00
16,1,1,0,0.004266494176251132,2019-03-24 08:45:00,2019-03-24 09:00:00
18,4,0,4,0.00351869018091239,2019-03-24 08:45:00,2019-03-24 09:00:00
19,1,0,1,0.00351869018091239,2019-03-24 08:45:00,2019-03-24 09:00:00
20,1,1,0,0.006509906162267355,2019-03-24 08:45:00,2019-03-24 09:00:00
22,2,2,0,0.00950112214362232,2019-03-24 08:45:00,2019-03-24 09:00:00
23,2,2,0,0.007973626840504084,2019-03-24 08:45:00,2019-03-24 09:00:00
26,1,1,0,0.006509906162267355,2019-03-24 08:45:00,2019-03-24 09:00:00
28,2,1,1,0.023408431181201724,2019-03-24 08:45:00,2019-03-24 09:00:00
37,2,2,0,0.007276686802098517,2019-03-24 08:45:00,2019-03-24 09:00:00
40,1,1,0,0.006509906162267355,2019-03-24 08:45:00,2019-03-24 09:00:00
41,2,2,0,0.005512834168482366,2019-03-24 08:45:00,2019-03-24 09:00:00
46,1,1,0,0.006509906162267355,2019-03-24 08:45:00,2019-03-24 09:00:00
57,2,1,1,0.023408431181201724,2019-03-24 08:45:00,2019-03-24 09:00:00
58,3,1,2,0.005014298171589873,2019-03-24 08:45:00,2019-03-24 09:00:00
61,1,0,1,0.00351869018091239,2019-03-24 08:45:00,2019-03-24 09:00:00
62,1,1,0,0.005014298171589873,2019-03-24 08:45:00,2019-03-24 09:00:00
67,2,0,2,0.00351869018091239,2019-03-24 08:45:00,2019-03-24 09:00:00
69,1,0,1,0.00351869018091239,2019-03-24 08:45:00,2019-03-24 09:00:00
79,1,0,1,0.00351869018091239,2019-03-24 08:45:00,2019-03-24 09:00:00
85,1,0,1,0.00351869018091239,2019-03-24 08:45:00,2019-03-24 09:00:00
87,2,1,1,0.023408431181201724,2019-03-24 08:45:00,2019-03-24 09:00:00
89,1,0,1,0.00351869018091239,2019-03-24 08:45:00,2019-03-24 09:00:00
90,2,0,2,0.00351869018091239,2019-03-24 08:45:00,2019-03-24 09:00:00
101,1,1,0,0.005781078811421034,2019-03-24 08:45:00,2019-03-24 09:00:00
104,2,1,1,0.023408431181201724,2019-03-24 08:45:00,2019-03-24 09:00:00
110,2,2,0,0.005014298171589873,2019-03-24 08:45:00,2019-03-24 09:00:00
111,4,0,4,0.00351869018091239,2019-03-24 08:45:00,2019-03-24 09:00:00
112,2,2,0,0.007257710157606096,2019-03-24 08:45:00,2019-03-24 09:00:00
115,3,3,0,0.00950112214362232,2019-03-24 08:45:00,2019-03-24 09:00:00
116,2,2,0,0.00950112214362232,2019-03-24 08:45:00,2019-03-24 09:00:00
118,1,0,1,0.00351869018091239,2019-03-24 08:45:00,2019-03-24 09:00:00
119,1,1,0,0.005014298171589873,2019-03-24 08:45:00,2019-03-24 09:00:00
122,4,2,2,0.023408431181201724,2019-03-24 08:45:00,2019-03-24 09:00:00
126,4,2,2,0.008721430835842824,2019-03-24 08:45:00,2019-03-24 09:00:00
127,1,0,1,0.00351869018091239,2019-03-24 08:45:00,2019-03-24 09:00:00
135,2,1,1,0.023408431181201724,2019-03-24 08:45:00,2019-03-24 09:00:00
137,7,3,4,0.010644837769394894,2019-03-24 08:45:00,2019-03-24 09:00:00
141,1,1,0,0.004266494176251132,2019-03-24 08:45:00,2019-03-24 09:00:00
147,1,0,1,0.00351869018091239,2019-03-24 08:45:00,2019-03-24 09:00:00
157,1,0,1,0.00351869018091239,2019-03-24 08:45:00,2019-03-24 09:00:00
158,2,2,0,0.007781344921116056,2019-03-24 08:45:00,2019-03-24 09:00:00
162,2,0,2,0.00351869018091239,2019-03-24 08:45:00,2019-03-24 09:00:00
164,2,0,2,0.00351869018091239,2019-03-24 08:45:00,2019-03-24 09:00:00
171,1,1,0,0.006509906162267355,2019-03-24 08:45:00,2019-03-24 09:00:00
172,1,1,0,0.005014298171589873,2019-03-24 08:45:00,2019-03-24 09:00:00
175,2,1,1,0.023408431181201724,2019-03-24 08:45:00,2019-03-24 09:00:00
189,1,1,0,0.004266494176251132,2019-03-24 08:45:00,2019-03-24 09:00:00
197,3,0,3,0.00351869018091239,2019-03-24 08:45:00,2019-03-24 09:00:00
199,1,0,1,0.00351869018091239,2019-03-24 08:45:00,2019-03-24 09:00:00
200,1,0,1,0.00351869018091239,2019-03-24 08:45:00,2019-03-24 09:00:00
201,3,1,2,0.0061200605083776075,2019-03-24 08:45:00,2019-03-24 09:00:00
203,2,1,1,0.023408431181201724,2019-03-24 08:45:00,2019-03-24 09:00:00
10,5,3,2,0.04069501467336727,2019-03-24 09:00:00,2019-03-24 09:15:00
15,1,1,0,0.004306609851378313,2019-03-24 09:00:00,2019-03-24 09:15:00
18,3,0,3,0.0033054947384060806,2019-03-24 09:00:00,2019-03-24 09:15:00
19,4,2,2,0.022000254705886686,2019-03-24 09:00:00,2019-03-24 09:15:00
20,1,1,0,0.006115512739502213,2019-03-24 09:00:00,2019-03-24 09:15:00
23,2,2,0,0.005613683748588439,2019-03-24 09:00:00,2019-03-24 09:15:00
26,1,1,0,0.006115512739502213,2019-03-24 09:00:00,2019-03-24 09:15:00
28,2,1,1,0.022000254705886686,2019-03-24 09:00:00,2019-03-24 09:15:00
37,2,2,0,0.006451836402776267,2019-03-24 09:00:00,2019-03-24 09:15:00
40,1,1,0,0.006115512739502213,2019-03-24 09:00:00,2019-03-24 09:15:00
46,1,1,0,0.006115512739502213,2019-03-24 09:00:00,2019-03-24 09:15:00
57,2,1,1,0.022000254705886686,2019-03-24 09:00:00,2019-03-24 09:15:00
58,1,1,0,0.004710503738954147,2019-03-24 09:00:00,2019-03-24 09:15:00
61,1,0,1,0.0033054947384060806,2019-03-24 09:00:00,2019-03-24 09:15:00
62,2,1,1,0.006115512739502213,2019-03-24 09:00:00,2019-03-24 09:15:00
67,2,0,2,0.0033054947384060806,2019-03-24 09:00:00,2019-03-24 09:15:00
69,1,0,1,0.0033054947384060806,2019-03-24 09:00:00,2019-03-24 09:15:00
79,1,0,1,0.0033054947384060806,2019-03-24 09:00:00,2019-03-24 09:15:00
85,1,0,1,0.0033054947384060806,2019-03-24 09:00:00,2019-03-24 09:15:00
87,2,1,1,0.022000254705886686,2019-03-24 09:00:00,2019-03-24 09:15:00
88,1,1,0,0.004710503738954147,2019-03-24 09:00:00,2019-03-24 09:15:00
89,2,0,2,0.0033054947384060806,2019-03-24 09:00:00,2019-03-24 09:15:00
90,2,0,2,0.0033054947384060806,2019-03-24 09:00:00,2019-03-24 09:15:00
101,1,1,0,0.005046827402228201,2019-03-24 09:00:00,2019-03-24 09:15:00
104,3,2,1,0.030694097741021924,2019-03-24 09:00:00,2019-03-24 09:15:00
110,2,2,0,0.005307724964350544,2019-03-24 09:00:00,2019-03-24 09:15:00
111,5,1,4,0.004710503738954147,2019-03-24 09:00:00,2019-03-24 09:15:00
112,4,3,1,0.046926601329194136,2019-03-24 09:00:00,2019-03-24 09:15:00
114,1,1,0,0.006920418841382633,2019-03-24 09:00:00,2019-03-24 09:15:00
115,2,2,0,0.0075205217400502785,2019-03-24 09:00:00,2019-03-24 09:15:00
116,1,1,0,0.006115512739502213,2019-03-24 09:00:00,2019-03-24 09:15:00
119,1,1,0,0.004710503738954147,2019-03-24 09:00:00,2019-03-24 09:15:00
120,1,0,1,0.0033054947384060806,2019-03-24 09:00:00,2019-03-24 09:15:00
122,4,2,2,0.022000254705886686,2019-03-24 09:00:00,2019-03-24 09:15:00
126,4,1,3,0.004612568635616206,2019-03-24 09:00:00,2019-03-24 09:15:00
127,1,0,1,0.0033054947384060806,2019-03-24 09:00:00,2019-03-24 09:15:00
135,2,1,1,0.022000254705886686,2019-03-24 09:00:00,2019-03-24 09:15:00
137,7,3,4,0.008193169066598387,2019-03-24 09:00:00,2019-03-24 09:15:00
141,1,1,0,0.004242167405438125,2019-03-24 09:00:00,2019-03-24 09:15:00
153,3,1,2,0.008504397641087803,2019-03-24 09:00:00,2019-03-24 09:15:00
157,1,0,1,0.0033054947384060806,2019-03-24 09:00:00,2019-03-24 09:15:00
162,1,0,1,0.0033054947384060806,2019-03-24 09:00:00,2019-03-24 09:15:00
171,1,1,0,0.006115512739502213,2019-03-24 09:00:00,2019-03-24 09:15:00
172,1,1,0,0.004710503738954147,2019-03-24 09:00:00,2019-03-24 09:15:00
175,2,1,1,0.022000254705886686,2019-03-24 09:00:00,2019-03-24 09:15:00
177,1,0,1,0.0033054947384060806,2019-03-24 09:00:00,2019-03-24 09:15:00
189,1,1,0,0.004242167405438125,2019-03-24 09:00:00,2019-03-24 09:15:00
191,1,1,0,0.006115512739502213,2019-03-24 09:00:00,2019-03-24 09:15:00
195,1,1,0,0.006920418841382633,2019-03-24 09:00:00,2019-03-24 09:15:00
199,1,0,1,0.0033054947384060806,2019-03-24 09:00:00,2019-03-24 09:15:00
200,1,0,1,0.0033054947384060806,2019-03-24 09:00:00,2019-03-24 09:15:00
201,2,0,2,0.0033054947384060806,2019-03-24 09:00:00,2019-03-24 09:15:00
203,2,1,1,0.022000254705886686,2019-03-24 09:00:00,2019-03-24 09:15:00
1,1,0,1,0.0034007128207375215,2019-03-24 09:15:00,2019-03-24 09:30:00
10,4,2,2,0.022630730331414835,2019-03-24 09:15:00,2019-03-24 09:30:00
18,1,0,1,0.0034007128207375215,2019-03-24 09:15:00,2019-03-24 09:30:00
19,3,1,2,0.005914848426636952,2019-03-24 09:15:00,2019-03-24 09:30:00
28,2,1,1,0.022630730331414835,2019-03-24 09:15:00,2019-03-24 09:30:00
37,1,1,0,0.004657780623687237,2019-03-24 09:15:00,2019-03-24 09:30:00
40,1,1,0,0.006291627309199602,2019-03-24 09:15:00,2019-03-24 09:30:00
41,1,0,1,0.0034007128207375215,2019-03-24 09:15:00,2019-03-24 09:30:00
57,2,1,1,0.022630730331414835,2019-03-24 09:15:00,2019-03-24 09:30:00
58,1,0,1,0.0034007128207375215,2019-03-24 09:15:00,2019-03-24 09:30:00
61,1,0,1,0.0034007128207375215,2019-03-24 09:15:00,2019-03-24 09:30:00
62,4,3,1,0.008805762915099033,2019-03-24 09:15:00,2019-03-24 09:30:00
67,1,0,1,0.0034007128207375215,2019-03-24 09:15:00,2019-03-24 09:30:00
68,2,2,0,0.008123356992312005,2019-03-24 09:15:00,2019-03-24 09:30:00
79,1,1,0,0.006291627309199602,2019-03-24 09:15:00,2019-03-24 09:30:00
87,2,1,1,0.022630730331414835,2019-03-24 09:15:00,2019-03-24 09:30:00
89,2,0,2,0.0034007128207375215,2019-03-24 09:15:00,2019-03-24 09:30:00
101,3,2,1,0.030988671283803775,2019-03-24 09:15:00,2019-03-24 09:30:00
104,3,2,1,0.038327163651568776,2019-03-24 09:15:00,2019-03-24 09:30:00
110,2,2,0,0.007520428063628975,2019-03-24 09:15:00,2019-03-24 09:30:00
111,3,1,2,0.004846170064968562,2019-03-24 09:15:00,2019-03-24 09:30:00
114,2,2,0,0.010572382204505078,2019-03-24 09:15:00,2019-03-24 09:30:00
115,2,2,0,0.0077370845534306424,2019-03-24 09:15:00,2019-03-24 09:30:00
116,1,1,0,0.008258649753738592,2019-03-24 09:15:00,2019-03-24 09:30:00
120,1,0,1,0.0034007128207375215,2019-03-24 09:15:00,2019-03-24 09:30:00
122,4,2,2,0.022630730331414835,2019-03-24 09:15:00,2019-03-24 09:30:00
126,6,2,4,0.011110550903845589,2019-03-24 09:15:00,2019-03-24 09:30:00
127,2,1,1,0.005714445271504005,2019-03-24 09:15:00,2019-03-24 09:30:00
135,2,1,1,0.022630730331414835,2019-03-24 09:15:00,2019-03-24 09:30:00
137,6,2,4,0.005914848426636952,2019-03-24 09:15:00,2019-03-24 09:30:00
141,1,1,0,0.006291627309199602,2019-03-24 09:15:00,2019-03-24 09:30:00
153,5,1,4,0.010886585541395127,2019-03-24 09:15:00,2019-03-24 09:30:00
157,1,0,1,0.0034007128207375215,2019-03-24 09:15:00,2019-03-24 09:30:00
159,1,0,1,0.0034007128207375215,2019-03-24 09:15:00,2019-03-24 09:30:00
171,1,1,0,0.006291627309199602,2019-03-24 09:15:00,2019-03-24 09:30:00
172,2,1,1,0.006291627309199602,2019-03-24 09:15:00,2019-03-24 09:30:00
175,2,1,1,0.022630730331414835,2019-03-24 09:15:00,2019-03-24 09:30:00
177,1,0,1,0.0034007128207375215,2019-03-24 09:15:00,2019-03-24 09:30:00
190,2,0,2,0.0034007128207375215,2019-03-24 09:15:00,2019-03-24 09:30:00
191,4,4,0,0.014964370774585843,2019-03-24 09:15:00,2019-03-24 09:30:00
195,1,1,0,0.005714445271504005,2019-03-24 09:15:00,2019-03-24 09:30:00
196,2,1,1,0.005714445271504005,2019-03-24 09:15:00,2019-03-24 09:30:00
203,2,1,1,0.022630730331414835,2019-03-24 09:15:00,2019-03-24 09:30:00
1,1,0,1,0.0034557680563934625,2019-03-24 09:30:00,2019-03-24 09:45:00
2,1,0,1,0.0034557680563934625,2019-03-24 09:30:00,2019-03-24 09:45:00
10,4,2,2,0.022995206329167565,2019-03-24 09:30:00,2019-03-24 09:45:00
18,1,0,1,0.0034557680563934625,2019-03-24 09:30:00,2019-03-24 09:45:00
19,2,1,1,0.00473319075522677,2019-03-24 09:30:00,2019-03-24 09:45:00
21,1,1,0,0.006393489163794463,2019-03-24 09:30:00,2019-03-24 09:45:00
28,2,1,1,0.022995206329167565,2019-03-24 09:30:00,2019-03-24 09:45:00
37,1,1,0,0.005716122961285883,2019-03-24 09:30:00,2019-03-24 09:45:00
40,1,1,0,0.006393489163794463,2019-03-24 09:30:00,2019-03-24 09:45:00
41,1,0,1,0.0034557680563934625,2019-03-24 09:30:00,2019-03-24 09:45:00
46,1,0,1,0.0034557680563934625,2019-03-24 09:30:00,2019-03-24 09:45:00
57,3,2,1,0.04253464460194167,2019-03-24 09:30:00,2019-03-24 09:45:00
58,3,1,2,0.006010613454060077,2019-03-24 09:30:00,2019-03-24 09:45:00
61,1,0,1,0.0034557680563934625,2019-03-24 09:30:00,2019-03-24 09:45:00
62,2,2,0,0.010417195115161579,2019-03-24 09:30:00,2019-03-24 09:45:00
67,1,0,1,0.0034557680563934625,2019-03-24 09:30:00,2019-03-24 09:45:00
68,2,2,0,0.006188691072591327,2019-03-24 09:30:00,2019-03-24 09:45:00
69,2,2,0,0.006393489163794463,2019-03-24 09:30:00,2019-03-24 09:45:00
85,4,2,2,0.022995206329167565,2019-03-24 09:30:00,2019-03-24 09:45:00
87,2,1,1,0.022995206329167565,2019-03-24 09:30:00,2019-03-24 09:45:00
89,1,0,1,0.0034557680563934625,2019-03-24 09:30:00,2019-03-24 09:45:00
101,2,1,1,0.022995206329167565,2019-03-24 09:30:00,2019-03-24 09:45:00
104,2,1,1,0.022995206329167565,2019-03-24 09:30:00,2019-03-24 09:45:00
110,2,2,0,0.006393489163794463,2019-03-24 09:30:00,2019-03-24 09:45:00
111,2,0,2,0.0034557680563934625,2019-03-24 09:30:00,2019-03-24 09:45:00
112,2,1,1,0.00473319075522677,2019-03-24 09:30:00,2019-03-24 09:45:00
115,2,2,0,0.009331210271195465,2019-03-24 09:30:00,2019-03-24 09:45:00
118,2,0,2,0.0034557680563934625,2019-03-24 09:30:00,2019-03-24 09:45:00
122,6,2,4,0.006010613454060077,2019-03-24 09:30:00,2019-03-24 09:45:00
126,4,1,3,0.004822229564492395,2019-03-24 09:30:00,2019-03-24 09:45:00
127,1,1,0,0.004924628610093963,2019-03-24 09:30:00,2019-03-24 09:45:00
135,2,1,1,0.022995206329167565,2019-03-24 09:30:00,2019-03-24 09:45:00
137,5,2,3,0.007976477866178304,2019-03-24 09:30:00,2019-03-24 09:45:00
141,1,1,0,0.006393489163794463,2019-03-24 09:30:00,2019-03-24 09:45:00
153,2,0,2,0.0034557680563934625,2019-03-24 09:30:00,2019-03-24 09:45:00
157,1,0,1,0.0034557680563934625,2019-03-24 09:30:00,2019-03-24 09:45:00
171,1,1,0,0.006393489163794463,2019-03-24 09:30:00,2019-03-24 09:45:00
172,1,1,0,0.006393489163794463,2019-03-24 09:30:00,2019-03-24 09:45:00
175,2,1,1,0.022995206329167565,2019-03-24 09:30:00,2019-03-24 09:45:00
177,2,1,1,0.007479474007760578,2019-03-24 09:30:00,2019-03-24 09:45:00
190,1,0,1,0.0034557680563934625,2019-03-24 09:30:00,2019-03-24 09:45:00
191,5,5,0,0.02118216597910133,2019-03-24 09:30:00,2019-03-24 09:45:00
196,1,1,0,0.004924628610093963,2019-03-24 09:30:00,2019-03-24 09:45:00
197,1,0,1,0.0034557680563934625,2019-03-24 09:30:00,2019-03-24 09:45:00
201,1,0,1,0.0034557680563934625,2019-03-24 09:30:00,2019-03-24 09:45:00
203,2,1,1,0.022995206329167565,2019-03-24 09:30:00,2019-03-24 09:45:00
1,2,1,1,0.003945054692614167,2019-03-24 09:45:00,2019-03-24 10:00:00
2,1,0,1,0.0031066267605553933,2019-03-24 09:45:00,2019-03-24 10:00:00
10,4,2,2,0.020681146472191828,2019-03-24 09:45:00,2019-03-24 10:00:00
15,2,0,2,0.0031066267605553933,2019-03-24 09:45:00,2019-03-24 10:00:00
18,1,0,1,0.0031066267605553933,2019-03-24 09:45:00,2019-03-24 10:00:00
19,2,1,1,0.0047431629750741,2019-03-24 09:45:00,2019-03-24 10:00:00
21,1,1,0,0.005747563844225492,2019-03-24 09:45:00,2019-03-24 10:00:00
23,2,2,0,0.007298766420849263,2019-03-24 09:45:00,2019-03-24 10:00:00
28,2,1,1,0.020681146472191828,2019-03-24 09:45:00,2019-03-24 10:00:00
35,2,1,1,0.020681146472191828,2019-03-24 09:45:00,2019-03-24 10:00:00
37,1,1,0,0.006283998807498296,2019-03-24 09:45:00,2019-03-24 10:00:00
40,1,1,0,0.005747563844225492,2019-03-24 09:45:00,2019-03-24 10:00:00
46,1,0,1,0.0031066267605553933,2019-03-24 09:45:00,2019-03-24 10:00:00
50,1,1,0,0.007138887318723273,2019-03-24 09:45:00,2019-03-24 10:00:00
57,5,2,3,0.0061776795495372735,2019-03-24 09:45:00,2019-03-24 10:00:00
58,3,2,1,0.04815044532591782,2019-03-24 09:45:00,2019-03-24 10:00:00
61,1,0,1,0.0031066267605553933,2019-03-24 09:45:00,2019-03-24 10:00:00
62,3,1,2,0.003945054692614167,2019-03-24 09:45:00,2019-03-24 10:00:00
67,2,1,1,0.005747563844225492,2019-03-24 09:45:00,2019-03-24 10:00:00
85,4,2,2,0.020681146472191828,2019-03-24 09:45:00,2019-03-24 10:00:00
86,2,2,0,0.006460338488790489,2019-03-24 09:45:00,2019-03-24 10:00:00
87,2,1,1,0.020681146472191828,2019-03-24 09:45:00,2019-03-24 10:00:00
88,2,1,1,0.005747563844225492,2019-03-24 09:45:00,2019-03-24 10:00:00
89,1,0,1,0.0031066267605553933,2019-03-24 09:45:00,2019-03-24 10:00:00
90,1,0,1,0.0031066267605553933,2019-03-24 09:45:00,2019-03-24 10:00:00
101,2,1,1,0.020681146472191828,2019-03-24 09:45:00,2019-03-24 10:00:00
104,2,1,1,0.020681146472191828,2019-03-24 09:45:00,2019-03-24 10:00:00
110,2,2,0,0.007992685495043825,2019-03-24 09:45:00,2019-03-24 10:00:00
111,3,1,2,0.005747563844225492,2019-03-24 09:45:00,2019-03-24 10:00:00
112,2,1,1,0.0047431629750741,2019-03-24 09:45:00,2019-03-24 10:00:00
114,2,2,0,0.005747563844225492,2019-03-24 09:45:00,2019-03-24 10:00:00
115,2,2,0,0.00838850092789559,2019-03-24 09:45:00,2019-03-24 10:00:00
118,1,0,1,0.0031066267605553933,2019-03-24 09:45:00,2019-03-24 10:00:00
122,7,3,4,0.007700167731427855,2019-03-24 09:45:00,2019-03-24 10:00:00
126,5,1,4,0.003945054692614167,2019-03-24 09:45:00,2019-03-24 10:00:00
127,1,1,0,0.004427095302390442,2019-03-24 09:45:00,2019-03-24 10:00:00
135,2,1,1,0.020681146472191828,2019-03-24 09:45:00,2019-03-24 10:00:00
137,6,3,3,0.011211955101588032,2019-03-24 09:45:00,2019-03-24 10:00:00
140,1,0,1,0.0031066267605553933,2019-03-24 09:45:00,2019-03-24 10:00:00
141,1,1,0,0.005747563844225492,2019-03-24 09:45:00,2019-03-24 10:00:00
153,2,0,2,0.0031066267605553933,2019-03-24 09:45:00,2019-03-24 10:00:00
157,1,0,1,0.0031066267605553933,2019-03-24 09:45:00,2019-03-24 10:00:00
158,2,1,1,0.0048572110077022244,2019-03-24 09:45:00,2019-03-24 10:00:00
171,1,1,0,0.005747563844225492,2019-03-24 09:45:00,2019-03-24 10:00:00
172,5,3,2,0.0531892488117946,2019-03-24 09:45:00,2019-03-24 10:00:00
173,1,0,1,0.0031066267605553933,2019-03-24 09:45:00,2019-03-24 10:00:00
175,2,1,1,0.020681146472191828,2019-03-24 09:45:00,2019-03-24 10:00:00
177,2,1,1,0.007138887318723273,2019-03-24 09:45:00,2019-03-24 10:00:00
189,1,1,0,0.007992685495043825,2019-03-24 09:45:00,2019-03-24 10:00:00
191,3,3,0,0.014457470599331675,2019-03-24 09:45:00,2019-03-24 10:00:00
196,1,1,0,0.004427095302390442,2019-03-24 09:45:00,2019-03-24 10:00:00
197,1,0,1,0.0031066267605553933,2019-03-24 09:45:00,2019-03-24 10:00:00
201,2,0,2,0.0031066267605553933,2019-03-24 09:45:00,2019-03-24 10:00:00
203,2,1,1,0.020681146472191828,2019-03-24 09:45:00,2019-03-24 10:00:00
1,1,1,0,0.003978731990512299,2019-03-24 10:00:00,2019-03-24 10:15:00
2,2,1,1,0.006109498006085991,2019-03-24 10:00:00,2019-03-24 10:15:00
5,1,0,1,0.003302274282019098,2019-03-24 10:00:00,2019-03-24 10:15:00
10,7,3,4,0.010626278133615904,2019-03-24 10:00:00,2019-03-24 10:15:00
15,7,2,5,0.005874268951535547,2019-03-24 10:00:00,2019-03-24 10:15:00
16,1,0,1,0.003302274282019098,2019-03-24 10:00:00,2019-03-24 10:15:00
18,6,4,2,0.012454209915726714,2019-03-24 10:00:00,2019-03-24 10:15:00
19,1,0,1,0.003302274282019098,2019-03-24 10:00:00,2019-03-24 10:15:00
23,5,2,3,0.005551979079478837,2019-03-24 10:00:00,2019-03-24 10:15:00
28,4,1,3,0.004608030826098914,2019-03-24 10:00:00,2019-03-24 10:15:00
30,2,0,2,0.003302274282019098,2019-03-24 10:00:00,2019-03-24 10:15:00
37,1,1,0,0.006316315590858251,2019-03-24 10:00:00,2019-03-24 10:15:00
40,2,2,0,0.009765783184401931,2019-03-24 10:00:00,2019-03-24 10:15:00
41,1,0,1,0.003302274282019098,2019-03-24 10:00:00,2019-03-24 10:15:00
50,1,1,0,0.006109498006085991,2019-03-24 10:00:00,2019-03-24 10:15:00
57,4,1,3,0.004608030826098914,2019-03-24 10:00:00,2019-03-24 10:15:00
58,4,1,3,0.004608030826098914,2019-03-24 10:00:00,2019-03-24 10:15:00
61,3,1,2,0.005743608899218034,2019-03-24 10:00:00,2019-03-24 10:15:00
62,4,2,2,0.0067859557145791925,2019-03-24 10:00:00,2019-03-24 10:15:00
67,1,0,1,0.003302274282019098,2019-03-24 10:00:00,2019-03-24 10:15:00
85,7,3,4,0.009112393338091482,2019-03-24 10:00:00,2019-03-24 10:15:00
86,2,2,0,0.009071003473103082,2019-03-24 10:00:00,2019-03-24 10:15:00
87,2,1,1,0.021958266832782396,2019-03-24 10:00:00,2019-03-24 10:15:00
88,1,0,1,0.003302274282019098,2019-03-24 10:00:00,2019-03-24 10:15:00
89,1,0,1,0.003302274282019098,2019-03-24 10:00:00,2019-03-24 10:15:00
90,1,1,0,0.004301021862569009,2019-03-24 10:00:00,2019-03-24 10:15:00
101,2,1,1,0.021958266832782396,2019-03-24 10:00:00,2019-03-24 10:15:00
104,2,1,1,0.021958266832782396,2019-03-24 10:00:00,2019-03-24 10:15:00
110,2,2,0,0.008495938654703973,2019-03-24 10:00:00,2019-03-24 10:15:00
111,3,1,2,0.006109498006085991,2019-03-24 10:00:00,2019-03-24 10:15:00
112,1,0,1,0.003302274282019098,2019-03-24 10:00:00,2019-03-24 10:15:00
114,2,2,0,0.005299769443118919,2019-03-24 10:00:00,2019-03-24 10:15:00
115,1,1,0,0.006109498006085991,2019-03-24 10:00:00,2019-03-24 10:15:00
119,2,1,1,0.004301021862569009,2019-03-24 10:00:00,2019-03-24 10:15:00
120,1,1,0,0.008495938654703973,2019-03-24 10:00:00,2019-03-24 10:15:00
122,5,3,2,0.04061425938354571,2019-03-24 10:00:00,2019-03-24 10:15:00
126,6,1,5,0.003978731990512299,2019-03-24 10:00:00,2019-03-24 10:15:00
127,3,1,2,0.008119198284706645,2019-03-24 10:00:00,2019-03-24 10:15:00
135,2,1,1,0.021958266832782396,2019-03-24 10:00:00,2019-03-24 10:15:00
137,6,3,3,0.010636113443777219,2019-03-24 10:00:00,2019-03-24 10:15:00
138,2,2,0,0.007819054409549012,2019-03-24 10:00:00,2019-03-24 10:15:00
140,1,0,1,0.003302274282019098,2019-03-24 10:00:00,2019-03-24 10:15:00
141,1,1,0,0.008596064711078055,2019-03-24 10:00:00,2019-03-24 10:15:00
153,8,6,2,0.011332524182405254,2019-03-24 10:00:00,2019-03-24 10:15:00
158,2,2,0,0.0065447371781230425,2019-03-24 10:00:00,2019-03-24 10:15:00
162,1,0,1,0.003302274282019098,2019-03-24 10:00:00,2019-03-24 10:15:00
170,1,0,1,0.003302274282019098,2019-03-24 10:00:00,2019-03-24 10:15:00
171,1,1,0,0.005743608899218034,2019-03-24 10:00:00,2019-03-24 10:15:00
172,7,3,4,0.010626278133615906,2019-03-24 10:00:00,2019-03-24 10:15:00
173,1,0,1,0.003302274282019098,2019-03-24 10:00:00,2019-03-24 10:15:00
175,2,1,1,0.021958266832782396,2019-03-24 10:00:00,2019-03-24 10:15:00
177,3,2,1,0.008367888069850948,2019-03-24 10:00:00,2019-03-24 10:15:00
189,1,1,0,0.006109498006085991,2019-03-24 10:00:00,2019-03-24 10:15:00
191,2,2,0,0.01322311031995834,2019-03-24 10:00:00,2019-03-24 10:15:00
196,2,2,0,0.013412988713765601,2019-03-24 10:00:00,2019-03-24 10:15:00
197,2,2,0,0.008367888069850948,2019-03-24 10:00:00,2019-03-24 10:15:00
200,4,2,2,0.021958266832782396,2019-03-24 10:00:00,2019-03-24 10:15:00
201,1,0,1,0.003302274282019098,2019-03-24 10:00:00,2019-03-24 10:15:00
203,2,1,1,0.021958266832782396,2019-03-24 10:00:00,2019-03-24 10:15:00
1,1,0,1,0.0030512315867945415,2019-03-24 10:15:00,2019-03-24 10:30:00
2,4,3,1,0.00737423744020497,2019-03-24 10:15:00,2019-03-24 10:30:00
10,11,5,6,0.012421001633188797,2019-03-24 10:15:00,2019-03-24 10:30:00
15,6,1,5,0.003676260405243042,2019-03-24 10:15:00,2019-03-24 10:30:00
16,1,0,1,0.0030512315867945415,2019-03-24 10:15:00,2019-03-24 10:30:00
18,5,4,1,0.01950667491822955,2019-03-24 10:15:00,2019-03-24 10:30:00
22,1,1,0,0.004348133342817671,2019-03-24 10:15:00,2019-03-24 10:30:00
23,2,1,1,0.008187330403812778,2019-03-24 10:15:00,2019-03-24 10:30:00
26,2,2,0,0.005464195751691693,2019-03-24 10:15:00,2019-03-24 10:30:00
28,3,1,2,0.005645035098840799,2019-03-24 10:15:00,2019-03-24 10:30:00
30,2,0,2,0.0030512315867945415,2019-03-24 10:15:00,2019-03-24 10:30:00
37,1,1,0,0.017098753681494473,2019-03-24 10:15:00,2019-03-24 10:30:00
57,2,1,1,0.02026952917086621,2019-03-24 10:15:00,2019-03-24 10:30:00
58,4,1,3,0.004257713669243117,2019-03-24 10:15:00,2019-03-24 10:30:00
61,3,1,2,0.005306946965501337,2019-03-24 10:15:00,2019-03-24 10:30:00
62,3,0,3,0.0030512315867945415,2019-03-24 10:15:00,2019-03-24 10:30:00
66,3,1,2,0.005306946965501337,2019-03-24 10:15:00,2019-03-24 10:30:00
67,2,0,2,0.0030512315867945415,2019-03-24 10:15:00,2019-03-24 10:30:00
69,2,1,1,0.006041682689378842,2019-03-24 10:15:00,2019-03-24 10:30:00
74,3,1,2,0.005306946965501337,2019-03-24 10:15:00,2019-03-24 10:30:00
85,5,2,3,0.007042547418339616,2019-03-24 10:15:00,2019-03-24 10:30:00
86,3,3,0,0.007036149306865508,2019-03-24 10:15:00,2019-03-24 10:30:00
87,2,1,1,0.02026952917086621,2019-03-24 10:15:00,2019-03-24 10:30:00
88,3,0,3,0.0030512315867945415,2019-03-24 10:15:00,2019-03-24 10:30:00
89,3,0,3,0.0030512315867945415,2019-03-24 10:15:00,2019-03-24 10:30:00
90,2,2,0,0.011975149500258997,2019-03-24 10:15:00,2019-03-24 10:30:00
101,2,1,1,0.02026952917086621,2019-03-24 10:15:00,2019-03-24 10:30:00
104,4,1,3,0.004257713669243117,2019-03-24 10:15:00,2019-03-24 10:30:00
110,3,2,1,0.009480289589575464,2019-03-24 10:15:00,2019-03-24 10:30:00
111,3,1,2,0.007562662344208131,2019-03-24 10:15:00,2019-03-24 10:30:00
112,5,2,3,0.010553113446792432,2019-03-24 10:15:00,2019-03-24 10:30:00
114,2,2,0,0.0043012892236915425,2019-03-24 10:15:00,2019-03-24 10:30:00
115,2,2,0,0.004540861575925128,2019-03-24 10:15:00,2019-03-24 10:30:00
119,1,1,0,0.003676260405243042,2019-03-24 10:15:00,2019-03-24 10:30:00
120,1,1,0,0.009320028016729496,2019-03-24 10:15:00,2019-03-24 10:30:00
122,4,2,2,0.02026952917086621,2019-03-24 10:15:00,2019-03-24 10:30:00
126,3,1,2,0.005306946965501337,2019-03-24 10:15:00,2019-03-24 10:30:00
127,3,1,2,0.008516029531254092,2019-03-24 10:15:00,2019-03-24 10:30:00
135,2,1,1,0.02026952917086621,2019-03-24 10:15:00,2019-03-24 10:30:00
137,9,6,3,0.049567430847816785,2019-03-24 10:15:00,2019-03-24 10:30:00
138,2,2,0,0.006747532974207408,2019-03-24 10:15:00,2019-03-24 10:30:00
141,3,1,2,0.019634347667184474,2019-03-24 10:15:00,2019-03-24 10:30:00
147,1,0,1,0.0030512315867945415,2019-03-24 10:15:00,2019-03-24 10:30:00
151,2,2,0,0.007850030849574016,2019-03-24 10:15:00,2019-03-24 10:30:00
153,8,6,2,0.012856798526517426,2019-03-24 10:15:00,2019-03-24 10:30:00
154,1,1,0,0.005645035098840799,2019-03-24 10:15:00,2019-03-24 10:30:00
158,1,1,0,0.005046889502567079,2019-03-24 10:15:00,2019-03-24 10:30:00
159,3,1,2,0.005645035098840799,2019-03-24 10:15:00,2019-03-24 10:30:00
162,1,1,0,0.003915832757476628,2019-03-24 10:15:00,2019-03-24 10:30:00
164,2,1,1,0.005306946965501337,2019-03-24 10:15:00,2019-03-24 10:30:00
170,1,0,1,0.0030512315867945415,2019-03-24 10:15:00,2019-03-24 10:30:00
171,2,1,1,0.005306946965501337,2019-03-24 10:15:00,2019-03-24 10:30:00
172,3,1,2,0.004348133342817671,2019-03-24 10:15:00,2019-03-24 10:30:00
175,2,1,1,0.02026952917086621,2019-03-24 10:15:00,2019-03-24 10:30:00
177,3,2,1,0.007801600613839357,2019-03-24 10:15:00,2019-03-24 10:30:00
191,1,1,0,0.009683543164779231,2019-03-24 10:15:00,2019-03-24 10:30:00
196,1,1,0,0.008516029531254092,2019-03-24 10:15:00,2019-03-24 10:30:00
197,3,1,2,0.004811149511255056,2019-03-24 10:15:00,2019-03-24 10:30:00
199,1,1,0,0.004811149511255056,2019-03-24 10:15:00,2019-03-24 10:30:00
200,4,2,2,0.02026952917086621,2019-03-24 10:15:00,2019-03-24 10:30:00
203,2,1,1,0.02026952917086621,2019-03-24 10:15:00,2019-03-24 10:30:00
2,2,2,0,0.0036687042409894333,2019-03-24 10:30:00,2019-03-24 10:45:00
5,2,1,1,0.017336721215167415,2019-03-24 10:30:00,2019-03-24 10:45:00
10,4,2,2,0.004007196353678841,2019-03-24 10:30:00,2019-03-24 10:45:00
15,4,2,2,0.008374445154204706,2019-03-24 10:30:00,2019-03-24 10:45:00
16,1,0,1,0.0026024944823972497,2019-03-24 10:30:00,2019-03-24 10:45:00
18,5,3,2,0.019501325169530338,2019-03-24 10:30:00,2019-03-24 10:45:00
20,1,1,0,0.003304845418038045,2019-03-24 10:30:00,2019-03-24 10:45:00
22,1,1,0,0.0037086578593409462,2019-03-24 10:30:00,2019-03-24 10:45:00
23,6,5,1,0.017275474336270122,2019-03-24 10:30:00,2019-03-24 10:45:00
28,2,0,2,0.0026024944823972497,2019-03-24 10:30:00,2019-03-24 10:45:00
37,1,1,0,0.0033469873311469693,2019-03-24 10:30:00,2019-03-24 10:45:00
46,1,1,0,0.004814821236284643,2019-03-24 10:30:00,2019-03-24 10:45:00
57,3,2,1,0.07249331837177451,2019-03-24 10:30:00,2019-03-24 10:45:00
58,2,0,2,0.0026024944823972497,2019-03-24 10:30:00,2019-03-24 10:45:00
61,4,2,2,0.005748110661294758,2019-03-24 10:30:00,2019-03-24 10:45:00
62,4,0,4,0.0026024944823972497,2019-03-24 10:30:00,2019-03-24 10:45:00
67,2,0,2,0.0026024944823972497,2019-03-24 10:30:00,2019-03-24 10:45:00
68,2,0,2,0.0026024944823972497,2019-03-24 10:30:00,2019-03-24 10:45:00
69,5,4,1,0.012250138952425424,2019-03-24 10:30:00,2019-03-24 10:45:00
74,1,0,1,0.0026024944823972497,2019-03-24 10:30:00,2019-03-24 10:45:00
75,1,0,1,0.0026024944823972497,2019-03-24 10:30:00,2019-03-24 10:45:00
79,2,0,2,0.0026024944823972497,2019-03-24 10:30:00,2019-03-24 10:45:00
85,5,2,3,0.006006958857763504,2019-03-24 10:30:00,2019-03-24 10:45:00
86,3,3,0,0.005920984613228339,2019-03-24 10:30:00,2019-03-24 10:45:00
87,2,1,1,0.017336721215167415,2019-03-24 10:30:00,2019-03-24 10:45:00
88,2,1,1,0.05319965314739407,2019-03-24 10:30:00,2019-03-24 10:45:00
89,6,1,5,0.0031355993616933413,2019-03-24 10:30:00,2019-03-24 10:45:00
90,5,4,1,0.05958307289746178,2019-03-24 10:30:00,2019-03-24 10:45:00
101,2,1,1,0.017336721215167415,2019-03-24 10:30:00,2019-03-24 10:45:00
104,1,0,1,0.0026024944823972497,2019-03-24 10:30:00,2019-03-24 10:45:00
106,4,2,2,0.005462130147622342,2019-03-24 10:30:00,2019-03-24 10:45:00
110,5,4,1,0.012050623556303415,2019-03-24 10:30:00,2019-03-24 10:45:00
111,3,1,2,0.007635879698819466,2019-03-24 10:30:00,2019-03-24 10:45:00
112,3,2,1,0.004585394003481643,2019-03-24 10:30:00,2019-03-24 10:45:00
114,1,0,1,0.0026024944823972497,2019-03-24 10:30:00,2019-03-24 10:45:00
115,3,3,0,0.0072283281589094975,2019-03-24 10:30:00,2019-03-24 10:45:00
116,5,1,4,0.003304845418038045,2019-03-24 10:30:00,2019-03-24 10:45:00
122,4,2,2,0.017336721215167415,2019-03-24 10:30:00,2019-03-24 10:45:00
126,2,1,1,0.017336721215167415,2019-03-24 10:30:00,2019-03-24 10:45:00
127,2,2,0,0.005838079335178962,2019-03-24 10:30:00,2019-03-24 10:45:00
135,2,1,1,0.017336721215167415,2019-03-24 10:30:00,2019-03-24 10:45:00
137,12,4,8,0.007006157869424877,2019-03-24 10:30:00,2019-03-24 10:45:00
138,2,2,0,0.006352251045805372,2019-03-24 10:30:00,2019-03-24 10:45:00
140,1,0,1,0.0026024944823972497,2019-03-24 10:30:00,2019-03-24 10:45:00
141,3,3,0,0.012381058094207323,2019-03-24 10:30:00,2019-03-24 10:45:00
147,1,0,1,0.0026024944823972497,2019-03-24 10:30:00,2019-03-24 10:45:00
151,2,2,0,0.008576232519664408,2019-03-24 10:30:00,2019-03-24 10:45:00
153,5,1,4,0.004814821236284643,2019-03-24 10:30:00,2019-03-24 10:45:00
154,1,0,1,0.0026024944823972497,2019-03-24 10:30:00,2019-03-24 10:45:00
157,1,0,1,0.0026024944823972497,2019-03-24 10:30:00,2019-03-24 10:45:00
158,1,1,0,0.004304726670080377,2019-03-24 10:30:00,2019-03-24 10:45:00
159,5,3,2,0.007027147990172036,2019-03-24 10:30:00,2019-03-24 10:45:00
162,1,1,0,0.0031555761708690977,2019-03-24 10:30:00,2019-03-24 10:45:00
164,3,2,1,0.005920984613228339,2019-03-24 10:30:00,2019-03-24 10:45:00
171,4,1,3,0.005045759725653963,2019-03-24 10:30:00,2019-03-24 10:45:00
172,4,2,2,0.004411008794981741,2019-03-24 10:30:00,2019-03-24 10:45:00
173,4,2,2,0.017336721215167415,2019-03-24 10:30:00,2019-03-24 10:45:00
175,2,1,1,0.017336721215167415,2019-03-24 10:30:00,2019-03-24 10:45:00
177,2,1,1,0.004305734848016734,2019-03-24 10:30:00,2019-03-24 10:45:00
191,1,1,0,0.006262776370142855,2019-03-24 10:30:00,2019-03-24 10:45:00
196,1,1,0,0.0036257525812915686,2019-03-24 10:30:00,2019-03-24 10:45:00
197,5,1,4,0.003304845418038045,2019-03-24 10:30:00,2019-03-24 10:45:00
199,1,1,0,0.004305734848016734,2019-03-24 10:30:00,2019-03-24 10:45:00
200,4,2,2,0.017336721215167415,2019-03-24 10:30:00,2019-03-24 10:45:00
203,2,1,1,0.017336721215167415,2019-03-24 10:30:00,2019-03-24 10:45:00
1,6,3,3,0.013060502586676745,2019-03-24 10:45:00,2019-03-24 11:00:00
2,5,3,2,0.004755154181938668,2019-03-24 10:45:00,2019-03-24 11:00:00
5,2,1,1,0.01560600784384538,2019-03-24 10:45:00,2019-03-24 11:00:00
10,3,2,1,0.006951338914825146,2019-03-24 10:45:00,2019-03-24 11:00:00
15,4,2,2,0.007539539973550086,2019-03-24 10:45:00,2019-03-24 11:00:00
16,1,1,0,0.004899145433635212,2019-03-24 10:45:00,2019-03-24 11:00:00
18,6,5,1,0.057520630140346946,2019-03-24 10:45:00,2019-03-24 11:00:00
20,2,1,1,0.003006903680920629,2019-03-24 10:45:00,2019-03-24 11:00:00
23,7,5,2,0.0075755664976967394,2019-03-24 10:45:00,2019-03-24 11:00:00
28,2,0,2,0.002342986608189334,2019-03-24 10:45:00,2019-03-24 11:00:00
37,2,2,0,0.0071746161161732065,2019-03-24 10:45:00,2019-03-24 11:00:00
40,2,1,1,0.01560600784384538,2019-03-24 10:45:00,2019-03-24 11:00:00
41,7,5,2,0.007286398115959627,2019-03-24 10:45:00,2019-03-24 11:00:00
46,1,1,0,0.0062426378113880285,2019-03-24 10:45:00,2019-03-24 11:00:00
57,6,1,5,0.0028229411438805956,2019-03-24 10:45:00,2019-03-24 11:00:00
58,9,0,9,0.002342986608189334,2019-03-24 10:45:00,2019-03-24 11:00:00
61,4,2,2,0.005229960700056418,2019-03-24 10:45:00,2019-03-24 11:00:00
62,2,1,1,0.0029753142474465825,2019-03-24 10:45:00,2019-03-24 11:00:00
67,1,0,1,0.002342986608189334,2019-03-24 10:45:00,2019-03-24 11:00:00
68,6,2,4,0.004075171063309584,2019-03-24 10:45:00,2019-03-24 11:00:00
69,9,4,5,0.009513407001957904,2019-03-24 10:45:00,2019-03-24 11:00:00
74,2,2,0,0.004334737826383219,2019-03-24 10:45:00,2019-03-24 11:00:00
75,3,2,1,0.006385553484495261,2019-03-24 10:45:00,2019-03-24 11:00:00
79,2,0,2,0.002342986608189334,2019-03-24 10:45:00,2019-03-24 11:00:00
85,5,2,3,0.005408124503363071,2019-03-24 10:45:00,2019-03-24 11:00:00
86,2,0,2,0.002342986608189334,2019-03-24 10:45:00,2019-03-24 11:00:00
87,2,1,1,0.01560600784384538,2019-03-24 10:45:00,2019-03-24 11:00:00
88,2,1,1,0.009647043164039068,2019-03-24 10:45:00,2019-03-24 11:00:00
89,4,0,4,0.002342986608189334,2019-03-24 10:45:00,2019-03-24 11:00:00
90,4,3,1,0.008590908080825597,2019-03-24 10:45:00,2019-03-24 11:00:00
101,2,1,1,0.01560600784384538,2019-03-24 10:45:00,2019-03-24 11:00:00
104,5,1,4,0.0029753142474465825,2019-03-24 10:45:00,2019-03-24 11:00:00
106,4,2,2,0.0055126333734180815,2019-03-24 10:45:00,2019-03-24 11:00:00
108,1,1,0,0.0039606232348357055,2019-03-24 10:45:00,2019-03-24 11:00:00
110,9,5,4,0.016068504187238288,2019-03-24 10:45:00,2019-03-24 11:00:00
111,7,2,5,0.010190091951447967,2019-03-24 10:45:00,2019-03-24 11:00:00
112,2,2,0,0.006864048383412213,2019-03-24 10:45:00,2019-03-24 11:00:00
113,3,2,1,0.003455268783137844,2019-03-24 10:45:00,2019-03-24 11:00:00
114,2,0,2,0.002342986608189334,2019-03-24 10:45:00,2019-03-24 11:00:00
115,3,3,0,0.006543664364453142,2019-03-24 10:45:00,2019-03-24 11:00:00
116,3,0,3,0.002342986608189334,2019-03-24 10:45:00,2019-03-24 11:00:00
119,1,1,0,0.005280318625480751,2019-03-24 10:45:00,2019-03-24 11:00:00
120,1,0,1,0.002342986608189334,2019-03-24 10:45:00,2019-03-24 11:00:00
122,7,3,4,0.018344454796432506,2019-03-24 10:45:00,2019-03-24 11:00:00
126,4,3,1,0.06482737974532296,2019-03-24 10:45:00,2019-03-24 11:00:00
127,2,2,0,0.00627514906322078,2019-03-24 10:45:00,2019-03-24 11:00:00
135,2,1,1,0.01560600784384538,2019-03-24 10:45:00,2019-03-24 11:00:00
137,16,7,9,0.014992611144459711,2019-03-24 10:45:00,2019-03-24 11:00:00
138,3,3,0,0.006574135470579019,2019-03-24 10:45:00,2019-03-24 11:00:00
140,1,0,1,0.002342986608189334,2019-03-24 10:45:00,2019-03-24 11:00:00
141,5,4,1,0.05606147651502289,2019-03-24 10:45:00,2019-03-24 11:00:00
147,1,0,1,0.002342986608189334,2019-03-24 10:45:00,2019-03-24 11:00:00
153,6,2,4,0.003818816752977538,2019-03-24 10:45:00,2019-03-24 11:00:00
154,1,0,1,0.002342986608189334,2019-03-24 10:45:00,2019-03-24 11:00:00
157,7,6,1,0.003670820753651924,2019-03-24 10:45:00,2019-03-24 11:00:00
158,1,1,0,0.0038755555557762025,2019-03-24 10:45:00,2019-03-24 11:00:00
159,3,3,0,0.0063264890445771035,2019-03-24 10:45:00,2019-03-24 11:00:00
164,4,3,1,0.0071925812721372285,2019-03-24 10:45:00,2019-03-24 11:00:00
168,2,0,2,0.002342986608189334,2019-03-24 10:45:00,2019-03-24 11:00:00
170,1,0,1,0.002342986608189334,2019-03-24 10:45:00,2019-03-24 11:00:00
171,9,4,5,0.009320513775168245,2019-03-24 10:45:00,2019-03-24 11:00:00
172,4,3,1,0.03329003615805344,2019-03-24 10:45:00,2019-03-24 11:00:00
173,4,2,2,0.01560600784384538,2019-03-24 10:45:00,2019-03-24 11:00:00
175,2,1,1,0.01560600784384538,2019-03-24 10:45:00,2019-03-24 11:00:00
177,1,0,1,0.002342986608189334,2019-03-24 10:45:00,2019-03-24 11:00:00
189,1,1,0,0.0025642922990997655,2019-03-24 10:45:00,2019-03-24 11:00:00
190,1,0,1,0.002342986608189334,2019-03-24 10:45:00,2019-03-24 11:00:00
191,2,2,0,0.007554881358142684,2019-03-24 10:45:00,2019-03-24 11:00:00
196,1,1,0,0.0031545826305229086,2019-03-24 10:45:00,2019-03-24 11:00:00
197,7,3,4,0.010841402543737933,2019-03-24 10:45:00,2019-03-24 11:00:00
199,3,1,2,0.00825267069474845,2019-03-24 10:45:00,2019-03-24 11:00:00
200,4,2,2,0.01560600784384538,2019-03-24 10:45:00,2019-03-24 11:00:00
202,1,0,1,0.002342986608189334,2019-03-24 10:45:00,2019-03-24 11:00:00
203,2,1,1,0.01560600784384538,2019-03-24 10:45:00,2019-03-24 11:00:00
1,6,3,3,0.006415051567429567,2019-03-24 11:00:00,2019-03-24 11:15:00
2,3,1,2,0.004160836291167344,2019-03-24 11:00:00,2019-03-24 11:15:00
5,4,3,1,0.06274822406227866,2019-03-24 11:00:00,2019-03-24 11:15:00
10,2,2,0,0.006876207030650188,2019-03-24 11:00:00,2019-03-24 11:15:00
11,1,1,0,0.004680545443236583,2019-03-24 11:00:00,2019-03-24 11:15:00
15,6,4,2,0.016169246820094057,2019-03-24 11:00:00,2019-03-24 11:15:00
16,4,2,2,0.005019710535406473,2019-03-24 11:00:00,2019-03-24 11:15:00
18,9,6,3,0.01910154944616059,2019-03-24 11:00:00,2019-03-24 11:15:00
19,1,1,0,0.012390532936823824,2019-03-24 11:00:00,2019-03-24 11:15:00
20,1,0,1,0.0024848838558229783,2019-03-24 11:00:00,2019-03-24 11:15:00
23,4,2,2,0.004597239422142557,2019-03-24 11:00:00,2019-03-24 11:15:00
26,5,4,1,0.004597239422142557,2019-03-24 11:00:00,2019-03-24 11:15:00
28,2,0,2,0.0024848838558229783,2019-03-24 11:00:00,2019-03-24 11:15:00
30,1,1,0,0.0035983267546212993,2019-03-24 11:00:00,2019-03-24 11:15:00
37,2,1,1,0.004160836291167344,2019-03-24 11:00:00,2019-03-24 11:15:00
41,7,5,2,0.009229211481392342,2019-03-24 11:00:00,2019-03-24 11:15:00
50,2,2,0,0.008995828998520378,2019-03-24 11:00:00,2019-03-24 11:15:00
57,5,1,4,0.0031554959302016413,2019-03-24 11:00:00,2019-03-24 11:15:00
58,7,0,7,0.0024848838558229783,2019-03-24 11:00:00,2019-03-24 11:15:00
61,3,1,2,0.004321910067438172,2019-03-24 11:00:00,2019-03-24 11:15:00
62,2,1,1,0.0031890023779295043,2019-03-24 11:00:00,2019-03-24 11:15:00
64,2,2,0,0.010497894659709121,2019-03-24 11:00:00,2019-03-24 11:15:00
67,1,0,1,0.0024848838558229783,2019-03-24 11:00:00,2019-03-24 11:15:00
68,3,2,1,0.03775353731009699,2019-03-24 11:00:00,2019-03-24 11:15:00
69,5,0,5,0.0024848838558229783,2019-03-24 11:00:00,2019-03-24 11:15:00
74,2,2,0,0.004597239422142557,2019-03-24 11:00:00,2019-03-24 11:15:00
75,3,2,1,0.006022143516738347,2019-03-24 11:00:00,2019-03-24 11:15:00
79,2,0,2,0.0024848838558229783,2019-03-24 11:00:00,2019-03-24 11:15:00
85,9,3,6,0.004321910067438172,2019-03-24 11:00:00,2019-03-24 11:15:00
86,2,0,2,0.0024848838558229783,2019-03-24 11:00:00,2019-03-24 11:15:00
87,2,1,1,0.01653721723815596,2019-03-24 11:00:00,2019-03-24 11:15:00
89,2,0,2,0.0024848838558229783,2019-03-24 11:00:00,2019-03-24 11:15:00
90,1,1,0,0.005195811490921026,2019-03-24 11:00:00,2019-03-24 11:15:00
104,3,0,3,0.0024848838558229783,2019-03-24 11:00:00,2019-03-24 11:15:00
106,2,2,0,0.00471176965341962,2019-03-24 11:00:00,2019-03-24 11:15:00
108,1,1,0,0.002907354969086894,2019-03-24 11:00:00,2019-03-24 11:15:00
110,13,8,5,0.023562838026627834,2019-03-24 11:00:00,2019-03-24 11:15:00
111,4,0,4,0.0024848838558229783,2019-03-24 11:00:00,2019-03-24 11:15:00
112,2,2,0,0.006178353418822673,2019-03-24 11:00:00,2019-03-24 11:15:00
113,2,1,1,0.0031890023779295043,2019-03-24 11:00:00,2019-03-24 11:15:00
114,5,0,5,0.0024848838558229783,2019-03-24 11:00:00,2019-03-24 11:15:00
115,11,7,4,0.04660033757770984,2019-03-24 11:00:00,2019-03-24 11:15:00
116,2,0,2,0.0024848838558229783,2019-03-24 11:00:00,2019-03-24 11:15:00
118,2,2,0,0.00332982608235081,2019-03-24 11:00:00,2019-03-24 11:15:00
119,2,2,0,0.00332982608235081,2019-03-24 11:00:00,2019-03-24 11:15:00
120,4,1,3,0.0034674257837246252,2019-03-24 11:00:00,2019-03-24 11:15:00
122,5,2,3,0.00573538883542455,2019-03-24 11:00:00,2019-03-24 11:15:00
126,7,4,3,0.011488336284065277,2019-03-24 11:00:00,2019-03-24 11:15:00
127,2,2,0,0.008518780128556487,2019-03-24 11:00:00,2019-03-24 11:15:00
135,2,1,1,0.01653721723815596,2019-03-24 11:00:00,2019-03-24 11:15:00
137,14,7,7,0.013799252021134703,2019-03-24 11:00:00,2019-03-24 11:15:00
138,4,3,1,0.0037522971956147257,2019-03-24 11:00:00,2019-03-24 11:15:00
141,3,1,2,0.007897879297857596,2019-03-24 11:00:00,2019-03-24 11:15:00
151,4,0,4,0.0024848838558229783,2019-03-24 11:00:00,2019-03-24 11:15:00
153,3,1,2,0.0031554959302016413,2019-03-24 11:00:00,2019-03-24 11:15:00
154,2,1,1,0.002907354969086894,2019-03-24 11:00:00,2019-03-24 11:15:00
157,9,8,1,0.0055201584823165555,2019-03-24 11:00:00,2019-03-24 11:15:00
158,1,1,0,0.003097225926361376,2019-03-24 11:00:00,2019-03-24 11:15:00
159,2,2,0,0.004597239422142557,2019-03-24 11:00:00,2019-03-24 11:15:00
160,2,1,1,0.01653721723815596,2019-03-24 11:00:00,2019-03-24 11:15:00
162,1,0,1,0.0024848838558229783,2019-03-24 11:00:00,2019-03-24 11:15:00
168,5,2,3,0.005806210246413573,2019-03-24 11:00:00,2019-03-24 11:15:00
169,2,2,0,0.004597239422142557,2019-03-24 11:00:00,2019-03-24 11:15:00
170,2,0,2,0.0024848838558229783,2019-03-24 11:00:00,2019-03-24 11:15:00
171,8,3,5,0.006548795865034814,2019-03-24 11:00:00,2019-03-24 11:15:00
172,3,2,1,0.03058955062048894,2019-03-24 11:00:00,2019-03-24 11:15:00
173,5,3,2,0.042529528436502345,2019-03-24 11:00:00,2019-03-24 11:15:00
175,2,1,1,0.01653721723815596,2019-03-24 11:00:00,2019-03-24 11:15:00
177,5,2,3,0.00573538883542455,2019-03-24 11:00:00,2019-03-24 11:15:00
189,1,1,0,0.002786648936725775,2019-03-24 11:00:00,2019-03-24 11:15:00
190,1,0,1,0.0024848838558229783,2019-03-24 11:00:00,2019-03-24 11:15:00
191,6,4,2,0.008176527798270836,2019-03-24 11:00:00,2019-03-24 11:15:00
196,1,1,0,0.0038261080045803044,2019-03-24 11:00:00,2019-03-24 11:15:00
197,6,2,4,0.010330865500514748,2019-03-24 11:00:00,2019-03-24 11:15:00
199,2,0,2,0.0024848838558229783,2019-03-24 11:00:00,2019-03-24 11:15:00
200,4,2,2,0.01653721723815596,2019-03-24 11:00:00,2019-03-24 11:15:00
203,2,1,1,0.01653721723815596,2019-03-24 11:00:00,2019-03-24 11:15:00
1,2,2,0,0.004548703756764342,2019-03-24 11:15:00,2019-03-24 11:30:00
2,2,0,2,0.002458675820118998,2019-03-24 11:15:00,2019-03-24 11:30:00
5,5,4,1,0.11835240367746229,2019-03-24 11:15:00,2019-03-24 11:30:00
10,6,4,2,0.023332120915663765,2019-03-24 11:15:00,2019-03-24 11:30:00
11,1,1,0,0.002981182804280334,2019-03-24 11:15:00,2019-03-24 11:30:00
15,8,5,3,0.04347535215796926,2019-03-24 11:15:00,2019-03-24 11:30:00
16,3,1,2,0.002876681407448067,2019-03-24 11:15:00,2019-03-24 11:30:00
18,14,5,9,0.011951516802132973,2019-03-24 11:15:00,2019-03-24 11:30:00
19,2,2,0,0.008716998183311736,2019-03-24 11:15:00,2019-03-24 11:30:00
20,4,1,3,0.0035875505262135815,2019-03-24 11:15:00,2019-03-24 11:30:00
23,3,2,1,0.0038520277778825605,2019-03-24 11:15:00,2019-03-24 11:30:00
26,6,5,1,0.005169876390007357,2019-03-24 11:15:00,2019-03-24 11:30:00
28,3,0,3,0.002458675820118998,2019-03-24 11:15:00,2019-03-24 11:30:00
30,1,1,0,0.0035603041334571466,2019-03-24 11:15:00,2019-03-24 11:30:00
37,1,1,0,0.003254651068836878,2019-03-24 11:15:00,2019-03-24 11:30:00
41,6,2,4,0.012718045558082182,2019-03-24 11:15:00,2019-03-24 11:30:00
50,2,2,0,0.004913805099021438,2019-03-24 11:15:00,2019-03-24 11:30:00
57,5,3,2,0.01066544551605756,2019-03-24 11:15:00,2019-03-24 11:30:00
58,6,0,6,0.002458675820118998,2019-03-24 11:15:00,2019-03-24 11:30:00
61,3,1,2,0.004276242124316728,2019-03-24 11:15:00,2019-03-24 11:30:00
62,2,2,0,0.0048755934599156725,2019-03-24 11:15:00,2019-03-24 11:30:00
64,5,3,2,0.01660387763894369,2019-03-24 11:15:00,2019-03-24 11:30:00
67,1,0,1,0.002458675820118998,2019-03-24 11:15:00,2019-03-24 11:30:00
68,1,1,0,0.0064805911050518,2019-03-24 11:15:00,2019-03-24 11:30:00
69,4,0,4,0.002458675820118998,2019-03-24 11:15:00,2019-03-24 11:30:00
74,2,2,0,0.004548703756764342,2019-03-24 11:15:00,2019-03-24 11:30:00
75,3,2,1,0.004548703756764342,2019-03-24 11:15:00,2019-03-24 11:30:00
79,2,0,2,0.002458675820118998,2019-03-24 11:15:00,2019-03-24 11:30:00
85,7,2,5,0.003725427967647654,2019-03-24 11:15:00,2019-03-24 11:30:00
86,2,0,2,0.002458675820118998,2019-03-24 11:15:00,2019-03-24 11:30:00
87,3,2,1,0.023332120915663765,2019-03-24 11:15:00,2019-03-24 11:30:00
89,1,0,1,0.002458675820118998,2019-03-24 11:15:00,2019-03-24 11:30:00
90,2,2,0,0.005677578462858926,2019-03-24 11:15:00,2019-03-24 11:30:00
101,4,2,2,0.016374305883815506,2019-03-24 11:15:00,2019-03-24 11:30:00
104,4,2,2,0.0032946869947771355,2019-03-24 11:15:00,2019-03-24 11:30:00
110,9,6,3,0.01250613012290253,2019-03-24 11:15:00,2019-03-24 11:30:00
111,4,0,4,0.002458675820118998,2019-03-24 11:15:00,2019-03-24 11:30:00
112,2,2,0,0.004661932446795296,2019-03-24 11:15:00,2019-03-24 11:30:00
113,1,0,1,0.002458675820118998,2019-03-24 11:15:00,2019-03-24 11:30:00
114,5,0,5,0.002458675820118998,2019-03-24 11:15:00,2019-03-24 11:30:00
115,8,4,4,0.022856072716611952,2019-03-24 11:15:00,2019-03-24 11:30:00
118,2,2,0,0.00350368978844167,2019-03-24 11:15:00,2019-03-24 11:30:00
119,4,3,1,0.004266832056290911,2019-03-24 11:15:00,2019-03-24 11:30:00
120,4,1,3,0.003430820881632773,2019-03-24 11:15:00,2019-03-24 11:30:00
122,6,3,3,0.00808667224301413,2019-03-24 11:15:00,2019-03-24 11:30:00
126,6,2,4,0.005776268396215562,2019-03-24 11:15:00,2019-03-24 11:30:00
127,2,2,0,0.019722765902716585,2019-03-24 11:15:00,2019-03-24 11:30:00
135,2,1,1,0.016374305883815506,2019-03-24 11:15:00,2019-03-24 11:30:00
137,11,5,6,0.005618147270038766,2019-03-24 11:15:00,2019-03-24 11:30:00
138,4,3,1,0.00473125442789289,2019-03-24 11:15:00,2019-03-24 11:30:00
141,6,5,1,0.010248660278305446,2019-03-24 11:15:00,2019-03-24 11:30:00
151,6,1,5,0.002962306967870642,2019-03-24 11:15:00,2019-03-24 11:30:00
153,2,0,2,0.002458675820118998,2019-03-24 11:15:00,2019-03-24 11:30:00
154,6,5,1,0.014060752238461177,2019-03-24 11:15:00,2019-03-24 11:30:00
157,9,8,1,0.005815455904292999,2019-03-24 11:15:00,2019-03-24 11:30:00
158,2,1,1,0.003092051893883326,2019-03-24 11:15:00,2019-03-24 11:30:00
159,2,2,0,0.004548703756764342,2019-03-24 11:15:00,2019-03-24 11:30:00
160,2,1,1,0.016374305883815506,2019-03-24 11:15:00,2019-03-24 11:30:00
162,1,0,1,0.002458675820118998,2019-03-24 11:15:00,2019-03-24 11:30:00
164,2,0,2,0.002458675820118998,2019-03-24 11:15:00,2019-03-24 11:30:00
168,7,4,3,0.01810027810926094,2019-03-24 11:15:00,2019-03-24 11:30:00
169,4,4,0,0.007470179754286764,2019-03-24 11:15:00,2019-03-24 11:30:00
170,3,1,2,0.00350368978844167,2019-03-24 11:15:00,2019-03-24 11:30:00
171,8,3,5,0.006479498750993027,2019-03-24 11:15:00,2019-03-24 11:30:00
172,2,1,1,0.004548703756764342,2019-03-24 11:15:00,2019-03-24 11:30:00
173,7,3,4,0.011920049499578238,2019-03-24 11:15:00,2019-03-24 11:30:00
175,2,1,1,0.016374305883815506,2019-03-24 11:15:00,2019-03-24 11:30:00
177,9,4,5,0.007685874831077888,2019-03-24 11:15:00,2019-03-24 11:30:00
191,6,4,2,0.014868789643363915,2019-03-24 11:15:00,2019-03-24 11:30:00
197,4,0,4,0.002458675820118998,2019-03-24 11:15:00,2019-03-24 11:30:00
199,2,0,2,0.002458675820118998,2019-03-24 11:15:00,2019-03-24 11:30:00
203,2,1,1,0.016374305883815506,2019-03-24 11:15:00,2019-03-24 11:30:00
2,7,3,4,0.004932395138524946,2019-03-24 11:30:00,2019-03-24 11:45:00
5,3,2,1,0.025214603044552534,2019-03-24 11:30:00,2019-03-24 11:45:00
10,7,4,3,0.008384800508188496,2019-03-24 11:30:00,2019-03-24 11:45:00
15,7,3,4,0.011056396148863917,2019-03-24 11:30:00,2019-03-24 11:45:00
16,3,0,3,0.0025769383355031894,2019-03-24 11:30:00,2019-03-24 11:45:00
18,11,4,7,0.009340846141769063,2019-03-24 11:30:00,2019-03-24 11:45:00
19,4,1,3,0.006955186267796839,2019-03-24 11:30:00,2019-03-24 11:45:00
20,5,1,4,0.0037113666822759343,2019-03-24 11:30:00,2019-03-24 11:45:00
23,2,1,1,0.003104808641141398,2019-03-24 11:30:00,2019-03-24 11:45:00
26,2,0,2,0.0025769383355031894,2019-03-24 11:30:00,2019-03-24 11:45:00
35,2,0,2,0.0025769383355031894,2019-03-24 11:30:00,2019-03-24 11:45:00
37,1,1,0,0.006467799088240437,2019-03-24 11:30:00,2019-03-24 11:45:00
41,4,1,3,0.004277162207400432,2019-03-24 11:30:00,2019-03-24 11:45:00
50,3,0,3,0.0025769383355031894,2019-03-24 11:30:00,2019-03-24 11:45:00
57,4,2,2,0.010758830978318933,2019-03-24 11:30:00,2019-03-24 11:45:00
58,8,1,7,0.002933140424254075,2019-03-24 11:30:00,2019-03-24 11:45:00
61,3,1,2,0.004482018077909263,2019-03-24 11:30:00,2019-03-24 11:45:00
62,6,6,0,0.01038966204165805,2019-03-24 11:30:00,2019-03-24 11:45:00
64,9,5,4,0.02157187062233589,2019-03-24 11:30:00,2019-03-24 11:45:00
67,1,0,1,0.0025769383355031894,2019-03-24 11:30:00,2019-03-24 11:45:00
69,2,0,2,0.0025769383355031894,2019-03-24 11:30:00,2019-03-24 11:45:00
74,2,2,0,0.004767543934597758,2019-03-24 11:30:00,2019-03-24 11:45:00
75,9,4,5,0.0070814860943588355,2019-03-24 11:30:00,2019-03-24 11:45:00
79,2,0,2,0.0025769383355031894,2019-03-24 11:30:00,2019-03-24 11:45:00
85,8,3,5,0.0060896925246235354,2019-03-24 11:30:00,2019-03-24 11:45:00
86,2,0,2,0.0025769383355031894,2019-03-24 11:30:00,2019-03-24 11:45:00
87,9,6,3,0.05087767321299798,2019-03-24 11:30:00,2019-03-24 11:45:00
88,1,1,0,0.010869107595517694,2019-03-24 11:30:00,2019-03-24 11:45:00
89,1,0,1,0.0025769383355031894,2019-03-24 11:30:00,2019-03-24 11:45:00
90,3,3,0,0.005894052481197422,2019-03-24 11:30:00,2019-03-24 11:45:00
101,4,2,2,0.017157446731928847,2019-03-24 11:30:00,2019-03-24 11:45:00
104,5,4,1,0.0051502696611408485,2019-03-24 11:30:00,2019-03-24 11:45:00
109,2,2,0,0.006629779820178967,2019-03-24 11:30:00,2019-03-24 11:45:00
110,7,4,3,0.009243444445277457,2019-03-24 11:30:00,2019-03-24 11:45:00
111,7,3,4,0.006688654391667143,2019-03-24 11:30:00,2019-03-24 11:45:00
112,3,0,3,0.0025769383355031894,2019-03-24 11:30:00,2019-03-24 11:45:00
114,12,4,8,0.006054209597416588,2019-03-24 11:30:00,2019-03-24 11:45:00
115,7,3,4,0.009038766227263465,2019-03-24 11:30:00,2019-03-24 11:45:00
116,1,1,0,0.006828491689359154,2019-03-24 11:30:00,2019-03-24 11:45:00
119,7,6,1,0.06659611405266115,2019-03-24 11:30:00,2019-03-24 11:45:00
120,6,3,3,0.005448639418905892,2019-03-24 11:30:00,2019-03-24 11:45:00
122,6,4,2,0.02687778566287928,2019-03-24 11:30:00,2019-03-24 11:45:00
126,3,1,2,0.004482018077909263,2019-03-24 11:30:00,2019-03-24 11:45:00
127,3,2,1,0.006369029193717007,2019-03-24 11:30:00,2019-03-24 11:45:00
137,8,5,3,0.013729620585628082,2019-03-24 11:30:00,2019-03-24 11:45:00
138,5,5,0,0.008863229276098401,2019-03-24 11:30:00,2019-03-24 11:45:00
141,6,5,1,0.00975400325078521,2019-03-24 11:30:00,2019-03-24 11:45:00
151,1,1,0,0.004767543934597758,2019-03-24 11:30:00,2019-03-24 11:45:00
153,3,0,3,0.0025769383355031894,2019-03-24 11:30:00,2019-03-24 11:45:00
154,3,2,1,0.005001072519378559,2019-03-24 11:30:00,2019-03-24 11:45:00
156,1,0,1,0.0025769383355031894,2019-03-24 11:30:00,2019-03-24 11:45:00
157,12,8,4,0.006784926034511353,2019-03-24 11:30:00,2019-03-24 11:45:00
158,1,1,0,0.0036123259187546154,2019-03-24 11:30:00,2019-03-24 11:45:00
159,2,2,0,0.004767543934597758,2019-03-24 11:30:00,2019-03-24 11:45:00
164,5,3,2,0.008489606187236702,2019-03-24 11:30:00,2019-03-24 11:45:00
168,4,3,1,0.042687590277574065,2019-03-24 11:30:00,2019-03-24 11:45:00
169,7,7,0,0.014861203794877976,2019-03-24 11:30:00,2019-03-24 11:45:00
170,3,1,2,0.003307140201868046,2019-03-24 11:30:00,2019-03-24 11:45:00
171,5,3,2,0.02983287538594842,2019-03-24 11:30:00,2019-03-24 11:45:00
172,3,1,2,0.004767543934597758,2019-03-24 11:30:00,2019-03-24 11:45:00
173,6,3,3,0.007633352609652388,2019-03-24 11:30:00,2019-03-24 11:45:00
175,2,1,1,0.017157446731928847,2019-03-24 11:30:00,2019-03-24 11:45:00
177,10,5,5,0.015487942803987308,2019-03-24 11:30:00,2019-03-24 11:45:00
190,1,1,0,0.003220271166912604,2019-03-24 11:30:00,2019-03-24 11:45:00
191,5,2,3,0.005999440283186598,2019-03-24 11:30:00,2019-03-24 11:45:00
197,6,1,5,0.003104808641141398,2019-03-24 11:30:00,2019-03-24 11:45:00
201,2,0,2,0.0025769383355031894,2019-03-24 11:30:00,2019-03-24 11:45:00
203,7,2,5,0.0039046713744303897,2019-03-24 11:30:00,2019-03-24 11:45:00
1,4,2,2,0.0045261476946896195,2019-03-24 11:45:00,2019-03-24 12:00:00
2,8,4,4,0.01934200851075338,2019-03-24 11:45:00,2019-03-24 12:00:00
5,2,1,1,0.015228833765497475,2019-03-24 11:45:00,2019-03-24 12:00:00
10,7,5,2,0.010544641353524991,2019-03-24 11:45:00,2019-03-24 12:00:00
15,6,2,4,0.007538781674054602,2019-03-24 11:45:00,2019-03-24 12:00:00
16,2,1,1,0.002934168564164179,2019-03-24 11:45:00,2019-03-24 12:00:00
18,8,2,6,0.005569674521838688,2019-03-24 11:45:00,2019-03-24 12:00:00
19,4,0,4,0.002286327916064216,2019-03-24 11:45:00,2019-03-24 12:00:00
20,2,0,2,0.002286327916064216,2019-03-24 11:45:00,2019-03-24 12:00:00
23,4,2,2,0.004322532364550232,2019-03-24 11:45:00,2019-03-24 12:00:00
26,8,2,6,0.009964864639186007,2019-03-24 11:45:00,2019-03-24 12:00:00
27,1,1,0,0.004229849860364104,2019-03-24 11:45:00,2019-03-24 12:00:00
28,2,1,1,0.015228833765497475,2019-03-24 11:45:00,2019-03-24 12:00:00
35,3,0,3,0.002286327916064216,2019-03-24 11:45:00,2019-03-24 12:00:00
37,1,1,0,0.005916206871175568,2019-03-24 11:45:00,2019-03-24 12:00:00
41,7,3,4,0.0043718390678293305,2019-03-24 11:45:00,2019-03-24 12:00:00
46,2,2,0,0.003723998419729368,2019-03-24 11:45:00,2019-03-24 12:00:00
50,3,0,3,0.002286327916064216,2019-03-24 11:45:00,2019-03-24 12:00:00
57,3,2,1,0.01846446022785579,2019-03-24 11:45:00,2019-03-24 12:00:00
58,8,1,7,0.0042850351286027434,2019-03-24 11:45:00,2019-03-24 12:00:00
61,3,1,2,0.003976491773568505,2019-03-24 11:45:00,2019-03-24 12:00:00
62,6,5,1,0.007371928350654689,2019-03-24 11:45:00,2019-03-24 12:00:00
64,7,4,3,0.012880695719435512,2019-03-24 11:45:00,2019-03-24 12:00:00
67,3,2,1,0.004229849860364104,2019-03-24 11:45:00,2019-03-24 12:00:00
68,1,0,1,0.002286327916064216,2019-03-24 11:45:00,2019-03-24 12:00:00
69,2,2,0,0.004887643878954507,2019-03-24 11:45:00,2019-03-24 12:00:00
74,1,1,0,0.0036981678001693366,2019-03-24 11:45:00,2019-03-24 12:00:00
75,9,3,6,0.003976491773568505,2019-03-24 11:45:00,2019-03-24 12:00:00
79,4,2,2,0.006283742341141271,2019-03-24 11:45:00,2019-03-24 12:00:00
80,2,1,1,0.015228833765497475,2019-03-24 11:45:00,2019-03-24 12:00:00
85,6,3,3,0.009450213957260381,2019-03-24 11:45:00,2019-03-24 12:00:00
87,8,5,3,0.0916190234324205,2019-03-24 11:45:00,2019-03-24 12:00:00
88,4,1,3,0.004006508309848728,2019-03-24 11:45:00,2019-03-24 12:00:00
89,2,1,1,0.0034216255022791893,2019-03-24 11:45:00,2019-03-24 12:00:00
90,5,4,1,0.009919323887496636,2019-03-24 11:45:00,2019-03-24 12:00:00
99,1,0,1,0.002286327916064216,2019-03-24 11:45:00,2019-03-24 12:00:00
101,2,1,1,0.015228833765497475,2019-03-24 11:45:00,2019-03-24 12:00:00
104,5,4,1,0.014023889550422861,2019-03-24 11:45:00,2019-03-24 12:00:00
108,1,1,0,0.002934168564164179,2019-03-24 11:45:00,2019-03-24 12:00:00
109,2,2,0,0.007286488382481228,2019-03-24 11:45:00,2019-03-24 12:00:00
110,7,4,3,0.0058123122023146356,2019-03-24 11:45:00,2019-03-24 12:00:00
111,10,3,7,0.005416514590835206,2019-03-24 11:45:00,2019-03-24 12:00:00
112,5,3,2,0.013535716101819896,2019-03-24 11:45:00,2019-03-24 12:00:00
114,11,5,6,0.020708271839906794,2019-03-24 11:45:00,2019-03-24 12:00:00
115,7,3,4,0.008631765676126649,2019-03-24 11:45:00,2019-03-24 12:00:00
118,2,0,2,0.002286327916064216,2019-03-24 11:45:00,2019-03-24 12:00:00
119,7,5,2,0.013726625532851932,2019-03-24 11:45:00,2019-03-24 12:00:00
120,6,3,3,0.009551621295666057,2019-03-24 11:45:00,2019-03-24 12:00:00
122,6,4,2,0.024799310015019848,2019-03-24 11:45:00,2019-03-24 12:00:00
126,2,1,1,0.015228833765497475,2019-03-24 11:45:00,2019-03-24 12:00:00
127,2,0,2,0.002286327916064216,2019-03-24 11:45:00,2019-03-24 12:00:00
137,12,8,4,0.017078172045710528,2019-03-24 11:45:00,2019-03-24 12:00:00
138,3,3,0,0.006153645584288004,2019-03-24 11:45:00,2019-03-24 12:00:00
141,9,5,4,0.008094014994384788,2019-03-24 11:45:00,2019-03-24 12:00:00
151,6,3,3,0.0070535296285743464,2019-03-24 11:45:00,2019-03-24 12:00:00
153,9,3,6,0.005073634689681556,2019-03-24 11:45:00,2019-03-24 12:00:00
156,1,0,1,0.002286327916064216,2019-03-24 11:45:00,2019-03-24 12:00:00
157,10,7,3,0.006380356611950071,2019-03-24 11:45:00,2019-03-24 12:00:00
158,1,1,0,0.004964294158274014,2019-03-24 11:45:00,2019-03-24 12:00:00
159,2,2,0,0.00762809732714812,2019-03-24 11:45:00,2019-03-24 12:00:00
160,2,1,1,0.015228833765497475,2019-03-24 11:45:00,2019-03-24 12:00:00
161,2,1,1,0.015228833765497475,2019-03-24 11:45:00,2019-03-24 12:00:00
164,5,5,0,0.006478931439196568,2019-03-24 11:45:00,2019-03-24 12:00:00
168,2,2,0,0.005955338673206345,2019-03-24 11:45:00,2019-03-24 12:00:00
169,10,10,0,0.012862160041123775,2019-03-24 11:45:00,2019-03-24 12:00:00
170,3,0,3,0.002286327916064216,2019-03-24 11:45:00,2019-03-24 12:00:00
171,5,3,2,0.026481175757426437,2019-03-24 11:45:00,2019-03-24 12:00:00
172,3,1,2,0.005881997554036307,2019-03-24 11:45:00,2019-03-24 12:00:00
173,2,1,1,0.002934168564164179,2019-03-24 11:45:00,2019-03-24 12:00:00
175,2,1,1,0.015228833765497475,2019-03-24 11:45:00,2019-03-24 12:00:00
177,11,5,6,0.01562724331910389,2019-03-24 11:45:00,2019-03-24 12:00:00
189,1,0,1,0.002286327916064216,2019-03-24 11:45:00,2019-03-24 12:00:00
190,2,2,0,0.005536742379355381,2019-03-24 11:45:00,2019-03-24 12:00:00
191,3,0,3,0.002286327916064216,2019-03-24 11:45:00,2019-03-24 12:00:00
197,8,1,7,0.0026023519707657197,2019-03-24 11:45:00,2019-03-24 12:00:00
201,2,0,2,0.002286327916064216,2019-03-24 11:45:00,2019-03-24 12:00:00
203,10,4,6,0.011128639735484565,2019-03-24 11:45:00,2019-03-24 12:00:00
1,4,3,1,0.00365074209063219,2019-03-24 12:00:00,2019-03-24 12:15:00
2,9,4,5,0.008189361883260944,2019-03-24 12:00:00,2019-03-24 12:15:00
5,10,5,5,0.011421147180372949,2019-03-24 12:00:00,2019-03-24 12:15:00
10,8,6,2,0.029119409703512802,2019-03-24 12:00:00,2019-03-24 12:15:00
15,4,1,3,0.003164766252066212,2019-03-24 12:00:00,2019-03-24 12:15:00
16,5,4,1,0.008823027339663097,2019-03-24 12:00:00,2019-03-24 12:15:00
18,5,3,2,0.004098114180015787,2019-03-24 12:00:00,2019-03-24 12:15:00
19,4,1,3,0.0024822280957858436,2019-03-24 12:00:00,2019-03-24 12:15:00
23,5,2,3,0.00589088721592905,2019-03-24 12:00:00,2019-03-24 12:15:00
26,8,2,6,0.0037334130169065596,2019-03-24 12:00:00,2019-03-24 12:15:00
27,1,1,0,0.005095260286648234,2019-03-24 12:00:00,2019-03-24 12:15:00
28,3,3,0,0.006407128916261023,2019-03-24 12:00:00,2019-03-24 12:15:00
35,1,0,1,0.0022680116605896658,2019-03-24 12:00:00,2019-03-24 12:15:00
37,1,1,0,0.0033205181886405612,2019-03-24 12:00:00,2019-03-24 12:15:00
41,12,3,9,0.004300658613623884,2019-03-24 12:00:00,2019-03-24 12:15:00
46,2,2,0,0.0037164016162007105,2019-03-24 12:00:00,2019-03-24 12:15:00
57,4,2,2,0.0051679365949708405,2019-03-24 12:00:00,2019-03-24 12:15:00
58,6,1,5,0.003384549011618086,2019-03-24 12:00:00,2019-03-24 12:15:00
61,4,1,3,0.003164766252066212,2019-03-24 12:00:00,2019-03-24 12:15:00
62,8,4,4,0.004406478952732821,2019-03-24 12:00:00,2019-03-24 12:15:00
64,10,6,4,0.023201729735884576,2019-03-24 12:00:00,2019-03-24 12:15:00
67,2,0,2,0.0022680116605896658,2019-03-24 12:00:00,2019-03-24 12:15:00
68,3,1,2,0.002674221830646178,2019-03-24 12:00:00,2019-03-24 12:15:00
69,5,5,0,0.00861330667004309,2019-03-24 12:00:00,2019-03-24 12:15:00
74,4,2,2,0.004466192933483324,2019-03-24 12:00:00,2019-03-24 12:15:00
75,15,7,8,0.025896453219381235,2019-03-24 12:00:00,2019-03-24 12:15:00
79,8,4,4,0.007828593930369204,2019-03-24 12:00:00,2019-03-24 12:15:00
80,2,1,1,0.015101830318389044,2019-03-24 12:00:00,2019-03-24 12:15:00
85,4,3,1,0.011235497884821172,2019-03-24 12:00:00,2019-03-24 12:15:00
87,10,7,3,0.05650930798688318,2019-03-24 12:00:00,2019-03-24 12:15:00
88,3,1,2,0.003944621233279929,2019-03-24 12:00:00,2019-03-24 12:15:00
89,3,2,1,0.004997127761330824,2019-03-24 12:00:00,2019-03-24 12:15:00
90,8,3,5,0.010332445117246996,2019-03-24 12:00:00,2019-03-24 12:15:00
99,3,2,1,0.0033259016258869174,2019-03-24 12:00:00,2019-03-24 12:15:00
104,4,3,1,0.0067692623563844635,2019-03-24 12:00:00,2019-03-24 12:15:00
106,2,1,1,0.015101830318389044,2019-03-24 12:00:00,2019-03-24 12:15:00
108,1,1,0,0.004195959577355267,2019-03-24 12:00:00,2019-03-24 12:15:00
109,4,2,2,0.005015409966382823,2019-03-24 12:00:00,2019-03-24 12:15:00
110,10,6,4,0.022739399102008437,2019-03-24 12:00:00,2019-03-24 12:15:00
111,7,0,7,0.0022680116605896658,2019-03-24 12:00:00,2019-03-24 12:15:00
112,5,3,2,0.006045414705994785,2019-03-24 12:00:00,2019-03-24 12:15:00
114,10,3,7,0.011360977127503166,2019-03-24 12:00:00,2019-03-24 12:15:00
115,6,3,3,0.010343797448061309,2019-03-24 12:00:00,2019-03-24 12:15:00
118,1,1,0,0.0032319856189724663,2019-03-24 12:00:00,2019-03-24 12:15:00
119,8,6,2,0.08192264583901407,2019-03-24 12:00:00,2019-03-24 12:15:00
120,7,3,4,0.005924350790609394,2019-03-24 12:00:00,2019-03-24 12:15:00
122,7,4,3,0.00857777950804434,2019-03-24 12:00:00,2019-03-24 12:15:00
126,7,2,5,0.003436525655436012,2019-03-24 12:00:00,2019-03-24 12:15:00
127,2,0,2,0.0022680116605896658,2019-03-24 12:00:00,2019-03-24 12:15:00
137,11,6,5,0.006190589941871558,2019-03-24 12:00:00,2019-03-24 12:15:00
138,3,3,0,0.0072993446509217,2019-03-24 12:00:00,2019-03-24 12:15:00
141,2,1,1,0.004009850852603558,2019-03-24 12:00:00,2019-03-24 12:15:00
151,7,3,4,0.005253849542652518,2019-03-24 12:00:00,2019-03-24 12:15:00
153,13,7,6,0.005111482850985252,2019-03-24 12:00:00,2019-03-24 12:15:00
154,2,1,1,0.015101830318389044,2019-03-24 12:00:00,2019-03-24 12:15:00
156,1,0,1,0.0022680116605896658,2019-03-24 12:00:00,2019-03-24 12:15:00
157,6,5,1,0.005533668696898691,2019-03-24 12:00:00,2019-03-24 12:15:00
158,1,1,0,0.011819131872364174,2019-03-24 12:00:00,2019-03-24 12:15:00
159,4,3,1,0.006712056579340782,2019-03-24 12:00:00,2019-03-24 12:15:00
160,2,1,1,0.015101830318389044,2019-03-24 12:00:00,2019-03-24 12:15:00
161,2,1,1,0.015101830318389044,2019-03-24 12:00:00,2019-03-24 12:15:00
162,1,1,0,0.003204468034257934,2019-03-24 12:00:00,2019-03-24 12:15:00
164,3,3,0,0.005781652046432273,2019-03-24 12:00:00,2019-03-24 12:15:00
168,14,6,8,0.014514041631982215,2019-03-24 12:00:00,2019-03-24 12:15:00
169,6,6,0,0.010185284595871837,2019-03-24 12:00:00,2019-03-24 12:15:00
170,1,0,1,0.0022680116605896658,2019-03-24 12:00:00,2019-03-24 12:15:00
171,5,3,2,0.02107036235155046,2019-03-24 12:00:00,2019-03-24 12:15:00
172,3,1,2,0.0032319856189724663,2019-03-24 12:00:00,2019-03-24 12:15:00
173,3,0,3,0.0022680116605896658,2019-03-24 12:00:00,2019-03-24 12:15:00
175,12,5,7,0.00577414324311779,2019-03-24 12:00:00,2019-03-24 12:15:00
177,10,4,6,0.00523458772613073,2019-03-24 12:00:00,2019-03-24 12:15:00
189,3,2,1,0.005781657572140431,2019-03-24 12:00:00,2019-03-24 12:15:00
190,8,8,0,0.009580860041802712,2019-03-24 12:00:00,2019-03-24 12:15:00
191,6,1,5,0.003204468034257934,2019-03-24 12:00:00,2019-03-24 12:15:00
195,2,1,1,0.015101830318389044,2019-03-24 12:00:00,2019-03-24 12:15:00
197,9,0,9,0.0022680116605896658,2019-03-24 12:00:00,2019-03-24 12:15:00
201,2,0,2,0.0022680116605896658,2019-03-24 12:00:00,2019-03-24 12:15:00
203,13,6,7,0.009320243349384902,2019-03-24 12:00:00,2019-03-24 12:15:00
1,7,4,3,0.003933793844467462,2019-03-24 12:15:00,2019-03-24 12:30:00
2,4,2,2,0.003775890489147482,2019-03-24 12:15:00,2019-03-24 12:30:00
5,6,3,3,0.0059935820048407935,2019-03-24 12:15:00,2019-03-24 12:30:00
10,8,5,3,0.00662194507291116,2019-03-24 12:15:00,2019-03-24 12:30:00
15,9,4,5,0.004804986884957115,2019-03-24 12:15:00,2019-03-24 12:30:00
16,7,6,1,0.0050588781435929155,2019-03-24 12:15:00,2019-03-24 12:30:00
18,6,3,3,0.003866103442265365,2019-03-24 12:15:00,2019-03-24 12:30:00
19,7,2,5,0.004464256787206857,2019-03-24 12:15:00,2019-03-24 12:30:00
20,1,1,0,0.003312586998169168,2019-03-24 12:15:00,2019-03-24 12:30:00
21,1,1,0,0.002756938379847665,2019-03-24 12:15:00,2019-03-24 12:30:00
22,1,0,1,0.0017905607152918401,2019-03-24 12:15:00,2019-03-24 12:30:00
23,2,1,1,0.002111238326838154,2019-03-24 12:15:00,2019-03-24 12:30:00
26,8,1,7,0.002227887536136196,2019-03-24 12:15:00,2019-03-24 12:30:00
27,2,0,2,0.0017905607152918401,2019-03-24 12:15:00,2019-03-24 12:30:00
28,1,0,1,0.0017905607152918401,2019-03-24 12:15:00,2019-03-24 12:30:00
30,4,2,2,0.011932166692229958,2019-03-24 12:15:00,2019-03-24 12:30:00
35,1,0,1,0.0017905607152918401,2019-03-24 12:15:00,2019-03-24 12:30:00
37,1,1,0,0.0022239752647596677,2019-03-24 12:15:00,2019-03-24 12:30:00
41,9,3,6,0.003101330661083031,2019-03-24 12:15:00,2019-03-24 12:30:00
46,3,3,0,0.0038619876462691704,2019-03-24 12:15:00,2019-03-24 12:30:00
50,2,0,2,0.0017905607152918401,2019-03-24 12:15:00,2019-03-24 12:30:00
57,4,2,2,0.0036281198810135685,2019-03-24 12:15:00,2019-03-24 12:30:00
58,3,2,1,0.02131275952772941,2019-03-24 12:15:00,2019-03-24 12:30:00
61,4,1,3,0.002498493070253953,2019-03-24 12:15:00,2019-03-24 12:30:00
62,13,5,8,0.004115823592883886,2019-03-24 12:15:00,2019-03-24 12:30:00
64,9,5,4,0.005990966045721899,2019-03-24 12:15:00,2019-03-24 12:30:00
66,2,2,0,0.0034243361291998228,2019-03-24 12:15:00,2019-03-24 12:30:00
67,3,1,2,0.0036860842514223895,2019-03-24 12:15:00,2019-03-24 12:30:00
68,2,1,1,0.002229938980946687,2019-03-24 12:15:00,2019-03-24 12:30:00
69,6,4,2,0.023734324003804343,2019-03-24 12:15:00,2019-03-24 12:30:00
70,1,1,0,0.006298833028442705,2019-03-24 12:15:00,2019-03-24 12:30:00
71,4,2,2,0.011932166692229958,2019-03-24 12:15:00,2019-03-24 12:30:00
74,6,4,2,0.02403159989249185,2019-03-24 12:15:00,2019-03-24 12:30:00
75,21,11,10,0.049841382030123046,2019-03-24 12:15:00,2019-03-24 12:30:00
79,6,2,4,0.003114113897862268,2019-03-24 12:15:00,2019-03-24 12:30:00
80,4,3,1,0.04207899610903029,2019-03-24 12:15:00,2019-03-24 12:30:00
85,6,3,3,0.013619489044833084,2019-03-24 12:15:00,2019-03-24 12:30:00
86,2,0,2,0.0017905607152918401,2019-03-24 12:15:00,2019-03-24 12:30:00
87,16,7,9,0.006267538079860712,2019-03-24 12:15:00,2019-03-24 12:30:00
88,5,1,4,0.002273749547569753,2019-03-24 12:15:00,2019-03-24 12:30:00
89,3,1,2,0.002273749547569753,2019-03-24 12:15:00,2019-03-24 12:30:00
90,4,0,4,0.0017905607152918401,2019-03-24 12:15:00,2019-03-24 12:30:00
99,4,2,2,0.0023316397759641752,2019-03-24 12:15:00,2019-03-24 12:30:00
101,2,2,0,0.007178277522998435,2019-03-24 12:15:00,2019-03-24 12:30:00
104,10,6,4,0.011072290981228191,2019-03-24 12:15:00,2019-03-24 12:30:00
106,3,2,1,0.027005581400630124,2019-03-24 12:15:00,2019-03-24 12:30:00
108,3,1,2,0.006338157688877749,2019-03-24 12:15:00,2019-03-24 12:30:00
109,5,2,3,0.01590474649401261,2019-03-24 12:15:00,2019-03-24 12:30:00
110,7,6,1,0.07535190437325831,2019-03-24 12:15:00,2019-03-24 12:30:00
111,7,1,6,0.0020861019315596674,2019-03-24 12:15:00,2019-03-24 12:30:00
112,5,3,2,0.00418724063985788,2019-03-24 12:15:00,2019-03-24 12:30:00
114,3,1,2,0.003201372062991734,2019-03-24 12:15:00,2019-03-24 12:30:00
115,14,11,3,0.024897823072799967,2019-03-24 12:15:00,2019-03-24 12:30:00
118,2,2,0,0.004879239040122977,2019-03-24 12:15:00,2019-03-24 12:30:00
119,6,5,1,0.056773893624130455,2019-03-24 12:15:00,2019-03-24 12:30:00
120,5,3,2,0.003924805191456321,2019-03-24 12:15:00,2019-03-24 12:30:00
122,7,4,3,0.006340879866320839,2019-03-24 12:15:00,2019-03-24 12:30:00
126,8,2,6,0.002498493070253953,2019-03-24 12:15:00,2019-03-24 12:30:00
127,4,2,2,0.0033194165860387184,2019-03-24 12:15:00,2019-03-24 12:30:00
137,12,5,7,0.0035691498583094636,2019-03-24 12:15:00,2019-03-24 12:30:00
140,1,0,1,0.0017905607152918401,2019-03-24 12:15:00,2019-03-24 12:30:00
141,3,1,2,0.0028860020365708908,2019-03-24 12:15:00,2019-03-24 12:30:00
151,3,1,2,0.003312586998169168,2019-03-24 12:15:00,2019-03-24 12:30:00
153,15,6,9,0.005065080887076769,2019-03-24 12:15:00,2019-03-24 12:30:00
154,6,5,1,0.038634830718227986,2019-03-24 12:15:00,2019-03-24 12:30:00
156,1,0,1,0.0017905607152918401,2019-03-24 12:15:00,2019-03-24 12:30:00
157,3,2,1,0.0033085033120770213,2019-03-24 12:15:00,2019-03-24 12:30:00
158,6,2,4,0.006260289827920359,2019-03-24 12:15:00,2019-03-24 12:30:00
159,4,3,1,0.004522015158924544,2019-03-24 12:15:00,2019-03-24 12:30:00
160,10,5,5,0.011932166692229958,2019-03-24 12:15:00,2019-03-24 12:30:00
161,2,1,1,0.011932166692229958,2019-03-24 12:15:00,2019-03-24 12:30:00
162,2,2,0,0.0027062894202912633,2019-03-24 12:15:00,2019-03-24 12:30:00
164,13,8,5,0.013148250334189784,2019-03-24 12:15:00,2019-03-24 12:30:00
168,15,6,9,0.00645259303104837,2019-03-24 12:15:00,2019-03-24 12:30:00
169,12,11,1,0.0222070805714332,2019-03-24 12:15:00,2019-03-24 12:30:00
170,3,2,1,0.005349864096368083,2019-03-24 12:15:00,2019-03-24 12:30:00
171,5,3,2,0.01664900350321796,2019-03-24 12:15:00,2019-03-24 12:30:00
172,1,1,0,0.003357212757245648,2019-03-24 12:15:00,2019-03-24 12:30:00
173,8,3,5,0.003866103442265365,2019-03-24 12:15:00,2019-03-24 12:30:00
175,10,4,6,0.004132357796645825,2019-03-24 12:15:00,2019-03-24 12:30:00
177,9,4,5,0.005596830522492064,2019-03-24 12:15:00,2019-03-24 12:30:00
189,2,2,0,0.0025515738567305044,2019-03-24 12:15:00,2019-03-24 12:30:00
190,11,8,3,0.007987876244717093,2019-03-24 12:15:00,2019-03-24 12:30:00
191,14,6,8,0.0071382529113084466,2019-03-24 12:15:00,2019-03-24 12:30:00
195,2,1,1,0.011932166692229958,2019-03-24 12:15:00,2019-03-24 12:30:00
197,12,2,10,0.003772526765063262,2019-03-24 12:15:00,2019-03-24 12:30:00
201,1,1,0,0.003312586998169168,2019-03-24 12:15:00,2019-03-24 12:30:00
203,15,5,10,0.003114113897862268,2019-03-24 12:15:00,2019-03-24 12:30:00
1,5,0,5,0.0020946850611081587,2019-03-24 12:30:00,2019-03-24 12:45:00
2,5,3,2,0.017602693539350223,2019-03-24 12:30:00,2019-03-24 12:45:00
5,2,2,0,0.0038935928959647342,2019-03-24 12:30:00,2019-03-24 12:45:00
10,6,4,2,0.008479751255711689,2019-03-24 12:30:00,2019-03-24 12:45:00
15,7,3,4,0.003718707379749495,2019-03-24 12:30:00,2019-03-24 12:45:00
16,8,8,0,0.01689021013546609,2019-03-24 12:30:00,2019-03-24 12:45:00
18,6,2,4,0.006402944289668472,2019-03-24 12:30:00,2019-03-24 12:45:00
19,4,2,2,0.004077974121253807,2019-03-24 12:30:00,2019-03-24 12:45:00
20,1,1,0,0.003875268080961795,2019-03-24 12:30:00,2019-03-24 12:45:00
21,3,3,0,0.007246517205108705,2019-03-24 12:30:00,2019-03-24 12:45:00
22,1,0,1,0.0020946850611081587,2019-03-24 12:30:00,2019-03-24 12:45:00
23,11,7,4,0.009105342613033437,2019-03-24 12:30:00,2019-03-24 12:45:00
26,10,6,4,0.005953121069682101,2019-03-24 12:30:00,2019-03-24 12:45:00
27,1,0,1,0.0020946850611081587,2019-03-24 12:30:00,2019-03-24 12:45:00
28,1,0,1,0.0020946850611081587,2019-03-24 12:30:00,2019-03-24 12:45:00
30,2,1,1,0.013928302668738094,2019-03-24 12:30:00,2019-03-24 12:45:00
35,4,2,2,0.006009807312858252,2019-03-24 12:30:00,2019-03-24 12:45:00
37,4,4,0,0.006165703252973534,2019-03-24 12:30:00,2019-03-24 12:45:00
40,2,1,1,0.013928302668738094,2019-03-24 12:30:00,2019-03-24 12:45:00
41,7,2,5,0.003946955567097619,2019-03-24 12:30:00,2019-03-24 12:45:00
46,3,1,2,0.002450801665078886,2019-03-24 12:30:00,2019-03-24 12:45:00
50,2,0,2,0.0020946850611081587,2019-03-24 12:30:00,2019-03-24 12:45:00
57,4,1,3,0.0029228873715229703,2019-03-24 12:30:00,2019-03-24 12:45:00
58,3,2,1,0.004763868740475054,2019-03-24 12:30:00,2019-03-24 12:45:00
61,6,1,5,0.0025237474351650227,2019-03-24 12:30:00,2019-03-24 12:45:00
62,17,7,10,0.010053249250953694,2019-03-24 12:30:00,2019-03-24 12:45:00
64,9,3,6,0.0035215972760598915,2019-03-24 12:30:00,2019-03-24 12:45:00
66,2,1,1,0.013928302668738094,2019-03-24 12:30:00,2019-03-24 12:45:00
67,1,0,1,0.0020946850611081587,2019-03-24 12:30:00,2019-03-24 12:45:00
68,3,3,0,0.010216029806685812,2019-03-24 12:30:00,2019-03-24 12:45:00
69,11,5,6,0.008198820937818234,2019-03-24 12:30:00,2019-03-24 12:45:00
70,1,1,0,0.006427652328057183,2019-03-24 12:30:00,2019-03-24 12:45:00
71,6,3,3,0.013928302668738094,2019-03-24 12:30:00,2019-03-24 12:45:00
74,4,2,2,0.004417873293700095,2019-03-24 12:30:00,2019-03-24 12:45:00
75,19,11,8,0.025020119397172955,2019-03-24 12:30:00,2019-03-24 12:45:00
79,8,2,6,0.0029228873715229703,2019-03-24 12:30:00,2019-03-24 12:45:00
80,4,3,1,0.02812693415887962,2019-03-24 12:30:00,2019-03-24 12:45:00
85,6,2,4,0.008455900048969567,2019-03-24 12:30:00,2019-03-24 12:45:00
86,3,0,3,0.0020946850611081587,2019-03-24 12:30:00,2019-03-24 12:45:00
87,18,7,11,0.007513684393577134,2019-03-24 12:30:00,2019-03-24 12:45:00
88,6,1,5,0.0025237474351650227,2019-03-24 12:30:00,2019-03-24 12:45:00
89,6,3,3,0.012148036351506603,2019-03-24 12:30:00,2019-03-24 12:45:00
90,15,6,9,0.005860770339590136,2019-03-24 12:30:00,2019-03-24 12:45:00
99,4,0,4,0.0020946850611081587,2019-03-24 12:30:00,2019-03-24 12:45:00
101,2,2,0,0.009042243749541934,2019-03-24 12:30:00,2019-03-24 12:45:00
104,4,2,2,0.002806918269049613,2019-03-24 12:30:00,2019-03-24 12:45:00
106,6,2,4,0.0040186949054122675,2019-03-24 12:30:00,2019-03-24 12:45:00
108,3,1,2,0.008172789203655934,2019-03-24 12:30:00,2019-03-24 12:45:00
109,6,4,2,0.010193826978972156,2019-03-24 12:30:00,2019-03-24 12:45:00
110,3,3,0,0.006410110240461424,2019-03-24 12:30:00,2019-03-24 12:45:00
111,4,1,3,0.0029228873715229703,2019-03-24 12:30:00,2019-03-24 12:45:00
112,9,6,3,0.008920398546935592,2019-03-24 12:30:00,2019-03-24 12:45:00
114,5,0,5,0.0020946850611081587,2019-03-24 12:30:00,2019-03-24 12:45:00
115,16,12,4,0.030849785677446485,2019-03-24 12:30:00,2019-03-24 12:45:00
118,2,1,1,0.003875268080961795,2019-03-24 12:30:00,2019-03-24 12:45:00
119,8,5,3,0.016916974260166803,2019-03-24 12:30:00,2019-03-24 12:45:00
120,8,5,3,0.016760707756129933,2019-03-24 12:30:00,2019-03-24 12:45:00
122,5,2,3,0.004834375982707582,2019-03-24 12:30:00,2019-03-24 12:45:00
126,8,5,3,0.007300097812147062,2019-03-24 12:30:00,2019-03-24 12:45:00
127,1,1,0,0.003928640289215273,2019-03-24 12:30:00,2019-03-24 12:45:00
137,12,6,6,0.012943221543628114,2019-03-24 12:30:00,2019-03-24 12:45:00
138,9,6,3,0.013146420198425818,2019-03-24 12:30:00,2019-03-24 12:45:00
140,2,1,1,0.0037655893727227925,2019-03-24 12:30:00,2019-03-24 12:45:00
141,5,3,2,0.00793423663285135,2019-03-24 12:30:00,2019-03-24 12:45:00
151,8,3,5,0.0058718268164663166,2019-03-24 12:30:00,2019-03-24 12:45:00
153,7,2,5,0.0054712706185844635,2019-03-24 12:30:00,2019-03-24 12:45:00
154,7,5,2,0.010738249684967956,2019-03-24 12:30:00,2019-03-24 12:45:00
156,1,0,1,0.0020946850611081587,2019-03-24 12:30:00,2019-03-24 12:45:00
157,6,2,4,0.00556118983693624,2019-03-24 12:30:00,2019-03-24 12:45:00
158,9,4,5,0.0069478326004575215,2019-03-24 12:30:00,2019-03-24 12:45:00
159,4,3,1,0.003921166739275231,2019-03-24 12:30:00,2019-03-24 12:45:00
160,10,5,5,0.013928302668738094,2019-03-24 12:30:00,2019-03-24 12:45:00
162,4,3,1,0.0257654014415906,2019-03-24 12:30:00,2019-03-24 12:45:00
164,17,9,8,0.015723425066894163,2019-03-24 12:30:00,2019-03-24 12:45:00
168,25,10,15,0.01716486173764036,2019-03-24 12:30:00,2019-03-24 12:45:00
169,32,22,10,0.05660241065691308,2019-03-24 12:30:00,2019-03-24 12:45:00
170,3,2,1,0.007150037478521514,2019-03-24 12:30:00,2019-03-24 12:45:00
171,1,1,0,0.0025237474351650227,2019-03-24 12:30:00,2019-03-24 12:45:00
172,5,4,1,0.006905630070213716,2019-03-24 12:30:00,2019-03-24 12:45:00
173,5,2,3,0.004834375982707582,2019-03-24 12:30:00,2019-03-24 12:45:00
175,10,6,4,0.02055722476927383,2019-03-24 12:30:00,2019-03-24 12:45:00
177,11,5,6,0.00718380121945447,2019-03-24 12:30:00,2019-03-24 12:45:00
189,2,2,0,0.003201807425400045,2019-03-24 12:30:00,2019-03-24 12:45:00
190,10,3,7,0.008810755600016427,2019-03-24 12:30:00,2019-03-24 12:45:00
191,9,4,5,0.009930098706549864,2019-03-24 12:30:00,2019-03-24 12:45:00
195,1,1,0,0.002688212734392704,2019-03-24 12:30:00,2019-03-24 12:45:00
197,8,2,6,0.0029849765710349765,2019-03-24 12:30:00,2019-03-24 12:45:00
201,1,1,0,0.005295831041220085,2019-03-24 12:30:00,2019-03-24 12:45:00
202,2,0,2,0.0020946850611081587,2019-03-24 12:30:00,2019-03-24 12:45:00
203,15,6,9,0.004413651530269631,2019-03-24 12:30:00,2019-03-24 12:45:00
1,4,0,4,0.0018084500492125681,2019-03-24 12:45:00,2019-03-24 13:00:00
2,14,8,6,0.013506875259094116,2019-03-24 12:45:00,2019-03-24 13:00:00
5,1,1,0,0.002178873128292498,2019-03-24 12:45:00,2019-03-24 13:00:00
10,7,5,2,0.008320633751130258,2019-03-24 12:45:00,2019-03-24 13:00:00
11,3,1,2,0.003145234421911486,2019-03-24 12:45:00,2019-03-24 13:00:00
15,6,2,4,0.0038797816025650696,2019-03-24 12:45:00,2019-03-24 13:00:00
16,7,7,0,0.014775691702245575,2019-03-24 12:45:00,2019-03-24 13:00:00
18,10,2,8,0.0043920551320542674,2019-03-24 12:45:00,2019-03-24 13:00:00
19,6,1,5,0.002632960892422288,2019-03-24 12:45:00,2019-03-24 13:00:00
20,5,0,5,0.0018084500492125681,2019-03-24 12:45:00,2019-03-24 13:00:00
21,3,2,1,0.003341028485596689,2019-03-24 12:45:00,2019-03-24 13:00:00
23,11,6,5,0.009602963692809826,2019-03-24 12:45:00,2019-03-24 13:00:00
26,16,7,9,0.004175717425814779,2019-03-24 12:45:00,2019-03-24 13:00:00
27,3,1,2,0.003145234421911486,2019-03-24 12:45:00,2019-03-24 13:00:00
28,1,1,0,0.003145234421911486,2019-03-24 12:45:00,2019-03-24 13:00:00
35,4,3,1,0.020620895634738727,2019-03-24 12:45:00,2019-03-24 13:00:00
37,8,4,4,0.005044429134371053,2019-03-24 12:45:00,2019-03-24 13:00:00
40,6,3,3,0.010905670946029887,2019-03-24 12:45:00,2019-03-24 13:00:00
41,7,3,4,0.008074134791972701,2019-03-24 12:45:00,2019-03-24 13:00:00
46,3,1,2,0.002901659199348626,2019-03-24 12:45:00,2019-03-24 13:00:00
57,7,3,4,0.004870611212272169,2019-03-24 12:45:00,2019-03-24 13:00:00
58,15,6,9,0.00640243412503531,2019-03-24 12:45:00,2019-03-24 13:00:00
61,6,1,5,0.002178873128292498,2019-03-24 12:45:00,2019-03-24 13:00:00
62,18,7,11,0.009915937527193528,2019-03-24 12:45:00,2019-03-24 13:00:00
64,5,1,4,0.002758084607234361,2019-03-24 12:45:00,2019-03-24 13:00:00
66,2,1,1,0.012039108204438782,2019-03-24 12:45:00,2019-03-24 13:00:00
67,4,2,2,0.0058748048269426055,2019-03-24 12:45:00,2019-03-24 13:00:00
68,5,2,3,0.011487110848433292,2019-03-24 12:45:00,2019-03-24 13:00:00
69,13,5,8,0.018881790883482855,2019-03-24 12:45:00,2019-03-24 13:00:00
70,2,1,1,0.009540413984227867,2019-03-24 12:45:00,2019-03-24 13:00:00
71,7,4,3,0.025289593227359547,2019-03-24 12:45:00,2019-03-24 13:00:00
74,4,2,2,0.005821660886706473,2019-03-24 12:45:00,2019-03-24 13:00:00
75,20,11,9,0.019899122610821628,2019-03-24 12:45:00,2019-03-24 13:00:00
79,9,2,7,0.0023885500023413902,2019-03-24 12:45:00,2019-03-24 13:00:00
80,4,3,1,0.01619210097514169,2019-03-24 12:45:00,2019-03-24 13:00:00
85,4,1,3,0.004378977985874876,2019-03-24 12:45:00,2019-03-24 13:00:00
86,3,1,2,0.003145234421911486,2019-03-24 12:45:00,2019-03-24 13:00:00
87,18,7,11,0.006416212451759572,2019-03-24 12:45:00,2019-03-24 13:00:00
88,9,4,5,0.0055852703529092875,2019-03-24 12:45:00,2019-03-24 13:00:00
89,4,2,2,0.011104144151554685,2019-03-24 12:45:00,2019-03-24 13:00:00
90,18,8,10,0.009542162197302573,2019-03-24 12:45:00,2019-03-24 13:00:00
99,4,0,4,0.0018084500492125681,2019-03-24 12:45:00,2019-03-24 13:00:00
101,7,5,2,0.04382886879953896,2019-03-24 12:45:00,2019-03-24 13:00:00
104,5,5,0,0.006061445911385352,2019-03-24 12:45:00,2019-03-24 13:00:00
106,6,2,4,0.0026927648627292876,2019-03-24 12:45:00,2019-03-24 13:00:00
108,2,0,2,0.0018084500492125681,2019-03-24 12:45:00,2019-03-24 13:00:00
109,5,4,1,0.00909481311249708,2019-03-24 12:45:00,2019-03-24 13:00:00
110,8,5,3,0.01011393272354113,2019-03-24 12:45:00,2019-03-24 13:00:00
111,10,6,4,0.00914422573610223,2019-03-24 12:45:00,2019-03-24 13:00:00
112,15,9,6,0.008800311852546412,2019-03-24 12:45:00,2019-03-24 13:00:00
113,1,1,0,0.002120528167955217,2019-03-24 12:45:00,2019-03-24 13:00:00
114,7,1,6,0.0022028408496342724,2019-03-24 12:45:00,2019-03-24 13:00:00
115,10,7,3,0.01717420448457773,2019-03-24 12:45:00,2019-03-24 13:00:00
116,3,2,1,0.0027037034602984283,2019-03-24 12:45:00,2019-03-24 13:00:00
118,1,0,1,0.0018084500492125681,2019-03-24 12:45:00,2019-03-24 13:00:00
119,21,12,9,0.03264699333758164,2019-03-24 12:45:00,2019-03-24 13:00:00
120,2,2,0,0.003994868349484685,2019-03-24 12:45:00,2019-03-24 13:00:00
122,4,2,2,0.012039108204438782,2019-03-24 12:45:00,2019-03-24 13:00:00
126,8,5,3,0.006834460525092401,2019-03-24 12:45:00,2019-03-24 13:00:00
127,1,1,0,0.002256076754755498,2019-03-24 12:45:00,2019-03-24 13:00:00
133,2,2,0,0.007540622935832136,2019-03-24 12:45:00,2019-03-24 13:00:00
137,20,7,13,0.010244168734414711,2019-03-24 12:45:00,2019-03-24 13:00:00
138,9,7,2,0.011385121514508932,2019-03-24 12:45:00,2019-03-24 13:00:00
140,2,1,1,0.003046892179702432,2019-03-24 12:45:00,2019-03-24 13:00:00
141,11,6,5,0.008747531110582952,2019-03-24 12:45:00,2019-03-24 13:00:00
151,9,4,5,0.005508831682545739,2019-03-24 12:45:00,2019-03-24 13:00:00
153,13,5,8,0.004751997044164751,2019-03-24 12:45:00,2019-03-24 13:00:00
154,7,5,2,0.006047916914509975,2019-03-24 12:45:00,2019-03-24 13:00:00
156,1,0,1,0.0018084500492125681,2019-03-24 12:45:00,2019-03-24 13:00:00
157,8,4,4,0.007981071940597622,2019-03-24 12:45:00,2019-03-24 13:00:00
158,8,6,2,0.009980582280561307,2019-03-24 12:45:00,2019-03-24 13:00:00
159,4,3,1,0.0033250954451593834,2019-03-24 12:45:00,2019-03-24 13:00:00
160,10,5,5,0.012039108204438782,2019-03-24 12:45:00,2019-03-24 13:00:00
162,3,2,1,0.015395160724499864,2019-03-24 12:45:00,2019-03-24 13:00:00
164,15,8,7,0.010196802050237605,2019-03-24 12:45:00,2019-03-24 13:00:00
168,17,9,8,0.018160337962625617,2019-03-24 12:45:00,2019-03-24 13:00:00
169,37,26,11,0.06013564991887739,2019-03-24 12:45:00,2019-03-24 13:00:00
170,2,2,0,0.0043020914694981306,2019-03-24 12:45:00,2019-03-24 13:00:00
171,1,1,0,0.002178873128292498,2019-03-24 12:45:00,2019-03-24 13:00:00
172,7,4,3,0.009771345664740286,2019-03-24 12:45:00,2019-03-24 13:00:00
173,4,2,2,0.012039108204438782,2019-03-24 12:45:00,2019-03-24 13:00:00
175,10,6,4,0.019823888251488255,2019-03-24 12:45:00,2019-03-24 13:00:00
177,14,6,8,0.005493215435193219,2019-03-24 12:45:00,2019-03-24 13:00:00
189,3,2,1,0.0034308683825023875,2019-03-24 12:45:00,2019-03-24 13:00:00
190,13,4,9,0.003304215491581556,2019-03-24 12:45:00,2019-03-24 13:00:00
191,15,8,7,0.016747284390932742,2019-03-24 12:45:00,2019-03-24 13:00:00
195,1,1,0,0.003145234421911486,2019-03-24 12:45:00,2019-03-24 13:00:00
197,7,2,5,0.002577070434778955,2019-03-24 12:45:00,2019-03-24 13:00:00
202,2,0,2,0.0018084500492125681,2019-03-24 12:45:00,2019-03-24 13:00:00
203,19,9,10,0.012858588289833044,2019-03-24 12:45:00,2019-03-24 13:00:00
1,3,0,3,0.001809846732781722,2019-03-24 13:00:00,2019-03-24 13:15:00
2,15,7,8,0.00621087264512471,2019-03-24 13:00:00,2019-03-24 13:15:00
5,6,3,3,0.005728960276265181,2019-03-24 13:00:00,2019-03-24 13:15:00
10,10,8,2,0.03257580671782174,2019-03-24 13:00:00,2019-03-24 13:15:00
11,11,5,6,0.006207290795793776,2019-03-24 13:00:00,2019-03-24 13:15:00
15,8,2,6,0.003785177935252881,2019-03-24 13:00:00,2019-03-24 13:15:00
16,7,7,0,0.010550323524259176,2019-03-24 13:00:00,2019-03-24 13:15:00
18,5,1,4,0.0059149901349815496,2019-03-24 13:00:00,2019-03-24 13:15:00
19,14,5,9,0.004766284849978828,2019-03-24 13:00:00,2019-03-24 13:15:00
20,8,0,8,0.001809846732781722,2019-03-24 13:00:00,2019-03-24 13:15:00
21,3,2,1,0.003166552646003947,2019-03-24 13:00:00,2019-03-24 13:15:00
22,1,0,1,0.001809846732781722,2019-03-24 13:00:00,2019-03-24 13:15:00
23,14,7,7,0.0078060138705302855,2019-03-24 13:00:00,2019-03-24 13:15:00
26,13,2,11,0.0026965883300915073,2019-03-24 13:00:00,2019-03-24 13:15:00
27,4,2,2,0.009657620754052267,2019-03-24 13:00:00,2019-03-24 13:15:00
28,2,1,1,0.0026893355453841325,2019-03-24 13:00:00,2019-03-24 13:15:00
35,3,2,1,0.01562666164428853,2019-03-24 13:00:00,2019-03-24 13:15:00
37,6,2,4,0.003435809208444846,2019-03-24 13:00:00,2019-03-24 13:15:00
40,6,4,2,0.005795199897165022,2019-03-24 13:00:00,2019-03-24 13:15:00
41,4,2,2,0.00348216898783668,2019-03-24 13:00:00,2019-03-24 13:15:00
46,1,1,0,0.002703650033810411,2019-03-24 13:00:00,2019-03-24 13:15:00
57,5,3,2,0.005159300010570047,2019-03-24 13:00:00,2019-03-24 13:15:00
58,9,4,5,0.014438376599748098,2019-03-24 13:00:00,2019-03-24 13:15:00
61,11,4,7,0.0055367453633302635,2019-03-24 13:00:00,2019-03-24 13:15:00
62,28,12,16,0.012767580475097387,2019-03-24 13:00:00,2019-03-24 13:15:00
64,5,1,4,0.00333598441317514,2019-03-24 13:00:00,2019-03-24 13:15:00
66,2,1,1,0.012058010890629012,2019-03-24 13:00:00,2019-03-24 13:15:00
67,9,5,4,0.007737309095377197,2019-03-24 13:00:00,2019-03-24 13:15:00
68,9,4,5,0.013716613070471933,2019-03-24 13:00:00,2019-03-24 13:15:00
69,7,3,4,0.013813213938783792,2019-03-24 13:00:00,2019-03-24 13:15:00
70,2,2,0,0.004893386788047726,2019-03-24 13:00:00,2019-03-24 13:15:00
71,7,4,3,0.031535290479715726,2019-03-24 13:00:00,2019-03-24 13:15:00
74,6,4,2,0.01066454879495792,2019-03-24 13:00:00,2019-03-24 13:15:00
75,21,10,11,0.008979085137646505,2019-03-24 13:00:00,2019-03-24 13:15:00
79,6,2,4,0.0031477045368256884,2019-03-24 13:00:00,2019-03-24 13:15:00
80,4,3,1,0.01666646732348006,2019-03-24 13:00:00,2019-03-24 13:15:00
85,4,1,3,0.004042864260861572,2019-03-24 13:00:00,2019-03-24 13:15:00
86,2,1,1,0.012058010890629012,2019-03-24 13:00:00,2019-03-24 13:15:00
87,15,6,9,0.008402121880069186,2019-03-24 13:00:00,2019-03-24 13:15:00
88,10,3,7,0.003954598932879744,2019-03-24 13:00:00,2019-03-24 13:15:00
89,3,2,1,0.005227222481661125,2019-03-24 13:00:00,2019-03-24 13:15:00
90,14,7,7,0.011329119718070138,2019-03-24 13:00:00,2019-03-24 13:15:00
99,1,1,0,0.002255185482879591,2019-03-24 13:00:00,2019-03-24 13:15:00
101,5,3,2,0.027561530435117845,2019-03-24 13:00:00,2019-03-24 13:15:00
104,10,7,3,0.01320754470696476,2019-03-24 13:00:00,2019-03-24 13:15:00
106,7,2,5,0.00259734808637414,2019-03-24 13:00:00,2019-03-24 13:15:00
108,3,1,2,0.0031477045368256884,2019-03-24 13:00:00,2019-03-24 13:15:00
109,6,6,0,0.007318220761161767,2019-03-24 13:00:00,2019-03-24 13:15:00
110,10,6,4,0.007180928597737579,2019-03-24 13:00:00,2019-03-24 13:15:00
111,10,6,4,0.005366988751330748,2019-03-24 13:00:00,2019-03-24 13:15:00
112,13,8,5,0.00846362377845114,2019-03-24 13:00:00,2019-03-24 13:15:00
113,3,3,0,0.008063054013009434,2019-03-24 13:00:00,2019-03-24 13:15:00
114,10,4,6,0.002836938328859608,2019-03-24 13:00:00,2019-03-24 13:15:00
115,5,4,1,0.04954619866703546,2019-03-24 13:00:00,2019-03-24 13:15:00
116,3,2,1,0.002710281403640857,2019-03-24 13:00:00,2019-03-24 13:15:00
118,7,2,5,0.005227222481661125,2019-03-24 13:00:00,2019-03-24 13:15:00
119,18,11,7,0.013254001702201406,2019-03-24 13:00:00,2019-03-24 13:15:00
120,3,2,1,0.0035974533348390996,2019-03-24 13:00:00,2019-03-24 13:15:00
122,4,2,2,0.012058010890629012,2019-03-24 13:00:00,2019-03-24 13:15:00
126,8,5,3,0.007727696243345515,2019-03-24 13:00:00,2019-03-24 13:15:00
127,1,1,0,0.0022600640682112895,2019-03-24 13:00:00,2019-03-24 13:15:00
133,4,4,0,0.006206874607249433,2019-03-24 13:00:00,2019-03-24 13:15:00
137,21,9,12,0.01174677616774177,2019-03-24 13:00:00,2019-03-24 13:15:00
138,14,11,3,0.012778599451713085,2019-03-24 13:00:00,2019-03-24 13:15:00
140,2,1,1,0.002290123680757526,2019-03-24 13:00:00,2019-03-24 13:15:00
141,8,4,4,0.007318388066534898,2019-03-24 13:00:00,2019-03-24 13:15:00
147,1,1,0,0.0033482940263017263,2019-03-24 13:00:00,2019-03-24 13:15:00
151,12,6,6,0.005823420144913621,2019-03-24 13:00:00,2019-03-24 13:15:00
153,13,6,7,0.005358785663252711,2019-03-24 13:00:00,2019-03-24 13:15:00
154,6,4,2,0.005253366391860932,2019-03-24 13:00:00,2019-03-24 13:15:00
156,3,0,3,0.001809846732781722,2019-03-24 13:00:00,2019-03-24 13:15:00
157,8,2,6,0.0064579359293783735,2019-03-24 13:00:00,2019-03-24 13:15:00
158,8,5,3,0.03518354317825114,2019-03-24 13:00:00,2019-03-24 13:15:00
159,3,3,0,0.003972746576362987,2019-03-24 13:00:00,2019-03-24 13:15:00
160,10,5,5,0.012058010890629012,2019-03-24 13:00:00,2019-03-24 13:15:00
162,3,2,1,0.01657243934495791,2019-03-24 13:00:00,2019-03-24 13:15:00
164,9,8,1,0.008108192296340447,2019-03-24 13:00:00,2019-03-24 13:15:00
168,17,10,7,0.014936474481685105,2019-03-24 13:00:00,2019-03-24 13:15:00
169,38,23,15,0.030146443376851895,2019-03-24 13:00:00,2019-03-24 13:15:00
170,2,0,2,0.001809846732781722,2019-03-24 13:00:00,2019-03-24 13:15:00
171,3,1,2,0.00248222298962216,2019-03-24 13:00:00,2019-03-24 13:15:00
172,5,1,4,0.003454352127326343,2019-03-24 13:00:00,2019-03-24 13:15:00
173,4,2,2,0.012058010890629012,2019-03-24 13:00:00,2019-03-24 13:15:00
175,10,6,4,0.021496065890996653,2019-03-24 13:00:00,2019-03-24 13:15:00
177,15,6,9,0.004714893439882181,2019-03-24 13:00:00,2019-03-24 13:15:00
189,5,1,4,0.002642084358842831,2019-03-24 13:00:00,2019-03-24 13:15:00
190,9,3,6,0.0024417090140488665,2019-03-24 13:00:00,2019-03-24 13:15:00
191,5,2,3,0.004176986537007239,2019-03-24 13:00:00,2019-03-24 13:15:00
196,2,2,0,0.003919875190343778,2019-03-24 13:00:00,2019-03-24 13:15:00
197,7,0,7,0.001809846732781722,2019-03-24 13:00:00,2019-03-24 13:15:00
199,4,1,3,0.0025254235979750186,2019-03-24 13:00:00,2019-03-24 13:15:00
203,21,11,10,0.010513341338128711,2019-03-24 13:00:00,2019-03-24 13:15:00
1,3,0,3,0.0016800500700011817,2019-03-24 13:15:00,2019-03-24 13:30:00
2,11,5,6,0.00699750743394777,2019-03-24 13:15:00,2019-03-24 13:30:00
5,10,5,5,0.006303963135765105,2019-03-24 13:15:00,2019-03-24 13:30:00
10,8,5,3,0.005410271489625597,2019-03-24 13:15:00,2019-03-24 13:30:00
11,11,5,6,0.005761416234167379,2019-03-24 13:15:00,2019-03-24 13:30:00
15,7,3,4,0.006201954585816534,2019-03-24 13:15:00,2019-03-24 13:30:00
16,11,9,2,0.0112802985329983,2019-03-24 13:15:00,2019-03-24 13:30:00
18,7,2,5,0.012094114216403684,2019-03-24 13:15:00,2019-03-24 13:30:00
19,9,3,6,0.010661217989936255,2019-03-24 13:15:00,2019-03-24 13:30:00
20,7,0,7,0.0016800500700011817,2019-03-24 13:15:00,2019-03-24 13:30:00
21,4,4,0,0.004122932887234237,2019-03-24 13:15:00,2019-03-24 13:30:00
22,4,1,3,0.0023442905208829953,2019-03-24 13:15:00,2019-03-24 13:30:00
23,12,5,7,0.00803530734490997,2019-03-24 13:15:00,2019-03-24 13:30:00
26,13,4,9,0.0040388313360001545,2019-03-24 13:15:00,2019-03-24 13:30:00
27,4,2,2,0.003966443512412087,2019-03-24 13:15:00,2019-03-24 13:30:00
28,5,2,3,0.003483332425311123,2019-03-24 13:15:00,2019-03-24 13:30:00
30,2,0,2,0.0016800500700011817,2019-03-24 13:15:00,2019-03-24 13:30:00
35,4,3,1,0.014779708596399004,2019-03-24 13:15:00,2019-03-24 13:30:00
37,7,4,3,0.006325598514173648,2019-03-24 13:15:00,2019-03-24 13:30:00
40,5,2,3,0.0023682929800230407,2019-03-24 13:15:00,2019-03-24 13:30:00
41,5,2,3,0.002628964999832344,2019-03-24 13:15:00,2019-03-24 13:30:00
46,3,3,0,0.007651742474617805,2019-03-24 13:15:00,2019-03-24 13:30:00
57,11,5,6,0.00475784517186135,2019-03-24 13:15:00,2019-03-24 13:30:00
58,8,4,4,0.008066795376698226,2019-03-24 13:15:00,2019-03-24 13:30:00
61,13,5,8,0.005488570608500162,2019-03-24 13:15:00,2019-03-24 13:30:00
62,23,9,14,0.009175858438843488,2019-03-24 13:15:00,2019-03-24 13:30:00
64,1,1,0,0.00239169438288695,2019-03-24 13:15:00,2019-03-24 13:30:00
66,4,3,1,0.024126627333145283,2019-03-24 13:15:00,2019-03-24 13:30:00
67,7,5,2,0.006840404892950216,2019-03-24 13:15:00,2019-03-24 13:30:00
68,9,2,7,0.0022189601721678896,2019-03-24 13:15:00,2019-03-24 13:30:00
69,9,4,5,0.0031966451434312423,2019-03-24 13:15:00,2019-03-24 13:30:00
70,1,1,0,0.003108141394207997,2019-03-24 13:15:00,2019-03-24 13:30:00
71,3,2,1,0.014809512713244762,2019-03-24 13:15:00,2019-03-24 13:30:00
74,2,2,0,0.0050205130678850594,2019-03-24 13:15:00,2019-03-24 13:30:00
75,13,4,9,0.002700144910635884,2019-03-24 13:15:00,2019-03-24 13:30:00
79,2,0,2,0.0016800500700011817,2019-03-24 13:15:00,2019-03-24 13:30:00
80,2,2,0,0.0026967828213664627,2019-03-24 13:15:00,2019-03-24 13:30:00
85,3,0,3,0.0016800500700011817,2019-03-24 13:15:00,2019-03-24 13:30:00
86,2,1,1,0.011190923332332972,2019-03-24 13:15:00,2019-03-24 13:30:00
87,11,4,7,0.003266896410426179,2019-03-24 13:15:00,2019-03-24 13:30:00
88,6,1,5,0.002024171525012111,2019-03-24 13:15:00,2019-03-24 13:30:00
89,4,2,2,0.0036118788423081553,2019-03-24 13:15:00,2019-03-24 13:30:00
90,16,7,9,0.013907470437177976,2019-03-24 13:15:00,2019-03-24 13:30:00
99,1,1,0,0.0042360371823338735,2019-03-24 13:15:00,2019-03-24 13:30:00
101,9,7,2,0.03403915130743138,2019-03-24 13:15:00,2019-03-24 13:30:00
104,10,4,6,0.004238496490141774,2019-03-24 13:15:00,2019-03-24 13:30:00
106,10,3,7,0.002897424909402258,2019-03-24 13:15:00,2019-03-24 13:30:00
108,7,2,5,0.0025455808045231347,2019-03-24 13:15:00,2019-03-24 13:30:00
109,7,6,1,0.010266241090202206,2019-03-24 13:15:00,2019-03-24 13:30:00
110,15,7,8,0.006697061656323697,2019-03-24 13:15:00,2019-03-24 13:30:00
111,10,6,4,0.0038389539650607383,2019-03-24 13:15:00,2019-03-24 13:30:00
112,1,0,1,0.0016800500700011817,2019-03-24 13:15:00,2019-03-24 13:30:00
113,6,4,2,0.014184665453898966,2019-03-24 13:15:00,2019-03-24 13:30:00
114,3,3,0,0.002824510125499789,2019-03-24 13:15:00,2019-03-24 13:30:00
115,6,4,2,0.00960893919320939,2019-03-24 13:15:00,2019-03-24 13:30:00
116,2,0,2,0.0016800500700011817,2019-03-24 13:15:00,2019-03-24 13:30:00
118,6,2,4,0.006942684206485458,2019-03-24 13:15:00,2019-03-24 13:30:00
119,18,11,7,0.014009476890130388,2019-03-24 13:15:00,2019-03-24 13:30:00
120,5,2,3,0.0030981666062658737,2019-03-24 13:15:00,2019-03-24 13:30:00
122,11,4,7,0.003266896410426179,2019-03-24 13:15:00,2019-03-24 13:30:00
126,7,4,3,0.004337011873528437,2019-03-24 13:15:00,2019-03-24 13:30:00
127,2,1,1,0.011190923332332972,2019-03-24 13:15:00,2019-03-24 13:30:00
133,4,4,0,0.004269781925440989,2019-03-24 13:15:00,2019-03-24 13:30:00
137,24,12,12,0.01612536836020539,2019-03-24 13:15:00,2019-03-24 13:30:00
138,14,11,3,0.01757004721918587,2019-03-24 13:15:00,2019-03-24 13:30:00
140,8,3,5,0.00477725612799077,2019-03-24 13:15:00,2019-03-24 13:30:00
141,12,6,6,0.01502181702759342,2019-03-24 13:15:00,2019-03-24 13:30:00
147,2,1,1,0.002223501882589642,2019-03-24 13:15:00,2019-03-24 13:30:00
151,13,7,6,0.0058547888469821,2019-03-24 13:15:00,2019-03-24 13:30:00
153,17,7,10,0.01204127660936122,2019-03-24 13:15:00,2019-03-24 13:30:00
154,7,6,1,0.02994106070645597,2019-03-24 13:15:00,2019-03-24 13:30:00
156,5,0,5,0.0016800500700011817,2019-03-24 13:15:00,2019-03-24 13:30:00
157,16,7,9,0.007709665721202497,2019-03-24 13:15:00,2019-03-24 13:30:00
158,17,10,7,0.018007481777734667,2019-03-24 13:15:00,2019-03-24 13:30:00
159,8,6,2,0.03642709406447209,2019-03-24 13:15:00,2019-03-24 13:30:00
160,10,5,5,0.011190923332332972,2019-03-24 13:15:00,2019-03-24 13:30:00
161,2,1,1,0.011190923332332972,2019-03-24 13:15:00,2019-03-24 13:30:00
162,6,4,2,0.023069322789630375,2019-03-24 13:15:00,2019-03-24 13:30:00
164,15,12,3,0.013401067709495711,2019-03-24 13:15:00,2019-03-24 13:30:00
168,21,12,9,0.01969819272281513,2019-03-24 13:15:00,2019-03-24 13:30:00
169,41,27,14,0.04332975228365377,2019-03-24 13:15:00,2019-03-24 13:30:00
170,4,2,2,0.003108141394207997,2019-03-24 13:15:00,2019-03-24 13:30:00
171,5,3,2,0.002966959894593563,2019-03-24 13:15:00,2019-03-24 13:30:00
172,5,1,4,0.004587747700624083,2019-03-24 13:15:00,2019-03-24 13:30:00
173,6,3,3,0.007365357211894482,2019-03-24 13:15:00,2019-03-24 13:30:00
175,8,4,4,0.011190923332332972,2019-03-24 13:15:00,2019-03-24 13:30:00
177,15,7,8,0.024050028217867454,2019-03-24 13:15:00,2019-03-24 13:30:00
189,10,2,8,0.0021334177920372677,2019-03-24 13:15:00,2019-03-24 13:30:00
190,13,6,7,0.004186193882556314,2019-03-24 13:15:00,2019-03-24 13:30:00
191,5,5,0,0.003376834404420591,2019-03-24 13:15:00,2019-03-24 13:30:00
196,2,2,0,0.004202107287833363,2019-03-24 13:15:00,2019-03-24 13:30:00
197,12,3,9,0.0023442905208829953,2019-03-24 13:15:00,2019-03-24 13:30:00
199,4,3,1,0.025413381690229064,2019-03-24 13:15:00,2019-03-24 13:30:00
201,2,1,1,0.011190923332332972,2019-03-24 13:15:00,2019-03-24 13:30:00
203,27,12,15,0.012510214955834788,2019-03-24 13:15:00,2019-03-24 13:30:00
1,3,0,3,0.0015134218648505979,2019-03-24 13:30:00,2019-03-24 13:45:00
2,9,5,4,0.006840363044483214,2019-03-24 13:30:00,2019-03-24 13:45:00
5,13,5,8,0.0044717524686805135,2019-03-24 13:30:00,2019-03-24 13:45:00
10,7,4,3,0.004273962040987201,2019-03-24 13:30:00,2019-03-24 13:45:00
11,15,7,8,0.005907882352672556,2019-03-24 13:30:00,2019-03-24 13:45:00
15,10,7,3,0.023787949579146456,2019-03-24 13:30:00,2019-03-24 13:45:00
16,17,12,5,0.013912090598286748,2019-03-24 13:30:00,2019-03-24 13:45:00
18,6,2,4,0.003228050523811185,2019-03-24 13:30:00,2019-03-24 13:45:00
19,10,4,6,0.004925429098170734,2019-03-24 13:30:00,2019-03-24 13:45:00
20,7,0,7,0.0015134218648505979,2019-03-24 13:30:00,2019-03-24 13:45:00
21,2,2,0,0.0023710477845648994,2019-03-24 13:30:00,2019-03-24 13:45:00
22,3,0,3,0.0015134218648505979,2019-03-24 13:30:00,2019-03-24 13:45:00
23,16,9,7,0.008419387748955107,2019-03-24 13:30:00,2019-03-24 13:45:00
26,19,6,13,0.006910004756906611,2019-03-24 13:30:00,2019-03-24 13:45:00
27,3,1,2,0.0026320932475858913,2019-03-24 13:30:00,2019-03-24 13:45:00
28,4,2,2,0.0028390724348895495,2019-03-24 13:30:00,2019-03-24 13:45:00
30,8,3,5,0.004731219062905915,2019-03-24 13:30:00,2019-03-24 13:45:00
35,5,4,1,0.020937736813372874,2019-03-24 13:30:00,2019-03-24 13:45:00
37,13,6,7,0.008961063291901031,2019-03-24 13:30:00,2019-03-24 13:45:00
40,6,4,2,0.007107366660775818,2019-03-24 13:30:00,2019-03-24 13:45:00
41,11,8,3,0.008458566471043257,2019-03-24 13:30:00,2019-03-24 13:45:00
46,3,3,0,0.004999736070415745,2019-03-24 13:30:00,2019-03-24 13:45:00
57,11,7,4,0.007431216455626729,2019-03-24 13:30:00,2019-03-24 13:45:00
58,6,4,2,0.019192339752367574,2019-03-24 13:30:00,2019-03-24 13:45:00
61,8,3,5,0.0030130628915058942,2019-03-24 13:30:00,2019-03-24 13:45:00
62,17,9,8,0.011893019004143152,2019-03-24 13:30:00,2019-03-24 13:45:00
64,6,2,4,0.0032638175412497273,2019-03-24 13:30:00,2019-03-24 13:45:00
66,4,3,1,0.02369036557044147,2019-03-24 13:30:00,2019-03-24 13:45:00
67,7,5,2,0.009370453744320386,2019-03-24 13:30:00,2019-03-24 13:45:00
68,11,2,9,0.0018658733946014727,2019-03-24 13:30:00,2019-03-24 13:45:00
69,12,6,6,0.009033640378009244,2019-03-24 13:30:00,2019-03-24 13:45:00
71,9,5,4,0.01858908030997821,2019-03-24 13:30:00,2019-03-24 13:45:00
74,2,1,1,0.005496602941003801,2019-03-24 13:30:00,2019-03-24 13:45:00
75,14,4,10,0.0022930950268688767,2019-03-24 13:30:00,2019-03-24 13:45:00
79,7,2,5,0.0024171255481223357,2019-03-24 13:30:00,2019-03-24 13:45:00
85,2,1,1,0.00227548469927674,2019-03-24 13:30:00,2019-03-24 13:45:00
86,2,0,2,0.0015134218648505979,2019-03-24 13:30:00,2019-03-24 13:45:00
87,10,6,4,0.02079687412932958,2019-03-24 13:30:00,2019-03-24 13:45:00
88,6,3,3,0.007166628526200994,2019-03-24 13:30:00,2019-03-24 13:45:00
89,9,4,5,0.0035840972000737758,2019-03-24 13:30:00,2019-03-24 13:45:00
90,12,5,7,0.009528743451095972,2019-03-24 13:30:00,2019-03-24 13:45:00
99,1,1,0,0.0045508560238211055,2019-03-24 13:30:00,2019-03-24 13:45:00
101,13,7,6,0.00513198527700049,2019-03-24 13:30:00,2019-03-24 13:45:00
104,11,5,6,0.006696551451057808,2019-03-24 13:30:00,2019-03-24 13:45:00
106,9,2,7,0.0037037070661369333,2019-03-24 13:30:00,2019-03-24 13:45:00
108,9,5,4,0.008189154920579665,2019-03-24 13:30:00,2019-03-24 13:45:00
109,7,5,2,0.0053036452084801785,2019-03-24 13:30:00,2019-03-24 13:45:00
110,10,4,6,0.0074579252328879015,2019-03-24 13:30:00,2019-03-24 13:45:00
111,12,7,5,0.012949838094631105,2019-03-24 13:30:00,2019-03-24 13:45:00
112,3,2,1,0.0023352940082567632,2019-03-24 13:30:00,2019-03-24 13:45:00
113,8,2,6,0.002984698701839052,2019-03-24 13:30:00,2019-03-24 13:45:00
114,13,8,5,0.010653412290004525,2019-03-24 13:30:00,2019-03-24 13:45:00
115,7,6,1,0.0711619831939557,2019-03-24 13:30:00,2019-03-24 13:45:00
116,2,0,2,0.0015134218648505979,2019-03-24 13:30:00,2019-03-24 13:45:00
118,5,2,3,0.0045278929282367136,2019-03-24 13:30:00,2019-03-24 13:45:00
119,14,9,5,0.024960540184244186,2019-03-24 13:30:00,2019-03-24 13:45:00
120,6,2,4,0.0024571081492086597,2019-03-24 13:30:00,2019-03-24 13:45:00
122,9,2,7,0.0019988753860761222,2019-03-24 13:30:00,2019-03-24 13:45:00
126,10,7,3,0.005944966373392771,2019-03-24 13:30:00,2019-03-24 13:45:00
133,6,4,2,0.004651404824824979,2019-03-24 13:30:00,2019-03-24 13:45:00
137,29,16,13,0.016031698845699476,2019-03-24 13:30:00,2019-03-24 13:45:00
138,15,11,4,0.022061575407632428,2019-03-24 13:30:00,2019-03-24 13:45:00
140,9,3,6,0.004206180335449522,2019-03-24 13:30:00,2019-03-24 13:45:00
141,9,3,6,0.0037266204155638233,2019-03-24 13:30:00,2019-03-24 13:45:00
147,2,1,1,0.0027934692982390127,2019-03-24 13:30:00,2019-03-24 13:45:00
151,13,7,6,0.005925551745132926,2019-03-24 13:30:00,2019-03-24 13:45:00
153,16,6,10,0.005692523390375911,2019-03-24 13:30:00,2019-03-24 13:45:00
154,7,6,1,0.035521990187903016,2019-03-24 13:30:00,2019-03-24 13:45:00
156,4,0,4,0.0015134218648505979,2019-03-24 13:30:00,2019-03-24 13:45:00
157,10,4,6,0.00537886452389635,2019-03-24 13:30:00,2019-03-24 13:45:00
158,18,9,9,0.013896741322211543,2019-03-24 13:30:00,2019-03-24 13:45:00
159,8,6,2,0.029219771378260234,2019-03-24 13:30:00,2019-03-24 13:45:00
160,8,4,4,0.010086171156482795,2019-03-24 13:30:00,2019-03-24 13:45:00
161,10,5,5,0.010086171156482795,2019-03-24 13:30:00,2019-03-24 13:45:00
162,5,4,1,0.03271721094617921,2019-03-24 13:30:00,2019-03-24 13:45:00
164,9,7,2,0.007662898181097347,2019-03-24 13:30:00,2019-03-24 13:45:00
168,16,10,6,0.013203330217088173,2019-03-24 13:30:00,2019-03-24 13:45:00
169,41,23,18,0.03191160977035022,2019-03-24 13:30:00,2019-03-24 13:45:00
170,2,2,0,0.0031221681876889753,2019-03-24 13:30:00,2019-03-24 13:45:00
171,6,4,2,0.0033540653952333784,2019-03-24 13:30:00,2019-03-24 13:45:00
172,5,1,4,0.005496602941003801,2019-03-24 13:30:00,2019-03-24 13:45:00
173,3,1,2,0.0026320932475858913,2019-03-24 13:30:00,2019-03-24 13:45:00
175,14,7,7,0.010086171156482795,2019-03-24 13:30:00,2019-03-24 13:45:00
177,13,7,6,0.02143160142452701,2019-03-24 13:30:00,2019-03-24 13:45:00
189,7,1,6,0.0017632170682285835,2019-03-24 13:30:00,2019-03-24 13:45:00
190,14,8,6,0.007919327633115475,2019-03-24 13:30:00,2019-03-24 13:45:00
191,10,5,5,0.004506894902814385,2019-03-24 13:30:00,2019-03-24 13:45:00
196,4,2,2,0.004364564549936443,2019-03-24 13:30:00,2019-03-24 13:45:00
197,15,4,11,0.0021905047708561283,2019-03-24 13:30:00,2019-03-24 13:45:00
199,2,2,0,0.002463732193177682,2019-03-24 13:30:00,2019-03-24 13:45:00
201,1,0,1,0.0015134218648505979,2019-03-24 13:30:00,2019-03-24 13:45:00
203,19,7,12,0.0066599205408272265,2019-03-24 13:30:00,2019-03-24 13:45:00
1,3,0,3,0.0015787913090347901,2019-03-24 13:45:00,2019-03-24 14:00:00
2,11,3,8,0.0027326077195885656,2019-03-24 13:45:00,2019-03-24 14:00:00
5,15,7,8,0.007198428686396961,2019-03-24 13:45:00,2019-03-24 14:00:00
10,6,3,3,0.00793028598298673,2019-03-24 13:45:00,2019-03-24 14:00:00
11,15,7,8,0.006163055217548072,2019-03-24 13:45:00,2019-03-24 14:00:00
15,12,10,2,0.019777123469444366,2019-03-24 13:45:00,2019-03-24 14:00:00
16,15,5,10,0.005078917570744545,2019-03-24 13:45:00,2019-03-24 14:00:00
18,5,2,3,0.0025030562775149993,2019-03-24 13:45:00,2019-03-24 14:00:00
19,8,5,3,0.006561146253040126,2019-03-24 13:45:00,2019-03-24 14:00:00
20,4,0,4,0.0015787913090347901,2019-03-24 13:45:00,2019-03-24 14:00:00
21,2,2,0,0.00247345902944772,2019-03-24 13:45:00,2019-03-24 14:00:00
22,3,0,3,0.0015787913090347901,2019-03-24 13:45:00,2019-03-24 14:00:00
23,12,7,5,0.008344894573197653,2019-03-24 13:45:00,2019-03-24 14:00:00
26,17,3,14,0.008599796718904117,2019-03-24 13:45:00,2019-03-24 14:00:00
27,4,1,3,0.0022029850174994084,2019-03-24 13:45:00,2019-03-24 14:00:00
28,2,2,0,0.004092815837589372,2019-03-24 13:45:00,2019-03-24 14:00:00
30,4,0,4,0.0015787913090347901,2019-03-24 13:45:00,2019-03-24 14:00:00
35,9,7,2,0.029192342747113,2019-03-24 13:45:00,2019-03-24 14:00:00
37,8,4,4,0.007894300802178802,2019-03-24 13:45:00,2019-03-24 14:00:00
40,4,4,0,0.011476422553767723,2019-03-24 13:45:00,2019-03-24 14:00:00
41,11,7,4,0.008738492895398598,2019-03-24 13:45:00,2019-03-24 14:00:00
46,3,3,0,0.005135474473707494,2019-03-24 13:45:00,2019-03-24 14:00:00
57,14,7,7,0.005224228150548259,2019-03-24 13:45:00,2019-03-24 14:00:00
58,5,3,2,0.015300890207135091,2019-03-24 13:45:00,2019-03-24 14:00:00
61,7,2,5,0.0023921376835491556,2019-03-24 13:45:00,2019-03-24 14:00:00
62,15,10,5,0.03340012067228409,2019-03-24 13:45:00,2019-03-24 14:00:00
64,6,2,4,0.0029060255963911587,2019-03-24 13:45:00,2019-03-24 14:00:00
66,3,2,1,0.013953580849259207,2019-03-24 13:45:00,2019-03-24 14:00:00
67,12,9,3,0.00897849607465378,2019-03-24 13:45:00,2019-03-24 14:00:00
68,10,2,8,0.002004826697047932,2019-03-24 13:45:00,2019-03-24 14:00:00
69,16,9,7,0.014305861798621136,2019-03-24 13:45:00,2019-03-24 14:00:00
70,1,1,0,0.002329712448958067,2019-03-24 13:45:00,2019-03-24 14:00:00
71,11,6,5,0.021996854885769145,2019-03-24 13:45:00,2019-03-24 14:00:00
74,2,0,2,0.0015787913090347901,2019-03-24 13:45:00,2019-03-24 14:00:00
75,12,5,7,0.0071537909296570616,2019-03-24 13:45:00,2019-03-24 14:00:00
79,8,2,6,0.0026232013474881775,2019-03-24 13:45:00,2019-03-24 14:00:00
85,3,1,2,0.0021966156098852333,2019-03-24 13:45:00,2019-03-24 14:00:00
86,2,0,2,0.0015787913090347901,2019-03-24 13:45:00,2019-03-24 14:00:00
87,8,5,3,0.020514526525964964,2019-03-24 13:45:00,2019-03-24 14:00:00
88,6,3,3,0.013221867292031841,2019-03-24 13:45:00,2019-03-24 14:00:00
89,20,11,9,0.009817232417714114,2019-03-24 13:45:00,2019-03-24 14:00:00
90,20,7,13,0.004123914494858588,2019-03-24 13:45:00,2019-03-24 14:00:00
99,3,3,0,0.003932948570182412,2019-03-24 13:45:00,2019-03-24 14:00:00
101,15,6,9,0.003899189178376384,2019-03-24 13:45:00,2019-03-24 14:00:00
104,7,4,3,0.013962424007171438,2019-03-24 13:45:00,2019-03-24 14:00:00
106,17,6,11,0.004244163895503349,2019-03-24 13:45:00,2019-03-24 14:00:00
108,14,7,7,0.00589412995313887,2019-03-24 13:45:00,2019-03-24 14:00:00
109,9,6,3,0.013814811368402844,2019-03-24 13:45:00,2019-03-24 14:00:00
110,11,3,8,0.006678277175896587,2019-03-24 13:45:00,2019-03-24 14:00:00
111,15,9,6,0.015792657204578498,2019-03-24 13:45:00,2019-03-24 14:00:00
112,10,6,4,0.006361658363464534,2019-03-24 13:45:00,2019-03-24 14:00:00
113,5,2,3,0.00398112122358723,2019-03-24 13:45:00,2019-03-24 14:00:00
114,9,6,3,0.013933125823541153,2019-03-24 13:45:00,2019-03-24 14:00:00
115,13,9,4,0.020767125111114736,2019-03-24 13:45:00,2019-03-24 14:00:00
116,3,1,2,0.00247563697456342,2019-03-24 13:45:00,2019-03-24 14:00:00
118,6,2,4,0.003533637257651029,2019-03-24 13:45:00,2019-03-24 14:00:00
119,21,10,11,0.021570505876383116,2019-03-24 13:45:00,2019-03-24 14:00:00
120,7,2,5,0.0029483951198762334,2019-03-24 13:45:00,2019-03-24 14:00:00
122,7,2,5,0.0023921376835491556,2019-03-24 13:45:00,2019-03-24 14:00:00
126,11,6,5,0.005756273659581363,2019-03-24 13:45:00,2019-03-24 14:00:00
127,1,0,1,0.0015787913090347901,2019-03-24 13:45:00,2019-03-24 14:00:00
133,12,7,5,0.007779249667095367,2019-03-24 13:45:00,2019-03-24 14:00:00
135,3,1,2,0.0022997447995972376,2019-03-24 13:45:00,2019-03-24 14:00:00
137,44,28,16,0.030817178414517348,2019-03-24 13:45:00,2019-03-24 14:00:00
138,22,13,9,0.03227926563938475,2019-03-24 13:45:00,2019-03-24 14:00:00
140,8,2,6,0.0021180921564803645,2019-03-24 13:45:00,2019-03-24 14:00:00
141,8,4,4,0.008035105098424967,2019-03-24 13:45:00,2019-03-24 14:00:00
151,15,8,7,0.005936988671537838,2019-03-24 13:45:00,2019-03-24 14:00:00
153,15,6,9,0.00949460586703178,2019-03-24 13:45:00,2019-03-24 14:00:00
154,8,5,3,0.005437570018775253,2019-03-24 13:45:00,2019-03-24 14:00:00
156,4,0,4,0.0015787913090347901,2019-03-24 13:45:00,2019-03-24 14:00:00
157,10,4,6,0.00436067509550015,2019-03-24 13:45:00,2019-03-24 14:00:00
158,10,5,5,0.005562325452760849,2019-03-24 13:45:00,2019-03-24 14:00:00
159,6,4,2,0.03015654903492269,2019-03-24 13:45:00,2019-03-24 14:00:00
160,12,6,6,0.005359084729256762,2019-03-24 13:45:00,2019-03-24 14:00:00
161,8,4,4,0.010511338948353061,2019-03-24 13:45:00,2019-03-24 14:00:00
162,6,3,3,0.004848931654917884,2019-03-24 13:45:00,2019-03-24 14:00:00
164,14,11,3,0.019283687695249963,2019-03-24 13:45:00,2019-03-24 14:00:00
168,15,11,4,0.02413445681733942,2019-03-24 13:45:00,2019-03-24 14:00:00
169,33,17,16,0.027024993824455258,2019-03-24 13:45:00,2019-03-24 14:00:00
170,3,2,1,0.0022497920993444875,2019-03-24 13:45:00,2019-03-24 14:00:00
171,3,3,0,0.0027607693055758443,2019-03-24 13:45:00,2019-03-24 14:00:00
172,3,2,1,0.009587488174815102,2019-03-24 13:45:00,2019-03-24 14:00:00
173,7,4,3,0.011339843043454496,2019-03-24 13:45:00,2019-03-24 14:00:00
175,14,7,7,0.010511338948353061,2019-03-24 13:45:00,2019-03-24 14:00:00
177,16,9,7,0.010784684268393806,2019-03-24 13:45:00,2019-03-24 14:00:00
189,9,3,6,0.0038637380455595104,2019-03-24 13:45:00,2019-03-24 14:00:00
190,10,6,4,0.007290018162850017,2019-03-24 13:45:00,2019-03-24 14:00:00
191,12,6,6,0.008484630707933608,2019-03-24 13:45:00,2019-03-24 14:00:00
195,9,4,5,0.003980674346801457,2019-03-24 13:45:00,2019-03-24 14:00:00
196,3,1,2,0.002920792889654185,2019-03-24 13:45:00,2019-03-24 14:00:00
197,13,4,9,0.009828609353711718,2019-03-24 13:45:00,2019-03-24 14:00:00
199,4,2,2,0.003108616414969209,2019-03-24 13:45:00,2019-03-24 14:00:00
201,2,0,2,0.0015787913090347901,2019-03-24 13:45:00,2019-03-24 14:00:00
202,2,1,1,0.002213195395873199,2019-03-24 13:45:00,2019-03-24 14:00:00
203,19,8,11,0.008860882836557019,2019-03-24 13:45:00,2019-03-24 14:00:00
1,4,1,3,0.0020271930185616254,2019-03-24 14:00:00,2019-03-24 14:15:00
2,8,2,6,0.0022780824881656,2019-03-24 14:00:00,2019-03-24 14:15:00
5,8,2,6,0.0036290774221887827,2019-03-24 14:00:00,2019-03-24 14:15:00
10,8,3,5,0.005828839708195772,2019-03-24 14:00:00,2019-03-24 14:15:00
11,14,7,7,0.010013711283787375,2019-03-24 14:00:00,2019-03-24 14:15:00
15,23,16,7,0.021036409502422224,2019-03-24 14:00:00,2019-03-24 14:15:00
16,13,2,11,0.005015418287248106,2019-03-24 14:00:00,2019-03-24 14:15:00
18,4,3,1,0.003994245671143114,2019-03-24 14:00:00,2019-03-24 14:15:00
19,13,9,4,0.018594183633662865,2019-03-24 14:00:00,2019-03-24 14:15:00
20,4,0,4,0.0015028707162267822,2019-03-24 14:00:00,2019-03-24 14:15:00
21,4,2,2,0.010013711283787375,2019-03-24 14:00:00,2019-03-24 14:15:00
22,4,2,2,0.010013711283787375,2019-03-24 14:00:00,2019-03-24 14:15:00
23,18,14,4,0.02079363878601531,2019-03-24 14:00:00,2019-03-24 14:15:00
26,21,5,16,0.00804148787913217,2019-03-24 14:00:00,2019-03-24 14:15:00
27,4,1,3,0.002097043294731345,2019-03-24 14:00:00,2019-03-24 14:15:00
28,3,3,0,0.0029472255417860053,2019-03-24 14:00:00,2019-03-24 14:15:00
30,3,1,2,0.0026137246543523436,2019-03-24 14:00:00,2019-03-24 14:15:00
35,9,7,2,0.034685161649305817,2019-03-24 14:00:00,2019-03-24 14:15:00
37,7,4,3,0.008734693245722135,2019-03-24 14:00:00,2019-03-24 14:15:00
40,4,4,0,0.007143175617200026,2019-03-24 14:00:00,2019-03-24 14:15:00
41,13,9,4,0.01102763568792493,2019-03-24 14:00:00,2019-03-24 14:15:00
57,17,6,11,0.0031456036341017107,2019-03-24 14:00:00,2019-03-24 14:15:00
58,7,4,3,0.0062036898606817655,2019-03-24 14:00:00,2019-03-24 14:15:00
61,6,2,4,0.0026137246543523436,2019-03-24 14:00:00,2019-03-24 14:15:00
62,21,12,9,0.038953983216467425,2019-03-24 14:00:00,2019-03-24 14:15:00
64,7,2,5,0.0033315563228175026,2019-03-24 14:00:00,2019-03-24 14:15:00
66,6,3,3,0.0044547395321522815,2019-03-24 14:00:00,2019-03-24 14:15:00
67,14,7,7,0.008608627707746643,2019-03-24 14:00:00,2019-03-24 14:15:00
68,8,3,5,0.003982439311509425,2019-03-24 14:00:00,2019-03-24 14:15:00
69,11,6,5,0.007980060674498383,2019-03-24 14:00:00,2019-03-24 14:15:00
70,2,1,1,0.002628335901458438,2019-03-24 14:00:00,2019-03-24 14:15:00
71,14,7,7,0.010013711283787375,2019-03-24 14:00:00,2019-03-24 14:15:00
74,1,0,1,0.0015028707162267822,2019-03-24 14:00:00,2019-03-24 14:15:00
75,19,9,10,0.007931023546956965,2019-03-24 14:00:00,2019-03-24 14:15:00
79,7,0,7,0.0015028707162267822,2019-03-24 14:00:00,2019-03-24 14:15:00
85,6,1,5,0.003260679000901456,2019-03-24 14:00:00,2019-03-24 14:15:00
86,4,2,2,0.002357456896791581,2019-03-24 14:00:00,2019-03-24 14:15:00
87,12,8,4,0.021506365374901023,2019-03-24 14:00:00,2019-03-24 14:15:00
88,11,6,5,0.01350216831215728,2019-03-24 14:00:00,2019-03-24 14:15:00
89,22,10,12,0.0055615495710767075,2019-03-24 14:00:00,2019-03-24 14:15:00
90,17,8,9,0.012995245175387572,2019-03-24 14:00:00,2019-03-24 14:15:00
99,4,3,1,0.005181362877264633,2019-03-24 14:00:00,2019-03-24 14:15:00
101,12,4,8,0.0026137246543523436,2019-03-24 14:00:00,2019-03-24 14:15:00
104,9,4,5,0.00393945219034513,2019-03-24 14:00:00,2019-03-24 14:15:00
106,11,5,6,0.003528045104612001,2019-03-24 14:00:00,2019-03-24 14:15:00
108,18,9,9,0.006074125121943937,2019-03-24 14:00:00,2019-03-24 14:15:00
109,13,5,8,0.011061062616903658,2019-03-24 14:00:00,2019-03-24 14:15:00
110,13,10,3,0.008885825569048447,2019-03-24 14:00:00,2019-03-24 14:15:00
111,18,7,11,0.00801883513547984,2019-03-24 14:00:00,2019-03-24 14:15:00
112,14,10,4,0.012562344803079953,2019-03-24 14:00:00,2019-03-24 14:15:00
113,6,1,5,0.002017011534296834,2019-03-24 14:00:00,2019-03-24 14:15:00
114,13,7,6,0.014466832813663356,2019-03-24 14:00:00,2019-03-24 14:15:00
115,20,12,8,0.022964669730614968,2019-03-24 14:00:00,2019-03-24 14:15:00
116,3,2,1,0.002438933828060028,2019-03-24 14:00:00,2019-03-24 14:15:00
118,10,5,5,0.00661988506435099,2019-03-24 14:00:00,2019-03-24 14:15:00
119,18,7,11,0.00482308997050109,2019-03-24 14:00:00,2019-03-24 14:15:00
120,6,3,3,0.002383018533519072,2019-03-24 14:00:00,2019-03-24 14:15:00
122,4,2,2,0.010013711283787375,2019-03-24 14:00:00,2019-03-24 14:15:00
126,9,5,4,0.005002587625121424,2019-03-24 14:00:00,2019-03-24 14:15:00
133,12,4,8,0.005902639978278003,2019-03-24 14:00:00,2019-03-24 14:15:00
135,5,2,3,0.002396595170456955,2019-03-24 14:00:00,2019-03-24 14:15:00
137,44,27,17,0.03307397014532066,2019-03-24 14:00:00,2019-03-24 14:15:00
138,23,12,11,0.014691211384630287,2019-03-24 14:00:00,2019-03-24 14:15:00
140,7,2,5,0.0043843827687538505,2019-03-24 14:00:00,2019-03-24 14:15:00
141,10,6,4,0.014703405821432605,2019-03-24 14:00:00,2019-03-24 14:15:00
151,20,11,9,0.006679369820750184,2019-03-24 14:00:00,2019-03-24 14:15:00
153,11,4,7,0.003390558214996486,2019-03-24 14:00:00,2019-03-24 14:15:00
154,5,4,1,0.023439257492941994,2019-03-24 14:00:00,2019-03-24 14:15:00
156,4,0,4,0.0015028707162267822,2019-03-24 14:00:00,2019-03-24 14:15:00
157,9,6,3,0.04716124654132047,2019-03-24 14:00:00,2019-03-24 14:15:00
158,8,5,3,0.007604665388270724,2019-03-24 14:00:00,2019-03-24 14:15:00
159,6,4,2,0.020772234134405463,2019-03-24 14:00:00,2019-03-24 14:15:00
160,5,2,3,0.0018678594090516655,2019-03-24 14:00:00,2019-03-24 14:15:00
161,8,4,4,0.010013711283787375,2019-03-24 14:00:00,2019-03-24 14:15:00
162,7,3,4,0.003357000863346715,2019-03-24 14:00:00,2019-03-24 14:15:00
164,16,12,4,0.012798411302294721,2019-03-24 14:00:00,2019-03-24 14:15:00
168,13,9,4,0.019080706951076214,2019-03-24 14:00:00,2019-03-24 14:15:00
169,33,16,17,0.02427643497745648,2019-03-24 14:00:00,2019-03-24 14:15:00
170,1,0,1,0.0015028707162267822,2019-03-24 14:00:00,2019-03-24 14:15:00
171,1,1,0,0.0020582976852895627,2019-03-24 14:00:00,2019-03-24 14:15:00
172,2,2,0,0.005268394178736908,2019-03-24 14:00:00,2019-03-24 14:15:00
173,10,4,6,0.0031372455230551967,2019-03-24 14:00:00,2019-03-24 14:15:00
175,18,9,9,0.010013711283787375,2019-03-24 14:00:00,2019-03-24 14:15:00
177,11,7,4,0.013285453828051491,2019-03-24 14:00:00,2019-03-24 14:15:00
189,7,2,5,0.0028512924305437544,2019-03-24 14:00:00,2019-03-24 14:15:00
190,8,5,3,0.007285622157507643,2019-03-24 14:00:00,2019-03-24 14:15:00
191,14,5,9,0.005551019279820275,2019-03-24 14:00:00,2019-03-24 14:15:00
195,12,4,8,0.002473951268686961,2019-03-24 14:00:00,2019-03-24 14:15:00
196,1,0,1,0.0015028707162267822,2019-03-24 14:00:00,2019-03-24 14:15:00
197,14,6,8,0.012257744004613772,2019-03-24 14:00:00,2019-03-24 14:15:00
199,7,3,4,0.003357000863346715,2019-03-24 14:00:00,2019-03-24 14:15:00
201,5,3,2,0.006898523775869579,2019-03-24 14:00:00,2019-03-24 14:15:00
202,1,1,0,0.001745958681745288,2019-03-24 14:00:00,2019-03-24 14:15:00
203,10,5,5,0.010232401218030023,2019-03-24 14:00:00,2019-03-24 14:15:00
1,6,3,3,0.0033794732302133996,2019-03-24 14:15:00,2019-03-24 14:30:00
2,15,4,11,0.003476383687858902,2019-03-24 14:15:00,2019-03-24 14:30:00
5,14,4,10,0.005300915528177716,2019-03-24 14:15:00,2019-03-24 14:30:00
10,10,5,5,0.01946664270624157,2019-03-24 14:15:00,2019-03-24 14:30:00
11,14,7,7,0.009941332176956048,2019-03-24 14:15:00,2019-03-24 14:30:00
15,25,16,9,0.027343391663426767,2019-03-24 14:15:00,2019-03-24 14:30:00
16,20,9,11,0.009364116082486676,2019-03-24 14:15:00,2019-03-24 14:30:00
18,7,5,2,0.009500279497393207,2019-03-24 14:15:00,2019-03-24 14:30:00
19,8,6,2,0.00711412196516821,2019-03-24 14:15:00,2019-03-24 14:30:00
20,3,0,3,0.0014917270640092285,2019-03-24 14:15:00,2019-03-24 14:30:00
21,2,0,2,0.0014917270640092285,2019-03-24 14:15:00,2019-03-24 14:30:00
22,3,2,1,0.0027597121856723873,2019-03-24 14:15:00,2019-03-24 14:30:00
23,16,11,5,0.0176177649620119,2019-03-24 14:15:00,2019-03-24 14:30:00
26,13,1,12,0.0016054478566384293,2019-03-24 14:15:00,2019-03-24 14:30:00
27,4,1,3,0.002081492168865537,2019-03-24 14:15:00,2019-03-24 14:30:00
28,7,2,5,0.0024541991028325153,2019-03-24 14:15:00,2019-03-24 14:30:00
30,1,0,1,0.0014917270640092285,2019-03-24 14:15:00,2019-03-24 14:30:00
35,11,9,2,0.04457601845047471,2019-03-24 14:15:00,2019-03-24 14:30:00
37,4,2,2,0.009941332176956048,2019-03-24 14:15:00,2019-03-24 14:30:00
40,4,2,2,0.005734885038695233,2019-03-24 14:15:00,2019-03-24 14:30:00
41,14,7,7,0.011142355275961302,2019-03-24 14:15:00,2019-03-24 14:30:00
46,4,4,0,0.012113153264154172,2019-03-24 14:15:00,2019-03-24 14:30:00
57,18,8,10,0.003964220994947706,2019-03-24 14:15:00,2019-03-24 14:30:00
58,7,4,3,0.00815961697590389,2019-03-24 14:15:00,2019-03-24 14:30:00
61,6,2,4,0.002594341003865003,2019-03-24 14:15:00,2019-03-24 14:30:00
62,21,12,9,0.026696449452743673,2019-03-24 14:15:00,2019-03-24 14:30:00
64,23,9,14,0.0050446676965655935,2019-03-24 14:15:00,2019-03-24 14:30:00
66,3,1,2,0.002594341003865003,2019-03-24 14:15:00,2019-03-24 14:30:00
67,17,8,9,0.009451362576582826,2019-03-24 14:15:00,2019-03-24 14:30:00
68,9,3,6,0.002813251154224515,2019-03-24 14:15:00,2019-03-24 14:30:00
69,8,3,5,0.005541090466939568,2019-03-24 14:15:00,2019-03-24 14:30:00
70,4,4,0,0.003881058419428642,2019-03-24 14:15:00,2019-03-24 14:30:00
71,18,9,9,0.009941332176956048,2019-03-24 14:15:00,2019-03-24 14:30:00
74,1,0,1,0.0014917270640092285,2019-03-24 14:15:00,2019-03-24 14:30:00
75,15,10,5,0.011730172794074565,2019-03-24 14:15:00,2019-03-24 14:30:00
79,4,0,4,0.0014917270640092285,2019-03-24 14:15:00,2019-03-24 14:30:00
80,6,2,4,0.002594341003865003,2019-03-24 14:15:00,2019-03-24 14:30:00
85,8,2,6,0.003734206484465177,2019-03-24 14:15:00,2019-03-24 14:30:00
86,2,2,0,0.0017191686492676304,2019-03-24 14:15:00,2019-03-24 14:30:00
87,18,7,11,0.014507090149394011,2019-03-24 14:15:00,2019-03-24 14:30:00
88,8,3,5,0.003356075681319323,2019-03-24 14:15:00,2019-03-24 14:30:00
89,16,8,8,0.006806555126875775,2019-03-24 14:15:00,2019-03-24 14:30:00
90,22,12,10,0.012833466659266496,2019-03-24 14:15:00,2019-03-24 14:30:00
99,5,4,1,0.0025536123941868223,2019-03-24 14:15:00,2019-03-24 14:30:00
101,10,4,6,0.003442549437650392,2019-03-24 14:15:00,2019-03-24 14:30:00
104,12,6,6,0.004578278801762484,2019-03-24 14:15:00,2019-03-24 14:30:00
106,17,8,9,0.004905666217881266,2019-03-24 14:15:00,2019-03-24 14:30:00
108,19,9,10,0.008625197252441331,2019-03-24 14:15:00,2019-03-24 14:30:00
109,14,6,8,0.007936533926071989,2019-03-24 14:15:00,2019-03-24 14:30:00
110,10,8,2,0.007286217278245112,2019-03-24 14:15:00,2019-03-24 14:30:00
111,14,6,8,0.004971751241395797,2019-03-24 14:15:00,2019-03-24 14:30:00
112,19,13,6,0.011063757451302053,2019-03-24 14:15:00,2019-03-24 14:30:00
113,5,0,5,0.0014917270640092285,2019-03-24 14:15:00,2019-03-24 14:30:00
114,7,4,3,0.0044853465259391346,2019-03-24 14:15:00,2019-03-24 14:30:00
115,16,7,9,0.009928867883258278,2019-03-24 14:15:00,2019-03-24 14:30:00
116,2,1,1,0.003152031644954998,2019-03-24 14:15:00,2019-03-24 14:30:00
118,10,3,7,0.004318068829862335,2019-03-24 14:15:00,2019-03-24 14:30:00
119,18,10,8,0.0085173690054579,2019-03-24 14:15:00,2019-03-24 14:30:00
120,3,2,1,0.0021656622463833075,2019-03-24 14:15:00,2019-03-24 14:30:00
122,4,2,2,0.009941332176956048,2019-03-24 14:15:00,2019-03-24 14:30:00
126,6,5,1,0.03295756858018756,2019-03-24 14:15:00,2019-03-24 14:30:00
133,4,1,3,0.0028584808150750067,2019-03-24 14:15:00,2019-03-24 14:30:00
135,1,0,1,0.0014917270640092285,2019-03-24 14:15:00,2019-03-24 14:30:00
137,37,25,12,0.04635750640272934,2019-03-24 14:15:00,2019-03-24 14:30:00
138,30,15,15,0.014181507230976203,2019-03-24 14:15:00,2019-03-24 14:30:00
140,8,3,5,0.004611558826784221,2019-03-24 14:15:00,2019-03-24 14:30:00
141,15,8,7,0.01048012013907895,2019-03-24 14:15:00,2019-03-24 14:30:00
151,12,7,5,0.00890660730734838,2019-03-24 14:15:00,2019-03-24 14:30:00
153,11,5,6,0.004611638589350278,2019-03-24 14:15:00,2019-03-24 14:30:00
154,6,4,2,0.0035225944891308265,2019-03-24 14:15:00,2019-03-24 14:30:00
156,4,0,4,0.0014917270640092285,2019-03-24 14:15:00,2019-03-24 14:30:00
157,16,10,6,0.050017831393340484,2019-03-24 14:15:00,2019-03-24 14:30:00
158,8,5,3,0.009104519443063659,2019-03-24 14:15:00,2019-03-24 14:30:00
159,5,2,3,0.003442549437650392,2019-03-24 14:15:00,2019-03-24 14:30:00
160,5,2,3,0.002125719624840808,2019-03-24 14:15:00,2019-03-24 14:30:00
161,8,4,4,0.009941332176956048,2019-03-24 14:15:00,2019-03-24 14:30:00
162,7,3,4,0.0027921196333103174,2019-03-24 14:15:00,2019-03-24 14:30:00
164,20,15,5,0.02365458352887632,2019-03-24 14:15:00,2019-03-24 14:30:00
168,16,9,7,0.011253716229950448,2019-03-24 14:15:00,2019-03-24 14:30:00
169,28,11,17,0.01717971546295325,2019-03-24 14:15:00,2019-03-24 14:30:00
171,2,1,1,0.0020430340339371157,2019-03-24 14:15:00,2019-03-24 14:30:00
172,5,2,3,0.003327062341506132,2019-03-24 14:15:00,2019-03-24 14:30:00
173,9,3,6,0.0033968868223406765,2019-03-24 14:15:00,2019-03-24 14:30:00
175,14,7,7,0.009941332176956048,2019-03-24 14:15:00,2019-03-24 14:30:00
177,11,8,3,0.014371704649862344,2019-03-24 14:15:00,2019-03-24 14:30:00
189,7,2,5,0.005480735383593825,2019-03-24 14:15:00,2019-03-24 14:30:00
190,9,5,4,0.004748244013777346,2019-03-24 14:15:00,2019-03-24 14:30:00
191,11,6,5,0.009765031364384119,2019-03-24 14:15:00,2019-03-24 14:30:00
195,4,0,4,0.0014917270640092285,2019-03-24 14:15:00,2019-03-24 14:30:00
196,2,1,1,0.001828694655196268,2019-03-24 14:15:00,2019-03-24 14:30:00
197,15,10,5,0.052516288228001175,2019-03-24 14:15:00,2019-03-24 14:30:00
199,6,2,4,0.002594341003865003,2019-03-24 14:15:00,2019-03-24 14:30:00
201,4,2,2,0.0030990927925541377,2019-03-24 14:15:00,2019-03-24 14:30:00
203,20,10,10,0.00913256773683133,2019-03-24 14:15:00,2019-03-24 14:30:00
1,6,2,4,0.0018852859955926934,2019-03-24 14:30:00,2019-03-24 14:45:00
2,15,5,10,0.0033286012373435047,2019-03-24 14:30:00,2019-03-24 14:45:00
5,19,6,13,0.007617492911361715,2019-03-24 14:30:00,2019-03-24 14:45:00
10,10,4,6,0.008148989705531521,2019-03-24 14:30:00,2019-03-24 14:45:00
11,14,7,7,0.010393042288189727,2019-03-24 14:30:00,2019-03-24 14:45:00
15,21,14,7,0.020058047401525086,2019-03-24 14:30:00,2019-03-24 14:45:00
16,24,17,7,0.018568628317542673,2019-03-24 14:30:00,2019-03-24 14:45:00
18,6,4,2,0.009981502285865907,2019-03-24 14:30:00,2019-03-24 14:45:00
19,5,4,1,0.005791027208686997,2019-03-24 14:30:00,2019-03-24 14:45:00
21,2,0,2,0.001559900194835945,2019-03-24 14:30:00,2019-03-24 14:45:00
22,3,2,1,0.0028858436843664124,2019-03-24 14:30:00,2019-03-24 14:45:00
23,14,9,5,0.014191004601915198,2019-03-24 14:30:00,2019-03-24 14:45:00
26,10,1,9,0.0017225930952143192,2019-03-24 14:30:00,2019-03-24 14:45:00
27,4,2,2,0.003296952821057369,2019-03-24 14:30:00,2019-03-24 14:45:00
28,3,1,2,0.0019605323741560122,2019-03-24 14:30:00,2019-03-24 14:45:00
30,2,1,1,0.003866287018344899,2019-03-24 14:30:00,2019-03-24 14:45:00
35,11,9,2,0.0524460605192689,2019-03-24 14:30:00,2019-03-24 14:45:00
40,3,1,2,0.003995938790551805,2019-03-24 14:30:00,2019-03-24 14:45:00
41,10,4,6,0.0072720619690981505,2019-03-24 14:30:00,2019-03-24 14:45:00
46,5,4,1,0.012672005953001853,2019-03-24 14:30:00,2019-03-24 14:45:00
50,1,1,0,0.012332591036911596,2019-03-24 14:30:00,2019-03-24 14:45:00
57,15,8,7,0.014006157359837497,2019-03-24 14:30:00,2019-03-24 14:45:00
58,7,5,2,0.03666171290131697,2019-03-24 14:30:00,2019-03-24 14:45:00
61,6,2,4,0.0027129205152300233,2019-03-24 14:30:00,2019-03-24 14:45:00
62,23,11,12,0.008881190394897466,2019-03-24 14:30:00,2019-03-24 14:45:00
64,26,11,15,0.008373920236465285,2019-03-24 14:30:00,2019-03-24 14:45:00
66,5,3,2,0.005149346165055456,2019-03-24 14:30:00,2019-03-24 14:45:00
67,13,6,7,0.007927074988298468,2019-03-24 14:30:00,2019-03-24 14:45:00
68,7,3,4,0.004958732734186563,2019-03-24 14:30:00,2019-03-24 14:45:00
69,6,3,3,0.005216612307501779,2019-03-24 14:30:00,2019-03-24 14:45:00
70,4,4,0,0.004774499045923999,2019-03-24 14:30:00,2019-03-24 14:45:00
71,14,7,7,0.010393042288189727,2019-03-24 14:30:00,2019-03-24 14:45:00
75,16,13,3,0.053211740400093514,2019-03-24 14:30:00,2019-03-24 14:45:00
80,2,0,2,0.001559900194835945,2019-03-24 14:30:00,2019-03-24 14:45:00
85,6,2,4,0.0029086549229248053,2019-03-24 14:30:00,2019-03-24 14:45:00
86,2,0,2,0.001559900194835945,2019-03-24 14:30:00,2019-03-24 14:45:00
87,13,4,9,0.007139302147565583,2019-03-24 14:30:00,2019-03-24 14:45:00
88,8,3,5,0.003339635916315833,2019-03-24 14:30:00,2019-03-24 14:45:00
89,17,9,8,0.00874366056114737,2019-03-24 14:30:00,2019-03-24 14:45:00
90,17,6,11,0.0036608416763048777,2019-03-24 14:30:00,2019-03-24 14:45:00
99,5,4,1,0.0035517759832347333,2019-03-24 14:30:00,2019-03-24 14:45:00
101,23,10,13,0.004506701930970566,2019-03-24 14:30:00,2019-03-24 14:45:00
104,8,2,6,0.0023702681284089415,2019-03-24 14:30:00,2019-03-24 14:45:00
106,13,5,8,0.003327892588037931,2019-03-24 14:30:00,2019-03-24 14:45:00
108,16,7,9,0.004603338886216527,2019-03-24 14:30:00,2019-03-24 14:45:00
109,12,6,6,0.007191256716577294,2019-03-24 14:30:00,2019-03-24 14:45:00
110,10,7,3,0.006209548209669123,2019-03-24 14:30:00,2019-03-24 14:45:00
111,10,3,7,0.003996355940838778,2019-03-24 14:30:00,2019-03-24 14:45:00
112,20,9,11,0.009062624231927541,2019-03-24 14:30:00,2019-03-24 14:45:00
113,3,0,3,0.001559900194835945,2019-03-24 14:30:00,2019-03-24 14:45:00
114,10,4,6,0.00753215663779634,2019-03-24 14:30:00,2019-03-24 14:45:00
115,14,5,9,0.006819596972746454,2019-03-24 14:30:00,2019-03-24 14:45:00
116,3,2,1,0.002556116611658352,2019-03-24 14:30:00,2019-03-24 14:45:00
118,3,1,2,0.003038066230991565,2019-03-24 14:30:00,2019-03-24 14:45:00
119,21,7,14,0.006403505556472041,2019-03-24 14:30:00,2019-03-24 14:45:00
120,2,1,1,0.010393042288189727,2019-03-24 14:30:00,2019-03-24 14:45:00
122,4,2,2,0.010393042288189727,2019-03-24 14:30:00,2019-03-24 14:45:00
126,10,7,3,0.008139398471828775,2019-03-24 14:30:00,2019-03-24 14:45:00
133,5,1,4,0.002185116376806664,2019-03-24 14:30:00,2019-03-24 14:45:00
135,3,3,0,0.004798274364322813,2019-03-24 14:30:00,2019-03-24 14:45:00
137,44,26,18,0.035161469957657156,2019-03-24 14:30:00,2019-03-24 14:45:00
138,34,19,15,0.020777022754714287,2019-03-24 14:30:00,2019-03-24 14:45:00
140,7,2,5,0.002125709612201442,2019-03-24 14:30:00,2019-03-24 14:45:00
141,21,12,9,0.01390451531207094,2019-03-24 14:30:00,2019-03-24 14:45:00
151,10,5,5,0.011926219554647913,2019-03-24 14:30:00,2019-03-24 14:45:00
153,12,6,6,0.009167391674523014,2019-03-24 14:30:00,2019-03-24 14:45:00
154,4,3,1,0.0023598512237821886,2019-03-24 14:30:00,2019-03-24 14:45:00
156,2,0,2,0.001559900194835945,2019-03-24 14:30:00,2019-03-24 14:45:00
157,20,11,9,0.021984728662899748,2019-03-24 14:30:00,2019-03-24 14:45:00
158,7,4,3,0.00916152338969813,2019-03-24 14:30:00,2019-03-24 14:45:00
159,5,2,3,0.003599908385612948,2019-03-24 14:30:00,2019-03-24 14:45:00
160,5,2,3,0.0028858436843664124,2019-03-24 14:30:00,2019-03-24 14:45:00
161,8,4,4,0.010393042288189727,2019-03-24 14:30:00,2019-03-24 14:45:00
162,8,4,4,0.004116311741826004,2019-03-24 14:30:00,2019-03-24 14:45:00
164,21,15,6,0.015102607192118665,2019-03-24 14:30:00,2019-03-24 14:45:00
168,22,8,14,0.010296280686008847,2019-03-24 14:30:00,2019-03-24 14:45:00
169,26,13,13,0.013099461428150444,2019-03-24 14:30:00,2019-03-24 14:45:00
171,5,4,1,0.004761992465489047,2019-03-24 14:30:00,2019-03-24 14:45:00
172,3,1,2,0.002522501229886679,2019-03-24 14:30:00,2019-03-24 14:45:00
173,5,2,3,0.003672586981336967,2019-03-24 14:30:00,2019-03-24 14:45:00
175,18,8,10,0.004875149501248172,2019-03-24 14:30:00,2019-03-24 14:45:00
177,9,7,2,0.0175725585476514,2019-03-24 14:30:00,2019-03-24 14:45:00
189,9,2,7,0.004881382370607954,2019-03-24 14:30:00,2019-03-24 14:45:00
190,12,6,6,0.005691463277544478,2019-03-24 14:30:00,2019-03-24 14:45:00
191,11,7,4,0.008359485227171792,2019-03-24 14:30:00,2019-03-24 14:45:00
195,1,0,1,0.001559900194835945,2019-03-24 14:30:00,2019-03-24 14:45:00
196,3,2,1,0.0037254179563766744,2019-03-24 14:30:00,2019-03-24 14:45:00
197,15,10,5,0.045022814705883506,2019-03-24 14:30:00,2019-03-24 14:45:00
199,5,2,3,0.003599908385612948,2019-03-24 14:30:00,2019-03-24 14:45:00
201,5,3,2,0.004197876925406159,2019-03-24 14:30:00,2019-03-24 14:45:00
203,31,15,16,0.02031533930533808,2019-03-24 14:30:00,2019-03-24 14:45:00
1,9,4,5,0.004022464598406233,2019-03-24 14:45:00,2019-03-24 15:00:00
2,15,8,7,0.01021950578725979,2019-03-24 14:45:00,2019-03-24 15:00:00
5,16,7,9,0.009509906080709774,2019-03-24 14:45:00,2019-03-24 15:00:00
10,10,4,6,0.009278082500050409,2019-03-24 14:45:00,2019-03-24 15:00:00
11,10,5,5,0.00985081549757441,2019-03-24 14:45:00,2019-03-24 15:00:00
15,15,9,6,0.016168762802945096,2019-03-24 14:45:00,2019-03-24 15:00:00
16,20,15,5,0.023662436266299134,2019-03-24 14:45:00,2019-03-24 15:00:00
18,8,4,4,0.008209770710428426,2019-03-24 14:45:00,2019-03-24 15:00:00
19,8,4,4,0.007100079951969623,2019-03-24 14:45:00,2019-03-24 15:00:00
20,2,2,0,0.0049892177585422115,2019-03-24 14:45:00,2019-03-24 15:00:00
21,2,0,2,0.0014782616088030351,2019-03-24 14:45:00,2019-03-24 15:00:00
23,19,14,5,0.01888831517139785,2019-03-24 14:45:00,2019-03-24 15:00:00
26,6,0,6,0.0014782616088030351,2019-03-24 14:45:00,2019-03-24 15:00:00
27,3,1,2,0.0025709229306872766,2019-03-24 14:45:00,2019-03-24 15:00:00
28,1,1,0,0.002162159006802541,2019-03-24 14:45:00,2019-03-24 15:00:00
30,1,1,0,0.004315772995030448,2019-03-24 14:45:00,2019-03-24 15:00:00
35,11,4,7,0.0035435923541610086,2019-03-24 14:45:00,2019-03-24 15:00:00
40,5,2,3,0.006354581418317947,2019-03-24 14:45:00,2019-03-24 15:00:00
41,8,4,4,0.008309352954590824,2019-03-24 14:45:00,2019-03-24 15:00:00
46,4,3,1,0.007553244588473744,2019-03-24 14:45:00,2019-03-24 15:00:00
50,3,1,2,0.007899628670183609,2019-03-24 14:45:00,2019-03-24 15:00:00
57,15,8,7,0.013844016740269985,2019-03-24 14:45:00,2019-03-24 15:00:00
58,12,8,4,0.01844444842425367,2019-03-24 14:45:00,2019-03-24 15:00:00
61,3,1,2,0.0025709229306872766,2019-03-24 14:45:00,2019-03-24 15:00:00
62,21,8,13,0.005735294495939847,2019-03-24 14:45:00,2019-03-24 15:00:00
64,26,10,16,0.005829046523158625,2019-03-24 14:45:00,2019-03-24 15:00:00
66,2,1,1,0.00985081549757441,2019-03-24 14:45:00,2019-03-24 15:00:00
67,12,4,8,0.005669099633574898,2019-03-24 14:45:00,2019-03-24 15:00:00
68,4,3,1,0.00575271877359062,2019-03-24 14:45:00,2019-03-24 15:00:00
69,4,3,1,0.025764619956435992,2019-03-24 14:45:00,2019-03-24 15:00:00
70,5,3,2,0.013863123899381283,2019-03-24 14:45:00,2019-03-24 15:00:00
71,11,5,6,0.005068968473121117,2019-03-24 14:45:00,2019-03-24 15:00:00
74,2,1,1,0.00985081549757441,2019-03-24 14:45:00,2019-03-24 15:00:00
75,19,13,6,0.021722829934859703,2019-03-24 14:45:00,2019-03-24 15:00:00
80,2,0,2,0.0014782616088030351,2019-03-24 14:45:00,2019-03-24 15:00:00
85,3,0,3,0.0014782616088030351,2019-03-24 14:45:00,2019-03-24 15:00:00
86,2,0,2,0.0014782616088030351,2019-03-24 14:45:00,2019-03-24 15:00:00
87,19,10,9,0.009797642981591971,2019-03-24 14:45:00,2019-03-24 15:00:00
88,9,5,4,0.008819163485330002,2019-03-24 14:45:00,2019-03-24 15:00:00
89,20,12,8,0.012892382274242052,2019-03-24 14:45:00,2019-03-24 15:00:00
90,12,6,6,0.005464758191461594,2019-03-24 14:45:00,2019-03-24 15:00:00
99,3,2,1,0.0018971086037902658,2019-03-24 14:45:00,2019-03-24 15:00:00
101,17,7,10,0.003650146087899166,2019-03-24 14:45:00,2019-03-24 15:00:00
104,6,2,4,0.002270466191604404,2019-03-24 14:45:00,2019-03-24 15:00:00
106,13,6,7,0.0054472477433137306,2019-03-24 14:45:00,2019-03-24 15:00:00
108,19,9,10,0.00629288954787301,2019-03-24 14:45:00,2019-03-24 15:00:00
109,11,6,5,0.009864718344971105,2019-03-24 14:45:00,2019-03-24 15:00:00
110,13,8,5,0.006016838414109142,2019-03-24 14:45:00,2019-03-24 15:00:00
111,14,4,10,0.005617383619883242,2019-03-24 14:45:00,2019-03-24 15:00:00
112,15,10,5,0.009869274836886283,2019-03-24 14:45:00,2019-03-24 15:00:00
113,3,0,3,0.0014782616088030351,2019-03-24 14:45:00,2019-03-24 15:00:00
114,14,5,9,0.00790530106409405,2019-03-24 14:45:00,2019-03-24 15:00:00
115,19,8,11,0.011686262071648591,2019-03-24 14:45:00,2019-03-24 15:00:00
116,4,2,2,0.003274850108058171,2019-03-24 14:45:00,2019-03-24 15:00:00
118,1,0,1,0.0014782616088030351,2019-03-24 14:45:00,2019-03-24 15:00:00
119,17,7,10,0.004962898778401781,2019-03-24 14:45:00,2019-03-24 15:00:00
120,2,1,1,0.00985081549757441,2019-03-24 14:45:00,2019-03-24 15:00:00
122,6,4,2,0.015583551476385269,2019-03-24 14:45:00,2019-03-24 15:00:00
126,10,7,3,0.010013120571744924,2019-03-24 14:45:00,2019-03-24 15:00:00
133,6,1,5,0.0017810437249125223,2019-03-24 14:45:00,2019-03-24 15:00:00
135,4,3,1,0.0034915390384621086,2019-03-24 14:45:00,2019-03-24 15:00:00
137,47,23,24,0.020947023914326283,2019-03-24 14:45:00,2019-03-24 15:00:00
138,29,16,13,0.01964094401464069,2019-03-24 14:45:00,2019-03-24 15:00:00
140,5,0,5,0.0014782616088030351,2019-03-24 14:45:00,2019-03-24 15:00:00
141,12,6,6,0.00412319967457469,2019-03-24 14:45:00,2019-03-24 15:00:00
147,3,0,3,0.0014782616088030351,2019-03-24 14:45:00,2019-03-24 15:00:00
151,5,2,3,0.003411464338014276,2019-03-24 14:45:00,2019-03-24 15:00:00
153,9,4,5,0.01162788810178492,2019-03-24 14:45:00,2019-03-24 15:00:00
154,9,4,5,0.0026588378386053135,2019-03-24 14:45:00,2019-03-24 15:00:00
156,2,0,2,0.0014782616088030351,2019-03-24 14:45:00,2019-03-24 15:00:00
157,17,9,8,0.019446794564449026,2019-03-24 14:45:00,2019-03-24 15:00:00
158,7,3,4,0.009390302310088814,2019-03-24 14:45:00,2019-03-24 15:00:00
159,5,2,3,0.003411464338014276,2019-03-24 14:45:00,2019-03-24 15:00:00
160,3,2,1,0.002734802593764727,2019-03-24 14:45:00,2019-03-24 15:00:00
161,6,3,3,0.00985081549757441,2019-03-24 14:45:00,2019-03-24 15:00:00
162,6,4,2,0.017232266142592722,2019-03-24 14:45:00,2019-03-24 15:00:00
164,28,19,9,0.02736796950176775,2019-03-24 14:45:00,2019-03-24 15:00:00
168,23,9,14,0.010080340681032706,2019-03-24 14:45:00,2019-03-24 15:00:00
169,21,14,7,0.02271571435124936,2019-03-24 14:45:00,2019-03-24 15:00:00
171,5,3,2,0.004361004988880996,2019-03-24 14:45:00,2019-03-24 15:00:00
172,2,2,0,0.0029838022864962614,2019-03-24 14:45:00,2019-03-24 15:00:00
173,1,1,0,0.002987219698715982,2019-03-24 14:45:00,2019-03-24 15:00:00
175,20,10,10,0.011016625226625871,2019-03-24 14:45:00,2019-03-24 15:00:00
177,5,3,2,0.004513438704812779,2019-03-24 14:45:00,2019-03-24 15:00:00
189,12,3,9,0.00327123550724334,2019-03-24 14:45:00,2019-03-24 15:00:00
190,9,3,6,0.005235306457800997,2019-03-24 14:45:00,2019-03-24 15:00:00
191,16,11,5,0.016140511717054776,2019-03-24 14:45:00,2019-03-24 15:00:00
195,3,1,2,0.0025709229306872766,2019-03-24 14:45:00,2019-03-24 15:00:00
196,3,2,1,0.0034626318717602723,2019-03-24 14:45:00,2019-03-24 15:00:00
197,9,8,1,0.08761473777553255,2019-03-24 14:45:00,2019-03-24 15:00:00
199,5,2,3,0.003411464338014276,2019-03-24 14:45:00,2019-03-24 15:00:00
200,2,1,1,0.00985081549757441,2019-03-24 14:45:00,2019-03-24 15:00:00
201,5,1,4,0.00225253793484744,2019-03-24 14:45:00,2019-03-24 15:00:00
202,2,1,1,0.002220256564402444,2019-03-24 14:45:00,2019-03-24 15:00:00
203,24,10,14,0.011051532102216469,2019-03-24 14:45:00,2019-03-24 15:00:00
1,12,6,6,0.006343405860826172,2019-03-24 15:00:00,2019-03-24 15:15:00
2,23,12,11,0.0177785238200101,2019-03-24 15:00:00,2019-03-24 15:15:00
5,11,5,6,0.008306094931072974,2019-03-24 15:00:00,2019-03-24 15:15:00
10,12,4,8,0.011742822712768676,2019-03-24 15:00:00,2019-03-24 15:15:00
11,6,5,1,0.03496226253119351,2019-03-24 15:00:00,2019-03-24 15:15:00
15,18,8,10,0.007801476703291175,2019-03-24 15:00:00,2019-03-24 15:15:00
16,17,9,8,0.013124193997453553,2019-03-24 15:00:00,2019-03-24 15:15:00
18,6,4,2,0.009456325365782274,2019-03-24 15:00:00,2019-03-24 15:15:00
19,9,5,4,0.01941595206191281,2019-03-24 15:00:00,2019-03-24 15:15:00
20,3,2,1,0.006884703148431945,2019-03-24 15:00:00,2019-03-24 15:15:00
21,2,0,2,0.0014651301716171123,2019-03-24 15:00:00,2019-03-24 15:15:00
23,20,16,4,0.022930326395843508,2019-03-24 15:00:00,2019-03-24 15:15:00
26,6,1,5,0.002710504349647999,2019-03-24 15:00:00,2019-03-24 15:15:00
27,6,4,2,0.006850752472377599,2019-03-24 15:00:00,2019-03-24 15:15:00
28,1,0,1,0.0014651301716171123,2019-03-24 15:00:00,2019-03-24 15:15:00
30,1,1,0,0.003465753228841963,2019-03-24 15:00:00,2019-03-24 15:15:00
35,12,5,7,0.004952330730220955,2019-03-24 15:00:00,2019-03-24 15:15:00
37,3,1,2,0.0025742971336131567,2019-03-24 15:00:00,2019-03-24 15:15:00
40,5,2,3,0.005978748836148264,2019-03-24 15:00:00,2019-03-24 15:15:00
41,8,4,4,0.006588316207935697,2019-03-24 15:00:00,2019-03-24 15:15:00
46,2,2,0,0.0070052134468270065,2019-03-24 15:00:00,2019-03-24 15:15:00
50,2,0,2,0.0014651301716171123,2019-03-24 15:00:00,2019-03-24 15:15:00
57,15,8,7,0.01399024917211054,2019-03-24 15:00:00,2019-03-24 15:15:00
58,14,7,7,0.012466442270477933,2019-03-24 15:00:00,2019-03-24 15:15:00
61,1,0,1,0.0014651301716171123,2019-03-24 15:00:00,2019-03-24 15:15:00
62,10,3,7,0.005979481818638927,2019-03-24 15:00:00,2019-03-24 15:15:00
64,24,10,14,0.008880755086378925,2019-03-24 15:00:00,2019-03-24 15:15:00
66,5,2,3,0.003381149241657329,2019-03-24 15:00:00,2019-03-24 15:15:00
67,17,11,6,0.009546865733389916,2019-03-24 15:00:00,2019-03-24 15:15:00
68,3,2,1,0.009718406786662668,2019-03-24 15:00:00,2019-03-24 15:15:00
69,5,2,3,0.003782118885448234,2019-03-24 15:00:00,2019-03-24 15:15:00
70,6,4,2,0.021522045618366886,2019-03-24 15:00:00,2019-03-24 15:15:00
71,1,0,1,0.0014651301716171123,2019-03-24 15:00:00,2019-03-24 15:15:00
74,2,1,1,0.009759225147468673,2019-03-24 15:00:00,2019-03-24 15:15:00
75,17,10,7,0.01727185404837015,2019-03-24 15:00:00,2019-03-24 15:15:00
79,2,2,0,0.0022199083331586214,2019-03-24 15:00:00,2019-03-24 15:15:00
85,2,0,2,0.0014651301716171123,2019-03-24 15:00:00,2019-03-24 15:15:00
86,2,0,2,0.0014651301716171123,2019-03-24 15:00:00,2019-03-24 15:15:00
87,17,9,8,0.011011591452794504,2019-03-24 15:00:00,2019-03-24 15:15:00
88,7,3,4,0.006000004033811655,2019-03-24 15:00:00,2019-03-24 15:15:00
89,20,12,8,0.014259040859886435,2019-03-24 15:00:00,2019-03-24 15:15:00
90,8,4,4,0.0063176727318947365,2019-03-24 15:00:00,2019-03-24 15:15:00
99,3,1,2,0.0025480773896713813,2019-03-24 15:00:00,2019-03-24 15:15:00
101,15,6,9,0.003381149241657329,2019-03-24 15:00:00,2019-03-24 15:15:00
104,3,2,1,0.01332616706958175,2019-03-24 15:00:00,2019-03-24 15:15:00
106,11,5,6,0.0050244827620897735,2019-03-24 15:00:00,2019-03-24 15:15:00
108,22,9,13,0.0035602333077574054,2019-03-24 15:00:00,2019-03-24 15:15:00
109,10,7,3,0.019431960682961675,2019-03-24 15:00:00,2019-03-24 15:15:00
110,11,7,4,0.006425030763721017,2019-03-24 15:00:00,2019-03-24 15:15:00
111,15,6,9,0.006768936068043744,2019-03-24 15:00:00,2019-03-24 15:15:00
112,11,8,3,0.008947306641537537,2019-03-24 15:00:00,2019-03-24 15:15:00
113,5,2,3,0.0041252636096221085,2019-03-24 15:00:00,2019-03-24 15:15:00
114,18,4,14,0.0038759506721833007,2019-03-24 15:00:00,2019-03-24 15:15:00
115,18,5,13,0.004907994174370992,2019-03-24 15:00:00,2019-03-24 15:15:00
116,3,1,2,0.004000436248678511,2019-03-24 15:00:00,2019-03-24 15:15:00
118,1,1,0,0.0028176635038971586,2019-03-24 15:00:00,2019-03-24 15:15:00
119,12,7,5,0.007976818663142982,2019-03-24 15:00:00,2019-03-24 15:15:00
120,3,2,1,0.02648664645091052,2019-03-24 15:00:00,2019-03-24 15:15:00
122,7,4,3,0.006157251922328983,2019-03-24 15:00:00,2019-03-24 15:15:00
126,8,5,3,0.00706058197988759,2019-03-24 15:00:00,2019-03-24 15:15:00
133,5,1,4,0.0018604885731803337,2019-03-24 15:00:00,2019-03-24 15:15:00
135,4,3,1,0.0038496261634781287,2019-03-24 15:00:00,2019-03-24 15:15:00
137,44,23,21,0.027399479501165284,2019-03-24 15:00:00,2019-03-24 15:15:00
138,30,15,15,0.014548293522263177,2019-03-24 15:00:00,2019-03-24 15:15:00
140,5,1,4,0.002340977566384184,2019-03-24 15:00:00,2019-03-24 15:15:00
141,5,3,2,0.0038800275559829484,2019-03-24 15:00:00,2019-03-24 15:15:00
147,4,1,3,0.0025592849562106404,2019-03-24 15:00:00,2019-03-24 15:15:00
151,7,2,5,0.0022199083331586214,2019-03-24 15:00:00,2019-03-24 15:15:00
153,14,7,7,0.010952080473490005,2019-03-24 15:00:00,2019-03-24 15:15:00
154,6,2,4,0.0023867127048324763,2019-03-24 15:00:00,2019-03-24 15:15:00
156,2,0,2,0.0014651301716171123,2019-03-24 15:00:00,2019-03-24 15:15:00
157,19,10,9,0.019798379621116885,2019-03-24 15:00:00,2019-03-24 15:15:00
158,4,2,2,0.004088293957606207,2019-03-24 15:00:00,2019-03-24 15:15:00
159,5,2,3,0.003381149241657329,2019-03-24 15:00:00,2019-03-24 15:15:00
160,3,2,1,0.002710504349647999,2019-03-24 15:00:00,2019-03-24 15:15:00
161,6,3,3,0.009759225147468673,2019-03-24 15:00:00,2019-03-24 15:15:00
162,9,6,3,0.010947051001812206,2019-03-24 15:00:00,2019-03-24 15:15:00
164,32,22,10,0.045767372996325245,2019-03-24 15:00:00,2019-03-24 15:15:00
168,14,7,7,0.024174808268259355,2019-03-24 15:00:00,2019-03-24 15:15:00
169,20,15,5,0.0350496972288328,2019-03-24 15:00:00,2019-03-24 15:15:00
170,1,0,1,0.0014651301716171123,2019-03-24 15:00:00,2019-03-24 15:15:00
171,3,0,3,0.0014651301716171123,2019-03-24 15:00:00,2019-03-24 15:15:00
172,2,2,0,0.003138589379674509,2019-03-24 15:00:00,2019-03-24 15:15:00
173,3,1,2,0.0055917684791398905,2019-03-24 15:00:00,2019-03-24 15:15:00
175,8,4,4,0.007297739455330485,2019-03-24 15:00:00,2019-03-24 15:15:00
177,4,1,3,0.0020443773500748927,2019-03-24 15:00:00,2019-03-24 15:15:00
189,6,0,6,0.0014651301716171123,2019-03-24 15:00:00,2019-03-24 15:15:00
190,5,3,2,0.004836995383468793,2019-03-24 15:00:00,2019-03-24 15:15:00
191,16,9,7,0.014547995762382866,2019-03-24 15:00:00,2019-03-24 15:15:00
195,3,1,2,0.0025480773896713813,2019-03-24 15:00:00,2019-03-24 15:15:00
196,2,1,1,0.003164159427885613,2019-03-24 15:00:00,2019-03-24 15:15:00
197,10,7,3,0.015331829128246644,2019-03-24 15:00:00,2019-03-24 15:15:00
199,5,2,3,0.003381149241657329,2019-03-24 15:00:00,2019-03-24 15:15:00
200,2,1,1,0.009759225147468673,2019-03-24 15:00:00,2019-03-24 15:15:00
201,8,3,5,0.005151501649218263,2019-03-24 15:00:00,2019-03-24 15:15:00
202,4,3,1,0.012553338666726404,2019-03-24 15:00:00,2019-03-24 15:15:00
203,29,11,18,0.016828635646985158,2019-03-24 15:00:00,2019-03-24 15:15:00
1,12,4,8,0.004387626573300922,2019-03-24 15:15:00,2019-03-24 15:30:00
2,26,16,10,0.019489550573525544,2019-03-24 15:15:00,2019-03-24 15:30:00
5,12,6,6,0.007451023925927644,2019-03-24 15:15:00,2019-03-24 15:30:00
10,9,3,6,0.01225620057495223,2019-03-24 15:15:00,2019-03-24 15:30:00
11,6,5,1,0.026367118148702625,2019-03-24 15:15:00,2019-03-24 15:30:00
15,16,8,8,0.005848912953205473,2019-03-24 15:15:00,2019-03-24 15:30:00
16,18,8,10,0.00803034304237954,2019-03-24 15:15:00,2019-03-24 15:30:00
18,6,4,2,0.016393564466093965,2019-03-24 15:15:00,2019-03-24 15:30:00
19,7,5,2,0.01992308783756597,2019-03-24 15:15:00,2019-03-24 15:30:00
20,2,1,1,0.009971830412993186,2019-03-24 15:15:00,2019-03-24 15:30:00
21,1,0,1,0.0014984150657101742,2019-03-24 15:15:00,2019-03-24 15:30:00
23,23,13,10,0.015815793990297228,2019-03-24 15:15:00,2019-03-24 15:30:00
26,8,1,7,0.006786652474412068,2019-03-24 15:15:00,2019-03-24 15:30:00
27,6,4,2,0.006042710470650238,2019-03-24 15:15:00,2019-03-24 15:30:00
28,1,0,1,0.0014984150657101742,2019-03-24 15:15:00,2019-03-24 15:30:00
30,1,1,0,0.003335337213911509,2019-03-24 15:15:00,2019-03-24 15:30:00
35,13,5,8,0.003196628406558622,2019-03-24 15:15:00,2019-03-24 15:30:00
37,2,1,1,0.0021483186703978073,2019-03-24 15:15:00,2019-03-24 15:30:00
40,4,0,4,0.0014984150657101742,2019-03-24 15:15:00,2019-03-24 15:30:00
41,7,4,3,0.0032659202957987664,2019-03-24 15:15:00,2019-03-24 15:30:00
46,5,3,2,0.007778197868867926,2019-03-24 15:15:00,2019-03-24 15:30:00
50,1,0,1,0.0014984150657101742,2019-03-24 15:15:00,2019-03-24 15:30:00
57,16,9,7,0.038635682817053346,2019-03-24 15:15:00,2019-03-24 15:30:00
58,11,6,5,0.015342222306201407,2019-03-24 15:15:00,2019-03-24 15:30:00
61,4,3,1,0.006222315279091603,2019-03-24 15:15:00,2019-03-24 15:30:00
62,9,2,7,0.005570070259503737,2019-03-24 15:15:00,2019-03-24 15:30:00
64,15,7,8,0.0077255259220481536,2019-03-24 15:15:00,2019-03-24 15:30:00
66,7,2,5,0.002270326350761166,2019-03-24 15:15:00,2019-03-24 15:30:00
67,18,10,8,0.00700115366514484,2019-03-24 15:15:00,2019-03-24 15:30:00
68,4,3,1,0.019073690973219617,2019-03-24 15:15:00,2019-03-24 15:30:00
69,6,2,4,0.0035200890411565683,2019-03-24 15:15:00,2019-03-24 15:30:00
70,4,2,2,0.009971830412993186,2019-03-24 15:15:00,2019-03-24 15:30:00
71,1,0,1,0.0014984150657101742,2019-03-24 15:15:00,2019-03-24 15:30:00
74,5,3,2,0.0040006695720506335,2019-03-24 15:15:00,2019-03-24 15:30:00
75,19,10,9,0.0168101948101759,2019-03-24 15:15:00,2019-03-24 15:30:00
79,4,3,1,0.017644334216863518,2019-03-24 15:15:00,2019-03-24 15:30:00
86,1,0,1,0.0014984150657101742,2019-03-24 15:15:00,2019-03-24 15:30:00
87,18,6,12,0.0058216396064904585,2019-03-24 15:15:00,2019-03-24 15:30:00
88,8,4,4,0.00900301002654937,2019-03-24 15:15:00,2019-03-24 15:30:00
89,18,11,7,0.01340564498982798,2019-03-24 15:15:00,2019-03-24 15:30:00
90,8,4,4,0.005951712366569876,2019-03-24 15:15:00,2019-03-24 15:30:00
99,2,1,1,0.009971830412993186,2019-03-24 15:15:00,2019-03-24 15:30:00
101,16,7,9,0.0044222626430370435,2019-03-24 15:15:00,2019-03-24 15:30:00
104,5,3,2,0.01540574114454299,2019-03-24 15:15:00,2019-03-24 15:30:00
106,12,5,7,0.003814287948878244,2019-03-24 15:15:00,2019-03-24 15:30:00
108,10,3,7,0.0033018540632009435,2019-03-24 15:15:00,2019-03-24 15:30:00
109,10,7,3,0.023368602038098055,2019-03-24 15:15:00,2019-03-24 15:30:00
110,9,4,5,0.003488682878227597,2019-03-24 15:15:00,2019-03-24 15:30:00
111,13,6,7,0.005431511297995621,2019-03-24 15:15:00,2019-03-24 15:30:00
112,18,9,9,0.007925740062337337,2019-03-24 15:15:00,2019-03-24 15:30:00
113,1,0,1,0.0014984150657101742,2019-03-24 15:15:00,2019-03-24 15:30:00
114,8,2,6,0.00299552907409525,2019-03-24 15:15:00,2019-03-24 15:30:00
115,15,4,11,0.00544209286109841,2019-03-24 15:15:00,2019-03-24 15:30:00
116,5,1,4,0.002246972069902712,2019-03-24 15:15:00,2019-03-24 15:30:00
118,5,3,2,0.00629197818053682,2019-03-24 15:15:00,2019-03-24 15:30:00
119,11,7,4,0.008686280774066801,2019-03-24 15:15:00,2019-03-24 15:30:00
120,3,3,0,0.002926257406242091,2019-03-24 15:15:00,2019-03-24 15:30:00
122,4,2,2,0.009971830412993186,2019-03-24 15:15:00,2019-03-24 15:30:00
126,9,6,3,0.006482819235648179,2019-03-24 15:15:00,2019-03-24 15:30:00
133,2,1,1,0.009971830412993186,2019-03-24 15:15:00,2019-03-24 15:30:00
135,6,3,3,0.002079104980065058,2019-03-24 15:15:00,2019-03-24 15:30:00
137,45,22,23,0.017583198227632192,2019-03-24 15:15:00,2019-03-24 15:30:00
138,35,17,18,0.013944350561779216,2019-03-24 15:15:00,2019-03-24 15:30:00
140,7,1,6,0.0018168288255036994,2019-03-24 15:15:00,2019-03-24 15:30:00
141,3,3,0,0.002817933609370318,2019-03-24 15:15:00,2019-03-24 15:30:00
147,5,3,2,0.006587577665796663,2019-03-24 15:15:00,2019-03-24 15:30:00
151,8,3,5,0.0034045095148833777,2019-03-24 15:15:00,2019-03-24 15:30:00
153,14,6,8,0.007910643102287146,2019-03-24 15:15:00,2019-03-24 15:30:00
154,4,2,2,0.0031463240459761515,2019-03-24 15:15:00,2019-03-24 15:30:00
157,18,10,8,0.01131881442568254,2019-03-24 15:15:00,2019-03-24 15:30:00
158,8,2,6,0.0025029169203632665,2019-03-24 15:15:00,2019-03-24 15:30:00
159,2,0,2,0.0014984150657101742,2019-03-24 15:15:00,2019-03-24 15:30:00
160,1,0,1,0.0014984150657101742,2019-03-24 15:15:00,2019-03-24 15:30:00
161,6,3,3,0.009971830412993186,2019-03-24 15:15:00,2019-03-24 15:30:00
162,11,7,4,0.0171585079141461,2019-03-24 15:15:00,2019-03-24 15:30:00
164,26,21,5,0.04275980089582069,2019-03-24 15:15:00,2019-03-24 15:30:00
168,20,11,9,0.029925575343562362,2019-03-24 15:15:00,2019-03-24 15:30:00
169,17,12,5,0.04283544347324783,2019-03-24 15:15:00,2019-03-24 15:30:00
170,4,4,0,0.003976461840281657,2019-03-24 15:15:00,2019-03-24 15:30:00
171,8,4,4,0.003948390399566759,2019-03-24 15:15:00,2019-03-24 15:30:00
172,8,8,0,0.007029185213799732,2019-03-24 15:15:00,2019-03-24 15:30:00
173,2,0,2,0.0014984150657101742,2019-03-24 15:15:00,2019-03-24 15:30:00
175,6,3,3,0.0037460257139725925,2019-03-24 15:15:00,2019-03-24 15:30:00
177,5,1,4,0.001902749860799453,2019-03-24 15:15:00,2019-03-24 15:30:00
189,7,2,5,0.004018514410870703,2019-03-24 15:15:00,2019-03-24 15:30:00
190,8,6,2,0.007052224686953021,2019-03-24 15:15:00,2019-03-24 15:30:00
191,11,5,6,0.004871876682200435,2019-03-24 15:15:00,2019-03-24 15:30:00
195,2,1,1,0.009971830412993186,2019-03-24 15:15:00,2019-03-24 15:30:00
196,4,2,2,0.008869317025418388,2019-03-24 15:15:00,2019-03-24 15:30:00
197,10,6,4,0.012612378736736355,2019-03-24 15:15:00,2019-03-24 15:30:00
199,6,3,3,0.0053977159838570436,2019-03-24 15:15:00,2019-03-24 15:30:00
200,2,1,1,0.009971830412993186,2019-03-24 15:15:00,2019-03-24 15:30:00
201,4,0,4,0.0014984150657101742,2019-03-24 15:15:00,2019-03-24 15:30:00
202,4,3,1,0.01640054498133717,2019-03-24 15:15:00,2019-03-24 15:30:00
203,31,11,20,0.004554337336048939,2019-03-24 15:15:00,2019-03-24 15:30:00
1,8,2,6,0.004254950022231273,2019-03-24 15:30:00,2019-03-24 15:45:00
2,21,12,9,0.012511402135824358,2019-03-24 15:30:00,2019-03-24 15:45:00
5,9,2,7,0.0050340757608776645,2019-03-24 15:30:00,2019-03-24 15:45:00
10,9,3,6,0.00465864663436001,2019-03-24 15:30:00,2019-03-24 15:45:00
11,6,5,1,0.056180261210496886,2019-03-24 15:30:00,2019-03-24 15:45:00
15,27,13,14,0.009533648584992113,2019-03-24 15:30:00,2019-03-24 15:45:00
16,25,5,20,0.004288537898873917,2019-03-24 15:30:00,2019-03-24 15:45:00
18,5,4,1,0.011873286423572478,2019-03-24 15:30:00,2019-03-24 15:45:00
19,14,5,9,0.005072114714593294,2019-03-24 15:30:00,2019-03-24 15:45:00
20,3,2,1,0.003983730416555166,2019-03-24 15:30:00,2019-03-24 15:45:00
23,31,16,15,0.022672941135652182,2019-03-24 15:30:00,2019-03-24 15:45:00
26,7,3,4,0.003724254150679942,2019-03-24 15:30:00,2019-03-24 15:45:00
27,8,5,3,0.011201592587094803,2019-03-24 15:30:00,2019-03-24 15:45:00
30,1,1,0,0.0024825676670338576,2019-03-24 15:30:00,2019-03-24 15:45:00
35,8,4,4,0.010460456643553412,2019-03-24 15:30:00,2019-03-24 15:45:00
37,2,1,1,0.0022537411671611487,2019-03-24 15:30:00,2019-03-24 15:45:00
40,4,0,4,0.0015703239994568868,2019-03-24 15:30:00,2019-03-24 15:45:00
41,9,8,1,0.012818132639592734,2019-03-24 15:30:00,2019-03-24 15:45:00
46,4,3,1,0.007059407598426007,2019-03-24 15:30:00,2019-03-24 15:45:00
50,1,0,1,0.0015703239994568868,2019-03-24 15:30:00,2019-03-24 15:45:00
57,21,10,11,0.03303835936811306,2019-03-24 15:30:00,2019-03-24 15:45:00
58,16,8,8,0.014234898973973112,2019-03-24 15:30:00,2019-03-24 15:45:00
61,8,8,0,0.009988616973210749,2019-03-24 15:30:00,2019-03-24 15:45:00
62,8,2,6,0.0033400634206845995,2019-03-24 15:30:00,2019-03-24 15:45:00
64,13,5,8,0.0073336128649728865,2019-03-24 15:30:00,2019-03-24 15:45:00
66,3,1,2,0.0027310421843746513,2019-03-24 15:30:00,2019-03-24 15:45:00
67,14,5,9,0.009871501003113152,2019-03-24 15:30:00,2019-03-24 15:45:00
68,9,8,1,0.00933452507975705,2019-03-24 15:30:00,2019-03-24 15:45:00
69,8,6,2,0.009277029328261178,2019-03-24 15:30:00,2019-03-24 15:45:00
70,5,3,2,0.021143823818509676,2019-03-24 15:30:00,2019-03-24 15:45:00
74,3,2,1,0.003511813889503593,2019-03-24 15:30:00,2019-03-24 15:45:00
75,16,10,6,0.01282529558960339,2019-03-24 15:30:00,2019-03-24 15:45:00
79,3,2,1,0.013532861927753662,2019-03-24 15:30:00,2019-03-24 15:45:00
80,7,4,3,0.006445747140070906,2019-03-24 15:30:00,2019-03-24 15:45:00
86,1,0,1,0.0015703239994568868,2019-03-24 15:30:00,2019-03-24 15:45:00
87,9,3,6,0.0027310421843746513,2019-03-24 15:30:00,2019-03-24 15:45:00
88,13,6,7,0.009625578339286331,2019-03-24 15:30:00,2019-03-24 15:45:00
89,12,8,4,0.00806788299376408,2019-03-24 15:30:00,2019-03-24 15:45:00
90,13,6,7,0.007615392506041168,2019-03-24 15:30:00,2019-03-24 15:45:00
99,4,1,3,0.002191167241279929,2019-03-24 15:30:00,2019-03-24 15:45:00
101,16,7,9,0.004634067634248058,2019-03-24 15:30:00,2019-03-24 15:45:00
104,4,2,2,0.010460456643553412,2019-03-24 15:30:00,2019-03-24 15:45:00
106,12,5,7,0.003997359712895682,2019-03-24 15:30:00,2019-03-24 15:45:00
108,7,3,4,0.004567753838030816,2019-03-24 15:30:00,2019-03-24 15:45:00
109,17,8,9,0.020880783519215747,2019-03-24 15:30:00,2019-03-24 15:45:00
110,10,2,8,0.00199407279402501,2019-03-24 15:30:00,2019-03-24 15:45:00
111,9,2,7,0.0036927983423251072,2019-03-24 15:30:00,2019-03-24 15:45:00
112,16,6,10,0.005433597111924349,2019-03-24 15:30:00,2019-03-24 15:45:00
113,4,0,4,0.0015703239994568868,2019-03-24 15:30:00,2019-03-24 15:45:00
114,15,7,8,0.013833789860271457,2019-03-24 15:30:00,2019-03-24 15:45:00
115,24,10,14,0.0154351953848241,2019-03-24 15:30:00,2019-03-24 15:45:00
116,8,3,5,0.0031052645773674116,2019-03-24 15:30:00,2019-03-24 15:45:00
118,5,1,4,0.007571300565204974,2019-03-24 15:30:00,2019-03-24 15:45:00
119,13,9,4,0.011853838040394539,2019-03-24 15:30:00,2019-03-24 15:45:00
122,6,2,4,0.0027310421843746513,2019-03-24 15:30:00,2019-03-24 15:45:00
126,12,6,6,0.0064387127554480375,2019-03-24 15:30:00,2019-03-24 15:45:00
135,6,3,3,0.002086479419498398,2019-03-24 15:30:00,2019-03-24 15:45:00
137,45,23,22,0.017685373942147194,2019-03-24 15:30:00,2019-03-24 15:45:00
138,42,23,19,0.0244567215489976,2019-03-24 15:30:00,2019-03-24 15:45:00
140,6,0,6,0.0015703239994568868,2019-03-24 15:30:00,2019-03-24 15:45:00
141,4,4,0,0.004582665167431989,2019-03-24 15:30:00,2019-03-24 15:45:00
147,5,3,2,0.006907384511015531,2019-03-24 15:30:00,2019-03-24 15:45:00
151,2,1,1,0.002032199290922937,2019-03-24 15:30:00,2019-03-24 15:45:00
153,10,5,5,0.015265944452253514,2019-03-24 15:30:00,2019-03-24 15:45:00
157,20,10,10,0.013998207840582776,2019-03-24 15:30:00,2019-03-24 15:45:00
158,10,4,6,0.0028005917424692144,2019-03-24 15:30:00,2019-03-24 15:45:00
159,8,3,5,0.003204820920266824,2019-03-24 15:30:00,2019-03-24 15:45:00
160,1,0,1,0.0015703239994568868,2019-03-24 15:30:00,2019-03-24 15:45:00
161,6,3,3,0.010460456643553412,2019-03-24 15:30:00,2019-03-24 15:45:00
162,11,6,5,0.0076256006650106695,2019-03-24 15:30:00,2019-03-24 15:45:00
164,22,17,5,0.019482888428646046,2019-03-24 15:30:00,2019-03-24 15:45:00
168,19,13,6,0.022433451566013857,2019-03-24 15:30:00,2019-03-24 15:45:00
169,17,9,8,0.016638972038190956,2019-03-24 15:30:00,2019-03-24 15:45:00
170,4,4,0,0.004607613447454778,2019-03-24 15:30:00,2019-03-24 15:45:00
171,7,5,2,0.022271504764359264,2019-03-24 15:30:00,2019-03-24 15:45:00
172,9,8,1,0.00633391034519587,2019-03-24 15:30:00,2019-03-24 15:45:00
173,3,1,2,0.002018797982151493,2019-03-24 15:30:00,2019-03-24 15:45:00
175,9,6,3,0.006044602998389614,2019-03-24 15:30:00,2019-03-24 15:45:00
177,6,2,4,0.0040591134202829235,2019-03-24 15:30:00,2019-03-24 15:45:00
189,5,3,2,0.0048980782657453426,2019-03-24 15:30:00,2019-03-24 15:45:00
190,11,9,2,0.022081567695556973,2019-03-24 15:30:00,2019-03-24 15:45:00
191,20,10,10,0.022821209425489437,2019-03-24 15:30:00,2019-03-24 15:45:00
195,2,1,1,0.010460456643553412,2019-03-24 15:30:00,2019-03-24 15:45:00
196,6,4,2,0.008314208539552953,2019-03-24 15:30:00,2019-03-24 15:45:00
197,12,7,5,0.009563903508751031,2019-03-24 15:30:00,2019-03-24 15:45:00
199,5,2,3,0.003623944373629923,2019-03-24 15:30:00,2019-03-24 15:45:00
200,2,1,1,0.010460456643553412,2019-03-24 15:30:00,2019-03-24 15:45:00
201,3,0,3,0.0015703239994568868,2019-03-24 15:30:00,2019-03-24 15:45:00
202,3,2,1,0.0040219417999273754,2019-03-24 15:30:00,2019-03-24 15:45:00
203,29,11,18,0.0036433688533419766,2019-03-24 15:30:00,2019-03-24 15:45:00
1,7,2,5,0.0050496363637626464,2019-03-24 15:45:00,2019-03-24 16:00:00
2,29,16,13,0.02182751863845241,2019-03-24 15:45:00,2019-03-24 16:00:00
5,10,2,8,0.0038704382398955057,2019-03-24 15:45:00,2019-03-24 16:00:00
10,6,1,5,0.0033134109879187673,2019-03-24 15:45:00,2019-03-24 16:00:00
11,4,3,1,0.026244678920714765,2019-03-24 15:45:00,2019-03-24 16:00:00
15,26,9,17,0.004419512414891823,2019-03-24 15:45:00,2019-03-24 16:00:00
16,21,5,16,0.004375122447889542,2019-03-24 15:45:00,2019-03-24 16:00:00
18,6,6,0,0.01030142451612397,2019-03-24 15:45:00,2019-03-24 16:00:00
19,12,1,11,0.0019035064660049708,2019-03-24 15:45:00,2019-03-24 16:00:00
20,4,3,1,0.0046054857332500886,2019-03-24 15:45:00,2019-03-24 16:00:00
23,27,14,13,0.01065452435251142,2019-03-24 15:45:00,2019-03-24 16:00:00
26,11,5,6,0.005669846007082587,2019-03-24 15:45:00,2019-03-24 16:00:00
27,10,6,4,0.012721831765909108,2019-03-24 15:45:00,2019-03-24 16:00:00
28,2,2,0,0.004737282100707186,2019-03-24 15:45:00,2019-03-24 16:00:00
30,1,1,0,0.0025637991391709416,2019-03-24 15:45:00,2019-03-24 16:00:00
35,7,5,2,0.04141211049349459,2019-03-24 15:45:00,2019-03-24 16:00:00
37,1,1,0,0.002975560680008778,2019-03-24 15:45:00,2019-03-24 16:00:00
40,8,2,6,0.002450850245092064,2019-03-24 15:45:00,2019-03-24 16:00:00
41,10,7,3,0.010690215043159796,2019-03-24 15:45:00,2019-03-24 16:00:00
46,3,3,0,0.00714159071085924,2019-03-24 15:45:00,2019-03-24 16:00:00
57,25,13,12,0.017727441696667734,2019-03-24 15:45:00,2019-03-24 16:00:00
58,19,9,10,0.007868549723707683,2019-03-24 15:45:00,2019-03-24 16:00:00
61,7,7,0,0.004940708166612605,2019-03-24 15:45:00,2019-03-24 16:00:00
62,8,3,5,0.007529426490632311,2019-03-24 15:45:00,2019-03-24 16:00:00
64,13,3,10,0.0023576350362970013,2019-03-24 15:45:00,2019-03-24 16:00:00
66,2,1,1,0.011696448273908193,2019-03-24 15:45:00,2019-03-24 16:00:00
67,7,1,6,0.0033353154845955687,2019-03-24 15:45:00,2019-03-24 16:00:00
68,8,4,4,0.004926906808864441,2019-03-24 15:45:00,2019-03-24 16:00:00
69,11,8,3,0.006855683146127878,2019-03-24 15:45:00,2019-03-24 16:00:00
70,2,1,1,0.002129663993483319,2019-03-24 15:45:00,2019-03-24 16:00:00
71,1,0,1,0.0017564110932655045,2019-03-24 15:45:00,2019-03-24 16:00:00
74,3,2,1,0.0042712590961196395,2019-03-24 15:45:00,2019-03-24 16:00:00
75,16,10,6,0.011576006923657529,2019-03-24 15:45:00,2019-03-24 16:00:00
79,5,2,3,0.0028536237653488746,2019-03-24 15:45:00,2019-03-24 16:00:00
80,7,4,3,0.005951976682300023,2019-03-24 15:45:00,2019-03-24 16:00:00
85,4,3,1,0.027923495870669723,2019-03-24 15:45:00,2019-03-24 16:00:00
86,1,0,1,0.0017564110932655045,2019-03-24 15:45:00,2019-03-24 16:00:00
87,9,5,4,0.00755968146272563,2019-03-24 15:45:00,2019-03-24 16:00:00
88,10,2,8,0.0024583474943878996,2019-03-24 15:45:00,2019-03-24 16:00:00
89,12,8,4,0.012328971587794267,2019-03-24 15:45:00,2019-03-24 16:00:00
90,13,7,6,0.009343547771008149,2019-03-24 15:45:00,2019-03-24 16:00:00
99,2,0,2,0.0017564110932655045,2019-03-24 15:45:00,2019-03-24 16:00:00
101,16,7,9,0.005183625574242963,2019-03-24 15:45:00,2019-03-24 16:00:00
104,8,6,2,0.0573993179519079,2019-03-24 15:45:00,2019-03-24 16:00:00
106,12,6,6,0.011143944650787083,2019-03-24 15:45:00,2019-03-24 16:00:00
108,6,3,3,0.004437422737876445,2019-03-24 15:45:00,2019-03-24 16:00:00
109,16,9,7,0.0077230811731269665,2019-03-24 15:45:00,2019-03-24 16:00:00
110,8,3,5,0.0037170869735137905,2019-03-24 15:45:00,2019-03-24 16:00:00
111,14,5,9,0.005320477594814236,2019-03-24 15:45:00,2019-03-24 16:00:00
112,24,7,17,0.005772126611723676,2019-03-24 15:45:00,2019-03-24 16:00:00
113,1,0,1,0.0017564110932655045,2019-03-24 15:45:00,2019-03-24 16:00:00
114,12,4,8,0.006758242304001315,2019-03-24 15:45:00,2019-03-24 16:00:00
115,23,9,14,0.008095928758853246,2019-03-24 15:45:00,2019-03-24 16:00:00
116,9,4,5,0.0047977129784754265,2019-03-24 15:45:00,2019-03-24 16:00:00
118,4,0,4,0.0017564110932655045,2019-03-24 15:45:00,2019-03-24 16:00:00
119,10,7,3,0.012973251132447869,2019-03-24 15:45:00,2019-03-24 16:00:00
120,4,2,2,0.0034590751023967294,2019-03-24 15:45:00,2019-03-24 16:00:00
122,8,6,2,0.01936643220740188,2019-03-24 15:45:00,2019-03-24 16:00:00
126,14,6,8,0.0075976334015134105,2019-03-24 15:45:00,2019-03-24 16:00:00
127,4,4,0,0.004709017803684986,2019-03-24 15:45:00,2019-03-24 16:00:00
135,4,1,3,0.002228956052223852,2019-03-24 15:45:00,2019-03-24 16:00:00
137,41,26,15,0.021510368395912867,2019-03-24 15:45:00,2019-03-24 16:00:00
138,34,15,19,0.02125434164846503,2019-03-24 15:45:00,2019-03-24 16:00:00
140,11,3,8,0.0037786173790273227,2019-03-24 15:45:00,2019-03-24 16:00:00
141,3,3,0,0.003767943975991279,2019-03-24 15:45:00,2019-03-24 16:00:00
147,3,1,2,0.0030547396502737635,2019-03-24 15:45:00,2019-03-24 16:00:00
151,9,5,4,0.007199075988951878,2019-03-24 15:45:00,2019-03-24 16:00:00
153,9,4,5,0.006443539730376518,2019-03-24 15:45:00,2019-03-24 16:00:00
154,1,1,0,0.002975560680008778,2019-03-24 15:45:00,2019-03-24 16:00:00
157,17,8,9,0.008787910272384323,2019-03-24 15:45:00,2019-03-24 16:00:00
158,6,3,3,0.0024537897779938695,2019-03-24 15:45:00,2019-03-24 16:00:00
159,5,2,3,0.004053564488852366,2019-03-24 15:45:00,2019-03-24 16:00:00
160,1,0,1,0.0017564110932655045,2019-03-24 15:45:00,2019-03-24 16:00:00
162,12,6,6,0.005995964443423622,2019-03-24 15:45:00,2019-03-24 16:00:00
164,18,12,6,0.008912664114883449,2019-03-24 15:45:00,2019-03-24 16:00:00
168,14,10,4,0.024353803385252067,2019-03-24 15:45:00,2019-03-24 16:00:00
169,10,6,4,0.007326252544165064,2019-03-24 15:45:00,2019-03-24 16:00:00
170,5,2,3,0.004314133740079114,2019-03-24 15:45:00,2019-03-24 16:00:00
171,7,5,2,0.024306219427771943,2019-03-24 15:45:00,2019-03-24 16:00:00
172,9,7,2,0.006202507751100563,2019-03-24 15:45:00,2019-03-24 16:00:00
173,4,2,2,0.0035149014519311357,2019-03-24 15:45:00,2019-03-24 16:00:00
175,5,4,1,0.015698796804312992,2019-03-24 15:45:00,2019-03-24 16:00:00
177,6,2,4,0.007766533885531379,2019-03-24 15:45:00,2019-03-24 16:00:00
189,7,4,3,0.0063621649268715535,2019-03-24 15:45:00,2019-03-24 16:00:00
190,13,9,4,0.011582590738930401,2019-03-24 15:45:00,2019-03-24 16:00:00
191,21,11,10,0.017530964923083273,2019-03-24 15:45:00,2019-03-24 16:00:00
196,5,3,2,0.0054335841636587116,2019-03-24 15:45:00,2019-03-24 16:00:00
197,14,10,4,0.020509215965754054,2019-03-24 15:45:00,2019-03-24 16:00:00
199,6,2,4,0.0030547396502737635,2019-03-24 15:45:00,2019-03-24 16:00:00
200,4,2,2,0.011696448273908193,2019-03-24 15:45:00,2019-03-24 16:00:00
202,2,2,0,0.004532560574662042,2019-03-24 15:45:00,2019-03-24 16:00:00
203,23,10,13,0.005367213396773629,2019-03-24 15:45:00,2019-03-24 16:00:00
1,2,1,1,0.0023759731199116583,2019-03-24 16:00:00,2019-03-24 16:15:00
2,34,19,15,0.03229394822559069,2019-03-24 16:00:00,2019-03-24 16:15:00
5,13,2,11,0.0038195182972772046,2019-03-24 16:00:00,2019-03-24 16:15:00
10,5,0,5,0.0017104852296862846,2019-03-24 16:00:00,2019-03-24 16:15:00
11,8,3,5,0.003431735052029308,2019-03-24 16:00:00,2019-03-24 16:15:00
15,19,5,14,0.004935814132091421,2019-03-24 16:00:00,2019-03-24 16:15:00
16,19,11,8,0.014739322378044815,2019-03-24 16:00:00,2019-03-24 16:15:00
18,10,8,2,0.009877907615043495,2019-03-24 16:00:00,2019-03-24 16:15:00
19,7,5,2,0.007567287798369071,2019-03-24 16:00:00,2019-03-24 16:15:00
20,6,6,0,0.008584159039700823,2019-03-24 16:00:00,2019-03-24 16:15:00
23,27,11,16,0.007810582372296732,2019-03-24 16:00:00,2019-03-24 16:15:00
26,11,6,5,0.007257629256665914,2019-03-24 16:00:00,2019-03-24 16:15:00
27,7,1,6,0.001992807855771745,2019-03-24 16:00:00,2019-03-24 16:15:00
28,6,4,2,0.01545884697034665,2019-03-24 16:00:00,2019-03-24 16:15:00
30,3,3,0,0.0031674102219314995,2019-03-24 16:00:00,2019-03-24 16:15:00
35,8,6,2,0.041953550851206584,2019-03-24 16:00:00,2019-03-24 16:15:00
37,1,1,0,0.0027698443205841413,2019-03-24 16:00:00,2019-03-24 16:15:00
40,12,4,8,0.0029748303614462843,2019-03-24 16:00:00,2019-03-24 16:15:00
41,9,4,5,0.00553182165606799,2019-03-24 16:00:00,2019-03-24 16:15:00
46,2,2,0,0.003164438281434022,2019-03-24 16:00:00,2019-03-24 16:15:00
57,13,5,8,0.008743538096295324,2019-03-24 16:00:00,2019-03-24 16:15:00
58,15,4,11,0.0056827654537452985,2019-03-24 16:00:00,2019-03-24 16:15:00
61,8,7,1,0.006877341629921076,2019-03-24 16:00:00,2019-03-24 16:15:00
62,13,8,5,0.009094630246782993,2019-03-24 16:00:00,2019-03-24 16:15:00
64,8,1,7,0.0019469015066104897,2019-03-24 16:00:00,2019-03-24 16:15:00
66,4,1,3,0.0023867524348899247,2019-03-24 16:00:00,2019-03-24 16:15:00
67,18,8,10,0.011340657236159592,2019-03-24 16:00:00,2019-03-24 16:15:00
68,8,3,5,0.006613402530701624,2019-03-24 16:00:00,2019-03-24 16:15:00
69,13,9,4,0.0071656930333549185,2019-03-24 16:00:00,2019-03-24 16:15:00
70,4,2,2,0.004775803073593883,2019-03-24 16:00:00,2019-03-24 16:15:00
71,1,0,1,0.0017104852296862846,2019-03-24 16:00:00,2019-03-24 16:15:00
74,1,0,1,0.0017104852296862846,2019-03-24 16:00:00,2019-03-24 16:15:00
75,17,10,7,0.01236467499099509,2019-03-24 16:00:00,2019-03-24 16:15:00
79,6,3,3,0.0038613221864963066,2019-03-24 16:00:00,2019-03-24 16:15:00
80,7,4,3,0.005310082326002199,2019-03-24 16:00:00,2019-03-24 16:15:00
85,2,2,0,0.00682934315316518,2019-03-24 16:00:00,2019-03-24 16:15:00
86,1,1,0,0.003164438281434022,2019-03-24 16:00:00,2019-03-24 16:15:00
87,14,7,7,0.007186986079817685,2019-03-24 16:00:00,2019-03-24 16:15:00
88,6,3,3,0.005576775403698863,2019-03-24 16:00:00,2019-03-24 16:15:00
89,14,8,6,0.012139401397990506,2019-03-24 16:00:00,2019-03-24 16:15:00
90,18,10,8,0.01644440899401922,2019-03-24 16:00:00,2019-03-24 16:15:00
99,1,1,0,0.003730184430750703,2019-03-24 16:00:00,2019-03-24 16:15:00
101,10,4,6,0.003947480711532078,2019-03-24 16:00:00,2019-03-24 16:15:00
104,12,7,5,0.011948108395145913,2019-03-24 16:00:00,2019-03-24 16:15:00
106,10,5,5,0.015600212567214408,2019-03-24 16:00:00,2019-03-24 16:15:00
108,12,8,4,0.021078618573355353,2019-03-24 16:00:00,2019-03-24 16:15:00
109,23,14,9,0.02222127796023443,2019-03-24 16:00:00,2019-03-24 16:15:00
110,10,5,5,0.004379209648574439,2019-03-24 16:00:00,2019-03-24 16:15:00
111,12,3,9,0.004047886257864163,2019-03-24 16:00:00,2019-03-24 16:15:00
112,17,5,12,0.005522710681962946,2019-03-24 16:00:00,2019-03-24 16:15:00
114,12,4,8,0.002889079245210693,2019-03-24 16:00:00,2019-03-24 16:15:00
115,19,6,13,0.00850429906969456,2019-03-24 16:00:00,2019-03-24 16:15:00
116,10,5,5,0.010377654155664308,2019-03-24 16:00:00,2019-03-24 16:15:00
118,4,2,2,0.002481566019888095,2019-03-24 16:00:00,2019-03-24 16:15:00
119,18,10,8,0.013398743121495048,2019-03-24 16:00:00,2019-03-24 16:15:00
120,1,0,1,0.0017104852296862846,2019-03-24 16:00:00,2019-03-24 16:15:00
122,9,7,2,0.02380815681960127,2019-03-24 16:00:00,2019-03-24 16:15:00
126,13,4,9,0.0036486368073225385,2019-03-24 16:00:00,2019-03-24 16:15:00
127,3,3,0,0.0029686275589447314,2019-03-24 16:00:00,2019-03-24 16:15:00
135,6,1,5,0.0026745391589590418,2019-03-24 16:00:00,2019-03-24 16:15:00
137,41,25,16,0.019937699479805254,2019-03-24 16:00:00,2019-03-24 16:15:00
138,38,15,23,0.010430904977717113,2019-03-24 16:00:00,2019-03-24 16:15:00
140,9,3,6,0.00549195204917889,2019-03-24 16:00:00,2019-03-24 16:15:00
141,9,4,5,0.00495027062763673,2019-03-24 16:00:00,2019-03-24 16:15:00
147,2,1,1,0.011389479308888515,2019-03-24 16:00:00,2019-03-24 16:15:00
151,8,4,4,0.005538742132596964,2019-03-24 16:00:00,2019-03-24 16:15:00
153,13,5,8,0.005353977195312547,2019-03-24 16:00:00,2019-03-24 16:15:00
154,2,2,0,0.004122841073779213,2019-03-24 16:00:00,2019-03-24 16:15:00
157,11,6,5,0.010410770409395904,2019-03-24 16:00:00,2019-03-24 16:15:00
158,7,3,4,0.006409445943614488,2019-03-24 16:00:00,2019-03-24 16:15:00
159,6,4,2,0.026933382159872347,2019-03-24 16:00:00,2019-03-24 16:15:00
160,2,0,2,0.0017104852296862846,2019-03-24 16:00:00,2019-03-24 16:15:00
162,10,5,5,0.004642615792846146,2019-03-24 16:00:00,2019-03-24 16:15:00
164,19,13,6,0.009549153352133488,2019-03-24 16:00:00,2019-03-24 16:15:00
168,28,18,10,0.041059073539524114,2019-03-24 16:00:00,2019-03-24 16:15:00
169,17,10,7,0.02487844208707005,2019-03-24 16:00:00,2019-03-24 16:15:00
170,7,4,3,0.0090317020346196,2019-03-24 16:00:00,2019-03-24 16:15:00
171,8,5,3,0.0070957431718398165,2019-03-24 16:00:00,2019-03-24 16:15:00
172,11,5,6,0.0059134328035712405,2019-03-24 16:00:00,2019-03-24 16:15:00
173,4,1,3,0.0026396428186286746,2019-03-24 16:00:00,2019-03-24 16:15:00
175,2,1,1,0.011389479308888515,2019-03-24 16:00:00,2019-03-24 16:15:00
177,12,4,8,0.0029748303614462843,2019-03-24 16:00:00,2019-03-24 16:15:00
189,7,2,5,0.0025916863457109067,2019-03-24 16:00:00,2019-03-24 16:15:00
190,11,7,4,0.00798189096349843,2019-03-24 16:00:00,2019-03-24 16:15:00
191,17,7,10,0.007828337306715307,2019-03-24 16:00:00,2019-03-24 16:15:00
196,4,2,2,0.004093595870376412,2019-03-24 16:00:00,2019-03-24 16:15:00
197,12,10,2,0.03300289582145201,2019-03-24 16:00:00,2019-03-24 16:15:00
199,6,2,4,0.0029748303614462843,2019-03-24 16:00:00,2019-03-24 16:15:00
200,4,2,2,0.011389479308888515,2019-03-24 16:00:00,2019-03-24 16:15:00
201,1,1,0,0.0025521224254125147,2019-03-24 16:00:00,2019-03-24 16:15:00
203,22,13,9,0.013454501590568158,2019-03-24 16:00:00,2019-03-24 16:15:00
1,5,2,3,0.0032462657296654434,2019-03-24 16:15:00,2019-03-24 16:30:00
2,34,16,18,0.02930078961975234,2019-03-24 16:15:00,2019-03-24 16:30:00
5,8,1,7,0.0026969518619892044,2019-03-24 16:15:00,2019-03-24 16:30:00
10,4,0,4,0.0017787052499289137,2019-03-24 16:15:00,2019-03-24 16:30:00
11,10,4,6,0.007042577036994967,2019-03-24 16:15:00,2019-03-24 16:30:00
15,21,8,13,0.006762194487464684,2019-03-24 16:15:00,2019-03-24 16:30:00
16,21,9,12,0.00785718332901909,2019-03-24 16:15:00,2019-03-24 16:30:00
18,13,11,2,0.011218782715227171,2019-03-24 16:15:00,2019-03-24 16:30:00
19,9,9,0,0.016044302916147127,2019-03-24 16:15:00,2019-03-24 16:30:00
20,12,7,5,0.007905428710290494,2019-03-24 16:15:00,2019-03-24 16:30:00
23,26,9,17,0.010952879226151225,2019-03-24 16:15:00,2019-03-24 16:30:00
26,13,7,6,0.015462830897968172,2019-03-24 16:15:00,2019-03-24 16:30:00
27,7,1,6,0.0020722932966717104,2019-03-24 16:15:00,2019-03-24 16:30:00
28,5,2,3,0.01014194824750211,2019-03-24 16:15:00,2019-03-24 16:30:00
30,3,3,0,0.003801017286478562,2019-03-24 16:15:00,2019-03-24 16:30:00
35,5,3,2,0.026532937685244323,2019-03-24 16:15:00,2019-03-24 16:30:00
37,2,2,0,0.003689724081476005,2019-03-24 16:15:00,2019-03-24 16:30:00
40,4,0,4,0.0017787052499289137,2019-03-24 16:15:00,2019-03-24 16:30:00
41,16,12,4,0.011167185915376864,2019-03-24 16:15:00,2019-03-24 16:30:00
46,2,2,0,0.002507371183325631,2019-03-24 16:15:00,2019-03-24 16:30:00
57,9,5,4,0.011083624213047915,2019-03-24 16:15:00,2019-03-24 16:30:00
58,12,3,9,0.004180877224969293,2019-03-24 16:15:00,2019-03-24 16:30:00
61,9,8,1,0.00645752526054408,2019-03-24 16:15:00,2019-03-24 16:30:00
62,17,9,8,0.00944481667240836,2019-03-24 16:15:00,2019-03-24 16:30:00
64,5,0,5,0.0017787052499289137,2019-03-24 16:15:00,2019-03-24 16:30:00
66,6,3,3,0.008097690775121149,2019-03-24 16:15:00,2019-03-24 16:30:00
67,18,10,8,0.029920413158143113,2019-03-24 16:15:00,2019-03-24 16:30:00
68,6,3,3,0.007848880545829943,2019-03-24 16:15:00,2019-03-24 16:30:00
69,20,15,5,0.01771994267587089,2019-03-24 16:15:00,2019-03-24 16:30:00
70,4,1,3,0.002818399076235596,2019-03-24 16:15:00,2019-03-24 16:30:00
71,1,0,1,0.0017787052499289137,2019-03-24 16:15:00,2019-03-24 16:30:00
74,12,5,7,0.004528054416924733,2019-03-24 16:15:00,2019-03-24 16:30:00
75,12,7,5,0.009541478093914719,2019-03-24 16:15:00,2019-03-24 16:30:00
79,5,4,1,0.004905184386342571,2019-03-24 16:15:00,2019-03-24 16:30:00
80,10,5,5,0.008679263260385144,2019-03-24 16:15:00,2019-03-24 16:30:00
85,5,5,0,0.012523536068589162,2019-03-24 16:15:00,2019-03-24 16:30:00
86,1,1,0,0.0023285750833280773,2019-03-24 16:15:00,2019-03-24 16:30:00
87,8,3,5,0.0036302173436413964,2019-03-24 16:15:00,2019-03-24 16:30:00
88,11,6,5,0.0056642939273871835,2019-03-24 16:15:00,2019-03-24 16:30:00
89,10,4,6,0.005001153010304481,2019-03-24 16:15:00,2019-03-24 16:30:00
90,23,11,12,0.011709863603170747,2019-03-24 16:15:00,2019-03-24 16:30:00
99,1,1,0,0.002698550499450948,2019-03-24 16:15:00,2019-03-24 16:30:00
101,6,3,3,0.01183650966251111,2019-03-24 16:15:00,2019-03-24 16:30:00
104,11,5,6,0.006381667210764557,2019-03-24 16:15:00,2019-03-24 16:30:00
106,9,4,5,0.006716070833162203,2019-03-24 16:15:00,2019-03-24 16:30:00
108,6,4,2,0.016140849602634785,2019-03-24 16:15:00,2019-03-24 16:30:00
109,18,10,8,0.012454477191715935,2019-03-24 16:15:00,2019-03-24 16:30:00
110,10,5,5,0.0053446408554504166,2019-03-24 16:15:00,2019-03-24 16:30:00
111,9,2,7,0.0034581441608050557,2019-03-24 16:15:00,2019-03-24 16:30:00
112,15,7,8,0.009519305439221502,2019-03-24 16:15:00,2019-03-24 16:30:00
114,14,7,7,0.005026704951304216,2019-03-24 16:15:00,2019-03-24 16:30:00
115,25,10,15,0.00974039545380937,2019-03-24 16:15:00,2019-03-24 16:30:00
116,9,4,5,0.004967786190104428,2019-03-24 16:15:00,2019-03-24 16:30:00
118,5,2,3,0.0036691388778682613,2019-03-24 16:15:00,2019-03-24 16:30:00
119,20,12,8,0.016180459157221206,2019-03-24 16:15:00,2019-03-24 16:30:00
120,5,3,2,0.003674670399206306,2019-03-24 16:15:00,2019-03-24 16:30:00
122,6,3,3,0.005513833658661494,2019-03-24 16:15:00,2019-03-24 16:30:00
126,12,5,7,0.007561165376572325,2019-03-24 16:15:00,2019-03-24 16:30:00
127,6,5,1,0.007813357892006358,2019-03-24 16:15:00,2019-03-24 16:30:00
135,5,0,5,0.0017787052499289137,2019-03-24 16:15:00,2019-03-24 16:30:00
137,47,27,20,0.023967363534229482,2019-03-24 16:15:00,2019-03-24 16:30:00
138,21,11,10,0.011118768301067556,2019-03-24 16:15:00,2019-03-24 16:30:00
140,5,3,2,0.008737486173402503,2019-03-24 16:15:00,2019-03-24 16:30:00
141,12,5,7,0.004785684282715034,2019-03-24 16:15:00,2019-03-24 16:30:00
147,5,1,4,0.0022587012641025203,2019-03-24 16:15:00,2019-03-24 16:30:00
151,9,2,7,0.00430525338345179,2019-03-24 16:15:00,2019-03-24 16:30:00
153,7,3,4,0.00432305623429509,2019-03-24 16:15:00,2019-03-24 16:30:00
154,1,1,0,0.0027830694250903093,2019-03-24 16:15:00,2019-03-24 16:30:00
157,8,5,3,0.03519984978376196,2019-03-24 16:15:00,2019-03-24 16:30:00
158,7,1,6,0.0020722932966717104,2019-03-24 16:15:00,2019-03-24 16:30:00
159,3,3,0,0.0033472152756645803,2019-03-24 16:15:00,2019-03-24 16:30:00
160,6,1,5,0.0021430382166272724,2019-03-24 16:15:00,2019-03-24 16:30:00
162,12,6,6,0.005736842584977363,2019-03-24 16:15:00,2019-03-24 16:30:00
164,18,9,9,0.010632843628746128,2019-03-24 16:15:00,2019-03-24 16:30:00
168,35,18,17,0.017842501393381657,2019-03-24 16:15:00,2019-03-24 16:30:00
169,25,12,13,0.01284090690829838,2019-03-24 16:15:00,2019-03-24 16:30:00
170,9,6,3,0.012606189975490126,2019-03-24 16:15:00,2019-03-24 16:30:00
171,9,5,4,0.004671290413319871,2019-03-24 16:15:00,2019-03-24 16:30:00
172,7,3,4,0.00934007547518179,2019-03-24 16:15:00,2019-03-24 16:30:00
173,4,2,2,0.005217504287766018,2019-03-24 16:15:00,2019-03-24 16:30:00
177,8,2,6,0.0024819604891439663,2019-03-24 16:15:00,2019-03-24 16:30:00
189,2,0,2,0.0017787052499289137,2019-03-24 16:15:00,2019-03-24 16:30:00
190,11,5,6,0.006751628569053267,2019-03-24 16:15:00,2019-03-24 16:30:00
191,15,8,7,0.00968870116622347,2019-03-24 16:15:00,2019-03-24 16:30:00
196,10,5,5,0.008363766816127362,2019-03-24 16:15:00,2019-03-24 16:30:00
197,9,7,2,0.0363494284751625,2019-03-24 16:15:00,2019-03-24 16:30:00
199,5,2,3,0.004105019431668567,2019-03-24 16:15:00,2019-03-24 16:30:00
200,2,1,1,0.01183650966251111,2019-03-24 16:15:00,2019-03-24 16:30:00
201,3,2,1,0.015695238501828305,2019-03-24 16:15:00,2019-03-24 16:30:00
202,2,0,2,0.0017787052499289137,2019-03-24 16:15:00,2019-03-24 16:30:00
203,23,14,9,0.022390297373268135,2019-03-24 16:15:00,2019-03-24 16:30:00
1,9,5,4,0.0057966316201770425,2019-03-24 16:30:00,2019-03-24 16:45:00
2,32,19,13,0.02907074646173894,2019-03-24 16:30:00,2019-03-24 16:45:00
5,7,0,7,0.0016365859673132758,2019-03-24 16:30:00,2019-03-24 16:45:00
10,5,0,5,0.0016365859673132758,2019-03-24 16:30:00,2019-03-24 16:45:00
11,8,4,4,0.005242336975725733,2019-03-24 16:30:00,2019-03-24 16:45:00
15,13,3,10,0.005016464236743036,2019-03-24 16:30:00,2019-03-24 16:45:00
16,9,4,5,0.0039608650796517635,2019-03-24 16:30:00,2019-03-24 16:45:00
18,16,12,4,0.012053849301971082,2019-03-24 16:30:00,2019-03-24 16:45:00
19,11,9,2,0.02189989483970541,2019-03-24 16:30:00,2019-03-24 16:45:00
20,10,3,7,0.0036117435587428256,2019-03-24 16:30:00,2019-03-24 16:45:00
23,20,9,11,0.00946007759857729,2019-03-24 16:30:00,2019-03-24 16:45:00
26,13,7,6,0.008329678707729524,2019-03-24 16:30:00,2019-03-24 16:45:00
27,5,1,4,0.0020782200354467206,2019-03-24 16:30:00,2019-03-24 16:45:00
28,4,1,3,0.0038587324552326902,2019-03-24 16:30:00,2019-03-24 16:45:00
30,3,2,1,0.0026139984602494655,2019-03-24 16:30:00,2019-03-24 16:45:00
35,8,4,4,0.010371353994307532,2019-03-24 16:30:00,2019-03-24 16:45:00
37,1,1,0,0.002943939929753937,2019-03-24 16:30:00,2019-03-24 16:45:00
40,3,1,2,0.002256179887741307,2019-03-24 16:30:00,2019-03-24 16:45:00
41,18,12,6,0.010482585157164328,2019-03-24 16:30:00,2019-03-24 16:45:00
46,2,2,0,0.002332153073499117,2019-03-24 16:30:00,2019-03-24 16:45:00
50,1,1,0,0.0024671264233191363,2019-03-24 16:30:00,2019-03-24 16:45:00
57,10,6,4,0.020832984600211994,2019-03-24 16:30:00,2019-03-24 16:45:00
58,19,4,15,0.002116292358466914,2019-03-24 16:30:00,2019-03-24 16:45:00
61,12,10,2,0.04189451343659482,2019-03-24 16:30:00,2019-03-24 16:45:00
62,13,8,5,0.012200076352595778,2019-03-24 16:30:00,2019-03-24 16:45:00
64,2,0,2,0.0016365859673132758,2019-03-24 16:30:00,2019-03-24 16:45:00
66,3,2,1,0.021076000704401958,2019-03-24 16:30:00,2019-03-24 16:45:00
67,15,9,6,0.024061672741746382,2019-03-24 16:30:00,2019-03-24 16:45:00
68,9,7,2,0.007066620652135815,2019-03-24 16:30:00,2019-03-24 16:45:00
69,23,15,8,0.01439070525534511,2019-03-24 16:30:00,2019-03-24 16:45:00
70,5,1,4,0.0021002973714371698,2019-03-24 16:30:00,2019-03-24 16:45:00
71,1,0,1,0.0016365859673132758,2019-03-24 16:30:00,2019-03-24 16:45:00
74,4,1,3,0.0022836343785759185,2019-03-24 16:30:00,2019-03-24 16:45:00
75,10,5,5,0.011135480373399858,2019-03-24 16:30:00,2019-03-24 16:45:00
79,4,4,0,0.004712478022010637,2019-03-24 16:30:00,2019-03-24 16:45:00
80,12,6,6,0.009435602291715058,2019-03-24 16:30:00,2019-03-24 16:45:00
85,5,5,0,0.0065159876839613875,2019-03-24 16:30:00,2019-03-24 16:45:00
87,6,3,3,0.010906807157012735,2019-03-24 16:30:00,2019-03-24 16:45:00
88,6,3,3,0.004221751725904338,2019-03-24 16:30:00,2019-03-24 16:45:00
89,7,4,3,0.0057280192523427,2019-03-24 16:30:00,2019-03-24 16:45:00
90,15,6,9,0.008100600498984133,2019-03-24 16:30:00,2019-03-24 16:45:00
101,6,3,3,0.010906807157012735,2019-03-24 16:30:00,2019-03-24 16:45:00
104,15,5,10,0.0072880455517865496,2019-03-24 16:30:00,2019-03-24 16:45:00
106,6,3,3,0.0069874454592003974,2019-03-24 16:30:00,2019-03-24 16:45:00
108,12,8,4,0.013298994071989517,2019-03-24 16:30:00,2019-03-24 16:45:00
109,22,13,9,0.010023798420591173,2019-03-24 16:30:00,2019-03-24 16:45:00
110,9,4,5,0.0034337152240641214,2019-03-24 16:30:00,2019-03-24 16:45:00
111,11,3,8,0.0029624086406877404,2019-03-24 16:30:00,2019-03-24 16:45:00
112,13,8,5,0.009678839939289603,2019-03-24 16:30:00,2019-03-24 16:45:00
114,14,5,9,0.006970406523619024,2019-03-24 16:30:00,2019-03-24 16:45:00
115,21,7,14,0.008047640475852963,2019-03-24 16:30:00,2019-03-24 16:45:00
116,12,6,6,0.005776906815535212,2019-03-24 16:30:00,2019-03-24 16:45:00
118,3,0,3,0.0016365859673132758,2019-03-24 16:30:00,2019-03-24 16:45:00
119,24,12,12,0.012538174322626676,2019-03-24 16:30:00,2019-03-24 16:45:00
120,5,3,2,0.004135194375511234,2019-03-24 16:30:00,2019-03-24 16:45:00
122,9,4,5,0.0051150391606235145,2019-03-24 16:30:00,2019-03-24 16:45:00
126,6,3,3,0.003627927392630432,2019-03-24 16:30:00,2019-03-24 16:45:00
127,9,5,4,0.009021536333201918,2019-03-24 16:30:00,2019-03-24 16:45:00
137,47,24,23,0.03536675291463058,2019-03-24 16:30:00,2019-03-24 16:45:00
138,22,14,8,0.020226563790938516,2019-03-24 16:30:00,2019-03-24 16:45:00
140,4,3,1,0.03602379876307168,2019-03-24 16:30:00,2019-03-24 16:45:00
141,12,4,8,0.003390971047286715,2019-03-24 16:30:00,2019-03-24 16:45:00
147,5,2,3,0.0047254515435959125,2019-03-24 16:30:00,2019-03-24 16:45:00
151,2,2,0,0.004100511226230441,2019-03-24 16:30:00,2019-03-24 16:45:00
153,8,2,6,0.002586461074388564,2019-03-24 16:30:00,2019-03-24 16:45:00
154,3,3,0,0.00367449406555009,2019-03-24 16:30:00,2019-03-24 16:45:00
157,4,3,1,0.04665683960807466,2019-03-24 16:30:00,2019-03-24 16:45:00
158,5,2,3,0.004576683899827954,2019-03-24 16:30:00,2019-03-24 16:45:00
159,8,4,4,0.005741705935929167,2019-03-24 16:30:00,2019-03-24 16:45:00
160,4,0,4,0.0016365859673132758,2019-03-24 16:30:00,2019-03-24 16:45:00
162,10,4,6,0.0041180231738266945,2019-03-24 16:30:00,2019-03-24 16:45:00
164,24,14,10,0.00939494618365826,2019-03-24 16:30:00,2019-03-24 16:45:00
168,16,9,7,0.008685122307161144,2019-03-24 16:30:00,2019-03-24 16:45:00
169,11,3,8,0.004756808729814141,2019-03-24 16:30:00,2019-03-24 16:45:00
170,11,3,8,0.0035586166881110617,2019-03-24 16:30:00,2019-03-24 16:45:00
171,9,2,7,0.002161548233157461,2019-03-24 16:30:00,2019-03-24 16:45:00
172,8,3,5,0.007406414266953732,2019-03-24 16:30:00,2019-03-24 16:45:00
173,4,3,1,0.004360005725119671,2019-03-24 16:30:00,2019-03-24 16:45:00
177,6,2,4,0.002846303650175094,2019-03-24 16:30:00,2019-03-24 16:45:00
189,1,0,1,0.0016365859673132758,2019-03-24 16:30:00,2019-03-24 16:45:00
190,9,6,3,0.0055942175850110494,2019-03-24 16:30:00,2019-03-24 16:45:00
191,13,6,7,0.007886538682309754,2019-03-24 16:30:00,2019-03-24 16:45:00
196,9,3,6,0.00586185568997636,2019-03-24 16:30:00,2019-03-24 16:45:00
197,8,7,1,0.06383387805239671,2019-03-24 16:30:00,2019-03-24 16:45:00
199,5,2,3,0.0037769297640681244,2019-03-24 16:30:00,2019-03-24 16:45:00
200,2,1,1,0.010906807157012735,2019-03-24 16:30:00,2019-03-24 16:45:00
201,7,3,4,0.006154004884493969,2019-03-24 16:30:00,2019-03-24 16:45:00
203,13,8,5,0.006252102891840913,2019-03-24 16:30:00,2019-03-24 16:45:00
1,12,7,5,0.009521547494560273,2019-03-24 16:45:00,2019-03-24 17:00:00
2,20,12,8,0.015061895287477516,2019-03-24 16:45:00,2019-03-24 17:00:00
5,3,0,3,0.0017744194313054377,2019-03-24 16:45:00,2019-03-24 17:00:00
10,6,1,5,0.0021471017556958546,2019-03-24 16:45:00,2019-03-24 17:00:00
11,8,5,3,0.00909140657287997,2019-03-24 16:45:00,2019-03-24 17:00:00
15,12,5,7,0.009068331143005856,2019-03-24 16:45:00,2019-03-24 17:00:00
16,7,5,2,0.004692780603613548,2019-03-24 16:45:00,2019-03-24 17:00:00
18,20,15,5,0.020924980258469963,2019-03-24 16:45:00,2019-03-24 17:00:00
19,12,7,5,0.009744335769557948,2019-03-24 16:45:00,2019-03-24 17:00:00
20,6,3,3,0.003058986406765927,2019-03-24 16:45:00,2019-03-24 17:00:00
21,1,0,1,0.0017744194313054377,2019-03-24 16:45:00,2019-03-24 17:00:00
23,20,11,9,0.02521281897756077,2019-03-24 16:45:00,2019-03-24 17:00:00
26,9,5,4,0.006710901899191298,2019-03-24 16:45:00,2019-03-24 17:00:00
27,3,1,2,0.0030860298216814405,2019-03-24 16:45:00,2019-03-24 17:00:00
28,2,1,1,0.01181078657151697,2019-03-24 16:45:00,2019-03-24 17:00:00
30,2,1,1,0.01181078657151697,2019-03-24 16:45:00,2019-03-24 17:00:00
35,9,4,5,0.005721282587076517,2019-03-24 16:45:00,2019-03-24 17:00:00
37,2,1,1,0.0028067806189091115,2019-03-24 16:45:00,2019-03-24 17:00:00
40,4,1,3,0.0019115379389213992,2019-03-24 16:45:00,2019-03-24 17:00:00
41,13,10,3,0.009170797879599983,2019-03-24 16:45:00,2019-03-24 17:00:00
46,3,3,0,0.0038684756996709103,2019-03-24 16:45:00,2019-03-24 17:00:00
50,2,2,0,0.0035973166082248144,2019-03-24 16:45:00,2019-03-24 17:00:00
57,13,9,4,0.025273346784185087,2019-03-24 16:45:00,2019-03-24 17:00:00
58,13,3,10,0.004384115303140085,2019-03-24 16:45:00,2019-03-24 17:00:00
61,9,2,7,0.0023435978434428106,2019-03-24 16:45:00,2019-03-24 17:00:00
62,12,9,3,0.020898668806754048,2019-03-24 16:45:00,2019-03-24 17:00:00
66,3,2,1,0.021898844836924256,2019-03-24 16:45:00,2019-03-24 17:00:00
67,19,13,6,0.01836323193733635,2019-03-24 16:45:00,2019-03-24 17:00:00
68,12,6,6,0.009362388416593863,2019-03-24 16:45:00,2019-03-24 17:00:00
69,18,10,8,0.014344260604400479,2019-03-24 16:45:00,2019-03-24 17:00:00
70,9,1,8,0.0027471261438560897,2019-03-24 16:45:00,2019-03-24 17:00:00
74,6,3,3,0.0097371056862189,2019-03-24 16:45:00,2019-03-24 17:00:00
75,6,4,2,0.008176671253728944,2019-03-24 16:45:00,2019-03-24 17:00:00
79,2,2,0,0.0022765612469446694,2019-03-24 16:45:00,2019-03-24 17:00:00
80,5,2,3,0.004095037962773962,2019-03-24 16:45:00,2019-03-24 17:00:00
85,4,2,2,0.005477549296552513,2019-03-24 16:45:00,2019-03-24 17:00:00
86,2,0,2,0.0017744194313054377,2019-03-24 16:45:00,2019-03-24 17:00:00
87,3,2,1,0.018630102936769397,2019-03-24 16:45:00,2019-03-24 17:00:00
88,8,4,4,0.0057708592349821845,2019-03-24 16:45:00,2019-03-24 17:00:00
89,9,5,4,0.009934419671892554,2019-03-24 16:45:00,2019-03-24 17:00:00
90,12,4,8,0.0030860298216814405,2019-03-24 16:45:00,2019-03-24 17:00:00
101,2,1,1,0.01181078657151697,2019-03-24 16:45:00,2019-03-24 17:00:00
104,11,0,11,0.0017744194313054377,2019-03-24 16:45:00,2019-03-24 17:00:00
106,5,2,3,0.004095037962773962,2019-03-24 16:45:00,2019-03-24 17:00:00
108,23,13,10,0.017656469581372177,2019-03-24 16:45:00,2019-03-24 17:00:00
109,22,7,15,0.009756818811047277,2019-03-24 16:45:00,2019-03-24 17:00:00
110,12,4,8,0.004910259979322289,2019-03-24 16:45:00,2019-03-24 17:00:00
111,6,0,6,0.0017744194313054377,2019-03-24 16:45:00,2019-03-24 17:00:00
112,13,11,2,0.03225095028087838,2019-03-24 16:45:00,2019-03-24 17:00:00
114,9,3,6,0.003022384675191305,2019-03-24 16:45:00,2019-03-24 17:00:00
115,16,4,12,0.006911552414124425,2019-03-24 16:45:00,2019-03-24 17:00:00
116,12,7,5,0.012646641568555559,2019-03-24 16:45:00,2019-03-24 17:00:00
118,1,1,0,0.0020663187016416226,2019-03-24 16:45:00,2019-03-24 17:00:00
119,23,12,11,0.015446945662193987,2019-03-24 16:45:00,2019-03-24 17:00:00
120,5,3,2,0.00515757442086419,2019-03-24 16:45:00,2019-03-24 17:00:00
122,10,5,5,0.01181078657151697,2019-03-24 16:45:00,2019-03-24 17:00:00
126,5,3,2,0.007962699808721775,2019-03-24 16:45:00,2019-03-24 17:00:00
127,4,1,3,0.0032006049663122235,2019-03-24 16:45:00,2019-03-24 17:00:00
137,34,15,19,0.023072801803785237,2019-03-24 16:45:00,2019-03-24 17:00:00
138,17,9,8,0.012196441610414215,2019-03-24 16:45:00,2019-03-24 17:00:00
140,2,1,1,0.01181078657151697,2019-03-24 16:45:00,2019-03-24 17:00:00
141,9,3,6,0.006321388550977468,2019-03-24 16:45:00,2019-03-24 17:00:00
151,6,4,2,0.033210318260063376,2019-03-24 16:45:00,2019-03-24 17:00:00
153,5,2,3,0.0039052847301441944,2019-03-24 16:45:00,2019-03-24 17:00:00
154,5,5,0,0.01089496318226131,2019-03-24 16:45:00,2019-03-24 17:00:00
157,7,4,3,0.005903617252778919,2019-03-24 16:45:00,2019-03-24 17:00:00
158,11,6,5,0.012815084717899505,2019-03-24 16:45:00,2019-03-24 17:00:00
159,9,5,4,0.027408116277090794,2019-03-24 16:45:00,2019-03-24 17:00:00
160,7,1,6,0.0020672957736003854,2019-03-24 16:45:00,2019-03-24 17:00:00
162,10,4,6,0.007228844257334288,2019-03-24 16:45:00,2019-03-24 17:00:00
164,27,14,13,0.012044004644787444,2019-03-24 16:45:00,2019-03-24 17:00:00
168,13,8,5,0.011296004810084352,2019-03-24 16:45:00,2019-03-24 17:00:00
169,4,1,3,0.00247596716369667,2019-03-24 16:45:00,2019-03-24 17:00:00
170,11,5,6,0.00870789673478966,2019-03-24 16:45:00,2019-03-24 17:00:00
171,9,3,6,0.0030860298216814405,2019-03-24 16:45:00,2019-03-24 17:00:00
172,6,3,3,0.0051593488455416205,2019-03-24 16:45:00,2019-03-24 17:00:00
173,7,4,3,0.006579254585132815,2019-03-24 16:45:00,2019-03-24 17:00:00
177,4,1,3,0.00247596716369667,2019-03-24 16:45:00,2019-03-24 17:00:00
189,4,3,1,0.004432702494926117,2019-03-24 16:45:00,2019-03-24 17:00:00
190,4,4,0,0.006134193227779423,2019-03-24 16:45:00,2019-03-24 17:00:00
191,16,5,11,0.005067298253754343,2019-03-24 16:45:00,2019-03-24 17:00:00
196,10,4,6,0.0050927731772193304,2019-03-24 16:45:00,2019-03-24 17:00:00
197,6,6,0,0.01085957167078384,2019-03-24 16:45:00,2019-03-24 17:00:00
199,4,1,3,0.005158968437804664,2019-03-24 16:45:00,2019-03-24 17:00:00
200,2,1,1,0.01181078657151697,2019-03-24 16:45:00,2019-03-24 17:00:00
201,6,3,3,0.007898132680971802,2019-03-24 16:45:00,2019-03-24 17:00:00
202,2,2,0,0.004161975235762443,2019-03-24 16:45:00,2019-03-24 17:00:00
203,17,10,7,0.009720380642831893,2019-03-24 16:45:00,2019-03-24 17:00:00
1,6,4,2,0.025282920864266135,2019-03-24 17:00:00,2019-03-24 17:15:00
2,13,8,5,0.009211609313679633,2019-03-24 17:00:00,2019-03-24 17:15:00
5,2,0,2,0.0018410159147342507,2019-03-24 17:00:00,2019-03-24 17:15:00
10,6,1,5,0.002887580589693693,2019-03-24 17:00:00,2019-03-24 17:15:00
11,7,5,2,0.022566268456645593,2019-03-24 17:00:00,2019-03-24 17:15:00
15,7,5,2,0.009311993371050018,2019-03-24 17:00:00,2019-03-24 17:15:00
16,14,7,7,0.016598593714448846,2019-03-24 17:00:00,2019-03-24 17:15:00
18,13,8,5,0.010614562358348352,2019-03-24 17:00:00,2019-03-24 17:15:00
19,8,4,4,0.005318085356770999,2019-03-24 17:00:00,2019-03-24 17:15:00
20,3,0,3,0.0018410159147342507,2019-03-24 17:00:00,2019-03-24 17:15:00
21,1,0,1,0.0018410159147342507,2019-03-24 17:00:00,2019-03-24 17:15:00
23,21,7,14,0.012626015607605696,2019-03-24 17:00:00,2019-03-24 17:15:00
26,10,5,5,0.006360152523848051,2019-03-24 17:00:00,2019-03-24 17:15:00
27,5,3,2,0.006963653591987072,2019-03-24 17:00:00,2019-03-24 17:15:00
28,4,3,1,0.0039136708727316736,2019-03-24 17:00:00,2019-03-24 17:15:00
30,1,1,0,0.005167967560655034,2019-03-24 17:00:00,2019-03-24 17:15:00
35,6,4,2,0.03928815546568442,2019-03-24 17:00:00,2019-03-24 17:15:00
37,2,1,1,0.002440808803188981,2019-03-24 17:00:00,2019-03-24 17:15:00
40,4,0,4,0.0018410159147342507,2019-03-24 17:00:00,2019-03-24 17:15:00
41,6,3,3,0.004758275685925088,2019-03-24 17:00:00,2019-03-24 17:15:00
46,3,3,0,0.004031899563300237,2019-03-24 17:00:00,2019-03-24 17:15:00
50,3,3,0,0.00732808685365276,2019-03-24 17:00:00,2019-03-24 17:15:00
57,11,8,3,0.010573298621600266,2019-03-24 17:00:00,2019-03-24 17:15:00
58,12,5,7,0.008617426637974818,2019-03-24 17:00:00,2019-03-24 17:15:00
61,6,1,5,0.003313650446801446,2019-03-24 17:00:00,2019-03-24 17:15:00
62,16,11,5,0.01921782002676671,2019-03-24 17:00:00,2019-03-24 17:15:00
66,4,3,1,0.0210577783990341,2019-03-24 17:00:00,2019-03-24 17:15:00
67,23,12,11,0.010568393246084721,2019-03-24 17:00:00,2019-03-24 17:15:00
68,19,7,12,0.0037537335814752815,2019-03-24 17:00:00,2019-03-24 17:15:00
69,16,7,9,0.007394492455111771,2019-03-24 17:00:00,2019-03-24 17:15:00
70,9,4,5,0.0059886753913982425,2019-03-24 17:00:00,2019-03-24 17:15:00
74,6,4,2,0.023113719132804186,2019-03-24 17:00:00,2019-03-24 17:15:00
75,8,5,3,0.011311076104779494,2019-03-24 17:00:00,2019-03-24 17:15:00
79,2,2,0,0.0025927681731778523,2019-03-24 17:00:00,2019-03-24 17:15:00
80,4,2,2,0.012259011182695234,2019-03-24 17:00:00,2019-03-24 17:15:00
86,2,0,2,0.0018410159147342507,2019-03-24 17:00:00,2019-03-24 17:15:00
87,6,3,3,0.005489779052621397,2019-03-24 17:00:00,2019-03-24 17:15:00
88,6,4,2,0.007607534924645915,2019-03-24 17:00:00,2019-03-24 17:15:00
89,3,1,2,0.0036457572387341253,2019-03-24 17:00:00,2019-03-24 17:15:00
90,16,9,7,0.015104717448906943,2019-03-24 17:00:00,2019-03-24 17:15:00
99,2,0,2,0.0018410159147342507,2019-03-24 17:00:00,2019-03-24 17:15:00
101,4,3,1,0.02154159147211956,2019-03-24 17:00:00,2019-03-24 17:15:00
104,6,0,6,0.0018410159147342507,2019-03-24 17:00:00,2019-03-24 17:15:00
106,5,2,3,0.004248768933431544,2019-03-24 17:00:00,2019-03-24 17:15:00
108,18,10,8,0.008765406480776377,2019-03-24 17:00:00,2019-03-24 17:15:00
109,23,11,12,0.010537424800005092,2019-03-24 17:00:00,2019-03-24 17:15:00
110,20,9,11,0.01220822400637412,2019-03-24 17:00:00,2019-03-24 17:15:00
111,3,1,2,0.002675096652239974,2019-03-24 17:00:00,2019-03-24 17:15:00
112,14,10,4,0.01538204036655908,2019-03-24 17:00:00,2019-03-24 17:15:00
114,6,3,3,0.00605972137435813,2019-03-24 17:00:00,2019-03-24 17:15:00
115,13,9,4,0.020135866496272376,2019-03-24 17:00:00,2019-03-24 17:15:00
116,12,8,4,0.035864319522613354,2019-03-24 17:00:00,2019-03-24 17:15:00
118,2,2,0,0.0045763551355327125,2019-03-24 17:00:00,2019-03-24 17:15:00
119,26,12,14,0.015301487182219707,2019-03-24 17:00:00,2019-03-24 17:15:00
120,3,1,2,0.003015115221834172,2019-03-24 17:00:00,2019-03-24 17:15:00
122,10,5,5,0.012259011182695234,2019-03-24 17:00:00,2019-03-24 17:15:00
126,6,2,4,0.003201863324901502,2019-03-24 17:00:00,2019-03-24 17:15:00
127,2,0,2,0.0018410159147342507,2019-03-24 17:00:00,2019-03-24 17:15:00
135,1,1,0,0.00511014109755065,2019-03-24 17:00:00,2019-03-24 17:15:00
137,41,18,23,0.01622738036422542,2019-03-24 17:00:00,2019-03-24 17:15:00
138,20,11,9,0.015589631551557456,2019-03-24 17:00:00,2019-03-24 17:15:00
140,3,1,2,0.00339062480345427,2019-03-24 17:00:00,2019-03-24 17:15:00
141,8,3,5,0.006009004738527861,2019-03-24 17:00:00,2019-03-24 17:15:00
153,6,4,2,0.011082286331782088,2019-03-24 17:00:00,2019-03-24 17:15:00
154,2,2,0,0.005935935528926005,2019-03-24 17:00:00,2019-03-24 17:15:00
157,6,4,2,0.006652941179480218,2019-03-24 17:00:00,2019-03-24 17:15:00
158,5,2,3,0.003877441389900284,2019-03-24 17:00:00,2019-03-24 17:15:00
159,9,5,4,0.009795341621344923,2019-03-24 17:00:00,2019-03-24 17:15:00
160,5,0,5,0.0018410159147342507,2019-03-24 17:00:00,2019-03-24 17:15:00
162,11,4,7,0.004102195524322156,2019-03-24 17:00:00,2019-03-24 17:15:00
164,29,11,18,0.01329604144195292,2019-03-24 17:00:00,2019-03-24 17:15:00
168,17,11,6,0.010259065389787578,2019-03-24 17:00:00,2019-03-24 17:15:00
169,4,1,3,0.0025688973438599393,2019-03-24 17:00:00,2019-03-24 17:15:00
170,10,2,8,0.0026234743606506745,2019-03-24 17:00:00,2019-03-24 17:15:00
171,9,4,5,0.004906022984461288,2019-03-24 17:00:00,2019-03-24 17:15:00
172,6,3,3,0.004226633678331289,2019-03-24 17:00:00,2019-03-24 17:15:00
173,13,8,5,0.02248989423572375,2019-03-24 17:00:00,2019-03-24 17:15:00
177,7,2,5,0.002846593964597356,2019-03-24 17:00:00,2019-03-24 17:15:00
189,4,4,0,0.008559739168566248,2019-03-24 17:00:00,2019-03-24 17:15:00
190,12,8,4,0.01778555195839517,2019-03-24 17:00:00,2019-03-24 17:15:00
191,13,4,9,0.008304400354584743,2019-03-24 17:00:00,2019-03-24 17:15:00
195,1,1,0,0.0026577286919453108,2019-03-24 17:00:00,2019-03-24 17:15:00
196,12,4,8,0.004869626964099891,2019-03-24 17:00:00,2019-03-24 17:15:00
197,9,6,3,0.012230144131518735,2019-03-24 17:00:00,2019-03-24 17:15:00
199,1,1,0,0.002521439619817876,2019-03-24 17:00:00,2019-03-24 17:15:00
201,1,1,0,0.0036457572387341253,2019-03-24 17:00:00,2019-03-24 17:15:00
202,4,2,2,0.004748216585941198,2019-03-24 17:00:00,2019-03-24 17:15:00
203,14,7,7,0.009667617729418078,2019-03-24 17:00:00,2019-03-24 17:15:00
1,6,4,2,0.02394855574133194,2019-03-24 17:15:00,2019-03-24 17:30:00
2,30,14,16,0.025015125379103876,2019-03-24 17:15:00,2019-03-24 17:30:00
5,3,0,3,0.0017717803981862042,2019-03-24 17:15:00,2019-03-24 17:30:00
10,5,1,4,0.0024445027294896287,2019-03-24 17:15:00,2019-03-24 17:30:00
11,7,5,2,0.01881793017239854,2019-03-24 17:15:00,2019-03-24 17:30:00
15,8,5,3,0.014556833679255511,2019-03-24 17:15:00,2019-03-24 17:30:00
16,14,7,7,0.014574151218031132,2019-03-24 17:15:00,2019-03-24 17:30:00
18,17,10,7,0.014106834985578947,2019-03-24 17:15:00,2019-03-24 17:30:00
19,8,3,5,0.0024922460940158568,2019-03-24 17:15:00,2019-03-24 17:30:00
20,2,0,2,0.0017717803981862042,2019-03-24 17:15:00,2019-03-24 17:30:00
23,17,8,9,0.012365475810561749,2019-03-24 17:15:00,2019-03-24 17:30:00
26,13,5,8,0.004728533763975412,2019-03-24 17:15:00,2019-03-24 17:30:00
27,10,7,3,0.007355696775630371,2019-03-24 17:15:00,2019-03-24 17:30:00
28,4,3,1,0.0036101430499000534,2019-03-24 17:15:00,2019-03-24 17:30:00
30,2,2,0,0.005648205008001303,2019-03-24 17:15:00,2019-03-24 17:30:00
35,8,5,3,0.015494664471730769,2019-03-24 17:15:00,2019-03-24 17:30:00
37,1,0,1,0.0017717803981862042,2019-03-24 17:15:00,2019-03-24 17:30:00
40,3,0,3,0.0017717803981862042,2019-03-24 17:15:00,2019-03-24 17:30:00
41,9,7,2,0.010650703223477071,2019-03-24 17:15:00,2019-03-24 17:30:00
46,3,2,1,0.0030571522018322033,2019-03-24 17:15:00,2019-03-24 17:30:00
50,3,3,0,0.008147474879896777,2019-03-24 17:15:00,2019-03-24 17:30:00
57,10,9,1,0.06608130121085931,2019-03-24 17:15:00,2019-03-24 17:30:00
58,5,2,3,0.002374210664944937,2019-03-24 17:15:00,2019-03-24 17:30:00
61,10,3,7,0.008256013219905942,2019-03-24 17:15:00,2019-03-24 17:30:00
62,12,5,7,0.010062839816506451,2019-03-24 17:15:00,2019-03-24 17:30:00
64,1,1,0,0.0031009958313915936,2019-03-24 17:15:00,2019-03-24 17:30:00
66,4,3,1,0.019599209419699885,2019-03-24 17:15:00,2019-03-24 17:30:00
67,14,6,8,0.005320307640690231,2019-03-24 17:15:00,2019-03-24 17:30:00
68,12,1,11,0.001920162869522087,2019-03-24 17:15:00,2019-03-24 17:30:00
69,12,4,8,0.005078048981951102,2019-03-24 17:15:00,2019-03-24 17:30:00
70,8,5,3,0.007139101162167867,2019-03-24 17:15:00,2019-03-24 17:30:00
71,6,3,3,0.01179620751235812,2019-03-24 17:15:00,2019-03-24 17:30:00
74,8,4,4,0.01179620751235812,2019-03-24 17:15:00,2019-03-24 17:30:00
75,11,8,3,0.013832517058937975,2019-03-24 17:15:00,2019-03-24 17:30:00
79,1,1,0,0.002022793009335676,2019-03-24 17:15:00,2019-03-24 17:30:00
80,2,1,1,0.01179620751235812,2019-03-24 17:15:00,2019-03-24 17:30:00
85,2,0,2,0.0017717803981862042,2019-03-24 17:15:00,2019-03-24 17:30:00
87,7,4,3,0.005690158735523938,2019-03-24 17:15:00,2019-03-24 17:30:00
88,5,4,1,0.006941429490845339,2019-03-24 17:15:00,2019-03-24 17:30:00
89,3,1,2,0.00348502874642285,2019-03-24 17:15:00,2019-03-24 17:30:00
90,14,9,5,0.017635442352173528,2019-03-24 17:15:00,2019-03-24 17:30:00
99,2,0,2,0.0017717803981862042,2019-03-24 17:15:00,2019-03-24 17:30:00
101,4,3,1,0.018967757215014976,2019-03-24 17:15:00,2019-03-24 17:30:00
104,6,0,6,0.0017717803981862042,2019-03-24 17:15:00,2019-03-24 17:30:00
106,6,3,3,0.01179620751235812,2019-03-24 17:15:00,2019-03-24 17:30:00
108,14,8,6,0.005458838769985921,2019-03-24 17:15:00,2019-03-24 17:30:00
109,16,10,6,0.00886881581651493,2019-03-24 17:15:00,2019-03-24 17:30:00
110,21,10,11,0.015966909734771335,2019-03-24 17:15:00,2019-03-24 17:30:00
111,4,2,2,0.0034620508275219107,2019-03-24 17:15:00,2019-03-24 17:30:00
112,15,11,4,0.014547660815720488,2019-03-24 17:15:00,2019-03-24 17:30:00
114,5,2,3,0.0040890287439999205,2019-03-24 17:15:00,2019-03-24 17:30:00
115,20,5,15,0.0062734719326102565,2019-03-24 17:15:00,2019-03-24 17:30:00
116,12,6,6,0.020251753257177655,2019-03-24 17:15:00,2019-03-24 17:30:00
118,3,2,1,0.004953423848837201,2019-03-24 17:15:00,2019-03-24 17:30:00
119,18,10,8,0.012002453661275864,2019-03-24 17:15:00,2019-03-24 17:30:00
120,1,1,0,0.0030221999249661798,2019-03-24 17:15:00,2019-03-24 17:30:00
122,10,5,5,0.01179620751235812,2019-03-24 17:15:00,2019-03-24 17:30:00
126,5,2,3,0.0040890287439999205,2019-03-24 17:15:00,2019-03-24 17:30:00
127,1,1,0,0.004641455736804666,2019-03-24 17:15:00,2019-03-24 17:30:00
133,2,0,2,0.0017717803981862042,2019-03-24 17:15:00,2019-03-24 17:30:00
135,1,1,0,0.0048636331617884585,2019-03-24 17:15:00,2019-03-24 17:30:00
137,46,21,25,0.02867526095558145,2019-03-24 17:15:00,2019-03-24 17:30:00
138,30,14,16,0.014019106049952372,2019-03-24 17:15:00,2019-03-24 17:30:00
140,6,2,4,0.004131010319178476,2019-03-24 17:15:00,2019-03-24 17:30:00
141,9,3,6,0.004620067100058115,2019-03-24 17:15:00,2019-03-24 17:30:00
147,1,0,1,0.0017717803981862042,2019-03-24 17:15:00,2019-03-24 17:30:00
151,1,0,1,0.0017717803981862042,2019-03-24 17:15:00,2019-03-24 17:30:00
153,5,3,2,0.009239044281144256,2019-03-24 17:15:00,2019-03-24 17:30:00
154,2,2,0,0.002374210664944937,2019-03-24 17:15:00,2019-03-24 17:30:00
157,6,4,2,0.007878643153605164,2019-03-24 17:15:00,2019-03-24 17:30:00
158,3,3,0,0.0059662014250103645,2019-03-24 17:15:00,2019-03-24 17:30:00
159,8,4,4,0.0039545940257330395,2019-03-24 17:15:00,2019-03-24 17:30:00
160,7,2,5,0.0037803052157739693,2019-03-24 17:15:00,2019-03-24 17:30:00
162,7,3,4,0.004888247711470958,2019-03-24 17:15:00,2019-03-24 17:30:00
164,24,9,15,0.011230901191357945,2019-03-24 17:15:00,2019-03-24 17:30:00
168,27,19,8,0.018317424116337775,2019-03-24 17:15:00,2019-03-24 17:30:00
169,4,1,3,0.002472295792241944,2019-03-24 17:15:00,2019-03-24 17:30:00
170,5,0,5,0.0017717803981862042,2019-03-24 17:15:00,2019-03-24 17:30:00
171,8,4,4,0.004958456399285822,2019-03-24 17:15:00,2019-03-24 17:30:00
172,4,1,3,0.0023371040615601676,2019-03-24 17:15:00,2019-03-24 17:30:00
173,13,8,5,0.012305568012942011,2019-03-24 17:15:00,2019-03-24 17:30:00
177,7,4,3,0.00693411863408096,2019-03-24 17:15:00,2019-03-24 17:30:00
189,4,4,0,0.0067192775917263355,2019-03-24 17:15:00,2019-03-24 17:30:00
190,12,8,4,0.02440144180340308,2019-03-24 17:15:00,2019-03-24 17:30:00
191,7,1,6,0.005699041546300549,2019-03-24 17:15:00,2019-03-24 17:30:00
195,1,1,0,0.0023371040615601676,2019-03-24 17:15:00,2019-03-24 17:30:00
196,7,2,5,0.0020685453408579696,2019-03-24 17:15:00,2019-03-24 17:30:00
197,5,2,3,0.002810740269708175,2019-03-24 17:15:00,2019-03-24 17:30:00
201,4,2,2,0.01179620751235812,2019-03-24 17:15:00,2019-03-24 17:30:00
202,6,4,2,0.008323448926846836,2019-03-24 17:15:00,2019-03-24 17:30:00
203,13,6,7,0.010295774915832293,2019-03-24 17:15:00,2019-03-24 17:30:00
1,7,4,3,0.008561404652598421,2019-03-24 17:30:00,2019-03-24 17:45:00
2,21,6,15,0.00646992723160457,2019-03-24 17:30:00,2019-03-24 17:45:00
5,3,1,2,0.0038442743520131126,2019-03-24 17:30:00,2019-03-24 17:45:00
10,4,0,4,0.001738547199557528,2019-03-24 17:30:00,2019-03-24 17:45:00
11,5,4,1,0.027080693018930856,2019-03-24 17:30:00,2019-03-24 17:45:00
15,8,3,5,0.0047563830431756595,2019-03-24 17:30:00,2019-03-24 17:45:00
16,13,7,6,0.005693412087852766,2019-03-24 17:30:00,2019-03-24 17:45:00
18,14,10,4,0.039977370259431766,2019-03-24 17:30:00,2019-03-24 17:45:00
19,9,3,6,0.003719140613182397,2019-03-24 17:30:00,2019-03-24 17:45:00
20,2,0,2,0.001738547199557528,2019-03-24 17:30:00,2019-03-24 17:45:00
21,2,2,0,0.007684081489224724,2019-03-24 17:30:00,2019-03-24 17:45:00
23,13,10,3,0.01837786670893544,2019-03-24 17:30:00,2019-03-24 17:45:00
26,18,9,9,0.03202384573231706,2019-03-24 17:30:00,2019-03-24 17:45:00
27,8,6,2,0.01703888126575931,2019-03-24 17:30:00,2019-03-24 17:45:00
28,7,6,1,0.008934815088947326,2019-03-24 17:30:00,2019-03-24 17:45:00
30,5,4,1,0.019290015625094324,2019-03-24 17:30:00,2019-03-24 17:45:00
35,5,2,3,0.0040123698382267935,2019-03-24 17:30:00,2019-03-24 17:45:00
40,6,2,4,0.0030236848956386292,2019-03-24 17:30:00,2019-03-24 17:45:00
41,11,6,5,0.012384556071375837,2019-03-24 17:30:00,2019-03-24 17:45:00
46,6,3,3,0.00915012237775425,2019-03-24 17:30:00,2019-03-24 17:45:00
50,3,3,0,0.004952368521157741,2019-03-24 17:30:00,2019-03-24 17:45:00
57,12,9,3,0.017296386622738347,2019-03-24 17:30:00,2019-03-24 17:45:00
58,4,1,3,0.0024653830392771777,2019-03-24 17:30:00,2019-03-24 17:45:00
61,10,3,7,0.006021032685817381,2019-03-24 17:30:00,2019-03-24 17:45:00
62,7,3,4,0.005913801781691138,2019-03-24 17:30:00,2019-03-24 17:45:00
64,6,6,0,0.007609896038306974,2019-03-24 17:30:00,2019-03-24 17:45:00
66,2,1,1,0.011570959921947737,2019-03-24 17:30:00,2019-03-24 17:45:00
67,7,3,4,0.0028964079213125455,2019-03-24 17:30:00,2019-03-24 17:45:00
68,6,2,4,0.003130706208052227,2019-03-24 17:30:00,2019-03-24 17:45:00
69,11,3,8,0.002552058371038385,2019-03-24 17:30:00,2019-03-24 17:45:00
70,5,4,1,0.009482623934978196,2019-03-24 17:30:00,2019-03-24 17:45:00
71,4,2,2,0.011570959921947737,2019-03-24 17:30:00,2019-03-24 17:45:00
74,12,5,7,0.021773860319953348,2019-03-24 17:30:00,2019-03-24 17:45:00
75,14,12,2,0.012172038443724466,2019-03-24 17:30:00,2019-03-24 17:45:00
79,4,2,2,0.005593960287800831,2019-03-24 17:30:00,2019-03-24 17:45:00
80,2,1,1,0.011570959921947737,2019-03-24 17:30:00,2019-03-24 17:45:00
85,2,0,2,0.001738547199557528,2019-03-24 17:30:00,2019-03-24 17:45:00
86,1,1,0,0.0026520789618983084,2019-03-24 17:30:00,2019-03-24 17:45:00
87,8,5,3,0.005730518327116983,2019-03-24 17:30:00,2019-03-24 17:45:00
88,4,2,2,0.0032553798234288547,2019-03-24 17:30:00,2019-03-24 17:45:00
89,2,0,2,0.001738547199557528,2019-03-24 17:30:00,2019-03-24 17:45:00
90,8,3,5,0.005689818292554104,2019-03-24 17:30:00,2019-03-24 17:45:00
101,5,4,1,0.016982300852493342,2019-03-24 17:30:00,2019-03-24 17:45:00
104,1,0,1,0.001738547199557528,2019-03-24 17:30:00,2019-03-24 17:45:00
106,8,4,4,0.011570959921947737,2019-03-24 17:30:00,2019-03-24 17:45:00
108,9,4,5,0.005433949182649626,2019-03-24 17:30:00,2019-03-24 17:45:00
109,18,9,9,0.00769515204382322,2019-03-24 17:30:00,2019-03-24 17:45:00
110,15,4,11,0.003988739322203772,2019-03-24 17:30:00,2019-03-24 17:45:00
111,1,1,0,0.0032163822473738465,2019-03-24 17:30:00,2019-03-24 17:45:00
112,14,9,5,0.01748400252060168,2019-03-24 17:30:00,2019-03-24 17:45:00
114,5,2,3,0.0040123698382267935,2019-03-24 17:30:00,2019-03-24 17:45:00
115,15,1,14,0.0018509305125639945,2019-03-24 17:30:00,2019-03-24 17:45:00
116,4,2,2,0.004417683315526489,2019-03-24 17:30:00,2019-03-24 17:45:00
118,7,4,3,0.021352593020207995,2019-03-24 17:30:00,2019-03-24 17:45:00
119,17,9,8,0.01549614943013817,2019-03-24 17:30:00,2019-03-24 17:45:00
120,2,2,0,0.011149585330393674,2019-03-24 17:30:00,2019-03-24 17:45:00
122,11,7,4,0.026490894627099942,2019-03-24 17:30:00,2019-03-24 17:45:00
126,5,2,3,0.0040123698382267935,2019-03-24 17:30:00,2019-03-24 17:45:00
127,2,1,1,0.011570959921947737,2019-03-24 17:30:00,2019-03-24 17:45:00
133,2,0,2,0.001738547199557528,2019-03-24 17:30:00,2019-03-24 17:45:00
137,34,12,22,0.01962624324390881,2019-03-24 17:30:00,2019-03-24 17:45:00
138,22,14,8,0.015058164535923962,2019-03-24 17:30:00,2019-03-24 17:45:00
140,2,1,1,0.011570959921947737,2019-03-24 17:30:00,2019-03-24 17:45:00
141,7,2,5,0.0030665293490339625,2019-03-24 17:30:00,2019-03-24 17:45:00
147,1,0,1,0.001738547199557528,2019-03-24 17:30:00,2019-03-24 17:45:00
151,1,0,1,0.001738547199557528,2019-03-24 17:30:00,2019-03-24 17:45:00
153,7,4,3,0.0065464375086186025,2019-03-24 17:30:00,2019-03-24 17:45:00
154,6,3,3,0.004488075161071238,2019-03-24 17:30:00,2019-03-24 17:45:00
157,6,4,2,0.02160977160121398,2019-03-24 17:30:00,2019-03-24 17:45:00
158,1,1,0,0.0024038703683325778,2019-03-24 17:30:00,2019-03-24 17:45:00
159,6,2,4,0.0030236848956386292,2019-03-24 17:30:00,2019-03-24 17:45:00
160,4,2,2,0.006241378708295111,2019-03-24 17:30:00,2019-03-24 17:45:00
162,5,2,3,0.0040123698382267935,2019-03-24 17:30:00,2019-03-24 17:45:00
164,21,10,11,0.012205680085880672,2019-03-24 17:30:00,2019-03-24 17:45:00
168,30,19,11,0.021318288393472627,2019-03-24 17:30:00,2019-03-24 17:45:00
169,6,2,4,0.0023504201440443166,2019-03-24 17:30:00,2019-03-24 17:45:00
170,2,0,2,0.001738547199557528,2019-03-24 17:30:00,2019-03-24 17:45:00
171,1,0,1,0.001738547199557528,2019-03-24 17:30:00,2019-03-24 17:45:00
172,4,1,3,0.0023540671403253074,2019-03-24 17:30:00,2019-03-24 17:45:00
173,5,2,3,0.003142514363384169,2019-03-24 17:30:00,2019-03-24 17:45:00
175,1,0,1,0.001738547199557528,2019-03-24 17:30:00,2019-03-24 17:45:00
177,5,4,1,0.033164656111734775,2019-03-24 17:30:00,2019-03-24 17:45:00
189,6,4,2,0.004632287724566459,2019-03-24 17:30:00,2019-03-24 17:45:00
190,16,8,8,0.012605575616108177,2019-03-24 17:30:00,2019-03-24 17:45:00
191,3,2,1,0.005971174336817469,2019-03-24 17:30:00,2019-03-24 17:45:00
195,1,1,0,0.0023540671403253074,2019-03-24 17:30:00,2019-03-24 17:45:00
196,9,4,5,0.004576434183612584,2019-03-24 17:30:00,2019-03-24 17:45:00
197,5,2,3,0.002477464723465687,2019-03-24 17:30:00,2019-03-24 17:45:00
199,1,1,0,0.004331456343708783,2019-03-24 17:30:00,2019-03-24 17:45:00
201,2,1,1,0.011570959921947737,2019-03-24 17:30:00,2019-03-24 17:45:00
202,4,2,2,0.0024719066983324455,2019-03-24 17:30:00,2019-03-24 17:45:00
203,14,6,8,0.008596643570750023,2019-03-24 17:30:00,2019-03-24 17:45:00
1,6,3,3,0.0070223742155052565,2019-03-24 17:45:00,2019-03-24 18:00:00
2,19,4,15,0.0049606781545919985,2019-03-24 17:45:00,2019-03-24 18:00:00
5,3,1,2,0.0029208496135115078,2019-03-24 17:45:00,2019-03-24 18:00:00
10,2,0,2,0.002003564409332596,2019-03-24 17:45:00,2019-03-24 18:00:00
11,5,4,1,0.028338022109622975,2019-03-24 17:45:00,2019-03-24 18:00:00
15,10,6,4,0.008018527452803053,2019-03-24 17:45:00,2019-03-24 18:00:00
16,11,4,7,0.0067753385626406135,2019-03-24 17:45:00,2019-03-24 18:00:00
18,14,8,6,0.03607355166167223,2019-03-24 17:45:00,2019-03-24 18:00:00
19,5,2,3,0.005534945172489311,2019-03-24 17:45:00,2019-03-24 18:00:00
20,1,0,1,0.002003564409332596,2019-03-24 17:45:00,2019-03-24 18:00:00
21,2,2,0,0.002935512085095828,2019-03-24 17:45:00,2019-03-24 18:00:00
23,15,7,8,0.011835814282885134,2019-03-24 17:45:00,2019-03-24 18:00:00
26,13,6,7,0.008978296371530269,2019-03-24 17:45:00,2019-03-24 18:00:00
27,7,6,1,0.012822839771984292,2019-03-24 17:45:00,2019-03-24 18:00:00
28,4,3,1,0.006461215874192696,2019-03-24 17:45:00,2019-03-24 18:00:00
30,2,2,0,0.008586913175483827,2019-03-24 17:45:00,2019-03-24 18:00:00
35,1,0,1,0.002003564409332596,2019-03-24 17:45:00,2019-03-24 18:00:00
41,8,2,6,0.006473939915898623,2019-03-24 17:45:00,2019-03-24 18:00:00
46,5,2,3,0.008032530022527112,2019-03-24 17:45:00,2019-03-24 18:00:00
50,3,3,0,0.0047554200218693325,2019-03-24 17:45:00,2019-03-24 18:00:00
57,12,7,5,0.015599372639522487,2019-03-24 17:45:00,2019-03-24 18:00:00
58,3,1,2,0.0037692547909109536,2019-03-24 17:45:00,2019-03-24 18:00:00
61,6,1,5,0.0035720523729867457,2019-03-24 17:45:00,2019-03-24 18:00:00
62,5,3,2,0.010406508119635997,2019-03-24 17:45:00,2019-03-24 18:00:00
64,6,5,1,0.028877094549393696,2019-03-24 17:45:00,2019-03-24 18:00:00
66,2,1,1,0.013336993220191586,2019-03-24 17:45:00,2019-03-24 18:00:00
67,7,2,5,0.003035838598549227,2019-03-24 17:45:00,2019-03-24 18:00:00
68,3,2,1,0.02505936621555395,2019-03-24 17:45:00,2019-03-24 18:00:00
69,12,5,7,0.004696834170710904,2019-03-24 17:45:00,2019-03-24 18:00:00
70,3,2,1,0.004172697774287215,2019-03-24 17:45:00,2019-03-24 18:00:00
71,4,2,2,0.013336993220191586,2019-03-24 17:45:00,2019-03-24 18:00:00
74,13,6,7,0.01175403375951492,2019-03-24 17:45:00,2019-03-24 18:00:00
75,15,12,3,0.010993099166459724,2019-03-24 17:45:00,2019-03-24 18:00:00
79,6,3,3,0.01315247518383174,2019-03-24 17:45:00,2019-03-24 18:00:00
80,2,1,1,0.013336993220191586,2019-03-24 17:45:00,2019-03-24 18:00:00
86,3,2,1,0.015467210602314384,2019-03-24 17:45:00,2019-03-24 18:00:00
87,7,4,3,0.007661909135146045,2019-03-24 17:45:00,2019-03-24 18:00:00
88,5,0,5,0.002003564409332596,2019-03-24 17:45:00,2019-03-24 18:00:00
89,3,1,2,0.0031945105913485147,2019-03-24 17:45:00,2019-03-24 18:00:00
90,8,4,4,0.005619011040278231,2019-03-24 17:45:00,2019-03-24 18:00:00
101,5,4,1,0.024717370351317557,2019-03-24 17:45:00,2019-03-24 18:00:00
104,2,1,1,0.004346295574167124,2019-03-24 17:45:00,2019-03-24 18:00:00
106,5,3,2,0.017130452263900246,2019-03-24 17:45:00,2019-03-24 18:00:00
108,12,5,7,0.005100910455546824,2019-03-24 17:45:00,2019-03-24 18:00:00
109,15,9,6,0.012461562663511578,2019-03-24 17:45:00,2019-03-24 18:00:00
110,13,2,11,0.0025658792498218282,2019-03-24 17:45:00,2019-03-24 18:00:00
111,2,0,2,0.002003564409332596,2019-03-24 17:45:00,2019-03-24 18:00:00
112,8,3,5,0.0027407847336595706,2019-03-24 17:45:00,2019-03-24 18:00:00
114,2,1,1,0.002755886698572935,2019-03-24 17:45:00,2019-03-24 18:00:00
115,10,4,6,0.0051723619574677695,2019-03-24 17:45:00,2019-03-24 18:00:00
116,4,4,0,0.006800321624167842,2019-03-24 17:45:00,2019-03-24 18:00:00
118,6,2,4,0.004519142506604786,2019-03-24 17:45:00,2019-03-24 18:00:00
119,15,9,6,0.013294280265024681,2019-03-24 17:45:00,2019-03-24 18:00:00
120,2,2,0,0.007807394543372112,2019-03-24 17:45:00,2019-03-24 18:00:00
122,13,7,6,0.008405438502873301,2019-03-24 17:45:00,2019-03-24 18:00:00
126,4,2,2,0.013336993220191586,2019-03-24 17:45:00,2019-03-24 18:00:00
127,2,1,1,0.013336993220191586,2019-03-24 17:45:00,2019-03-24 18:00:00
133,2,0,2,0.002003564409332596,2019-03-24 17:45:00,2019-03-24 18:00:00
135,2,2,0,0.003924508573851932,2019-03-24 17:45:00,2019-03-24 18:00:00
137,36,16,20,0.020983376797399363,2019-03-24 17:45:00,2019-03-24 18:00:00
138,20,15,5,0.01899007215000062,2019-03-24 17:45:00,2019-03-24 18:00:00
140,1,1,0,0.0071152448183482,2019-03-24 17:45:00,2019-03-24 18:00:00
141,4,1,3,0.0028263807151270035,2019-03-24 17:45:00,2019-03-24 18:00:00
147,1,0,1,0.002003564409332596,2019-03-24 17:45:00,2019-03-24 18:00:00
153,8,5,3,0.009171693850211212,2019-03-24 17:45:00,2019-03-24 18:00:00
154,8,6,2,0.004930504523552423,2019-03-24 17:45:00,2019-03-24 18:00:00
157,4,2,2,0.013336993220191586,2019-03-24 17:45:00,2019-03-24 18:00:00
158,1,1,0,0.0032613534579686914,2019-03-24 17:45:00,2019-03-24 18:00:00
159,4,2,2,0.013336993220191586,2019-03-24 17:45:00,2019-03-24 18:00:00
160,1,1,0,0.0030939459699948343,2019-03-24 17:45:00,2019-03-24 18:00:00
162,1,0,1,0.002003564409332596,2019-03-24 17:45:00,2019-03-24 18:00:00
164,20,9,11,0.008956271274229675,2019-03-24 17:45:00,2019-03-24 18:00:00
168,23,13,10,0.015845098454535626,2019-03-24 17:45:00,2019-03-24 18:00:00
169,5,1,4,0.002544264503548969,2019-03-24 17:45:00,2019-03-24 18:00:00
170,1,1,0,0.0031945105913485147,2019-03-24 17:45:00,2019-03-24 18:00:00
172,2,2,0,0.004121857358449775,2019-03-24 17:45:00,2019-03-24 18:00:00
173,3,0,3,0.002003564409332596,2019-03-24 17:45:00,2019-03-24 18:00:00
175,2,1,1,0.026531553145217372,2019-03-24 17:45:00,2019-03-24 18:00:00
177,6,3,3,0.013336993220191586,2019-03-24 17:45:00,2019-03-24 18:00:00
189,4,2,2,0.002644218160648102,2019-03-24 17:45:00,2019-03-24 18:00:00
190,15,7,8,0.01567218612285902,2019-03-24 17:45:00,2019-03-24 18:00:00
191,3,3,0,0.00989829681090484,2019-03-24 17:45:00,2019-03-24 18:00:00
195,1,1,0,0.0025197015039409116,2019-03-24 17:45:00,2019-03-24 18:00:00
196,8,2,6,0.005309849140490077,2019-03-24 17:45:00,2019-03-24 18:00:00
197,3,2,1,0.0037067239364055983,2019-03-24 17:45:00,2019-03-24 18:00:00
199,1,1,0,0.004279979570174638,2019-03-24 17:45:00,2019-03-24 18:00:00
202,4,2,2,0.0025658792498218282,2019-03-24 17:45:00,2019-03-24 18:00:00
203,13,4,9,0.0033913494187743343,2019-03-24 17:45:00,2019-03-24 18:00:00
1,6,3,3,0.004587429674659229,2019-03-24 18:00:00,2019-03-24 18:15:00
2,12,4,8,0.0031831669644621394,2019-03-24 18:00:00,2019-03-24 18:15:00
5,5,2,3,0.004509535568032547,2019-03-24 18:00:00,2019-03-24 18:15:00
10,2,0,2,0.001953758245824463,2019-03-24 18:00:00,2019-03-24 18:15:00
11,2,1,1,0.013014315529243344,2019-03-24 18:00:00,2019-03-24 18:15:00
15,7,5,2,0.007697843552635093,2019-03-24 18:00:00,2019-03-24 18:15:00
16,12,7,5,0.01424434047916856,2019-03-24 18:00:00,2019-03-24 18:15:00
18,12,8,4,0.033165280240095914,2019-03-24 18:00:00,2019-03-24 18:15:00
19,6,2,4,0.0038757081886137907,2019-03-24 18:00:00,2019-03-24 18:15:00
20,4,1,3,0.0027262853433305226,2019-03-24 18:00:00,2019-03-24 18:15:00
23,5,2,3,0.0038757081886137902,2019-03-24 18:00:00,2019-03-24 18:15:00
26,13,5,8,0.007035364435062706,2019-03-24 18:00:00,2019-03-24 18:15:00
27,7,6,1,0.012043111508389638,2019-03-24 18:00:00,2019-03-24 18:15:00
28,2,2,0,0.004189753366809608,2019-03-24 18:00:00,2019-03-24 18:15:00
35,1,0,1,0.001953758245824463,2019-03-24 18:00:00,2019-03-24 18:15:00
37,1,0,1,0.001953758245824463,2019-03-24 18:00:00,2019-03-24 18:15:00
40,2,1,1,0.013014315529243344,2019-03-24 18:00:00,2019-03-24 18:15:00
41,6,2,4,0.004055339739552502,2019-03-24 18:00:00,2019-03-24 18:15:00
46,2,0,2,0.001953758245824463,2019-03-24 18:00:00,2019-03-24 18:15:00
50,3,3,0,0.004539390533951642,2019-03-24 18:00:00,2019-03-24 18:15:00
57,13,8,5,0.020471927357154404,2019-03-24 18:00:00,2019-03-24 18:15:00
58,5,4,1,0.0042087034359974025,2019-03-24 18:00:00,2019-03-24 18:15:00
61,2,0,2,0.001953758245824463,2019-03-24 18:00:00,2019-03-24 18:15:00
62,3,2,1,0.003804662098018716,2019-03-24 18:00:00,2019-03-24 18:15:00
64,3,2,1,0.0035613252896604056,2019-03-24 18:00:00,2019-03-24 18:15:00
66,2,1,1,0.013014315529243344,2019-03-24 18:00:00,2019-03-24 18:15:00
67,8,4,4,0.006286878490112859,2019-03-24 18:00:00,2019-03-24 18:15:00
68,2,1,1,0.0022508077514709957,2019-03-24 18:00:00,2019-03-24 18:15:00
69,13,5,8,0.008011177203609408,2019-03-24 18:00:00,2019-03-24 18:15:00
70,3,2,1,0.004465920364666297,2019-03-24 18:00:00,2019-03-24 18:15:00
71,4,2,2,0.013014315529243344,2019-03-24 18:00:00,2019-03-24 18:15:00
74,19,10,9,0.015617929336124074,2019-03-24 18:00:00,2019-03-24 18:15:00
75,3,0,3,0.001953758245824463,2019-03-24 18:00:00,2019-03-24 18:15:00
79,6,3,3,0.006426368559688609,2019-03-24 18:00:00,2019-03-24 18:15:00
86,2,0,2,0.001953758245824463,2019-03-24 18:00:00,2019-03-24 18:15:00
87,4,3,1,0.016966258019976657,2019-03-24 18:00:00,2019-03-24 18:15:00
88,4,0,4,0.001953758245824463,2019-03-24 18:00:00,2019-03-24 18:15:00
89,3,3,0,0.003190842396269096,2019-03-24 18:00:00,2019-03-24 18:15:00
90,9,6,3,0.010012847630021257,2019-03-24 18:00:00,2019-03-24 18:15:00
99,1,1,0,0.0027014121087230642,2019-03-24 18:00:00,2019-03-24 18:15:00
101,4,3,1,0.02434530842990793,2019-03-24 18:00:00,2019-03-24 18:15:00
104,2,0,2,0.001953758245824463,2019-03-24 18:00:00,2019-03-24 18:15:00
106,5,3,2,0.018679811979575627,2019-03-24 18:00:00,2019-03-24 18:15:00
108,11,5,6,0.006474909373982551,2019-03-24 18:00:00,2019-03-24 18:15:00
109,17,7,10,0.0075629159025515135,2019-03-24 18:00:00,2019-03-24 18:15:00
110,9,2,7,0.0026302786492206198,2019-03-24 18:00:00,2019-03-24 18:15:00
112,5,3,2,0.003740870076983929,2019-03-24 18:00:00,2019-03-24 18:15:00
114,3,1,2,0.0027014121087230642,2019-03-24 18:00:00,2019-03-24 18:15:00
115,7,2,5,0.0029604032383537286,2019-03-24 18:00:00,2019-03-24 18:15:00
116,4,4,0,0.003967048230882994,2019-03-24 18:00:00,2019-03-24 18:15:00
118,4,0,4,0.001953758245824463,2019-03-24 18:00:00,2019-03-24 18:15:00
119,15,6,9,0.008508576728356828,2019-03-24 18:00:00,2019-03-24 18:15:00
120,1,1,0,0.002297527610175941,2019-03-24 18:00:00,2019-03-24 18:15:00
122,5,3,2,0.031882807339607494,2019-03-24 18:00:00,2019-03-24 18:15:00
126,7,2,5,0.0029604032383537286,2019-03-24 18:00:00,2019-03-24 18:15:00
127,3,3,0,0.011097973423335723,2019-03-24 18:00:00,2019-03-24 18:15:00
133,2,0,2,0.001953758245824463,2019-03-24 18:00:00,2019-03-24 18:15:00
135,2,2,0,0.0027841813352644006,2019-03-24 18:00:00,2019-03-24 18:15:00
137,49,19,30,0.010482114075240512,2019-03-24 18:00:00,2019-03-24 18:15:00
138,21,17,4,0.016699281835102147,2019-03-24 18:00:00,2019-03-24 18:15:00
140,1,1,0,0.00900373276278316,2019-03-24 18:00:00,2019-03-24 18:15:00
141,6,1,5,0.004375804203061976,2019-03-24 18:00:00,2019-03-24 18:15:00
147,1,0,1,0.001953758245824463,2019-03-24 18:00:00,2019-03-24 18:15:00
151,2,0,2,0.001953758245824463,2019-03-24 18:00:00,2019-03-24 18:15:00
153,5,3,2,0.008289052759433353,2019-03-24 18:00:00,2019-03-24 18:15:00
154,12,6,6,0.007390102043817107,2019-03-24 18:00:00,2019-03-24 18:15:00
157,4,2,2,0.013014315529243344,2019-03-24 18:00:00,2019-03-24 18:15:00
160,1,1,0,0.0027014121087230642,2019-03-24 18:00:00,2019-03-24 18:15:00
164,18,6,12,0.004852305974443346,2019-03-24 18:00:00,2019-03-24 18:15:00
168,15,12,3,0.06032621727899227,2019-03-24 18:00:00,2019-03-24 18:15:00
169,5,2,3,0.00314081810842363,2019-03-24 18:00:00,2019-03-24 18:15:00
172,4,4,0,0.008528580145341552,2019-03-24 18:00:00,2019-03-24 18:15:00
173,3,2,1,0.0036078741678883977,2019-03-24 18:00:00,2019-03-24 18:15:00
175,3,2,1,0.033154100582468864,2019-03-24 18:00:00,2019-03-24 18:15:00
177,8,5,3,0.03284529176608791,2019-03-24 18:00:00,2019-03-24 18:15:00
190,11,5,6,0.010523779128170317,2019-03-24 18:00:00,2019-03-24 18:15:00
191,6,4,2,0.04856053689510452,2019-03-24 18:00:00,2019-03-24 18:15:00
195,1,1,0,0.0032898952785287237,2019-03-24 18:00:00,2019-03-24 18:15:00
196,2,0,2,0.001953758245824463,2019-03-24 18:00:00,2019-03-24 18:15:00
197,5,4,1,0.02960515145437166,2019-03-24 18:00:00,2019-03-24 18:15:00
199,1,0,1,0.001953758245824463,2019-03-24 18:00:00,2019-03-24 18:15:00
201,6,3,3,0.013014315529243344,2019-03-24 18:00:00,2019-03-24 18:15:00
202,4,2,2,0.0026302786492206198,2019-03-24 18:00:00,2019-03-24 18:15:00
203,11,5,6,0.005896910685062549,2019-03-24 18:00:00,2019-03-24 18:15:00
1,7,1,6,0.0025281282866282725,2019-03-24 18:15:00,2019-03-24 18:30:00
2,10,5,5,0.0048811990696959896,2019-03-24 18:15:00,2019-03-24 18:30:00
5,9,4,5,0.006782867374181238,2019-03-24 18:15:00,2019-03-24 18:30:00
10,3,1,2,0.003876249100023195,2019-03-24 18:15:00,2019-03-24 18:30:00
15,6,3,3,0.013501065546247845,2019-03-24 18:15:00,2019-03-24 18:30:00
16,8,5,3,0.012640910008446714,2019-03-24 18:15:00,2019-03-24 18:30:00
18,9,6,3,0.0366424987954649,2019-03-24 18:15:00,2019-03-24 18:30:00
19,4,2,2,0.015660813974379195,2019-03-24 18:15:00,2019-03-24 18:30:00
20,8,4,4,0.005439642003982467,2019-03-24 18:15:00,2019-03-24 18:30:00
23,4,2,2,0.02772206418543169,2019-03-24 18:15:00,2019-03-24 18:30:00
26,3,0,3,0.0021699529345497,2019-03-24 18:15:00,2019-03-24 18:30:00
27,3,2,1,0.009540842518371421,2019-03-24 18:15:00,2019-03-24 18:30:00
28,5,5,0,0.013411394755803357,2019-03-24 18:15:00,2019-03-24 18:30:00
37,1,0,1,0.0021699529345497,2019-03-24 18:15:00,2019-03-24 18:30:00
40,2,1,1,0.014439832876135008,2019-03-24 18:15:00,2019-03-24 18:30:00
41,3,1,2,0.00882730485004989,2019-03-24 18:15:00,2019-03-24 18:30:00
46,3,0,3,0.0021699529345497,2019-03-24 18:15:00,2019-03-24 18:30:00
57,16,7,9,0.007459408560686658,2019-03-24 18:15:00,2019-03-24 18:30:00
58,5,4,1,0.00410060545447915,2019-03-24 18:15:00,2019-03-24 18:30:00
61,2,0,2,0.0021699529345497,2019-03-24 18:15:00,2019-03-24 18:30:00
62,2,1,1,0.0029541556308939343,2019-03-24 18:15:00,2019-03-24 18:30:00
64,2,2,0,0.0037383583272381686,2019-03-24 18:15:00,2019-03-24 18:30:00
66,2,1,1,0.014439832876135008,2019-03-24 18:15:00,2019-03-24 18:30:00
67,8,4,4,0.006982225685980622,2019-03-24 18:15:00,2019-03-24 18:30:00
68,3,1,2,0.00252041970011749,2019-03-24 18:15:00,2019-03-24 18:30:00
69,9,4,5,0.00661545756242309,2019-03-24 18:15:00,2019-03-24 18:30:00
70,5,2,3,0.006088661422925778,2019-03-24 18:15:00,2019-03-24 18:30:00
71,4,2,2,0.014439832876135008,2019-03-24 18:15:00,2019-03-24 18:30:00
74,12,5,7,0.005524341263356199,2019-03-24 18:15:00,2019-03-24 18:30:00
85,2,2,0,0.0029298170276163323,2019-03-24 18:15:00,2019-03-24 18:30:00
86,3,3,0,0.004582984483179752,2019-03-24 18:15:00,2019-03-24 18:30:00
87,2,1,1,0.014439832876135008,2019-03-24 18:15:00,2019-03-24 18:30:00
88,1,0,1,0.0021699529345497,2019-03-24 18:15:00,2019-03-24 18:30:00
89,5,5,0,0.003951752043354176,2019-03-24 18:15:00,2019-03-24 18:30:00
90,6,4,2,0.008303881248265609,2019-03-24 18:15:00,2019-03-24 18:30:00
101,2,1,1,0.014439832876135008,2019-03-24 18:15:00,2019-03-24 18:30:00
104,3,2,1,0.006514156661436757,2019-03-24 18:15:00,2019-03-24 18:30:00
106,5,3,2,0.021911606787349994,2019-03-24 18:15:00,2019-03-24 18:30:00
108,11,5,6,0.007604315827048579,2019-03-24 18:15:00,2019-03-24 18:30:00
109,11,3,8,0.0035754421138159713,2019-03-24 18:15:00,2019-03-24 18:30:00
110,4,0,4,0.0021699529345497,2019-03-24 18:15:00,2019-03-24 18:30:00
111,1,1,0,0.0028745085826803914,2019-03-24 18:15:00,2019-03-24 18:30:00
112,6,4,2,0.006542760858210689,2019-03-24 18:15:00,2019-03-24 18:30:00
114,4,2,2,0.0048434377964557684,2019-03-24 18:15:00,2019-03-24 18:30:00
115,12,4,8,0.003862295281942635,2019-03-24 18:15:00,2019-03-24 18:30:00
116,8,7,1,0.01619427590997749,2019-03-24 18:15:00,2019-03-24 18:30:00
119,13,5,8,0.007379240796290991,2019-03-24 18:15:00,2019-03-24 18:30:00
122,5,3,2,0.03789226747660229,2019-03-24 18:15:00,2019-03-24 18:30:00
126,3,1,2,0.004681266388649814,2019-03-24 18:15:00,2019-03-24 18:30:00
127,3,3,0,0.01477280582257175,2019-03-24 18:15:00,2019-03-24 18:30:00
137,29,6,23,0.009481183153620872,2019-03-24 18:15:00,2019-03-24 18:30:00
138,23,16,7,0.03034498827774592,2019-03-24 18:15:00,2019-03-24 18:30:00
141,3,2,1,0.00923817603982206,2019-03-24 18:15:00,2019-03-24 18:30:00
147,2,1,1,0.002580352176748111,2019-03-24 18:15:00,2019-03-24 18:30:00
151,2,0,2,0.0021699529345497,2019-03-24 18:15:00,2019-03-24 18:30:00
153,1,0,1,0.0021699529345497,2019-03-24 18:15:00,2019-03-24 18:30:00
154,7,3,4,0.0052194368719661,2019-03-24 18:15:00,2019-03-24 18:30:00
157,5,3,2,0.016758764717553595,2019-03-24 18:15:00,2019-03-24 18:30:00
158,3,1,2,0.0051099018724669425,2019-03-24 18:15:00,2019-03-24 18:30:00
160,1,1,0,0.002784812428946635,2019-03-24 18:15:00,2019-03-24 18:30:00
164,17,9,8,0.027663970923689517,2019-03-24 18:15:00,2019-03-24 18:30:00
168,7,4,3,0.01912399055502914,2019-03-24 18:15:00,2019-03-24 18:30:00
169,4,2,2,0.004383689666665823,2019-03-24 18:15:00,2019-03-24 18:30:00
172,3,3,0,0.005498378551860564,2019-03-24 18:15:00,2019-03-24 18:30:00
173,6,3,3,0.015474523507087709,2019-03-24 18:15:00,2019-03-24 18:30:00
175,2,1,1,0.014439832876135008,2019-03-24 18:15:00,2019-03-24 18:30:00
177,8,5,3,0.0387651993621328,2019-03-24 18:15:00,2019-03-24 18:30:00
190,9,4,5,0.010770117200777144,2019-03-24 18:15:00,2019-03-24 18:30:00
191,3,1,2,0.004014531417740505,2019-03-24 18:15:00,2019-03-24 18:30:00
195,1,1,0,0.0036538000686697587,2019-03-24 18:15:00,2019-03-24 18:30:00
196,1,0,1,0.0021699529345497,2019-03-24 18:15:00,2019-03-24 18:30:00
197,5,3,2,0.007309585672542183,2019-03-24 18:15:00,2019-03-24 18:30:00
199,3,2,1,0.002886303638706845,2019-03-24 18:15:00,2019-03-24 18:30:00
201,2,1,1,0.014439832876135008,2019-03-24 18:15:00,2019-03-24 18:30:00
202,4,2,2,0.0038297987729926197,2019-03-24 18:15:00,2019-03-24 18:30:00
203,3,3,0,0.008720730840175155,2019-03-24 18:15:00,2019-03-24 18:30:00
1,4,1,3,0.0035464466815646337,2019-03-24 18:30:00,2019-03-24 18:45:00
2,4,2,2,0.0060363651552029695,2019-03-24 18:30:00,2019-03-24 18:45:00
5,7,3,4,0.007012800819391357,2019-03-24 18:30:00,2019-03-24 18:45:00
10,3,0,3,0.002541527930709714,2019-03-24 18:30:00,2019-03-24 18:45:00
15,7,3,4,0.008163398645343128,2019-03-24 18:30:00,2019-03-24 18:45:00
16,7,4,3,0.007766532843896701,2019-03-24 18:30:00,2019-03-24 18:45:00
18,10,6,4,0.019677696634305762,2019-03-24 18:30:00,2019-03-24 18:45:00
19,2,1,1,0.013465104268572425,2019-03-24 18:30:00,2019-03-24 18:45:00
20,4,3,1,0.009858329170757444,2019-03-24 18:30:00,2019-03-24 18:45:00
23,7,2,5,0.0056159979672946595,2019-03-24 18:30:00,2019-03-24 18:45:00
26,5,2,3,0.006561202934129393,2019-03-24 18:30:00,2019-03-24 18:45:00
27,3,2,1,0.0043995672629338406,2019-03-24 18:30:00,2019-03-24 18:45:00
28,3,3,0,0.006560046894549023,2019-03-24 18:30:00,2019-03-24 18:45:00
30,3,3,0,0.022595978014317918,2019-03-24 18:30:00,2019-03-24 18:45:00
35,1,1,0,0.004702007562324897,2019-03-24 18:30:00,2019-03-24 18:45:00
40,2,1,1,0.016911580381519388,2019-03-24 18:30:00,2019-03-24 18:45:00
41,5,3,2,0.0045724538808420215,2019-03-24 18:30:00,2019-03-24 18:45:00
46,1,0,1,0.002541527930709714,2019-03-24 18:30:00,2019-03-24 18:45:00
57,13,6,7,0.020081794719015784,2019-03-24 18:30:00,2019-03-24 18:45:00
58,2,2,0,0.005815510018064351,2019-03-24 18:30:00,2019-03-24 18:45:00
61,2,0,2,0.002541527930709714,2019-03-24 18:30:00,2019-03-24 18:45:00
62,5,3,2,0.010124516868474827,2019-03-24 18:30:00,2019-03-24 18:45:00
66,2,1,1,0.016911580381519388,2019-03-24 18:30:00,2019-03-24 18:45:00
67,10,4,6,0.006561202934129393,2019-03-24 18:30:00,2019-03-24 18:45:00
68,1,0,1,0.002541527930709714,2019-03-24 18:30:00,2019-03-24 18:45:00
69,5,2,3,0.005865967985423612,2019-03-24 18:30:00,2019-03-24 18:45:00
70,4,1,3,0.0035464466815646337,2019-03-24 18:30:00,2019-03-24 18:45:00
74,8,3,5,0.005187378824917774,2019-03-24 18:30:00,2019-03-24 18:45:00
75,1,0,1,0.002541527930709714,2019-03-24 18:30:00,2019-03-24 18:45:00
79,1,0,1,0.002541527930709714,2019-03-24 18:30:00,2019-03-24 18:45:00
85,2,2,0,0.008742048163725131,2019-03-24 18:30:00,2019-03-24 18:45:00
86,3,3,0,0.0064659081584636045,2019-03-24 18:30:00,2019-03-24 18:45:00
87,2,1,1,0.016911580381519388,2019-03-24 18:30:00,2019-03-24 18:45:00
88,1,0,1,0.002541527930709714,2019-03-24 18:30:00,2019-03-24 18:45:00
90,2,1,1,0.004702007562324897,2019-03-24 18:30:00,2019-03-24 18:45:00
101,2,1,1,0.016911580381519388,2019-03-24 18:30:00,2019-03-24 18:45:00
104,2,2,0,0.008572855363968308,2019-03-24 18:30:00,2019-03-24 18:45:00
106,4,2,2,0.016911580381519388,2019-03-24 18:30:00,2019-03-24 18:45:00
108,4,2,2,0.016911580381519388,2019-03-24 18:30:00,2019-03-24 18:45:00
109,6,4,2,0.00729383063664543,2019-03-24 18:30:00,2019-03-24 18:45:00
110,4,0,4,0.002541527930709714,2019-03-24 18:30:00,2019-03-24 18:45:00
111,1,1,0,0.00498046167739229,2019-03-24 18:30:00,2019-03-24 18:45:00
112,8,5,3,0.00658643727887036,2019-03-24 18:30:00,2019-03-24 18:45:00
113,1,1,0,0.004203747958066663,2019-03-24 18:30:00,2019-03-24 18:45:00
114,4,1,3,0.0035464466815646337,2019-03-24 18:30:00,2019-03-24 18:45:00
115,7,3,4,0.005359799361765651,2019-03-24 18:30:00,2019-03-24 18:45:00
116,4,2,2,0.004986784257580144,2019-03-24 18:30:00,2019-03-24 18:45:00
118,1,1,0,0.0035464466815646337,2019-03-24 18:30:00,2019-03-24 18:45:00
119,13,5,8,0.007060288084547608,2019-03-24 18:30:00,2019-03-24 18:45:00
122,5,3,2,0.04349120565152354,2019-03-24 18:30:00,2019-03-24 18:45:00
127,3,2,1,0.005362711444676946,2019-03-24 18:30:00,2019-03-24 18:45:00
137,15,8,7,0.013478889958071952,2019-03-24 18:30:00,2019-03-24 18:45:00
138,16,6,10,0.010927740452103027,2019-03-24 18:30:00,2019-03-24 18:45:00
141,2,1,1,0.0047423059459058056,2019-03-24 18:30:00,2019-03-24 18:45:00
147,2,1,1,0.0036806036922857844,2019-03-24 18:30:00,2019-03-24 18:45:00
151,2,0,2,0.002541527930709714,2019-03-24 18:30:00,2019-03-24 18:45:00
153,2,1,1,0.005670344841180947,2019-03-24 18:30:00,2019-03-24 18:45:00
154,7,3,4,0.016073905451622315,2019-03-24 18:30:00,2019-03-24 18:45:00
157,5,3,2,0.027775656572105935,2019-03-24 18:30:00,2019-03-24 18:45:00
158,5,3,2,0.007094696977077961,2019-03-24 18:30:00,2019-03-24 18:45:00
159,2,2,0,0.0043995672629338406,2019-03-24 18:30:00,2019-03-24 18:45:00
160,1,1,0,0.00440072330251421,2019-03-24 18:30:00,2019-03-24 18:45:00
164,16,7,9,0.016067784103301452,2019-03-24 18:30:00,2019-03-24 18:45:00
168,7,3,4,0.007012800819391357,2019-03-24 18:30:00,2019-03-24 18:45:00
169,2,1,1,0.016911580381519388,2019-03-24 18:30:00,2019-03-24 18:45:00
170,2,0,2,0.002541527930709714,2019-03-24 18:30:00,2019-03-24 18:45:00
171,1,0,1,0.002541527930709714,2019-03-24 18:30:00,2019-03-24 18:45:00
172,4,4,0,0.007751243254168875,2019-03-24 18:30:00,2019-03-24 18:45:00
173,5,2,3,0.008313953812735716,2019-03-24 18:30:00,2019-03-24 18:45:00
177,7,4,3,0.021701597865122615,2019-03-24 18:30:00,2019-03-24 18:45:00
190,3,2,1,0.021413533914240588,2019-03-24 18:30:00,2019-03-24 18:45:00
191,4,3,1,0.012849640748029682,2019-03-24 18:30:00,2019-03-24 18:45:00
195,1,1,0,0.0034711256166119623,2019-03-24 18:30:00,2019-03-24 18:45:00
196,2,2,0,0.00440072330251421,2019-03-24 18:30:00,2019-03-24 18:45:00
197,7,2,5,0.003981847685119836,2019-03-24 18:30:00,2019-03-24 18:45:00
199,1,1,0,0.0035464466815646337,2019-03-24 18:30:00,2019-03-24 18:45:00
203,2,2,0,0.006973696972414923,2019-03-24 18:30:00,2019-03-24 18:45:00
1,2,1,1,0.016456928120242,2019-03-24 18:45:00,2019-03-24 19:00:00
2,5,4,1,0.008544976600718773,2019-03-24 18:45:00,2019-03-24 19:00:00
5,6,3,3,0.016456928120242,2019-03-24 18:45:00,2019-03-24 19:00:00
10,3,0,3,0.0024723189780918005,2019-03-24 18:45:00,2019-03-24 19:00:00
15,9,2,7,0.004786374917727384,2019-03-24 18:45:00,2019-03-24 19:00:00
16,11,6,5,0.010190900195407974,2019-03-24 18:45:00,2019-03-24 19:00:00
18,7,5,2,0.011784519675604515,2019-03-24 18:45:00,2019-03-24 19:00:00
19,2,0,2,0.0024723189780918005,2019-03-24 18:45:00,2019-03-24 19:00:00
20,1,1,0,0.0035528323570227817,2019-03-24 18:45:00,2019-03-24 19:00:00
23,7,1,6,0.0031728751309212737,2019-03-24 18:45:00,2019-03-24 19:00:00
26,7,3,4,0.008959846443149531,2019-03-24 18:45:00,2019-03-24 19:00:00
27,9,5,4,0.010866601136309868,2019-03-24 18:45:00,2019-03-24 19:00:00
30,3,3,0,0.008583239710911347,2019-03-24 18:45:00,2019-03-24 19:00:00
35,1,1,0,0.004573987436580221,2019-03-24 18:45:00,2019-03-24 19:00:00
41,6,3,3,0.005765071412307258,2019-03-24 18:45:00,2019-03-24 19:00:00
46,5,1,4,0.0030536100229293433,2019-03-24 18:45:00,2019-03-24 19:00:00
57,4,3,1,0.06240208508437392,2019-03-24 18:45:00,2019-03-24 19:00:00
58,5,2,3,0.005937848767687881,2019-03-24 18:45:00,2019-03-24 19:00:00
61,3,0,3,0.0024723189780918005,2019-03-24 18:45:00,2019-03-24 19:00:00
62,5,3,2,0.005952136610458696,2019-03-24 18:45:00,2019-03-24 19:00:00
64,2,1,1,0.016456928120242,2019-03-24 18:45:00,2019-03-24 19:00:00
66,2,1,1,0.016456928120242,2019-03-24 18:45:00,2019-03-24 19:00:00
67,8,2,6,0.003449888827827058,2019-03-24 18:45:00,2019-03-24 19:00:00
68,2,1,1,0.004567273411819294,2019-03-24 18:45:00,2019-03-24 19:00:00
69,5,2,3,0.00570637101043662,2019-03-24 18:45:00,2019-03-24 19:00:00
70,6,1,5,0.0029787577973808465,2019-03-24 18:45:00,2019-03-24 19:00:00
74,8,3,5,0.005046205298375703,2019-03-24 18:45:00,2019-03-24 19:00:00
75,1,0,1,0.0024723189780918005,2019-03-24 18:45:00,2019-03-24 19:00:00
79,1,0,1,0.0024723189780918005,2019-03-24 18:45:00,2019-03-24 19:00:00
86,2,2,0,0.004188243191614403,2019-03-24 18:45:00,2019-03-24 19:00:00
87,2,1,1,0.016456928120242,2019-03-24 18:45:00,2019-03-24 19:00:00
88,1,0,1,0.0024723189780918005,2019-03-24 18:45:00,2019-03-24 19:00:00
89,2,0,2,0.0024723189780918005,2019-03-24 18:45:00,2019-03-24 19:00:00
90,2,1,1,0.004573987436580221,2019-03-24 18:45:00,2019-03-24 19:00:00
101,2,1,1,0.016456928120242,2019-03-24 18:45:00,2019-03-24 19:00:00
104,2,2,0,0.014542298547508114,2019-03-24 18:45:00,2019-03-24 19:00:00
108,4,2,2,0.016456928120242,2019-03-24 18:45:00,2019-03-24 19:00:00
109,8,7,1,0.007854375421450996,2019-03-24 18:45:00,2019-03-24 19:00:00
110,1,1,0,0.00758895248334676,2019-03-24 18:45:00,2019-03-24 19:00:00
112,4,3,1,0.0039347316910618825,2019-03-24 18:45:00,2019-03-24 19:00:00
113,1,1,0,0.004089344994264211,2019-03-24 18:45:00,2019-03-24 19:00:00
114,3,1,2,0.004376598668381492,2019-03-24 18:45:00,2019-03-24 19:00:00
115,11,5,6,0.014785561659090004,2019-03-24 18:45:00,2019-03-24 19:00:00
116,2,1,1,0.0029218540524837905,2019-03-24 18:45:00,2019-03-24 19:00:00
118,1,1,0,0.004332636419002535,2019-03-24 18:45:00,2019-03-24 19:00:00
119,12,3,9,0.009356869972975669,2019-03-24 18:45:00,2019-03-24 19:00:00
120,1,1,0,0.0029218540524837905,2019-03-24 18:45:00,2019-03-24 19:00:00
122,5,3,2,0.04232447794605398,2019-03-24 18:45:00,2019-03-24 19:00:00
127,2,1,1,0.005817190309757997,2019-03-24 18:45:00,2019-03-24 19:00:00
137,12,8,4,0.024071301049042163,2019-03-24 18:45:00,2019-03-24 19:00:00
138,10,3,7,0.006032543839167645,2019-03-24 18:45:00,2019-03-24 19:00:00
141,2,1,1,0.004205083872889841,2019-03-24 18:45:00,2019-03-24 19:00:00
147,2,1,1,0.004567273411819294,2019-03-24 18:45:00,2019-03-24 19:00:00
151,2,1,1,0.016456928120242,2019-03-24 18:45:00,2019-03-24 19:00:00
153,6,1,5,0.006355049624261384,2019-03-24 18:45:00,2019-03-24 19:00:00
154,3,1,2,0.0030536100229293433,2019-03-24 18:45:00,2019-03-24 19:00:00
157,4,2,2,0.016456928120242,2019-03-24 18:45:00,2019-03-24 19:00:00
158,6,4,2,0.014197511906940272,2019-03-24 18:45:00,2019-03-24 19:00:00
159,2,2,0,0.003937589405440151,2019-03-24 18:45:00,2019-03-24 19:00:00
160,1,1,0,0.004376598668381492,2019-03-24 18:45:00,2019-03-24 19:00:00
164,16,10,6,0.022854081284617918,2019-03-24 18:45:00,2019-03-24 19:00:00
168,15,7,8,0.009655265631178817,2019-03-24 18:45:00,2019-03-24 19:00:00
169,2,1,1,0.016456928120242,2019-03-24 18:45:00,2019-03-24 19:00:00
170,2,0,2,0.0024723189780918005,2019-03-24 18:45:00,2019-03-24 19:00:00
171,1,0,1,0.0024723189780918005,2019-03-24 18:45:00,2019-03-24 19:00:00
172,4,4,0,0.006846036264370951,2019-03-24 18:45:00,2019-03-24 19:00:00
173,4,2,2,0.005837857039185875,2019-03-24 18:45:00,2019-03-24 19:00:00
177,3,2,1,0.02111846450095873,2019-03-24 18:45:00,2019-03-24 19:00:00
191,3,2,1,0.00849800935485038,2019-03-24 18:45:00,2019-03-24 19:00:00
195,1,1,0,0.002961103902959429,2019-03-24 18:45:00,2019-03-24 19:00:00
196,6,6,0,0.006162565417537471,2019-03-24 18:45:00,2019-03-24 19:00:00
197,5,2,3,0.003873431283750747,2019-03-24 18:45:00,2019-03-24 19:00:00
201,1,1,0,0.007481505481069475,2019-03-24 18:45:00,2019-03-24 19:00:00
203,1,1,0,0.009736801209370712,2019-03-24 18:45:00,2019-03-24 19:00:00
1,2,1,1,0.018380850613708623,2019-03-24 19:00:00,2019-03-24 19:15:00
2,8,5,3,0.016348725567058388,2019-03-24 19:00:00,2019-03-24 19:15:00
5,7,4,3,0.02272544111923809,2019-03-24 19:00:00,2019-03-24 19:15:00
10,3,0,3,0.0027625069071098244,2019-03-24 19:00:00,2019-03-24 19:15:00
15,10,2,8,0.005297418286974502,2019-03-24 19:00:00,2019-03-24 19:15:00
16,9,5,4,0.009856351505003639,2019-03-24 19:00:00,2019-03-24 19:15:00
18,13,6,7,0.010094017000523179,2019-03-24 19:00:00,2019-03-24 19:15:00
19,3,2,1,0.0056721254529606205,2019-03-24 19:00:00,2019-03-24 19:15:00
23,5,0,5,0.0027625069071098244,2019-03-24 19:00:00,2019-03-24 19:15:00
26,7,4,3,0.016214710103662364,2019-03-24 19:00:00,2019-03-24 19:15:00
27,1,0,1,0.0027625069071098244,2019-03-24 19:00:00,2019-03-24 19:15:00
30,4,4,0,0.007232814595142787,2019-03-24 19:00:00,2019-03-24 19:15:00
41,5,0,5,0.0027625069071098244,2019-03-24 19:00:00,2019-03-24 19:15:00
46,2,2,0,0.00397990830509182,2019-03-24 19:00:00,2019-03-24 19:15:00
50,3,0,3,0.0027625069071098244,2019-03-24 19:00:00,2019-03-24 19:15:00
57,4,2,2,0.012798059086284104,2019-03-24 19:00:00,2019-03-24 19:15:00
58,6,4,2,0.00913656806142217,2019-03-24 19:00:00,2019-03-24 19:15:00
61,2,1,1,0.018380850613708623,2019-03-24 19:00:00,2019-03-24 19:15:00
62,3,1,2,0.0034169813085212592,2019-03-24 19:00:00,2019-03-24 19:15:00
66,2,1,1,0.018380850613708623,2019-03-24 19:00:00,2019-03-24 19:15:00
67,9,3,6,0.005884921864684409,2019-03-24 19:00:00,2019-03-24 19:15:00
69,5,2,3,0.006376052788244688,2019-03-24 19:00:00,2019-03-24 19:15:00
70,4,0,4,0.0027625069071098244,2019-03-24 19:00:00,2019-03-24 19:15:00
74,1,1,0,0.003988337657328335,2019-03-24 19:00:00,2019-03-24 19:15:00
75,1,0,1,0.0027625069071098244,2019-03-24 19:00:00,2019-03-24 19:15:00
87,4,1,3,0.0038548082923817277,2019-03-24 19:00:00,2019-03-24 19:15:00
89,2,0,2,0.0027625069071098244,2019-03-24 19:00:00,2019-03-24 19:15:00
90,6,2,4,0.008294657292697578,2019-03-24 19:00:00,2019-03-24 19:15:00
101,2,1,1,0.018380850613708623,2019-03-24 19:00:00,2019-03-24 19:15:00
108,4,2,2,0.018380850613708623,2019-03-24 19:00:00,2019-03-24 19:15:00
109,6,2,4,0.00464281205873977,2019-03-24 19:00:00,2019-03-24 19:15:00
110,2,2,0,0.005412763851667994,2019-03-24 19:00:00,2019-03-24 19:15:00
111,2,2,0,0.006288256116545602,2019-03-24 19:00:00,2019-03-24 19:15:00
112,3,2,1,0.0039366760115703715,2019-03-24 19:00:00,2019-03-24 19:15:00
113,4,4,0,0.014957252011015993,2019-03-24 19:00:00,2019-03-24 19:15:00
114,1,0,1,0.0027625069071098244,2019-03-24 19:00:00,2019-03-24 19:15:00
115,7,4,3,0.012156737898102187,2019-03-24 19:00:00,2019-03-24 19:15:00
116,2,0,2,0.0027625069071098244,2019-03-24 19:00:00,2019-03-24 19:15:00
119,11,3,8,0.006158785657920304,2019-03-24 19:00:00,2019-03-24 19:15:00
120,2,2,0,0.006578664155653644,2019-03-24 19:00:00,2019-03-24 19:15:00
122,8,3,5,0.006857133505025588,2019-03-24 19:00:00,2019-03-24 19:15:00
127,1,0,1,0.0027625069071098244,2019-03-24 19:00:00,2019-03-24 19:15:00
135,2,1,1,0.018380850613708623,2019-03-24 19:00:00,2019-03-24 19:15:00
137,12,6,6,0.01473134012237878,2019-03-24 19:00:00,2019-03-24 19:15:00
138,21,11,10,0.017113059612419747,2019-03-24 19:00:00,2019-03-24 19:15:00
140,2,2,0,0.0047359262350767295,2019-03-24 19:00:00,2019-03-24 19:15:00
141,2,1,1,0.004857236098994095,2019-03-24 19:00:00,2019-03-24 19:15:00
151,2,1,1,0.018380850613708623,2019-03-24 19:00:00,2019-03-24 19:15:00
153,5,2,3,0.0051108451160309185,2019-03-24 19:00:00,2019-03-24 19:15:00
154,2,2,0,0.0037951015454646035,2019-03-24 19:00:00,2019-03-24 19:15:00
157,5,3,2,0.033999194320307416,2019-03-24 19:00:00,2019-03-24 19:15:00
159,2,2,0,0.0056721254529606205,2019-03-24 19:00:00,2019-03-24 19:15:00
164,19,11,8,0.01855691835474995,2019-03-24 19:00:00,2019-03-24 19:15:00
168,16,8,8,0.018380850613708623,2019-03-24 19:00:00,2019-03-24 19:15:00
169,2,1,1,0.018380850613708623,2019-03-24 19:00:00,2019-03-24 19:15:00
170,2,1,1,0.018380850613708623,2019-03-24 19:00:00,2019-03-24 19:15:00
172,1,1,0,0.0035963097494344175,2019-03-24 19:00:00,2019-03-24 19:15:00
173,6,3,3,0.007519941338281497,2019-03-24 19:00:00,2019-03-24 19:15:00
177,4,2,2,0.006166220145196681,2019-03-24 19:00:00,2019-03-24 19:15:00
191,3,2,1,0.005893624519004616,2019-03-24 19:00:00,2019-03-24 19:15:00
195,2,2,0,0.014137406197075373,2019-03-24 19:00:00,2019-03-24 19:15:00
196,8,7,1,0.01239962871684402,2019-03-24 19:00:00,2019-03-24 19:15:00
197,2,2,0,0.00432806571305722,2019-03-24 19:00:00,2019-03-24 19:15:00
201,2,2,0,0.009428763884692465,2019-03-24 19:00:00,2019-03-24 19:15:00
203,2,2,0,0.0088502642139019,2019-03-24 19:00:00,2019-03-24 19:15:00
1,2,1,1,0.017481105114092354,2019-03-24 19:15:00,2019-03-24 19:30:00
2,4,2,2,0.006222008423975602,2019-03-24 19:15:00,2019-03-24 19:30:00
5,7,4,3,0.022432762190877042,2019-03-24 19:15:00,2019-03-24 19:30:00
10,2,0,2,0.002626133883738281,2019-03-24 19:15:00,2019-03-24 19:30:00
11,2,1,1,0.017481105114092354,2019-03-24 19:15:00,2019-03-24 19:30:00
15,6,4,2,0.0090490476987035,2019-03-24 19:15:00,2019-03-24 19:30:00
16,4,1,3,0.0033561295624706692,2019-03-24 19:15:00,2019-03-24 19:30:00
18,12,3,9,0.009769840997558774,2019-03-24 19:15:00,2019-03-24 19:30:00
19,2,2,0,0.0049273364152920066,2019-03-24 19:15:00,2019-03-24 19:30:00
20,2,2,0,0.00501059812910595,2019-03-24 19:15:00,2019-03-24 19:30:00
23,5,2,3,0.005781499922783293,2019-03-24 19:15:00,2019-03-24 19:30:00
26,8,3,5,0.005106902845026723,2019-03-24 19:15:00,2019-03-24 19:30:00
27,1,0,1,0.002626133883738281,2019-03-24 19:15:00,2019-03-24 19:30:00
28,6,3,3,0.01121524430318645,2019-03-24 19:15:00,2019-03-24 19:30:00
30,2,2,0,0.004114458833359379,2019-03-24 19:15:00,2019-03-24 19:30:00
35,1,0,1,0.002626133883738281,2019-03-24 19:15:00,2019-03-24 19:30:00
41,5,2,3,0.006756528277683941,2019-03-24 19:15:00,2019-03-24 19:30:00
46,3,1,2,0.00337029635854883,2019-03-24 19:15:00,2019-03-24 19:30:00
50,3,0,3,0.002626133883738281,2019-03-24 19:15:00,2019-03-24 19:30:00
57,7,3,4,0.0056095478642744275,2019-03-24 19:15:00,2019-03-24 19:30:00
58,3,0,3,0.002626133883738281,2019-03-24 19:15:00,2019-03-24 19:30:00
66,3,2,1,0.021092343328388434,2019-03-24 19:15:00,2019-03-24 19:30:00
67,8,3,5,0.00572290992232039,2019-03-24 19:15:00,2019-03-24 19:30:00
70,3,1,2,0.005421991837722916,2019-03-24 19:15:00,2019-03-24 19:30:00
74,2,2,0,0.007442601483793689,2019-03-24 19:15:00,2019-03-24 19:30:00
75,3,2,1,0.004626487634234089,2019-03-24 19:15:00,2019-03-24 19:30:00
79,1,1,0,0.006815199294667373,2019-03-24 19:15:00,2019-03-24 19:30:00
85,1,0,1,0.002626133883738281,2019-03-24 19:15:00,2019-03-24 19:30:00
87,4,3,1,0.0399078230952816,2019-03-24 19:15:00,2019-03-24 19:30:00
88,7,2,5,0.005882341184996769,2019-03-24 19:15:00,2019-03-24 19:30:00
89,1,0,1,0.002626133883738281,2019-03-24 19:15:00,2019-03-24 19:30:00
90,4,1,3,0.005342302460374342,2019-03-24 19:15:00,2019-03-24 19:30:00
99,2,1,1,0.017481105114092354,2019-03-24 19:15:00,2019-03-24 19:30:00
101,2,1,1,0.017481105114092354,2019-03-24 19:15:00,2019-03-24 19:30:00
104,3,3,0,0.006565677854251748,2019-03-24 19:15:00,2019-03-24 19:30:00
108,4,2,2,0.017481105114092354,2019-03-24 19:15:00,2019-03-24 19:30:00
109,9,2,7,0.004471891112965011,2019-03-24 19:15:00,2019-03-24 19:30:00
111,1,1,0,0.0048586213081699275,2019-03-24 19:15:00,2019-03-24 19:30:00
112,6,4,2,0.009159705161068534,2019-03-24 19:15:00,2019-03-24 19:30:00
113,4,4,0,0.006978904502376586,2019-03-24 19:15:00,2019-03-24 19:30:00
114,1,1,0,0.005804445381246543,2019-03-24 19:15:00,2019-03-24 19:30:00
115,12,5,7,0.008052393320594806,2019-03-24 19:15:00,2019-03-24 19:30:00
119,3,0,3,0.002626133883738281,2019-03-24 19:15:00,2019-03-24 19:30:00
120,2,2,0,0.010366401614464943,2019-03-24 19:15:00,2019-03-24 19:30:00
122,5,3,2,0.02753165833366452,2019-03-24 19:15:00,2019-03-24 19:30:00
126,1,1,0,0.00360418316343132,2019-03-24 19:15:00,2019-03-24 19:30:00
127,2,0,2,0.002626133883738281,2019-03-24 19:15:00,2019-03-24 19:30:00
135,2,1,1,0.017481105114092354,2019-03-24 19:15:00,2019-03-24 19:30:00
137,10,6,4,0.012777737724011067,2019-03-24 19:15:00,2019-03-24 19:30:00
138,25,12,13,0.017593452363529542,2019-03-24 19:15:00,2019-03-24 19:30:00
140,3,3,0,0.004712524264785835,2019-03-24 19:15:00,2019-03-24 19:30:00
141,5,3,2,0.005307360557042843,2019-03-24 19:15:00,2019-03-24 19:30:00
151,2,1,1,0.017481105114092354,2019-03-24 19:15:00,2019-03-24 19:30:00
153,3,3,0,0.006773264102376963,2019-03-24 19:15:00,2019-03-24 19:30:00
154,5,2,3,0.005950821523281687,2019-03-24 19:15:00,2019-03-24 19:30:00
157,2,1,1,0.017481105114092354,2019-03-24 19:15:00,2019-03-24 19:30:00
159,3,2,1,0.0049273364152920066,2019-03-24 19:15:00,2019-03-24 19:30:00
164,15,5,10,0.008586213664030399,2019-03-24 19:15:00,2019-03-24 19:30:00
168,7,4,3,0.021092343328388434,2019-03-24 19:15:00,2019-03-24 19:30:00
169,2,1,1,0.017481105114092354,2019-03-24 19:15:00,2019-03-24 19:30:00
171,1,0,1,0.002626133883738281,2019-03-24 19:15:00,2019-03-24 19:30:00
172,1,1,0,0.003599221270140904,2019-03-24 19:15:00,2019-03-24 19:30:00
173,6,5,1,0.038832460788421154,2019-03-24 19:15:00,2019-03-24 19:30:00
177,3,1,2,0.004567700938142123,2019-03-24 19:15:00,2019-03-24 19:30:00
190,2,0,2,0.002626133883738281,2019-03-24 19:15:00,2019-03-24 19:30:00
191,2,2,0,0.0044865400707646535,2019-03-24 19:15:00,2019-03-24 19:30:00
195,2,2,0,0.00639507922412554,2019-03-24 19:15:00,2019-03-24 19:30:00
196,6,4,2,0.006577470470474248,2019-03-24 19:15:00,2019-03-24 19:30:00
197,4,2,2,0.0048586213081699275,2019-03-24 19:15:00,2019-03-24 19:30:00
201,2,2,0,0.0060508534308537625,2019-03-24 19:15:00,2019-03-24 19:30:00
203,2,2,0,0.006421555570428197,2019-03-24 19:15:00,2019-03-24 19:30:00
1,4,2,2,0.016614091919132015,2019-03-24 19:30:00,2019-03-24 19:45:00
2,2,1,1,0.004807775644075988,2019-03-24 19:30:00,2019-03-24 19:45:00
5,7,4,3,0.023673708185883883,2019-03-24 19:30:00,2019-03-24 19:45:00
10,2,0,2,0.002494859385628283,2019-03-24 19:30:00,2019-03-24 19:45:00
11,2,1,1,0.016614091919132015,2019-03-24 19:30:00,2019-03-24 19:45:00
15,6,4,2,0.01007785539821697,2019-03-24 19:30:00,2019-03-24 19:45:00
16,7,3,4,0.010881731839757033,2019-03-24 19:30:00,2019-03-24 19:45:00
18,9,5,4,0.009950811177444494,2019-03-24 19:30:00,2019-03-24 19:45:00
19,4,1,3,0.003481364574319223,2019-03-24 19:30:00,2019-03-24 19:45:00
20,4,4,0,0.011233793884638302,2019-03-24 19:30:00,2019-03-24 19:45:00
23,4,3,1,0.006022816988037081,2019-03-24 19:30:00,2019-03-24 19:45:00
26,4,1,3,0.005502951552649214,2019-03-24 19:30:00,2019-03-24 19:45:00
27,1,0,1,0.002494859385628283,2019-03-24 19:30:00,2019-03-24 19:45:00
28,6,3,3,0.007312895705111267,2019-03-24 19:30:00,2019-03-24 19:45:00
30,1,1,0,0.004456775893183966,2019-03-24 19:30:00,2019-03-24 19:45:00
35,1,0,1,0.002494859385628283,2019-03-24 19:30:00,2019-03-24 19:45:00
40,2,2,0,0.004615717165986892,2019-03-24 19:30:00,2019-03-24 19:45:00
41,3,1,2,0.004615717165986892,2019-03-24 19:30:00,2019-03-24 19:45:00
46,2,0,2,0.002494859385628283,2019-03-24 19:30:00,2019-03-24 19:45:00
50,4,1,3,0.003481364574319223,2019-03-24 19:30:00,2019-03-24 19:45:00
57,8,5,3,0.012936324909155462,2019-03-24 19:30:00,2019-03-24 19:45:00
58,2,1,1,0.00353848800378176,2019-03-24 19:30:00,2019-03-24 19:45:00
66,2,1,1,0.016614091919132015,2019-03-24 19:30:00,2019-03-24 19:45:00
67,6,2,4,0.004339316884010801,2019-03-24 19:30:00,2019-03-24 19:45:00
68,1,0,1,0.002494859385628283,2019-03-24 19:30:00,2019-03-24 19:45:00
70,1,1,0,0.0036840093037085013,2019-03-24 19:30:00,2019-03-24 19:45:00
74,5,3,2,0.011572995010829888,2019-03-24 19:30:00,2019-03-24 19:45:00
75,3,2,1,0.0030759360444168153,2019-03-24 19:30:00,2019-03-24 19:45:00
79,1,0,1,0.002494859385628283,2019-03-24 19:30:00,2019-03-24 19:45:00
87,6,3,3,0.013314077538694822,2019-03-24 19:30:00,2019-03-24 19:45:00
88,11,2,9,0.0030759360444168153,2019-03-24 19:30:00,2019-03-24 19:45:00
89,3,2,1,0.02857022883849746,2019-03-24 19:30:00,2019-03-24 19:45:00
90,2,0,2,0.002494859385628283,2019-03-24 19:30:00,2019-03-24 19:45:00
101,2,1,1,0.016614091919132015,2019-03-24 19:30:00,2019-03-24 19:45:00
104,4,2,2,0.0039019592076784725,2019-03-24 19:30:00,2019-03-24 19:45:00
108,5,3,2,0.049318334151708096,2019-03-24 19:30:00,2019-03-24 19:45:00
109,9,4,5,0.006987485661042812,2019-03-24 19:30:00,2019-03-24 19:45:00
110,4,4,0,0.008234882759828338,2019-03-24 19:30:00,2019-03-24 19:45:00
112,3,1,2,0.004807775644075988,2019-03-24 19:30:00,2019-03-24 19:45:00
113,1,1,0,0.007457726789592771,2019-03-24 19:30:00,2019-03-24 19:45:00
114,1,1,0,0.004567220061350293,2019-03-24 19:30:00,2019-03-24 19:45:00
115,5,1,4,0.0031681743536672467,2019-03-24 19:30:00,2019-03-24 19:45:00
116,2,2,0,0.005812008226681201,2019-03-24 19:30:00,2019-03-24 19:45:00
119,2,0,2,0.002494859385628283,2019-03-24 19:30:00,2019-03-24 19:45:00
120,1,1,0,0.00677885757372919,2019-03-24 19:30:00,2019-03-24 19:45:00
122,5,3,2,0.02367370818588388,2019-03-24 19:30:00,2019-03-24 19:45:00
126,1,1,0,0.0031681743536672467,2019-03-24 19:30:00,2019-03-24 19:45:00
127,3,1,2,0.003481364574319223,2019-03-24 19:30:00,2019-03-24 19:45:00
137,13,7,6,0.012701848245086087,2019-03-24 19:30:00,2019-03-24 19:45:00
138,11,4,7,0.005792966134953098,2019-03-24 19:30:00,2019-03-24 19:45:00
140,2,1,1,0.002785397715022549,2019-03-24 19:30:00,2019-03-24 19:45:00
141,7,5,2,0.012148848132237943,2019-03-24 19:30:00,2019-03-24 19:45:00
147,1,1,0,0.0031681743536672467,2019-03-24 19:30:00,2019-03-24 19:45:00
153,3,3,0,0.006994017002147328,2019-03-24 19:30:00,2019-03-24 19:45:00
154,4,2,2,0.00828829842947292,2019-03-24 19:30:00,2019-03-24 19:45:00
157,4,3,1,0.03242436223262764,2019-03-24 19:30:00,2019-03-24 19:45:00
158,4,1,3,0.003682905994074414,2019-03-24 19:30:00,2019-03-24 19:45:00
164,12,3,9,0.009629244471488633,2019-03-24 19:30:00,2019-03-24 19:45:00
168,6,4,2,0.04960838837974919,2019-03-24 19:30:00,2019-03-24 19:45:00
169,2,1,1,0.016614091919132015,2019-03-24 19:30:00,2019-03-24 19:45:00
171,5,1,4,0.0031681743536672467,2019-03-24 19:30:00,2019-03-24 19:45:00
172,2,2,0,0.005379004642375224,2019-03-24 19:30:00,2019-03-24 19:45:00
173,4,3,1,0.03736888168075525,2019-03-24 19:30:00,2019-03-24 19:45:00
177,4,2,2,0.01167522903423691,2019-03-24 19:30:00,2019-03-24 19:45:00
191,3,2,1,0.004961122357355634,2019-03-24 19:30:00,2019-03-24 19:45:00
195,1,1,0,0.0034170881348195422,2019-03-24 19:30:00,2019-03-24 19:45:00
196,9,4,5,0.006994017002147328,2019-03-24 19:30:00,2019-03-24 19:45:00
197,2,2,0,0.004615717165986892,2019-03-24 19:30:00,2019-03-24 19:45:00
199,1,0,1,0.002494859385628283,2019-03-24 19:30:00,2019-03-24 19:45:00
201,2,0,2,0.002494859385628283,2019-03-24 19:30:00,2019-03-24 19:45:00
203,2,2,0,0.007285839541648017,2019-03-24 19:30:00,2019-03-24 19:45:00
1,9,5,4,0.010985877125797945,2019-03-24 19:45:00,2019-03-24 20:00:00
2,1,0,1,0.002541124246177337,2019-03-24 19:45:00,2019-03-24 20:00:00
5,7,4,3,0.019714712016410202,2019-03-24 19:45:00,2019-03-24 20:00:00
10,2,0,2,0.002541124246177337,2019-03-24 19:45:00,2019-03-24 20:00:00
15,9,7,2,0.01971081786878904,2019-03-24 19:45:00,2019-03-24 20:00:00
16,5,5,0,0.00869735685742418,2019-03-24 19:45:00,2019-03-24 20:00:00
18,3,3,0,0.00620077955678978,2019-03-24 19:45:00,2019-03-24 20:00:00
19,2,0,2,0.002541124246177337,2019-03-24 19:45:00,2019-03-24 20:00:00
20,2,2,0,0.008014696559064949,2019-03-24 19:45:00,2019-03-24 20:00:00
23,8,4,4,0.008853599419390895,2019-03-24 19:45:00,2019-03-24 20:00:00
26,2,1,1,0.0067211986215156274,2019-03-24 19:45:00,2019-03-24 20:00:00
27,1,0,1,0.002541124246177337,2019-03-24 19:45:00,2019-03-24 20:00:00
28,2,2,0,0.0034591798123048308,2019-03-24 19:45:00,2019-03-24 20:00:00
30,1,1,0,0.004951260505037771,2019-03-24 19:45:00,2019-03-24 20:00:00
40,2,2,0,0.004701260166476984,2019-03-24 19:45:00,2019-03-24 20:00:00
41,3,1,2,0.0056701514083552585,2019-03-24 19:45:00,2019-03-24 20:00:00
46,2,1,1,0.00296057567634031,2019-03-24 19:45:00,2019-03-24 20:00:00
50,1,0,1,0.002541124246177337,2019-03-24 19:45:00,2019-03-24 20:00:00
57,6,4,2,0.021388416261322245,2019-03-24 19:45:00,2019-03-24 20:00:00
58,5,4,1,0.004917273758506948,2019-03-24 19:45:00,2019-03-24 20:00:00
62,1,1,0,0.0032611695529438855,2019-03-24 19:45:00,2019-03-24 20:00:00
66,2,1,1,0.016922355959731888,2019-03-24 19:45:00,2019-03-24 20:00:00
67,6,2,4,0.004419682289699276,2019-03-24 19:45:00,2019-03-24 20:00:00
68,1,0,1,0.002541124246177337,2019-03-24 19:45:00,2019-03-24 20:00:00
70,2,1,1,0.016922355959731888,2019-03-24 19:45:00,2019-03-24 20:00:00
74,5,2,3,0.005053025738151518,2019-03-24 19:45:00,2019-03-24 20:00:00
75,2,2,0,0.00300567892511657,2019-03-24 19:45:00,2019-03-24 20:00:00
79,4,2,2,0.007361396763898206,2019-03-24 19:45:00,2019-03-24 20:00:00
87,4,1,3,0.0035458848429670096,2019-03-24 19:45:00,2019-03-24 20:00:00
88,13,2,11,0.00300567892511657,2019-03-24 19:45:00,2019-03-24 20:00:00
89,1,1,0,0.003539612567855627,2019-03-24 19:45:00,2019-03-24 20:00:00
90,4,2,2,0.012430901585742081,2019-03-24 19:45:00,2019-03-24 20:00:00
101,2,1,1,0.016922355959731888,2019-03-24 19:45:00,2019-03-24 20:00:00
104,3,1,2,0.008929945779378303,2019-03-24 19:45:00,2019-03-24 20:00:00
108,6,4,2,0.035982302038089525,2019-03-24 19:45:00,2019-03-24 20:00:00
109,11,4,7,0.003869733293236429,2019-03-24 19:45:00,2019-03-24 20:00:00
110,6,6,0,0.009874362148856253,2019-03-24 19:45:00,2019-03-24 20:00:00
111,3,1,2,0.011632808162633828,2019-03-24 19:45:00,2019-03-24 20:00:00
112,2,0,2,0.002541124246177337,2019-03-24 19:45:00,2019-03-24 20:00:00
113,6,2,4,0.006334092383300462,2019-03-24 19:45:00,2019-03-24 20:00:00
115,7,3,4,0.007011875770682366,2019-03-24 19:45:00,2019-03-24 20:00:00
116,6,2,4,0.010133554793528328,2019-03-24 19:45:00,2019-03-24 20:00:00
119,7,1,6,0.00296057567634031,2019-03-24 19:45:00,2019-03-24 20:00:00
122,6,4,2,0.0871384084162635,2019-03-24 19:45:00,2019-03-24 20:00:00
127,3,0,3,0.002541124246177337,2019-03-24 19:45:00,2019-03-24 20:00:00
137,24,12,12,0.014093515635686997,2019-03-24 19:45:00,2019-03-24 20:00:00
138,8,4,4,0.01287543671642467,2019-03-24 19:45:00,2019-03-24 20:00:00
140,1,0,1,0.002541124246177337,2019-03-24 19:45:00,2019-03-24 20:00:00
141,5,3,2,0.0059382981027362725,2019-03-24 19:45:00,2019-03-24 20:00:00
147,1,1,0,0.0032269024728352144,2019-03-24 19:45:00,2019-03-24 20:00:00
151,3,1,2,0.0056701514083552585,2019-03-24 19:45:00,2019-03-24 20:00:00
153,4,2,2,0.016922355959731888,2019-03-24 19:45:00,2019-03-24 20:00:00
154,2,2,0,0.005108758046465229,2019-03-24 19:45:00,2019-03-24 20:00:00
157,4,3,1,0.023178844602160017,2019-03-24 19:45:00,2019-03-24 20:00:00
158,5,0,5,0.002541124246177337,2019-03-24 19:45:00,2019-03-24 20:00:00
164,10,3,7,0.008629884958442035,2019-03-24 19:45:00,2019-03-24 20:00:00
168,5,3,2,0.02361059151811433,2019-03-24 19:45:00,2019-03-24 20:00:00
169,2,1,1,0.016922355959731888,2019-03-24 19:45:00,2019-03-24 20:00:00
170,2,2,0,0.003481002477241705,2019-03-24 19:45:00,2019-03-24 20:00:00
171,5,1,4,0.0032269024728352144,2019-03-24 19:45:00,2019-03-24 20:00:00
172,6,6,0,0.010350135931526469,2019-03-24 19:45:00,2019-03-24 20:00:00
173,6,4,2,0.015028544348667502,2019-03-24 19:45:00,2019-03-24 20:00:00
177,4,2,2,0.00575647553558485,2019-03-24 19:45:00,2019-03-24 20:00:00
191,9,3,6,0.005424386958244189,2019-03-24 19:45:00,2019-03-24 20:00:00
195,1,1,0,0.003480403267938307,2019-03-24 19:45:00,2019-03-24 20:00:00
197,2,2,0,0.004701260166476984,2019-03-24 19:45:00,2019-03-24 20:00:00
199,2,1,1,0.016922355959731888,2019-03-24 19:45:00,2019-03-24 20:00:00
201,2,0,2,0.002541124246177337,2019-03-24 19:45:00,2019-03-24 20:00:00
203,1,1,0,0.004701260166476984,2019-03-24 19:45:00,2019-03-24 20:00:00
1,5,3,2,0.010545139467504908,2019-03-24 20:00:00,2019-03-24 20:15:00
2,1,0,1,0.0022920426563118237,2019-03-24 20:00:00,2019-03-24 20:15:00
5,7,4,3,0.02824712516192189,2019-03-24 20:00:00,2019-03-24 20:15:00
10,2,2,0,0.003071419513704082,2019-03-24 20:00:00,2019-03-24 20:15:00
11,1,0,1,0.0022920426563118237,2019-03-24 20:00:00,2019-03-24 20:15:00
15,10,8,2,0.01043750445387131,2019-03-24 20:00:00,2019-03-24 20:15:00
16,6,6,0,0.007985744596224718,2019-03-24 20:00:00,2019-03-24 20:15:00
18,6,6,0,0.00734455643290481,2019-03-24 20:00:00,2019-03-24 20:15:00
19,3,2,1,0.010280933967201483,2019-03-24 20:00:00,2019-03-24 20:15:00
20,5,0,5,0.0022920426563118237,2019-03-24 20:00:00,2019-03-24 20:15:00
23,7,2,5,0.0048309731384338795,2019-03-24 20:00:00,2019-03-24 20:15:00
26,2,1,1,0.005927028214102056,2019-03-24 20:00:00,2019-03-24 20:15:00
27,1,0,1,0.0022920426563118237,2019-03-24 20:00:00,2019-03-24 20:15:00
28,2,2,0,0.004634133267144827,2019-03-24 20:00:00,2019-03-24 20:15:00
40,4,2,2,0.053445061565149415,2019-03-24 20:00:00,2019-03-24 20:15:00
41,2,1,1,0.005114891885080042,2019-03-24 20:00:00,2019-03-24 20:15:00
46,2,0,2,0.0022920426563118237,2019-03-24 20:00:00,2019-03-24 20:15:00
50,4,2,2,0.01025686340280741,2019-03-24 20:00:00,2019-03-24 20:15:00
57,11,8,3,0.014095144279224831,2019-03-24 20:00:00,2019-03-24 20:15:00
58,3,2,1,0.004275761258358395,2019-03-24 20:00:00,2019-03-24 20:15:00
61,5,2,3,0.005290607150200739,2019-03-24 20:00:00,2019-03-24 20:15:00
62,1,1,0,0.004177150565770085,2019-03-24 20:00:00,2019-03-24 20:15:00
66,3,1,2,0.003986571946805663,2019-03-24 20:00:00,2019-03-24 20:15:00
67,7,2,5,0.003473019333594643,2019-03-24 20:00:00,2019-03-24 20:15:00
70,2,1,1,0.015269583909116856,2019-03-24 20:00:00,2019-03-24 20:15:00
74,2,0,2,0.0022920426563118237,2019-03-24 20:00:00,2019-03-24 20:15:00
75,4,2,2,0.003977659384088914,2019-03-24 20:00:00,2019-03-24 20:15:00
79,4,2,2,0.006640582486837126,2019-03-24 20:00:00,2019-03-24 20:15:00
87,2,1,1,0.015269583909116856,2019-03-24 20:00:00,2019-03-24 20:15:00
88,7,2,5,0.004957004584632969,2019-03-24 20:00:00,2019-03-24 20:15:00
90,8,5,3,0.008192769206047446,2019-03-24 20:00:00,2019-03-24 20:15:00
101,2,1,1,0.015269583909116856,2019-03-24 20:00:00,2019-03-24 20:15:00
108,6,4,2,0.02824712516192189,2019-03-24 20:00:00,2019-03-24 20:15:00
109,4,1,3,0.003087501343322514,2019-03-24 20:00:00,2019-03-24 20:15:00
110,7,5,2,0.014700396936703377,2019-03-24 20:00:00,2019-03-24 20:15:00
111,5,2,3,0.005281130876031967,2019-03-24 20:00:00,2019-03-24 20:15:00
112,4,0,4,0.0022920426563118237,2019-03-24 20:00:00,2019-03-24 20:15:00
113,5,0,5,0.0022920426563118237,2019-03-24 20:00:00,2019-03-24 20:15:00
114,2,2,0,0.0034917602092050734,2019-03-24 20:00:00,2019-03-24 20:15:00
115,8,3,5,0.0046784187173438945,2019-03-24 20:00:00,2019-03-24 20:15:00
116,8,3,5,0.0036732717460654977,2019-03-24 20:00:00,2019-03-24 20:15:00
119,1,0,1,0.0022920426563118237,2019-03-24 20:00:00,2019-03-24 20:15:00
120,3,2,1,0.004087633740803075,2019-03-24 20:00:00,2019-03-24 20:15:00
122,8,5,3,0.0461769211769273,2019-03-24 20:00:00,2019-03-24 20:15:00
126,1,0,1,0.0022920426563118237,2019-03-24 20:00:00,2019-03-24 20:15:00
127,4,1,3,0.006652013113915971,2019-03-24 20:00:00,2019-03-24 20:15:00
137,19,10,9,0.013703428864980997,2019-03-24 20:00:00,2019-03-24 20:15:00
138,2,2,0,0.007524282891239159,2019-03-24 20:00:00,2019-03-24 20:15:00
140,3,0,3,0.0022920426563118237,2019-03-24 20:00:00,2019-03-24 20:15:00
141,4,2,2,0.0037843317346939174,2019-03-24 20:00:00,2019-03-24 20:15:00
151,3,1,2,0.005114891885080042,2019-03-24 20:00:00,2019-03-24 20:15:00
153,7,1,6,0.0026703901964541454,2019-03-24 20:00:00,2019-03-24 20:15:00
154,3,1,2,0.003986571946805663,2019-03-24 20:00:00,2019-03-24 20:15:00
157,3,2,1,0.026552595871428053,2019-03-24 20:00:00,2019-03-24 20:15:00
164,9,2,7,0.004439783215183082,2019-03-24 20:00:00,2019-03-24 20:15:00
168,3,2,1,0.02824712516192189,2019-03-24 20:00:00,2019-03-24 20:15:00
169,2,1,1,0.015269583909116856,2019-03-24 20:00:00,2019-03-24 20:15:00
171,3,2,1,0.03840997274689891,2019-03-24 20:00:00,2019-03-24 20:15:00
172,6,6,0,0.01013532860751037,2019-03-24 20:00:00,2019-03-24 20:15:00
173,1,1,0,0.006774923648588386,2019-03-24 20:00:00,2019-03-24 20:15:00
177,2,1,1,0.015269583909116856,2019-03-24 20:00:00,2019-03-24 20:15:00
191,4,1,3,0.0026817310850079526,2019-03-24 20:00:00,2019-03-24 20:15:00
195,1,1,0,0.0028825309949532334,2019-03-24 20:00:00,2019-03-24 20:15:00
196,1,0,1,0.0022920426563118237,2019-03-24 20:00:00,2019-03-24 20:15:00
197,2,1,1,0.004240484799792469,2019-03-24 20:00:00,2019-03-24 20:15:00
199,2,1,1,0.015269583909116856,2019-03-24 20:00:00,2019-03-24 20:15:00
201,6,4,2,0.06021546402065419,2019-03-24 20:00:00,2019-03-24 20:15:00
203,1,1,0,0.004240484799792469,2019-03-24 20:00:00,2019-03-24 20:15:00
1,3,1,2,0.004666205548198667,2019-03-24 20:15:00,2019-03-24 20:30:00
2,3,0,3,0.0026828070032683783,2019-03-24 20:15:00,2019-03-24 20:30:00
5,5,4,1,0.06177044110317399,2019-03-24 20:15:00,2019-03-24 20:30:00
10,2,2,0,0.0038231243346968187,2019-03-24 20:15:00,2019-03-24 20:30:00
11,1,0,1,0.0026828070032683783,2019-03-24 20:15:00,2019-03-24 20:30:00
15,5,5,0,0.012013325218231147,2019-03-24 20:15:00,2019-03-24 20:30:00
16,3,3,0,0.005973871290537094,2019-03-24 20:15:00,2019-03-24 20:30:00
18,8,4,4,0.010368160400313558,2019-03-24 20:15:00,2019-03-24 20:30:00
19,1,0,1,0.0026828070032683783,2019-03-24 20:15:00,2019-03-24 20:30:00
20,2,0,2,0.0026828070032683783,2019-03-24 20:15:00,2019-03-24 20:30:00
23,4,2,2,0.007050230195943898,2019-03-24 20:15:00,2019-03-24 20:30:00
26,1,0,1,0.0026828070032683783,2019-03-24 20:15:00,2019-03-24 20:30:00
27,2,1,1,0.004086573868073096,2019-03-24 20:15:00,2019-03-24 20:30:00
41,2,1,1,0.004963441666125258,2019-03-24 20:15:00,2019-03-24 20:30:00
46,6,1,5,0.0032323734125506084,2019-03-24 20:15:00,2019-03-24 20:30:00
50,1,1,0,0.006902241722300745,2019-03-24 20:15:00,2019-03-24 20:30:00
57,6,4,2,0.012599799727919823,2019-03-24 20:15:00,2019-03-24 20:30:00
58,1,0,1,0.0026828070032683783,2019-03-24 20:15:00,2019-03-24 20:30:00
61,4,2,2,0.017850678565758248,2019-03-24 20:15:00,2019-03-24 20:30:00
66,3,1,2,0.004666205548198667,2019-03-24 20:15:00,2019-03-24 20:30:00
67,7,2,5,0.004065118582532651,2019-03-24 20:15:00,2019-03-24 20:30:00
68,1,1,0,0.006359074406311761,2019-03-24 20:15:00,2019-03-24 20:30:00
70,2,1,1,0.017850678565758248,2019-03-24 20:15:00,2019-03-24 20:30:00
75,2,0,2,0.0026828070032683783,2019-03-24 20:15:00,2019-03-24 20:30:00
79,1,0,1,0.0026828070032683783,2019-03-24 20:15:00,2019-03-24 20:30:00
87,2,1,1,0.017850678565758248,2019-03-24 20:15:00,2019-03-24 20:30:00
88,8,7,1,0.011178217215252037,2019-03-24 20:15:00,2019-03-24 20:30:00
89,5,2,3,0.004203230111839632,2019-03-24 20:15:00,2019-03-24 20:30:00
90,4,4,0,0.020083358692859408,2019-03-24 20:15:00,2019-03-24 20:30:00
101,2,1,1,0.017850678565758248,2019-03-24 20:15:00,2019-03-24 20:30:00
104,1,1,0,0.004666205548198667,2019-03-24 20:15:00,2019-03-24 20:30:00
108,4,2,2,0.017850678565758248,2019-03-24 20:15:00,2019-03-24 20:30:00
110,4,2,2,0.010319165065062943,2019-03-24 20:15:00,2019-03-24 20:30:00
111,4,2,2,0.010279001928164198,2019-03-24 20:15:00,2019-03-24 20:30:00
112,6,2,4,0.006604990224834019,2019-03-24 20:15:00,2019-03-24 20:30:00
113,4,0,4,0.0026828070032683783,2019-03-24 20:15:00,2019-03-24 20:30:00
114,2,1,1,0.0062077487793213235,2019-03-24 20:15:00,2019-03-24 20:30:00
115,3,1,2,0.004666205548198667,2019-03-24 20:15:00,2019-03-24 20:30:00
116,3,0,3,0.0026828070032683783,2019-03-24 20:15:00,2019-03-24 20:30:00
120,5,3,2,0.010834833037756734,2019-03-24 20:15:00,2019-03-24 20:30:00
122,6,3,3,0.017850678565758248,2019-03-24 20:15:00,2019-03-24 20:30:00
126,2,1,1,0.0043243555619771395,2019-03-24 20:15:00,2019-03-24 20:30:00
137,8,5,3,0.01875573877045525,2019-03-24 20:15:00,2019-03-24 20:30:00
138,9,3,6,0.011585269568695163,2019-03-24 20:15:00,2019-03-24 20:30:00
140,2,0,2,0.0026828070032683783,2019-03-24 20:15:00,2019-03-24 20:30:00
141,4,2,2,0.013326112217362848,2019-03-24 20:15:00,2019-03-24 20:30:00
153,7,4,3,0.012438679423650298,2019-03-24 20:15:00,2019-03-24 20:30:00
154,1,0,1,0.0026828070032683783,2019-03-24 20:15:00,2019-03-24 20:30:00
157,3,2,1,0.03103515158331783,2019-03-24 20:15:00,2019-03-24 20:30:00
158,2,1,1,0.0043243555619771395,2019-03-24 20:15:00,2019-03-24 20:30:00
164,8,3,5,0.012648875643181647,2019-03-24 20:15:00,2019-03-24 20:30:00
168,3,2,1,0.021642646456380712,2019-03-24 20:15:00,2019-03-24 20:30:00
169,2,1,1,0.017850678565758248,2019-03-24 20:15:00,2019-03-24 20:30:00
171,1,1,0,0.007288453491209887,2019-03-24 20:15:00,2019-03-24 20:30:00
172,8,6,2,0.019023876078363724,2019-03-24 20:15:00,2019-03-24 20:30:00
177,2,1,1,0.017850678565758248,2019-03-24 20:15:00,2019-03-24 20:30:00
195,1,1,0,0.0033739627929005147,2019-03-24 20:15:00,2019-03-24 20:30:00
196,4,0,4,0.0026828070032683783,2019-03-24 20:15:00,2019-03-24 20:30:00
197,2,1,1,0.004963441666125258,2019-03-24 20:15:00,2019-03-24 20:30:00
201,6,3,3,0.01598554762992452,2019-03-24 20:15:00,2019-03-24 20:30:00
202,1,1,0,0.0038738630144818913,2019-03-24 20:15:00,2019-03-24 20:30:00
203,3,3,0,0.012503206327466529,2019-03-24 20:15:00,2019-03-24 20:30:00
1,3,2,1,0.061887321965160176,2019-03-24 20:30:00,2019-03-24 20:45:00
2,4,1,3,0.004383182246402596,2019-03-24 20:30:00,2019-03-24 20:45:00
5,6,4,2,0.00971574629209536,2019-03-24 20:30:00,2019-03-24 20:45:00
10,2,2,0,0.0033761941308946483,2019-03-24 20:30:00,2019-03-24 20:45:00
15,4,2,2,0.008079715943438186,2019-03-24 20:30:00,2019-03-24 20:45:00
16,8,4,4,0.01331737114295076,2019-03-24 20:30:00,2019-03-24 20:45:00
18,15,4,11,0.013870185148793035,2019-03-24 20:30:00,2019-03-24 20:45:00
23,2,0,2,0.0023692060153867,2019-03-24 20:30:00,2019-03-24 20:45:00
26,1,0,1,0.0023692060153867,2019-03-24 20:30:00,2019-03-24 20:45:00
27,2,1,1,0.005936027537713349,2019-03-24 20:30:00,2019-03-24 20:45:00
41,2,2,0,0.005127625552240667,2019-03-24 20:30:00,2019-03-24 20:45:00
46,3,1,2,0.007881271677314037,2019-03-24 20:30:00,2019-03-24 20:45:00
57,5,3,2,0.009680920474799766,2019-03-24 20:30:00,2019-03-24 20:45:00
58,2,0,2,0.0023692060153867,2019-03-24 20:30:00,2019-03-24 20:45:00
66,2,1,1,0.01577707341823835,2019-03-24 20:30:00,2019-03-24 20:45:00
67,6,2,4,0.0041206374367327185,2019-03-24 20:30:00,2019-03-24 20:45:00
68,1,1,0,0.008712037440780501,2019-03-24 20:30:00,2019-03-24 20:45:00
70,2,1,1,0.01577707341823835,2019-03-24 20:30:00,2019-03-24 20:45:00
75,3,1,2,0.003715744909135772,2019-03-24 20:30:00,2019-03-24 20:45:00
79,3,1,2,0.0041206374367327185,2019-03-24 20:30:00,2019-03-24 20:45:00
87,2,1,1,0.01577707341823835,2019-03-24 20:30:00,2019-03-24 20:45:00
88,11,9,2,0.02485102930368975,2019-03-24 20:30:00,2019-03-24 20:45:00
89,5,3,2,0.007684026497487309,2019-03-24 20:30:00,2019-03-24 20:45:00
90,3,1,2,0.0033761941308946483,2019-03-24 20:30:00,2019-03-24 20:45:00
101,2,1,1,0.01577707341823835,2019-03-24 20:30:00,2019-03-24 20:45:00
106,4,2,2,0.01577707341823835,2019-03-24 20:30:00,2019-03-24 20:45:00
108,4,2,2,0.01577707341823835,2019-03-24 20:30:00,2019-03-24 20:45:00
109,1,1,0,0.0033761941308946483,2019-03-24 20:30:00,2019-03-24 20:45:00
110,2,1,1,0.006484046406136719,2019-03-24 20:30:00,2019-03-24 20:45:00
111,4,2,2,0.006330260233500468,2019-03-24 20:30:00,2019-03-24 20:45:00
112,5,2,3,0.012584848766652133,2019-03-24 20:30:00,2019-03-24 20:45:00
113,4,0,4,0.0023692060153867,2019-03-24 20:30:00,2019-03-24 20:45:00
114,1,0,1,0.0023692060153867,2019-03-24 20:30:00,2019-03-24 20:45:00
115,5,3,2,0.009112386891100895,2019-03-24 20:30:00,2019-03-24 20:45:00
116,1,1,0,0.0033761941308946483,2019-03-24 20:30:00,2019-03-24 20:45:00
119,6,3,3,0.031292915651731715,2019-03-24 20:30:00,2019-03-24 20:45:00
122,6,4,2,0.03629648786228951,2019-03-24 20:30:00,2019-03-24 20:45:00
126,3,2,1,0.00815707146458365,2019-03-24 20:30:00,2019-03-24 20:45:00
137,17,8,9,0.0119656170792817,2019-03-24 20:30:00,2019-03-24 20:45:00
138,10,3,7,0.011087176699990545,2019-03-24 20:30:00,2019-03-24 20:45:00
140,3,2,1,0.009237882895266558,2019-03-24 20:30:00,2019-03-24 20:45:00
141,1,0,1,0.0023692060153867,2019-03-24 20:30:00,2019-03-24 20:45:00
153,6,3,3,0.010076088113444171,2019-03-24 20:30:00,2019-03-24 20:45:00
154,1,0,1,0.0023692060153867,2019-03-24 20:30:00,2019-03-24 20:45:00
157,4,3,1,0.05028458870917936,2019-03-24 20:30:00,2019-03-24 20:45:00
158,4,3,1,0.007460504705924429,2019-03-24 20:30:00,2019-03-24 20:45:00
164,6,2,4,0.005566080084049746,2019-03-24 20:30:00,2019-03-24 20:45:00
168,3,2,1,0.02248100711966418,2019-03-24 20:30:00,2019-03-24 20:45:00
169,2,1,1,0.01577707341823835,2019-03-24 20:30:00,2019-03-24 20:45:00
170,2,2,0,0.007008100692253101,2019-03-24 20:30:00,2019-03-24 20:45:00
171,1,1,0,0.005936027537713349,2019-03-24 20:30:00,2019-03-24 20:45:00
172,2,2,0,0.004316994880599462,2019-03-24 20:30:00,2019-03-24 20:45:00
189,1,0,1,0.0023692060153867,2019-03-24 20:30:00,2019-03-24 20:45:00
190,2,1,1,0.005224460979412444,2019-03-24 20:30:00,2019-03-24 20:45:00
191,2,2,0,0.004513352324466204,2019-03-24 20:30:00,2019-03-24 20:45:00
195,1,1,0,0.0032449217260597093,2019-03-24 20:30:00,2019-03-24 20:45:00
196,2,0,2,0.0023692060153867,2019-03-24 20:30:00,2019-03-24 20:45:00
201,4,2,2,0.023496655916560385,2019-03-24 20:30:00,2019-03-24 20:45:00
203,5,3,2,0.023587819418487723,2019-03-24 20:30:00,2019-03-24 20:45:00
1,3,2,1,0.038843885322930746,2019-03-24 20:45:00,2019-03-24 21:00:00
2,2,1,1,0.005839512590208413,2019-03-24 20:45:00,2019-03-24 21:00:00
5,2,1,1,0.0038271368658757705,2019-03-24 20:45:00,2019-03-24 21:00:00
16,8,5,3,0.00771277370114494,2019-03-24 20:45:00,2019-03-24 21:00:00
18,7,5,2,0.013671758265480706,2019-03-24 20:45:00,2019-03-24 21:00:00
26,1,0,1,0.0031563449577648897,2019-03-24 20:45:00,2019-03-24 21:00:00
27,4,3,1,0.008522680222651936,2019-03-24 20:45:00,2019-03-24 21:00:00
40,2,2,0,0.0074735258472440926,2019-03-24 20:45:00,2019-03-24 21:00:00
41,1,1,0,0.005839512590208413,2019-03-24 20:45:00,2019-03-24 21:00:00
46,1,1,0,0.006804662235158512,2019-03-24 20:45:00,2019-03-24 21:00:00
57,4,3,1,0.04424971494022845,2019-03-24 20:45:00,2019-03-24 21:00:00
58,1,0,1,0.0031563449577648897,2019-03-24 20:45:00,2019-03-24 21:00:00
66,2,1,1,0.02100011514034782,2019-03-24 20:45:00,2019-03-24 21:00:00
67,6,2,4,0.005489794465072464,2019-03-24 20:45:00,2019-03-24 21:00:00
75,3,2,1,0.004916062194984685,2019-03-24 20:45:00,2019-03-24 21:00:00
79,2,1,1,0.02100011514034782,2019-03-24 20:45:00,2019-03-24 21:00:00
87,2,1,1,0.02100011514034782,2019-03-24 20:45:00,2019-03-24 21:00:00
88,12,9,3,0.014087306035830097,2019-03-24 20:45:00,2019-03-24 21:00:00
89,2,2,0,0.0075236344824117845,2019-03-24 20:45:00,2019-03-24 21:00:00
101,2,1,1,0.02100011514034782,2019-03-24 20:45:00,2019-03-24 21:00:00
106,4,2,2,0.02100011514034782,2019-03-24 20:45:00,2019-03-24 21:00:00
109,9,1,8,0.003531618914443766,2019-03-24 20:45:00,2019-03-24 21:00:00
110,2,1,1,0.00429164182467251,2019-03-24 20:45:00,2019-03-24 21:00:00
111,5,1,4,0.005341909092409124,2019-03-24 20:45:00,2019-03-24 21:00:00
112,4,0,4,0.0031563449577648897,2019-03-24 20:45:00,2019-03-24 21:00:00
113,2,0,2,0.0031563449577648897,2019-03-24 20:45:00,2019-03-24 21:00:00
114,2,0,2,0.0031563449577648897,2019-03-24 20:45:00,2019-03-24 21:00:00
115,3,1,2,0.005489794465072464,2019-03-24 20:45:00,2019-03-24 21:00:00
119,2,2,0,0.010059622120903156,2019-03-24 20:45:00,2019-03-24 21:00:00
122,7,3,4,0.010156693479687616,2019-03-24 20:45:00,2019-03-24 21:00:00
126,1,0,1,0.0031563449577648897,2019-03-24 20:45:00,2019-03-24 21:00:00
137,7,4,3,0.011039209877723081,2019-03-24 20:45:00,2019-03-24 21:00:00
138,18,5,13,0.009548619710653227,2019-03-24 20:45:00,2019-03-24 21:00:00
153,1,0,1,0.0031563449577648897,2019-03-24 20:45:00,2019-03-24 21:00:00
154,1,0,1,0.0031563449577648897,2019-03-24 20:45:00,2019-03-24 21:00:00
157,3,2,1,0.042634035960465604,2019-03-24 20:45:00,2019-03-24 21:00:00
158,2,2,0,0.005717183049088,2019-03-24 20:45:00,2019-03-24 21:00:00
164,7,2,5,0.004782626288454694,2019-03-24 20:45:00,2019-03-24 21:00:00
168,1,1,0,0.005489794465072464,2019-03-24 20:45:00,2019-03-24 21:00:00
169,3,1,2,0.005489794465072464,2019-03-24 20:45:00,2019-03-24 21:00:00
170,2,2,0,0.004451557236187946,2019-03-24 20:45:00,2019-03-24 21:00:00
171,1,1,0,0.0038271368658757705,2019-03-24 20:45:00,2019-03-24 21:00:00
172,2,2,0,0.004993861619529558,2019-03-24 20:45:00,2019-03-24 21:00:00
173,1,0,1,0.0031563449577648897,2019-03-24 20:45:00,2019-03-24 21:00:00
177,2,2,0,0.01514154396633506,2019-03-24 20:45:00,2019-03-24 21:00:00
189,1,0,1,0.0031563449577648897,2019-03-24 20:45:00,2019-03-24 21:00:00
190,1,1,0,0.005839512590208413,2019-03-24 20:45:00,2019-03-24 21:00:00
191,7,4,3,0.021146798270968607,2019-03-24 20:45:00,2019-03-24 21:00:00
195,1,1,0,0.004323069711418677,2019-03-24 20:45:00,2019-03-24 21:00:00
201,2,2,0,0.011140376093700928,2019-03-24 20:45:00,2019-03-24 21:00:00
203,3,1,2,0.008120491397441415,2019-03-24 20:45:00,2019-03-24 21:00:00
1,2,1,1,0.020186025324681584,2019-03-24 21:00:00,2019-03-24 21:15:00
2,2,1,1,0.00432176534669977,2019-03-24 21:00:00,2019-03-24 21:15:00
5,2,2,0,0.009022381463086872,2019-03-24 21:00:00,2019-03-24 21:15:00
15,2,2,0,0.011190918960772761,2019-03-24 21:00:00,2019-03-24 21:15:00
16,5,5,0,0.007744251437776703,2019-03-24 21:00:00,2019-03-24 21:15:00
18,8,5,3,0.01884735724580456,2019-03-24 21:00:00,2019-03-24 21:15:00
23,2,1,1,0.006563889477997038,2019-03-24 21:00:00,2019-03-24 21:15:00
26,1,0,1,0.0030327130245532716,2019-03-24 21:00:00,2019-03-24 21:15:00
27,4,3,1,0.008188922313139262,2019-03-24 21:00:00,2019-03-24 21:15:00
35,2,1,1,0.004153775090201906,2019-03-24 21:00:00,2019-03-24 21:15:00
40,2,2,0,0.00527483715585054,2019-03-24 21:00:00,2019-03-24 21:15:00
41,1,1,0,0.008068707577523149,2019-03-24 21:00:00,2019-03-24 21:15:00
46,1,1,0,0.004765163455284839,2019-03-24 21:00:00,2019-03-24 21:15:00
57,3,2,1,0.037339337624809885,2019-03-24 21:00:00,2019-03-24 21:15:00
58,2,1,1,0.005923918534369683,2019-03-24 21:00:00,2019-03-24 21:15:00
66,5,4,1,0.033540961225824416,2019-03-24 21:00:00,2019-03-24 21:15:00
67,6,2,4,0.00527483715585054,2019-03-24 21:00:00,2019-03-24 21:15:00
71,2,1,1,0.020186025324681584,2019-03-24 21:00:00,2019-03-24 21:15:00
75,2,2,0,0.007630698717455029,2019-03-24 21:00:00,2019-03-24 21:15:00
79,2,1,1,0.020186025324681584,2019-03-24 21:00:00,2019-03-24 21:15:00
87,2,1,1,0.020186025324681584,2019-03-24 21:00:00,2019-03-24 21:15:00
88,4,3,1,0.0041376150149645555,2019-03-24 21:00:00,2019-03-24 21:15:00
89,2,2,0,0.006918420928886943,2019-03-24 21:00:00,2019-03-24 21:15:00
101,2,1,1,0.020186025324681584,2019-03-24 21:00:00,2019-03-24 21:15:00
104,2,0,2,0.0030327130245532716,2019-03-24 21:00:00,2019-03-24 21:15:00
106,4,2,2,0.020186025324681584,2019-03-24 21:00:00,2019-03-24 21:15:00
109,7,0,7,0.0030327130245532716,2019-03-24 21:00:00,2019-03-24 21:15:00
110,3,1,2,0.004075842162940188,2019-03-24 21:00:00,2019-03-24 21:15:00
111,5,2,3,0.013715118311902183,2019-03-24 21:00:00,2019-03-24 21:15:00
112,6,1,5,0.0038140236854129605,2019-03-24 21:00:00,2019-03-24 21:15:00
113,2,0,2,0.0030327130245532716,2019-03-24 21:00:00,2019-03-24 21:15:00
114,2,0,2,0.0030327130245532716,2019-03-24 21:00:00,2019-03-24 21:15:00
115,5,3,2,0.008903618452217835,2019-03-24 21:00:00,2019-03-24 21:15:00
116,4,3,1,0.037339337624809885,2019-03-24 21:00:00,2019-03-24 21:15:00
118,1,1,0,0.0036811788194124158,2019-03-24 21:00:00,2019-03-24 21:15:00
119,4,1,3,0.0036811788194124158,2019-03-24 21:00:00,2019-03-24 21:15:00
120,1,0,1,0.0030327130245532716,2019-03-24 21:00:00,2019-03-24 21:15:00
122,6,2,4,0.00527483715585054,2019-03-24 21:00:00,2019-03-24 21:15:00
137,6,4,2,0.030579819310287536,2019-03-24 21:00:00,2019-03-24 21:15:00
138,11,2,9,0.00752850476508748,2019-03-24 21:00:00,2019-03-24 21:15:00
141,1,1,0,0.004765163455284839,2019-03-24 21:00:00,2019-03-24 21:15:00
153,4,3,1,0.004767436330443119,2019-03-24 21:00:00,2019-03-24 21:15:00
157,2,1,1,0.020186025324681584,2019-03-24 21:00:00,2019-03-24 21:15:00
158,2,1,1,0.0034010136880236993,2019-03-24 21:00:00,2019-03-24 21:15:00
164,7,2,5,0.004595334346272649,2019-03-24 21:00:00,2019-03-24 21:15:00
168,1,1,0,0.00432176534669977,2019-03-24 21:00:00,2019-03-24 21:15:00
169,2,1,1,0.020186025324681584,2019-03-24 21:00:00,2019-03-24 21:15:00
170,2,2,0,0.004455002203840229,2019-03-24 21:00:00,2019-03-24 21:15:00
173,1,0,1,0.0030327130245532716,2019-03-24 21:00:00,2019-03-24 21:15:00
177,2,2,0,0.004189195228479836,2019-03-24 21:00:00,2019-03-24 21:15:00
189,2,0,2,0.0030327130245532716,2019-03-24 21:00:00,2019-03-24 21:15:00
191,6,1,5,0.0034010136880236993,2019-03-24 21:00:00,2019-03-24 21:15:00
195,1,1,0,0.004153775090201906,2019-03-24 21:00:00,2019-03-24 21:15:00
199,1,1,0,0.007085551614052396,2019-03-24 21:00:00,2019-03-24 21:15:00
203,1,1,0,0.006706670698178223,2019-03-24 21:00:00,2019-03-24 21:15:00
1,2,1,1,0.019844579243858337,2019-03-24 21:15:00,2019-03-24 21:30:00
2,1,1,0,0.00551323162349677,2019-03-24 21:15:00,2019-03-24 21:30:00
5,1,1,0,0.004542254020076183,2019-03-24 21:15:00,2019-03-24 21:30:00
15,1,1,0,0.007666833281394081,2019-03-24 21:15:00,2019-03-24 21:30:00
16,6,4,2,0.010333832593031916,2019-03-24 21:15:00,2019-03-24 21:30:00
18,4,1,3,0.00551323162349677,2019-03-24 21:15:00,2019-03-24 21:30:00
19,6,2,4,0.005183115819032237,2019-03-24 21:15:00,2019-03-24 21:30:00
23,2,1,1,0.00551323162349677,2019-03-24 21:15:00,2019-03-24 21:30:00
26,2,1,1,0.0033418597085714532,2019-03-24 21:15:00,2019-03-24 21:30:00
27,1,0,1,0.002979964389417234,2019-03-24 21:15:00,2019-03-24 21:30:00
35,1,0,1,0.002979964389417234,2019-03-24 21:15:00,2019-03-24 21:30:00
37,1,1,0,0.003824386800777079,2019-03-24 21:15:00,2019-03-24 21:30:00
40,2,0,2,0.002979964389417234,2019-03-24 21:15:00,2019-03-24 21:30:00
57,3,2,1,0.03875652947263681,2019-03-24 21:15:00,2019-03-24 21:30:00
62,2,2,0,0.005183115819032237,2019-03-24 21:15:00,2019-03-24 21:30:00
66,4,3,1,0.03670919409829945,2019-03-24 21:15:00,2019-03-24 21:30:00
67,5,2,3,0.006878517879612363,2019-03-24 21:15:00,2019-03-24 21:30:00
71,1,1,0,0.00551323162349677,2019-03-24 21:15:00,2019-03-24 21:30:00
75,2,2,0,0.0114029405091331,2019-03-24 21:15:00,2019-03-24 21:30:00
79,2,1,1,0.019844579243858337,2019-03-24 21:15:00,2019-03-24 21:30:00
87,2,1,1,0.019844579243858337,2019-03-24 21:15:00,2019-03-24 21:30:00
88,1,1,0,0.00437886858760561,2019-03-24 21:15:00,2019-03-24 21:30:00
101,2,1,1,0.019844579243858337,2019-03-24 21:15:00,2019-03-24 21:30:00
104,2,0,2,0.002979964389417234,2019-03-24 21:15:00,2019-03-24 21:30:00
106,4,2,2,0.019844579243858337,2019-03-24 21:15:00,2019-03-24 21:30:00
108,1,0,1,0.002979964389417234,2019-03-24 21:15:00,2019-03-24 21:30:00
109,7,3,4,0.006582020017220613,2019-03-24 21:15:00,2019-03-24 21:30:00
110,1,1,0,0.003824386800777079,2019-03-24 21:15:00,2019-03-24 21:30:00
111,6,5,1,0.009482233296174513,2019-03-24 21:15:00,2019-03-24 21:30:00
112,2,0,2,0.002979964389417234,2019-03-24 21:15:00,2019-03-24 21:30:00
115,6,2,4,0.005183115819032237,2019-03-24 21:15:00,2019-03-24 21:30:00
116,4,3,1,0.036709194098299446,2019-03-24 21:15:00,2019-03-24 21:30:00
118,2,1,1,0.019844579243858337,2019-03-24 21:15:00,2019-03-24 21:30:00
119,3,0,3,0.002979964389417234,2019-03-24 21:15:00,2019-03-24 21:30:00
122,5,3,2,0.04905481590056062,2019-03-24 21:15:00,2019-03-24 21:30:00
137,6,4,2,0.035530851213028514,2019-03-24 21:15:00,2019-03-24 21:30:00
138,7,0,7,0.002979964389417234,2019-03-24 21:15:00,2019-03-24 21:30:00
153,1,0,1,0.002979964389417234,2019-03-24 21:15:00,2019-03-24 21:30:00
157,2,1,1,0.019844579243858337,2019-03-24 21:15:00,2019-03-24 21:30:00
164,4,1,3,0.004158307274688159,2019-03-24 21:15:00,2019-03-24 21:30:00
169,2,1,1,0.019844579243858337,2019-03-24 21:15:00,2019-03-24 21:30:00
170,3,3,0,0.005102659225914049,2019-03-24 21:15:00,2019-03-24 21:30:00
171,2,1,1,0.00737278131845724,2019-03-24 21:15:00,2019-03-24 21:30:00
177,2,2,0,0.00551323162349677,2019-03-24 21:15:00,2019-03-24 21:30:00
189,1,0,1,0.002979964389417234,2019-03-24 21:15:00,2019-03-24 21:30:00
191,2,0,2,0.002979964389417234,2019-03-24 21:15:00,2019-03-24 21:30:00
195,1,1,0,0.004929241134514799,2019-03-24 21:15:00,2019-03-24 21:30:00
199,1,1,0,0.00551323162349677,2019-03-24 21:15:00,2019-03-24 21:30:00
201,1,1,0,0.00437886858760561,2019-03-24 21:15:00,2019-03-24 21:30:00
1,3,2,1,0.057295978261606435,2019-03-24 21:30:00,2019-03-24 21:45:00
2,1,1,0,0.004993275813066104,2019-03-24 21:30:00,2019-03-24 21:45:00
10,2,2,0,0.004993275813066104,2019-03-24 21:30:00,2019-03-24 21:45:00
11,2,1,1,0.017982972181576275,2019-03-24 21:30:00,2019-03-24 21:45:00
15,2,1,1,0.004993275813066104,2019-03-24 21:30:00,2019-03-24 21:45:00
16,3,2,1,0.0262607951361241,2019-03-24 21:30:00,2019-03-24 21:45:00
18,3,3,0,0.006383873784517324,2019-03-24 21:30:00,2019-03-24 21:45:00
19,2,0,2,0.002698958092539856,2019-03-24 21:30:00,2019-03-24 21:45:00
20,3,0,3,0.002698958092539856,2019-03-24 21:30:00,2019-03-24 21:45:00
26,2,1,1,0.003394257078265466,2019-03-24 21:30:00,2019-03-24 21:45:00
27,1,0,1,0.002698958092539856,2019-03-24 21:30:00,2019-03-24 21:45:00
37,2,2,0,0.0061404346733292285,2019-03-24 21:30:00,2019-03-24 21:45:00
41,2,0,2,0.002698958092539856,2019-03-24 21:30:00,2019-03-24 21:45:00
46,1,1,0,0.004993275813066104,2019-03-24 21:30:00,2019-03-24 21:45:00
57,3,2,1,0.03720282599074881,2019-03-24 21:30:00,2019-03-24 21:45:00
62,2,2,0,0.004993275813066104,2019-03-24 21:30:00,2019-03-24 21:45:00
66,2,1,1,0.017982972181576275,2019-03-24 21:30:00,2019-03-24 21:45:00
67,4,2,2,0.008684830025059643,2019-03-24 21:30:00,2019-03-24 21:45:00
69,1,0,1,0.002698958092539856,2019-03-24 21:30:00,2019-03-24 21:45:00
70,2,1,1,0.017982972181576275,2019-03-24 21:30:00,2019-03-24 21:45:00
71,1,1,0,0.004993275813066104,2019-03-24 21:30:00,2019-03-24 21:45:00
79,2,1,1,0.017982972181576275,2019-03-24 21:30:00,2019-03-24 21:45:00
87,2,1,1,0.017982972181576275,2019-03-24 21:30:00,2019-03-24 21:45:00
101,2,1,1,0.017982972181576275,2019-03-24 21:30:00,2019-03-24 21:45:00
106,4,2,2,0.017982972181576275,2019-03-24 21:30:00,2019-03-24 21:45:00
108,1,0,1,0.002698958092539856,2019-03-24 21:30:00,2019-03-24 21:45:00
109,11,6,5,0.010589514356229337,2019-03-24 21:30:00,2019-03-24 21:45:00
110,1,0,1,0.002698958092539856,2019-03-24 21:30:00,2019-03-24 21:45:00
111,4,2,2,0.012942008679260604,2019-03-24 21:30:00,2019-03-24 21:45:00
115,3,1,2,0.004694248736713118,2019-03-24 21:30:00,2019-03-24 21:45:00
118,1,1,0,0.004993275813066104,2019-03-24 21:30:00,2019-03-24 21:45:00
119,2,0,2,0.002698958092539856,2019-03-24 21:30:00,2019-03-24 21:45:00
122,4,2,2,0.017982972181576275,2019-03-24 21:30:00,2019-03-24 21:45:00
126,2,1,1,0.006943676559092683,2019-03-24 21:30:00,2019-03-24 21:45:00
137,13,8,5,0.05351309662982057,2019-03-24 21:30:00,2019-03-24 21:45:00
138,7,2,5,0.004089556063991076,2019-03-24 21:30:00,2019-03-24 21:45:00
141,1,0,1,0.002698958092539856,2019-03-24 21:30:00,2019-03-24 21:45:00
154,1,0,1,0.002698958092539856,2019-03-24 21:30:00,2019-03-24 21:45:00
157,2,1,1,0.017982972181576275,2019-03-24 21:30:00,2019-03-24 21:45:00
164,6,3,3,0.019113281852996853,2019-03-24 21:30:00,2019-03-24 21:45:00
169,2,1,1,0.017982972181576275,2019-03-24 21:30:00,2019-03-24 21:45:00
171,2,1,1,0.024989163316064857,2019-03-24 21:30:00,2019-03-24 21:45:00
177,2,1,1,0.017982972181576275,2019-03-24 21:30:00,2019-03-24 21:45:00
189,1,0,1,0.002698958092539856,2019-03-24 21:30:00,2019-03-24 21:45:00
195,1,1,0,0.006390512304533394,2019-03-24 21:30:00,2019-03-24 21:45:00
196,1,0,1,0.002698958092539856,2019-03-24 21:30:00,2019-03-24 21:45:00
199,2,1,1,0.017982972181576275,2019-03-24 21:30:00,2019-03-24 21:45:00
201,1,1,0,0.004499432042034842,2019-03-24 21:30:00,2019-03-24 21:45:00
203,1,0,1,0.002698958092539856,2019-03-24 21:30:00,2019-03-24 21:45:00
1,2,1,1,0.019899819812279073,2019-03-24 21:45:00,2019-03-24 22:00:00
11,2,1,1,0.019899819812279073,2019-03-24 21:45:00,2019-03-24 22:00:00
15,3,1,2,0.005529361876976368,2019-03-24 21:45:00,2019-03-24 22:00:00
16,2,2,0,0.005529361876976368,2019-03-24 21:45:00,2019-03-24 22:00:00
18,3,3,0,0.007142572041889122,2019-03-24 21:45:00,2019-03-24 22:00:00
19,4,1,3,0.004170472316422557,2019-03-24 21:45:00,2019-03-24 22:00:00
20,3,0,3,0.0029886735025512782,2019-03-24 21:45:00,2019-03-24 22:00:00
26,1,0,1,0.0029886735025512782,2019-03-24 21:45:00,2019-03-24 22:00:00
27,1,0,1,0.0029886735025512782,2019-03-24 21:45:00,2019-03-24 22:00:00
28,2,2,0,0.005529361876976368,2019-03-24 21:45:00,2019-03-24 22:00:00
37,2,0,2,0.0029886735025512782,2019-03-24 21:45:00,2019-03-24 22:00:00
41,1,1,0,0.0067405095964870945,2019-03-24 21:45:00,2019-03-24 22:00:00
46,2,1,1,0.0044132558616830995,2019-03-24 21:45:00,2019-03-24 22:00:00
50,1,1,0,0.005529361876976368,2019-03-24 21:45:00,2019-03-24 22:00:00
57,4,2,2,0.009617534125447854,2019-03-24 21:45:00,2019-03-24 22:00:00
58,2,0,2,0.0029886735025512782,2019-03-24 21:45:00,2019-03-24 22:00:00
61,1,1,0,0.007527481326858038,2019-03-24 21:45:00,2019-03-24 22:00:00
62,2,2,0,0.005352271130293837,2019-03-24 21:45:00,2019-03-24 22:00:00
66,2,1,1,0.019899819812279073,2019-03-24 21:45:00,2019-03-24 22:00:00
67,4,2,2,0.009617534125447854,2019-03-24 21:45:00,2019-03-24 22:00:00
69,1,0,1,0.0029886735025512782,2019-03-24 21:45:00,2019-03-24 22:00:00
70,2,1,1,0.019899819812279073,2019-03-24 21:45:00,2019-03-24 22:00:00
74,1,0,1,0.0029886735025512782,2019-03-24 21:45:00,2019-03-24 22:00:00
87,2,1,1,0.019899819812279073,2019-03-24 21:45:00,2019-03-24 22:00:00
89,3,3,0,0.00921664758841307,2019-03-24 21:45:00,2019-03-24 22:00:00
101,2,1,1,0.019899819812279073,2019-03-24 21:45:00,2019-03-24 22:00:00
104,2,2,0,0.004163827591710691,2019-03-24 21:45:00,2019-03-24 22:00:00
106,1,1,0,0.005529361876976368,2019-03-24 21:45:00,2019-03-24 22:00:00
109,11,3,8,0.005529361876976368,2019-03-24 21:45:00,2019-03-24 22:00:00
110,1,1,0,0.004259017689763823,2019-03-24 21:45:00,2019-03-24 22:00:00
111,2,0,2,0.0029886735025512782,2019-03-24 21:45:00,2019-03-24 22:00:00
115,2,1,1,0.019899819812279073,2019-03-24 21:45:00,2019-03-24 22:00:00
118,3,2,1,0.03681096612200687,2019-03-24 21:45:00,2019-03-24 22:00:00
119,1,1,0,0.004259017689763823,2019-03-24 21:45:00,2019-03-24 22:00:00
122,4,2,2,0.019899819812279073,2019-03-24 21:45:00,2019-03-24 22:00:00
126,1,1,0,0.005338981680870105,2019-03-24 21:45:00,2019-03-24 22:00:00
127,1,0,1,0.0029886735025512782,2019-03-24 21:45:00,2019-03-24 22:00:00
137,14,10,4,0.07335278459659147,2019-03-24 21:45:00,2019-03-24 22:00:00
138,5,1,4,0.003795278585007655,2019-03-24 21:45:00,2019-03-24 22:00:00
141,4,1,3,0.007076845751022763,2019-03-24 21:45:00,2019-03-24 22:00:00
154,1,0,1,0.0029886735025512782,2019-03-24 21:45:00,2019-03-24 22:00:00
157,6,3,3,0.019899819812279073,2019-03-24 21:45:00,2019-03-24 22:00:00
158,8,5,3,0.0074502326380125996,2019-03-24 21:45:00,2019-03-24 22:00:00
164,9,4,5,0.00837852659524001,2019-03-24 21:45:00,2019-03-24 22:00:00
169,2,1,1,0.019899819812279073,2019-03-24 21:45:00,2019-03-24 22:00:00
173,2,0,2,0.0029886735025512782,2019-03-24 21:45:00,2019-03-24 22:00:00
177,2,1,1,0.019899819812279073,2019-03-24 21:45:00,2019-03-24 22:00:00
191,2,1,1,0.005338981680870105,2019-03-24 21:45:00,2019-03-24 22:00:00
195,1,1,0,0.007076845751022763,2019-03-24 21:45:00,2019-03-24 22:00:00
199,2,1,1,0.019899819812279073,2019-03-24 21:45:00,2019-03-24 22:00:00
202,1,1,0,0.003795278585007655,2019-03-24 21:45:00,2019-03-24 22:00:00
203,1,0,1,0.0029886735025512782,2019-03-24 21:45:00,2019-03-24 22:00:00
1,2,1,1,0.02161269447276384,2019-03-24 22:00:00,2019-03-24 22:15:00
15,1,0,1,0.003247789848884876,2019-03-24 22:00:00,2019-03-24 22:15:00
16,2,2,0,0.007498973992084811,2019-03-24 22:00:00,2019-03-24 22:15:00
18,2,1,1,0.006008699304015971,2019-03-24 22:00:00,2019-03-24 22:15:00
19,2,0,2,0.003247789848884876,2019-03-24 22:00:00,2019-03-24 22:15:00
23,1,0,1,0.003247789848884876,2019-03-24 22:00:00,2019-03-24 22:15:00
26,1,0,1,0.003247789848884876,2019-03-24 22:00:00,2019-03-24 22:15:00
27,1,0,1,0.003247789848884876,2019-03-24 22:00:00,2019-03-24 22:15:00
28,2,2,0,0.006008699304015971,2019-03-24 22:00:00,2019-03-24 22:15:00
41,1,1,0,0.006008699304015971,2019-03-24 22:00:00,2019-03-24 22:15:00
46,1,0,1,0.003247789848884876,2019-03-24 22:00:00,2019-03-24 22:15:00
50,1,1,0,0.006008699304015971,2019-03-24 22:00:00,2019-03-24 22:15:00
57,7,4,3,0.010856846921370532,2019-03-24 22:00:00,2019-03-24 22:15:00
58,4,2,2,0.005000813248467633,2019-03-24 22:00:00,2019-03-24 22:15:00
61,1,1,0,0.0099204913405202,2019-03-24 22:00:00,2019-03-24 22:15:00
62,2,2,0,0.006008699304015971,2019-03-24 22:00:00,2019-03-24 22:15:00
66,2,1,1,0.02161269447276384,2019-03-24 22:00:00,2019-03-24 22:15:00
67,4,2,2,0.010450991227842207,2019-03-24 22:00:00,2019-03-24 22:15:00
69,1,0,1,0.003247789848884876,2019-03-24 22:00:00,2019-03-24 22:15:00
70,2,1,1,0.02161269447276384,2019-03-24 22:00:00,2019-03-24 22:15:00
74,1,0,1,0.003247789848884876,2019-03-24 22:00:00,2019-03-24 22:15:00
87,2,1,1,0.02161269447276384,2019-03-24 22:00:00,2019-03-24 22:15:00
89,3,3,0,0.014505500929965168,2019-03-24 22:00:00,2019-03-24 22:15:00
101,2,1,1,0.02161269447276384,2019-03-24 22:00:00,2019-03-24 22:15:00
104,3,2,1,0.005088396152305607,2019-03-24 22:00:00,2019-03-24 22:15:00
106,1,1,0,0.006008699304015971,2019-03-24 22:00:00,2019-03-24 22:15:00
109,3,0,3,0.003247789848884876,2019-03-24 22:00:00,2019-03-24 22:15:00
111,5,1,4,0.004168093000595241,2019-03-24 22:00:00,2019-03-24 22:15:00
112,1,1,0,0.006008699304015971,2019-03-24 22:00:00,2019-03-24 22:15:00
113,1,1,0,0.006324303535023465,2019-03-24 22:00:00,2019-03-24 22:15:00
114,1,1,0,0.00835577452591851,2019-03-24 22:00:00,2019-03-24 22:15:00
115,2,1,1,0.02161269447276384,2019-03-24 22:00:00,2019-03-24 22:15:00
118,2,1,1,0.02161269447276384,2019-03-24 22:00:00,2019-03-24 22:15:00
122,4,2,2,0.02161269447276384,2019-03-24 22:00:00,2019-03-24 22:15:00
126,1,1,0,0.006008699304015971,2019-03-24 22:00:00,2019-03-24 22:15:00
127,1,0,1,0.003247789848884876,2019-03-24 22:00:00,2019-03-24 22:15:00
137,12,6,6,0.013750436862830463,2019-03-24 22:00:00,2019-03-24 22:15:00
138,5,1,4,0.004124301548676255,2019-03-24 22:00:00,2019-03-24 22:15:00
140,2,1,1,0.02161269447276384,2019-03-24 22:00:00,2019-03-24 22:15:00
141,4,3,1,0.010220967644481814,2019-03-24 22:00:00,2019-03-24 22:15:00
151,3,3,0,0.006929002455726337,2019-03-24 22:00:00,2019-03-24 22:15:00
153,3,0,3,0.003247789848884876,2019-03-24 22:00:00,2019-03-24 22:15:00
154,1,1,0,0.004602449246399321,2019-03-24 22:00:00,2019-03-24 22:15:00
157,6,3,3,0.02161269447276384,2019-03-24 22:00:00,2019-03-24 22:15:00
158,4,1,3,0.004532005820320762,2019-03-24 22:00:00,2019-03-24 22:15:00
159,2,0,2,0.003247789848884876,2019-03-24 22:00:00,2019-03-24 22:15:00
164,7,3,4,0.006374083177615292,2019-03-24 22:00:00,2019-03-24 22:15:00
169,2,1,1,0.02161269447276384,2019-03-24 22:00:00,2019-03-24 22:15:00
172,1,0,1,0.003247789848884876,2019-03-24 22:00:00,2019-03-24 22:15:00
173,2,0,2,0.003247789848884876,2019-03-24 22:00:00,2019-03-24 22:15:00
191,4,3,1,0.007849305607436702,2019-03-24 22:00:00,2019-03-24 22:15:00
195,1,1,0,0.007690081772711112,2019-03-24 22:00:00,2019-03-24 22:15:00
199,2,1,1,0.02161269447276384,2019-03-24 22:00:00,2019-03-24 22:15:00
202,2,2,0,0.008449927818409043,2019-03-24 22:00:00,2019-03-24 22:15:00
1,2,1,1,0.023005890292110694,2019-03-24 22:15:00,2019-03-24 22:30:00
15,1,0,1,0.0034652870064854025,2019-03-24 22:15:00,2019-03-24 22:30:00
16,1,0,1,0.0034652870064854025,2019-03-24 22:15:00,2019-03-24 22:30:00
18,2,1,1,0.006411099530682113,2019-03-24 22:15:00,2019-03-24 22:30:00
19,3,1,2,0.008566888652564846,2019-03-24 22:15:00,2019-03-24 22:30:00
23,1,0,1,0.0034652870064854025,2019-03-24 22:15:00,2019-03-24 22:30:00
26,1,0,1,0.0034652870064854025,2019-03-24 22:15:00,2019-03-24 22:30:00
27,1,0,1,0.0034652870064854025,2019-03-24 22:15:00,2019-03-24 22:30:00
28,2,1,1,0.006411099530682113,2019-03-24 22:15:00,2019-03-24 22:30:00
37,1,1,0,0.005731820757711203,2019-03-24 22:15:00,2019-03-24 22:30:00
46,1,0,1,0.0034652870064854025,2019-03-24 22:15:00,2019-03-24 22:30:00
57,6,4,2,0.017726561252574175,2019-03-24 22:15:00,2019-03-24 22:30:00
58,2,2,0,0.008881546953870681,2019-03-24 22:15:00,2019-03-24 22:30:00
61,2,1,1,0.008915365797244387,2019-03-24 22:15:00,2019-03-24 22:30:00
62,5,2,3,0.010748075301198722,2019-03-24 22:15:00,2019-03-24 22:30:00
64,1,1,0,0.008915365797244387,2019-03-24 22:15:00,2019-03-24 22:30:00
66,2,1,1,0.023005890292110694,2019-03-24 22:15:00,2019-03-24 22:30:00
67,4,2,2,0.011150884025431677,2019-03-24 22:15:00,2019-03-24 22:30:00
68,1,1,0,0.004037302140102835,2019-03-24 22:15:00,2019-03-24 22:30:00
69,1,0,1,0.0034652870064854025,2019-03-24 22:15:00,2019-03-24 22:30:00
70,1,0,1,0.0034652870064854025,2019-03-24 22:15:00,2019-03-24 22:30:00
87,2,1,1,0.023005890292110694,2019-03-24 22:15:00,2019-03-24 22:30:00
89,2,2,0,0.004447224514550973,2019-03-24 22:15:00,2019-03-24 22:30:00
90,1,0,1,0.0034652870064854025,2019-03-24 22:15:00,2019-03-24 22:30:00
101,2,1,1,0.023005890292110694,2019-03-24 22:15:00,2019-03-24 22:30:00
104,3,2,1,0.005429162022616543,2019-03-24 22:15:00,2019-03-24 22:30:00
109,3,0,3,0.0034652870064854025,2019-03-24 22:15:00,2019-03-24 22:30:00
111,3,1,2,0.004447224514550973,2019-03-24 22:15:00,2019-03-24 22:30:00
112,2,1,1,0.006411099530682113,2019-03-24 22:15:00,2019-03-24 22:30:00
113,1,1,0,0.011000180781993333,2019-03-24 22:15:00,2019-03-24 22:30:00
114,1,1,0,0.006173416980178041,2019-03-24 22:15:00,2019-03-24 22:30:00
115,5,2,3,0.007998354508937003,2019-03-24 22:15:00,2019-03-24 22:30:00
119,1,1,0,0.008915365797244387,2019-03-24 22:15:00,2019-03-24 22:30:00
120,1,1,0,0.0054975999210931355,2019-03-24 22:15:00,2019-03-24 22:30:00
122,4,2,2,0.023005890292110694,2019-03-24 22:15:00,2019-03-24 22:30:00
126,3,3,0,0.012402624113073073,2019-03-24 22:15:00,2019-03-24 22:30:00
137,9,5,4,0.0162613043571282,2019-03-24 22:15:00,2019-03-24 22:30:00
138,5,2,3,0.009556711122873901,2019-03-24 22:15:00,2019-03-24 22:30:00
140,4,2,2,0.011150884025431677,2019-03-24 22:15:00,2019-03-24 22:30:00
141,4,4,0,0.01332330211934048,2019-03-24 22:15:00,2019-03-24 22:30:00
151,1,1,0,0.004447224514550973,2019-03-24 22:15:00,2019-03-24 22:30:00
153,3,0,3,0.0034652870064854025,2019-03-24 22:15:00,2019-03-24 22:30:00
154,6,5,1,0.006001177156233975,2019-03-24 22:15:00,2019-03-24 22:30:00
157,7,3,4,0.0095622257503086,2019-03-24 22:15:00,2019-03-24 22:30:00
158,6,0,6,0.0034652870064854025,2019-03-24 22:15:00,2019-03-24 22:30:00
164,7,1,6,0.004037302140102835,2019-03-24 22:15:00,2019-03-24 22:30:00
169,2,1,1,0.023005890292110694,2019-03-24 22:15:00,2019-03-24 22:30:00
170,2,0,2,0.0034652870064854025,2019-03-24 22:15:00,2019-03-24 22:30:00
171,1,1,0,0.004037302140102835,2019-03-24 22:15:00,2019-03-24 22:30:00
172,1,0,1,0.0034652870064854025,2019-03-24 22:15:00,2019-03-24 22:30:00
191,3,3,0,0.008374974546813253,2019-03-24 22:15:00,2019-03-24 22:30:00
195,1,1,0,0.008205071501234968,2019-03-24 22:15:00,2019-03-24 22:30:00
196,1,0,1,0.0034652870064854025,2019-03-24 22:15:00,2019-03-24 22:30:00
199,1,1,0,0.01104432495544833,2019-03-24 22:15:00,2019-03-24 22:30:00
201,1,1,0,0.006411099530682113,2019-03-24 22:15:00,2019-03-24 22:30:00
202,2,2,0,0.011026422899253673,2019-03-24 22:15:00,2019-03-24 22:30:00
1,2,1,1,0.02163486711647406,2019-03-24 22:30:00,2019-03-24 22:45:00
10,2,2,0,0.008778986252080007,2019-03-24 22:30:00,2019-03-24 22:45:00
18,2,1,1,0.006015102838720931,2019-03-24 22:30:00,2019-03-24 22:45:00
19,1,1,0,0.00836477074551321,2019-03-24 22:30:00,2019-03-24 22:45:00
20,1,0,1,0.003251219425361854,2019-03-24 22:30:00,2019-03-24 22:45:00
23,1,1,0,0.005654935085318434,2019-03-24 22:30:00,2019-03-24 22:45:00
26,1,0,1,0.003251219425361854,2019-03-24 22:30:00,2019-03-24 22:45:00
27,1,0,1,0.003251219425361854,2019-03-24 22:30:00,2019-03-24 22:45:00
28,2,1,1,0.006015102838720931,2019-03-24 22:30:00,2019-03-24 22:45:00
41,3,1,2,0.005654935085318434,2019-03-24 22:30:00,2019-03-24 22:45:00
46,3,1,2,0.005654935085318434,2019-03-24 22:30:00,2019-03-24 22:45:00
57,3,2,1,0.040018514807586274,2019-03-24 22:30:00,2019-03-24 22:45:00
61,1,1,0,0.00836477074551321,2019-03-24 22:30:00,2019-03-24 22:45:00
62,2,0,2,0.003251219425361854,2019-03-24 22:30:00,2019-03-24 22:45:00
64,1,1,0,0.00836477074551321,2019-03-24 22:30:00,2019-03-24 22:45:00
66,4,2,2,0.02163486711647406,2019-03-24 22:30:00,2019-03-24 22:45:00
67,4,2,2,0.008058650745275016,2019-03-24 22:30:00,2019-03-24 22:45:00
68,1,1,0,0.003917237862443634,2019-03-24 22:30:00,2019-03-24 22:45:00
69,2,0,2,0.003251219425361854,2019-03-24 22:30:00,2019-03-24 22:45:00
70,1,0,1,0.003251219425361854,2019-03-24 22:30:00,2019-03-24 22:45:00
85,2,1,1,0.02163486711647406,2019-03-24 22:30:00,2019-03-24 22:45:00
86,1,1,0,0.008927364698432957,2019-03-24 22:30:00,2019-03-24 22:45:00
87,2,1,1,0.02163486711647406,2019-03-24 22:30:00,2019-03-24 22:45:00
90,2,1,1,0.004157403466379913,2019-03-24 22:30:00,2019-03-24 22:45:00
101,2,1,1,0.02163486711647406,2019-03-24 22:30:00,2019-03-24 22:45:00
109,2,1,1,0.004633161132041392,2019-03-24 22:30:00,2019-03-24 22:45:00
110,3,3,0,0.00596977154841603,2019-03-24 22:30:00,2019-03-24 22:45:00
111,1,0,1,0.003251219425361854,2019-03-24 22:30:00,2019-03-24 22:45:00
112,2,1,1,0.004633161132041392,2019-03-24 22:30:00,2019-03-24 22:45:00
115,2,1,1,0.02163486711647406,2019-03-24 22:30:00,2019-03-24 22:45:00
119,1,1,0,0.007189936792117072,2019-03-24 22:30:00,2019-03-24 22:45:00
120,1,1,0,0.0051582597049770135,2019-03-24 22:30:00,2019-03-24 22:45:00
122,4,2,2,0.02163486711647406,2019-03-24 22:30:00,2019-03-24 22:45:00
126,2,2,0,0.00857187849879661,2019-03-24 22:30:00,2019-03-24 22:45:00
127,1,0,1,0.003251219425361854,2019-03-24 22:30:00,2019-03-24 22:45:00
137,10,4,6,0.006395624381561532,2019-03-24 22:30:00,2019-03-24 22:45:00
138,2,2,0,0.006015102838720931,2019-03-24 22:30:00,2019-03-24 22:45:00
140,3,2,1,0.045136845107050155,2019-03-24 22:30:00,2019-03-24 22:45:00
141,1,1,0,0.004633161132041392,2019-03-24 22:30:00,2019-03-24 22:45:00
151,1,1,0,0.004633161132041392,2019-03-24 22:30:00,2019-03-24 22:45:00
153,2,0,2,0.003251219425361854,2019-03-24 22:30:00,2019-03-24 22:45:00
154,2,1,1,0.006015102838720931,2019-03-24 22:30:00,2019-03-24 22:45:00
157,7,3,4,0.008972340264207332,2019-03-24 22:30:00,2019-03-24 22:45:00
164,6,1,5,0.003917237862443634,2019-03-24 22:30:00,2019-03-24 22:45:00
169,2,1,1,0.02163486711647406,2019-03-24 22:30:00,2019-03-24 22:45:00
170,2,0,2,0.003251219425361854,2019-03-24 22:30:00,2019-03-24 22:45:00
171,1,1,0,0.003917237862443634,2019-03-24 22:30:00,2019-03-24 22:45:00
172,1,1,0,0.006015102838720931,2019-03-24 22:30:00,2019-03-24 22:45:00
177,1,0,1,0.003251219425361854,2019-03-24 22:30:00,2019-03-24 22:45:00
195,2,1,1,0.006676709038595477,2019-03-24 22:30:00,2019-03-24 22:45:00
197,2,1,1,0.02163486711647406,2019-03-24 22:30:00,2019-03-24 22:45:00
202,1,1,0,0.005654935085318434,2019-03-24 22:30:00,2019-03-24 22:45:00
1,2,1,1,0.02083685037956895,2019-03-24 22:45:00,2019-03-24 23:00:00
5,2,1,1,0.02083685037956895,2019-03-24 22:45:00,2019-03-24 23:00:00
10,3,2,1,0.008456698580112759,2019-03-24 22:45:00,2019-03-24 23:00:00
15,2,1,1,0.02083685037956895,2019-03-24 22:45:00,2019-03-24 23:00:00
18,2,1,1,0.0045223145333951114,2019-03-24 22:45:00,2019-03-24 23:00:00
19,2,0,2,0.003131862027056493,2019-03-24 22:45:00,2019-03-24 23:00:00
20,1,0,1,0.003131862027056493,2019-03-24 22:45:00,2019-03-24 23:00:00
23,1,1,0,0.010763131228086649,2019-03-24 22:45:00,2019-03-24 23:00:00
26,3,0,3,0.003131862027056493,2019-03-24 22:45:00,2019-03-24 23:00:00
27,5,2,3,0.004906807544741915,2019-03-24 22:45:00,2019-03-24 23:00:00
28,1,1,0,0.005794280303584626,2019-03-24 22:45:00,2019-03-24 23:00:00
41,4,2,2,0.01795236723207795,2019-03-24 22:45:00,2019-03-24 23:00:00
46,3,1,2,0.005447332782614129,2019-03-24 22:45:00,2019-03-24 23:00:00
57,1,1,0,0.004019334785899204,2019-03-24 22:45:00,2019-03-24 23:00:00
62,2,0,2,0.003131862027056493,2019-03-24 22:45:00,2019-03-24 23:00:00
64,1,1,0,0.006976365386962677,2019-03-24 22:45:00,2019-03-24 23:00:00
66,3,2,1,0.024953492845910637,2019-03-24 22:45:00,2019-03-24 23:00:00
67,4,2,2,0.0077628035381717645,2019-03-24 22:45:00,2019-03-24 23:00:00
68,1,1,0,0.007980055201860615,2019-03-24 22:45:00,2019-03-24 23:00:00
69,2,0,2,0.003131862027056493,2019-03-24 22:45:00,2019-03-24 23:00:00
70,1,0,1,0.003131862027056493,2019-03-24 22:45:00,2019-03-24 23:00:00
86,1,1,0,0.010863031204624693,2019-03-24 22:45:00,2019-03-24 23:00:00
87,2,1,1,0.02083685037956895,2019-03-24 22:45:00,2019-03-24 23:00:00
90,3,1,2,0.00441735181749001,2019-03-24 22:45:00,2019-03-24 23:00:00
101,2,1,1,0.02083685037956895,2019-03-24 22:45:00,2019-03-24 23:00:00
104,1,1,0,0.005447332782614129,2019-03-24 22:45:00,2019-03-24 23:00:00
109,3,2,1,0.008158450470340728,2019-03-24 22:45:00,2019-03-24 23:00:00
110,3,2,1,0.005702841607923526,2019-03-24 22:45:00,2019-03-24 23:00:00
111,3,2,1,0.005794280303584626,2019-03-24 22:45:00,2019-03-24 23:00:00
112,1,1,0,0.004463071165320559,2019-03-24 22:45:00,2019-03-24 23:00:00
113,1,1,0,0.005794280303584626,2019-03-24 22:45:00,2019-03-24 23:00:00
115,2,1,1,0.02083685037956895,2019-03-24 22:45:00,2019-03-24 23:00:00
118,1,1,0,0.004463071165320559,2019-03-24 22:45:00,2019-03-24 23:00:00
119,1,0,1,0.003131862027056493,2019-03-24 22:45:00,2019-03-24 23:00:00
120,1,1,0,0.005794280303584626,2019-03-24 22:45:00,2019-03-24 23:00:00
122,4,2,2,0.02083685037956895,2019-03-24 22:45:00,2019-03-24 23:00:00
126,2,2,0,0.011398865090347526,2019-03-24 22:45:00,2019-03-24 23:00:00
127,1,0,1,0.003131862027056493,2019-03-24 22:45:00,2019-03-24 23:00:00
135,2,0,2,0.003131862027056493,2019-03-24 22:45:00,2019-03-24 23:00:00
137,10,5,5,0.007560469338642079,2019-03-24 22:45:00,2019-03-24 23:00:00
138,2,2,0,0.005794280303584626,2019-03-24 22:45:00,2019-03-24 23:00:00
140,2,1,1,0.02083685037956895,2019-03-24 22:45:00,2019-03-24 23:00:00
153,2,0,2,0.003131862027056493,2019-03-24 22:45:00,2019-03-24 23:00:00
154,1,1,0,0.008057689167316211,2019-03-24 22:45:00,2019-03-24 23:00:00
157,2,1,1,0.02083685037956895,2019-03-24 22:45:00,2019-03-24 23:00:00
164,8,2,6,0.0043702805142021945,2019-03-24 22:45:00,2019-03-24 23:00:00
168,10,5,5,0.02083685037956895,2019-03-24 22:45:00,2019-03-24 23:00:00
169,2,1,1,0.02083685037956895,2019-03-24 22:45:00,2019-03-24 23:00:00
170,2,2,0,0.00688716775272262,2019-03-24 22:45:00,2019-03-24 23:00:00
171,1,0,1,0.003131862027056493,2019-03-24 22:45:00,2019-03-24 23:00:00
172,1,1,0,0.005794280303584626,2019-03-24 22:45:00,2019-03-24 23:00:00
173,4,2,2,0.0059127670397337295,2019-03-24 22:45:00,2019-03-24 23:00:00
177,1,0,1,0.003131862027056493,2019-03-24 22:45:00,2019-03-24 23:00:00
190,2,2,0,0.005794280303584626,2019-03-24 22:45:00,2019-03-24 23:00:00
191,2,0,2,0.003131862027056493,2019-03-24 22:45:00,2019-03-24 23:00:00
195,4,3,1,0.009094012676435831,2019-03-24 22:45:00,2019-03-24 23:00:00
197,2,1,1,0.02083685037956895,2019-03-24 22:45:00,2019-03-24 23:00:00
201,3,1,2,0.005447332782614129,2019-03-24 22:45:00,2019-03-24 23:00:00
202,1,1,0,0.005447332782614129,2019-03-24 22:45:00,2019-03-24 23:00:00
1,2,1,1,0.0187152487016266,2019-03-24 23:00:00,2019-03-24 23:15:00
5,2,1,1,0.0187152487016266,2019-03-24 23:00:00,2019-03-24 23:15:00
15,2,1,1,0.0187152487016266,2019-03-24 23:00:00,2019-03-24 23:15:00
18,2,1,1,0.005201144611995104,2019-03-24 23:00:00,2019-03-24 23:15:00
19,2,0,2,0.0028112671966058125,2019-03-24 23:00:00,2019-03-24 23:15:00
22,1,1,0,0.005201144611995104,2019-03-24 23:00:00,2019-03-24 23:15:00
26,1,0,1,0.0028112671966058125,2019-03-24 23:00:00,2019-03-24 23:15:00
27,1,0,1,0.0028112671966058125,2019-03-24 23:00:00,2019-03-24 23:15:00
28,2,1,1,0.0187152487016266,2019-03-24 23:00:00,2019-03-24 23:15:00
46,4,3,1,0.0346192302066474,2019-03-24 23:00:00,2019-03-24 23:15:00
50,2,1,1,0.0187152487016266,2019-03-24 23:00:00,2019-03-24 23:15:00
57,3,2,1,0.009622740787649783,2019-03-24 23:00:00,2019-03-24 23:15:00
58,1,1,0,0.0059924303074742015,2019-03-24 23:00:00,2019-03-24 23:15:00
62,2,0,2,0.0028112671966058125,2019-03-24 23:00:00,2019-03-24 23:15:00
66,3,2,1,0.025358091958207197,2019-03-24 23:00:00,2019-03-24 23:15:00
67,4,2,2,0.0192264850676784,2019-03-24 23:00:00,2019-03-24 23:15:00
68,4,3,1,0.009694464427044136,2019-03-24 23:00:00,2019-03-24 23:15:00
85,1,1,0,0.005022065284433152,2019-03-24 23:00:00,2019-03-24 23:15:00
87,2,1,1,0.0187152487016266,2019-03-24 23:00:00,2019-03-24 23:15:00
88,2,2,0,0.012360709867378453,2019-03-24 23:00:00,2019-03-24 23:15:00
89,1,0,1,0.0028112671966058125,2019-03-24 23:00:00,2019-03-24 23:15:00
90,4,2,2,0.007082966628077638,2019-03-24 23:00:00,2019-03-24 23:15:00
101,2,1,1,0.0187152487016266,2019-03-24 23:00:00,2019-03-24 23:15:00
104,1,1,0,0.005201144611995104,2019-03-24 23:00:00,2019-03-24 23:15:00
109,4,2,2,0.007483666339216795,2019-03-24 23:00:00,2019-03-24 23:15:00
110,4,2,2,0.005201144611995104,2019-03-24 23:00:00,2019-03-24 23:15:00
111,6,5,1,0.008421446266672896,2019-03-24 23:00:00,2019-03-24 23:15:00
113,2,0,2,0.0028112671966058125,2019-03-24 23:00:00,2019-03-24 23:15:00
114,6,3,3,0.0187152487016266,2019-03-24 23:00:00,2019-03-24 23:15:00
115,2,1,1,0.0187152487016266,2019-03-24 23:00:00,2019-03-24 23:15:00
118,2,2,0,0.005997770417124868,2019-03-24 23:00:00,2019-03-24 23:15:00
120,1,1,0,0.005201144611995104,2019-03-24 23:00:00,2019-03-24 23:15:00
122,6,4,2,0.05477617755285949,2019-03-24 23:00:00,2019-03-24 23:15:00
137,15,7,8,0.01026151699383564,2019-03-24 23:00:00,2019-03-24 23:15:00
138,3,2,1,0.005201144611995104,2019-03-24 23:00:00,2019-03-24 23:15:00
140,2,0,2,0.0028112671966058125,2019-03-24 23:00:00,2019-03-24 23:15:00
141,6,2,4,0.004889725223547648,2019-03-24 23:00:00,2019-03-24 23:15:00
147,1,0,1,0.0028112671966058125,2019-03-24 23:00:00,2019-03-24 23:15:00
153,3,0,3,0.0028112671966058125,2019-03-24 23:00:00,2019-03-24 23:15:00
157,2,1,1,0.0187152487016266,2019-03-24 23:00:00,2019-03-24 23:15:00
158,3,1,2,0.0038100512937121337,2019-03-24 23:00:00,2019-03-24 23:15:00
159,1,0,1,0.0028112671966058125,2019-03-24 23:00:00,2019-03-24 23:15:00
164,9,3,6,0.00704907308321868,2019-03-24 23:00:00,2019-03-24 23:15:00
168,11,6,5,0.02562801044066608,2019-03-24 23:00:00,2019-03-24 23:15:00
169,2,1,1,0.0187152487016266,2019-03-24 23:00:00,2019-03-24 23:15:00
170,2,2,0,0.008833008697924109,2019-03-24 23:00:00,2019-03-24 23:15:00
171,1,0,1,0.0028112671966058125,2019-03-24 23:00:00,2019-03-24 23:15:00
173,5,1,4,0.010991890404729953,2019-03-24 23:00:00,2019-03-24 23:15:00
190,2,2,0,0.006555623785505363,2019-03-24 23:00:00,2019-03-24 23:15:00
191,4,2,2,0.00440451880686534,2019-03-24 23:00:00,2019-03-24 23:15:00
195,1,1,0,0.010984645329706888,2019-03-24 23:00:00,2019-03-24 23:15:00
201,1,0,1,0.0028112671966058125,2019-03-24 23:00:00,2019-03-24 23:15:00
1,2,1,1,0.021105203932499955,2019-03-24 23:15:00,2019-03-24 23:30:00
5,2,1,1,0.021105203932499955,2019-03-24 23:15:00,2019-03-24 23:30:00
15,1,0,1,0.003170836509288261,2019-03-24 23:15:00,2019-03-24 23:30:00
16,3,3,0,0.008489136319854198,2019-03-24 23:15:00,2019-03-24 23:30:00
18,2,1,1,0.0058663695680900435,2019-03-24 23:15:00,2019-03-24 23:30:00
19,2,1,1,0.021105203932499955,2019-03-24 23:15:00,2019-03-24 23:30:00
20,1,0,1,0.003170836509288261,2019-03-24 23:15:00,2019-03-24 23:30:00
22,1,1,0,0.0058663695680900435,2019-03-24 23:15:00,2019-03-24 23:30:00
27,1,0,1,0.003170836509288261,2019-03-24 23:15:00,2019-03-24 23:30:00
28,2,1,1,0.021105203932499955,2019-03-24 23:15:00,2019-03-24 23:30:00
41,1,0,1,0.003170836509288261,2019-03-24 23:15:00,2019-03-24 23:30:00
46,2,2,0,0.0058663695680900435,2019-03-24 23:15:00,2019-03-24 23:30:00
50,2,1,1,0.021105203932499955,2019-03-24 23:15:00,2019-03-24 23:30:00
57,4,3,1,0.009411733791156032,2019-03-24 23:15:00,2019-03-24 23:30:00
58,2,2,0,0.007708659694925208,2019-03-24 23:15:00,2019-03-24 23:30:00
66,2,1,1,0.021105203932499955,2019-03-24 23:15:00,2019-03-24 23:30:00
67,3,1,2,0.005515096419456466,2019-03-24 23:15:00,2019-03-24 23:30:00
68,2,2,0,0.012668654798198125,2019-03-24 23:15:00,2019-03-24 23:30:00
85,1,1,0,0.00494360311281024,2019-03-24 23:15:00,2019-03-24 23:30:00
87,2,1,1,0.021105203932499955,2019-03-24 23:15:00,2019-03-24 23:30:00
88,2,2,0,0.0076026642256758975,2019-03-24 23:15:00,2019-03-24 23:30:00
90,2,2,0,0.005220954917892851,2019-03-24 23:15:00,2019-03-24 23:30:00
101,2,1,1,0.021105203932499955,2019-03-24 23:15:00,2019-03-24 23:30:00
109,3,0,3,0.003170836509288261,2019-03-24 23:15:00,2019-03-24 23:30:00
110,14,7,7,0.014596531312212356,2019-03-24 23:15:00,2019-03-24 23:30:00
111,8,4,4,0.008169584346098033,2019-03-24 23:15:00,2019-03-24 23:30:00
113,2,0,2,0.003170836509288261,2019-03-24 23:15:00,2019-03-24 23:30:00
115,2,1,1,0.021105203932499955,2019-03-24 23:15:00,2019-03-24 23:30:00
122,6,4,2,0.029596546245775276,2019-03-24 23:15:00,2019-03-24 23:30:00
137,9,4,5,0.006773145301079369,2019-03-24 23:15:00,2019-03-24 23:30:00
138,8,2,6,0.004424655095718787,2019-03-24 23:15:00,2019-03-24 23:30:00
141,1,0,1,0.003170836509288261,2019-03-24 23:15:00,2019-03-24 23:30:00
157,2,1,1,0.021105203932499955,2019-03-24 23:15:00,2019-03-24 23:30:00
158,1,1,0,0.00382038351617982,2019-03-24 23:15:00,2019-03-24 23:30:00
159,1,0,1,0.003170836509288261,2019-03-24 23:15:00,2019-03-24 23:30:00
164,6,1,5,0.00382038351617982,2019-03-24 23:15:00,2019-03-24 23:30:00
168,12,7,5,0.04320970856490693,2019-03-24 23:15:00,2019-03-24 23:30:00
169,2,1,1,0.021105203932499955,2019-03-24 23:15:00,2019-03-24 23:30:00
172,1,1,0,0.006810148675324614,2019-03-24 23:15:00,2019-03-24 23:30:00
173,3,1,2,0.011172016050144501,2019-03-24 23:15:00,2019-03-24 23:30:00
189,2,0,2,0.003170836509288261,2019-03-24 23:15:00,2019-03-24 23:30:00
191,4,2,2,0.008561902626891825,2019-03-24 23:15:00,2019-03-24 23:30:00
195,1,1,0,0.005515096419456466,2019-03-24 23:15:00,2019-03-24 23:30:00
1,3,1,2,0.006004693473880102,2019-03-24 23:30:00,2019-03-24 23:45:00
5,2,1,1,0.022972478889672746,2019-03-24 23:30:00,2019-03-24 23:45:00
16,4,4,0,0.012984339691772791,2019-03-24 23:30:00,2019-03-24 23:45:00
18,1,1,0,0.006387196276958232,2019-03-24 23:30:00,2019-03-24 23:45:00
20,1,0,1,0.0034523687978880607,2019-03-24 23:30:00,2019-03-24 23:45:00
22,2,1,1,0.006387196276958232,2019-03-24 23:30:00,2019-03-24 23:45:00
27,1,0,1,0.0034523687978880607,2019-03-24 23:30:00,2019-03-24 23:45:00
28,2,1,1,0.022972478889672746,2019-03-24 23:30:00,2019-03-24 23:45:00
41,1,1,0,0.006387196276958232,2019-03-24 23:30:00,2019-03-24 23:45:00
46,2,2,0,0.006387196276958232,2019-03-24 23:30:00,2019-03-24 23:45:00
57,2,2,0,0.005408920450601509,2019-03-24 23:30:00,2019-03-24 23:45:00
66,2,1,1,0.022972478889672746,2019-03-24 23:30:00,2019-03-24 23:45:00
67,3,1,2,0.006004693473880102,2019-03-24 23:30:00,2019-03-24 23:45:00
75,1,1,0,0.007218840455217699,2019-03-24 23:30:00,2019-03-24 23:45:00
87,2,1,1,0.022972478889672746,2019-03-24 23:30:00,2019-03-24 23:45:00
88,3,2,1,0.03994026430546537,2019-03-24 23:30:00,2019-03-24 23:45:00
90,2,1,1,0.007496500316099315,2019-03-24 23:30:00,2019-03-24 23:45:00
101,2,1,1,0.022972478889672746,2019-03-24 23:30:00,2019-03-24 23:45:00
109,2,0,2,0.0034523687978880607,2019-03-24 23:30:00,2019-03-24 23:45:00
110,7,4,3,0.010349542551271719,2019-03-24 23:30:00,2019-03-24 23:45:00
111,5,2,3,0.006387196276958232,2019-03-24 23:30:00,2019-03-24 23:45:00
113,2,0,2,0.0034523687978880607,2019-03-24 23:30:00,2019-03-24 23:45:00
115,2,1,1,0.022972478889672746,2019-03-24 23:30:00,2019-03-24 23:45:00
122,4,2,2,0.022972478889672746,2019-03-24 23:30:00,2019-03-24 23:45:00
137,7,4,3,0.014270860805654728,2019-03-24 23:30:00,2019-03-24 23:45:00
138,3,0,3,0.0034523687978880607,2019-03-24 23:30:00,2019-03-24 23:45:00
140,1,1,0,0.009825463836793962,2019-03-24 23:30:00,2019-03-24 23:45:00
147,1,1,0,0.008882128811736632,2019-03-24 23:30:00,2019-03-24 23:45:00
154,4,0,4,0.0034523687978880607,2019-03-24 23:30:00,2019-03-24 23:45:00
157,2,1,1,0.022972478889672746,2019-03-24 23:30:00,2019-03-24 23:45:00
158,4,4,0,0.007120903146725775,2019-03-24 23:30:00,2019-03-24 23:45:00
159,1,0,1,0.0034523687978880607,2019-03-24 23:30:00,2019-03-24 23:45:00
164,4,1,3,0.004817483283560141,2019-03-24 23:30:00,2019-03-24 23:45:00
168,2,1,1,0.004430644624244784,2019-03-24 23:30:00,2019-03-24 23:45:00
169,2,1,1,0.022972478889672746,2019-03-24 23:30:00,2019-03-24 23:45:00
172,1,1,0,0.006387196276958232,2019-03-24 23:30:00,2019-03-24 23:45:00
189,2,0,2,0.0034523687978880607,2019-03-24 23:30:00,2019-03-24 23:45:00
191,1,0,1,0.0034523687978880607,2019-03-24 23:30:00,2019-03-24 23:45:00
195,1,1,0,0.006004693473880102,2019-03-24 23:30:00,2019-03-24 23:45:00
1,3,1,2,0.006335626433261719,2019-03-24 23:45:00,2019-03-25 00:00:00
16,1,0,1,0.003642634953501235,2019-03-24 23:45:00,2019-03-25 00:00:00
18,1,1,0,0.006739210940123553,2019-03-24 23:45:00,2019-03-25 00:00:00
20,2,0,2,0.003642634953501235,2019-03-24 23:45:00,2019-03-25 00:00:00
27,1,0,1,0.003642634953501235,2019-03-24 23:45:00,2019-03-25 00:00:00
41,1,1,0,0.005190922946812394,2019-03-24 23:45:00,2019-03-25 00:00:00
46,10,3,7,0.005730396530633416,2019-03-24 23:45:00,2019-03-25 00:00:00
57,1,1,0,0.005190922946812394,2019-03-24 23:45:00,2019-03-25 00:00:00
66,2,1,1,0.024228015657881786,2019-03-24 23:45:00,2019-03-25 00:00:00
67,3,1,2,0.006335626433261719,2019-03-24 23:45:00,2019-03-25 00:00:00
68,2,2,0,0.006739210940123553,2019-03-24 23:45:00,2019-03-25 00:00:00
74,1,1,0,0.006739210940123553,2019-03-24 23:45:00,2019-03-25 00:00:00
75,1,1,0,0.008055430578010163,2019-03-24 23:45:00,2019-03-25 00:00:00
86,1,0,1,0.003642634953501235,2019-03-24 23:45:00,2019-03-25 00:00:00
87,2,1,1,0.024228015657881786,2019-03-24 23:45:00,2019-03-25 00:00:00
88,5,3,2,0.042120404882501856,2019-03-24 23:45:00,2019-03-25 00:00:00
90,2,1,1,0.009935192660258997,2019-03-24 23:45:00,2019-03-25 00:00:00
101,2,1,1,0.024228015657881786,2019-03-24 23:45:00,2019-03-25 00:00:00
109,1,0,1,0.003642634953501235,2019-03-24 23:45:00,2019-03-25 00:00:00
110,3,3,0,0.005730396530633416,2019-03-24 23:45:00,2019-03-25 00:00:00
111,1,1,0,0.004338555479211962,2019-03-24 23:45:00,2019-03-25 00:00:00
115,2,1,1,0.024228015657881786,2019-03-24 23:45:00,2019-03-25 00:00:00
122,4,2,2,0.024228015657881786,2019-03-24 23:45:00,2019-03-25 00:00:00
137,8,5,3,0.022205028109820668,2019-03-24 23:45:00,2019-03-25 00:00:00
138,2,0,2,0.003642634953501235,2019-03-24 23:45:00,2019-03-25 00:00:00
140,1,1,0,0.012089063221412363,2019-03-24 23:45:00,2019-03-25 00:00:00
157,2,1,1,0.024228015657881786,2019-03-24 23:45:00,2019-03-25 00:00:00
158,1,1,0,0.006739210940123553,2019-03-24 23:45:00,2019-03-25 00:00:00
164,4,1,3,0.0050829858315920295,2019-03-24 23:45:00,2019-03-25 00:00:00
168,2,1,1,0.005190922946812394,2019-03-24 23:45:00,2019-03-25 00:00:00
169,2,1,1,0.024228015657881786,2019-03-24 23:45:00,2019-03-25 00:00:00
190,1,1,0,0.005190922946812394,2019-03-24 23:45:00,2019-03-25 00:00:00
195,1,1,0,0.006335626433261719,2019-03-24 23:45:00,2019-03-25 00:00:00
196,2,0,2,0.003642634953501235,2019-03-24 23:45:00,2019-03-25 00:00:00
1,3,1,2,0.006213885988016886,2019-03-25 00:00:00,2019-03-25 00:15:00
16,5,1,4,0.006609715230963233,2019-03-25 00:00:00,2019-03-25 00:15:00
18,1,1,0,0.006609715230963233,2019-03-25 00:00:00,2019-03-25 00:15:00
20,1,0,1,0.003572642319777921,2019-03-25 00:00:00,2019-03-25 00:15:00
27,1,0,1,0.003572642319777921,2019-03-25 00:00:00,2019-03-25 00:15:00
46,4,0,4,0.003572642319777921,2019-03-25 00:00:00,2019-03-25 00:15:00
66,2,1,1,0.023768497565584815,2019-03-25 00:00:00,2019-03-25 00:15:00
67,3,1,2,0.006213885988016886,2019-03-25 00:00:00,2019-03-25 00:15:00
75,1,1,0,0.009191568653622306,2019-03-25 00:00:00,2019-03-25 00:15:00
85,1,1,0,0.007205204990672157,2019-03-25 00:00:00,2019-03-25 00:15:00
87,2,1,1,0.023768497565584815,2019-03-25 00:00:00,2019-03-25 00:15:00
88,5,3,2,0.04132310914315275,2019-03-25 00:00:00,2019-03-25 00:15:00
90,1,1,0,0.011052949754652753,2019-03-25 00:00:00,2019-03-25 00:15:00
101,2,1,1,0.023768497565584815,2019-03-25 00:00:00,2019-03-25 00:15:00
104,1,0,1,0.003572642319777921,2019-03-25 00:00:00,2019-03-25 00:15:00
110,3,3,0,0.005850447003166906,2019-03-25 00:00:00,2019-03-25 00:15:00
111,6,4,2,0.008546105297957539,2019-03-25 00:00:00,2019-03-25 00:15:00
115,2,1,1,0.023768497565584815,2019-03-25 00:00:00,2019-03-25 00:15:00
122,4,2,2,0.023768497565584815,2019-03-25 00:00:00,2019-03-25 00:15:00
137,9,6,3,0.02639589796451812,2019-03-25 00:00:00,2019-03-25 00:15:00
138,1,0,1,0.003572642319777921,2019-03-25 00:00:00,2019-03-25 00:15:00
157,2,1,1,0.023768497565584815,2019-03-25 00:00:00,2019-03-25 00:15:00
164,4,1,3,0.0049853155800955225,2019-03-25 00:00:00,2019-03-25 00:15:00
168,2,1,1,0.006609715230963233,2019-03-25 00:00:00,2019-03-25 00:15:00
169,2,1,1,0.023768497565584815,2019-03-25 00:00:00,2019-03-25 00:15:00
173,2,1,1,0.023768497565584815,2019-03-25 00:00:00,2019-03-25 00:15:00
190,1,1,0,0.006609715230963233,2019-03-25 00:00:00,2019-03-25 00:15:00
195,1,1,0,0.006213885988016886,2019-03-25 00:00:00,2019-03-25 00:15:00
1,2,1,1,0.022826900924424662,2019-03-25 00:15:00,2019-03-25 00:30:00
16,4,1,3,0.006344084491791382,2019-03-25 00:15:00,2019-03-25 00:30:00
18,1,1,0,0.006344084491791382,2019-03-25 00:15:00,2019-03-25 00:30:00
23,1,0,1,0.0034290460040968585,2019-03-25 00:15:00,2019-03-25 00:30:00
28,1,1,0,0.006344084491791382,2019-03-25 00:15:00,2019-03-25 00:30:00
35,1,0,1,0.0034290460040968585,2019-03-25 00:15:00,2019-03-25 00:30:00
57,1,1,0,0.006344084491791382,2019-03-25 00:15:00,2019-03-25 00:30:00
58,1,0,1,0.0034290460040968585,2019-03-25 00:15:00,2019-03-25 00:30:00
66,2,1,1,0.022826900924424662,2019-03-25 00:15:00,2019-03-25 00:30:00
67,3,1,2,0.005964211434942744,2019-03-25 00:15:00,2019-03-25 00:30:00
69,2,2,0,0.006344084491791382,2019-03-25 00:15:00,2019-03-25 00:30:00
70,2,0,2,0.0034290460040968585,2019-03-25 00:15:00,2019-03-25 00:30:00
87,2,1,1,0.022826900924424662,2019-03-25 00:15:00,2019-03-25 00:30:00
88,2,1,1,0.022826900924424662,2019-03-25 00:15:00,2019-03-25 00:30:00
101,2,1,1,0.022826900924424662,2019-03-25 00:15:00,2019-03-25 00:30:00
104,1,0,1,0.0034290460040968585,2019-03-25 00:15:00,2019-03-25 00:30:00
111,5,4,1,0.058707572277385746,2019-03-25 00:15:00,2019-03-25 00:30:00
115,2,1,1,0.022826900924424662,2019-03-25 00:15:00,2019-03-25 00:30:00
118,1,1,0,0.006344084491791382,2019-03-25 00:15:00,2019-03-25 00:30:00
122,4,2,2,0.022826900924424662,2019-03-25 00:15:00,2019-03-25 00:30:00
126,1,1,0,0.006344084491791382,2019-03-25 00:15:00,2019-03-25 00:30:00
137,6,4,2,0.0408688339329058,2019-03-25 00:15:00,2019-03-25 00:30:00
138,1,1,0,0.006344084491791382,2019-03-25 00:15:00,2019-03-25 00:30:00
140,1,0,1,0.0034290460040968585,2019-03-25 00:15:00,2019-03-25 00:30:00
157,2,1,1,0.022826900924424662,2019-03-25 00:15:00,2019-03-25 00:30:00
158,1,0,1,0.0034290460040968585,2019-03-25 00:15:00,2019-03-25 00:30:00
164,4,1,3,0.004784967915943518,2019-03-25 00:15:00,2019-03-25 00:30:00
169,2,1,1,0.022826900924424662,2019-03-25 00:15:00,2019-03-25 00:30:00
191,1,0,1,0.0034290460040968585,2019-03-25 00:15:00,2019-03-25 00:30:00
195,1,1,0,0.005964211434942744,2019-03-25 00:15:00,2019-03-25 00:30:00
1,2,1,1,0.024582431441449323,2019-03-25 00:30:00,2019-03-25 00:45:00
16,2,0,2,0.0036945950273058778,2019-03-25 00:30:00,2019-03-25 00:45:00
18,1,1,0,0.006835350701186433,2019-03-25 00:30:00,2019-03-25 00:45:00
23,1,0,1,0.0036945950273058778,2019-03-25 00:30:00,2019-03-25 00:45:00
28,1,1,0,0.006835350701186433,2019-03-25 00:30:00,2019-03-25 00:45:00
35,1,0,1,0.0036945950273058778,2019-03-25 00:30:00,2019-03-25 00:45:00
57,2,2,0,0.009976106375066988,2019-03-25 00:30:00,2019-03-25 00:45:00
66,2,1,1,0.024582431441449323,2019-03-25 00:30:00,2019-03-25 00:45:00
67,3,1,2,0.006426022125272152,2019-03-25 00:30:00,2019-03-25 00:45:00
69,1,1,0,0.006835350701186433,2019-03-25 00:30:00,2019-03-25 00:45:00
70,1,0,1,0.0036945950273058778,2019-03-25 00:30:00,2019-03-25 00:45:00
87,2,1,1,0.024582431441449323,2019-03-25 00:30:00,2019-03-25 00:45:00
101,2,1,1,0.024582431441449323,2019-03-25 00:30:00,2019-03-25 00:45:00
115,2,1,1,0.024582431441449323,2019-03-25 00:30:00,2019-03-25 00:45:00
118,1,1,0,0.006835350701186433,2019-03-25 00:30:00,2019-03-25 00:45:00
120,1,1,0,0.006835350701186433,2019-03-25 00:30:00,2019-03-25 00:45:00
122,4,2,2,0.024582431441449323,2019-03-25 00:30:00,2019-03-25 00:45:00
126,1,1,0,0.006835350701186433,2019-03-25 00:30:00,2019-03-25 00:45:00
137,6,4,2,0.04400936383752809,2019-03-25 00:30:00,2019-03-25 00:45:00
138,2,2,0,0.006835350701186433,2019-03-25 00:30:00,2019-03-25 00:45:00
140,1,0,1,0.0036945950273058778,2019-03-25 00:30:00,2019-03-25 00:45:00
154,1,0,1,0.0036945950273058778,2019-03-25 00:30:00,2019-03-25 00:45:00
157,2,1,1,0.024582431441449323,2019-03-25 00:30:00,2019-03-25 00:45:00
158,1,0,1,0.0036945950273058778,2019-03-25 00:30:00,2019-03-25 00:45:00
164,4,1,3,0.005155499045370543,2019-03-25 00:30:00,2019-03-25 00:45:00
169,2,1,1,0.024582431441449323,2019-03-25 00:30:00,2019-03-25 00:45:00
191,1,0,1,0.0036945950273058778,2019-03-25 00:30:00,2019-03-25 00:45:00
195,1,1,0,0.006426022125272152,2019-03-25 00:30:00,2019-03-25 00:45:00
196,1,0,1,0.0036945950273058778,2019-03-25 00:30:00,2019-03-25 00:45:00
1,2,1,1,0.024453425604026895,2019-03-25 00:45:00,2019-03-25 01:00:00
16,2,0,2,0.0036756611412867763,2019-03-25 00:45:00,2019-03-25 01:00:00
18,1,1,0,0.006800392765019057,2019-03-25 00:45:00,2019-03-25 01:00:00
57,1,1,0,0.006800392765019057,2019-03-25 00:45:00,2019-03-25 01:00:00
66,2,1,1,0.024453425604026895,2019-03-25 00:45:00,2019-03-25 01:00:00
67,3,1,2,0.00639322636685696,2019-03-25 00:45:00,2019-03-25 01:00:00
87,5,4,1,0.04523119006676702,2019-03-25 00:45:00,2019-03-25 01:00:00
101,2,1,1,0.024453425604026895,2019-03-25 00:45:00,2019-03-25 01:00:00
111,3,0,3,0.0036756611412867763,2019-03-25 00:45:00,2019-03-25 01:00:00
115,2,1,1,0.024453425604026895,2019-03-25 00:45:00,2019-03-25 01:00:00
120,1,1,0,0.006800392765019057,2019-03-25 00:45:00,2019-03-25 01:00:00
122,4,2,2,0.024453425604026895,2019-03-25 00:45:00,2019-03-25 01:00:00
137,6,4,2,0.043777720666988734,2019-03-25 00:45:00,2019-03-25 01:00:00
138,2,2,0,0.006800392765019057,2019-03-25 00:45:00,2019-03-25 01:00:00
140,1,0,1,0.0036756611412867763,2019-03-25 00:45:00,2019-03-25 01:00:00
154,1,0,1,0.0036756611412867763,2019-03-25 00:45:00,2019-03-25 01:00:00
157,2,1,1,0.024453425604026895,2019-03-25 00:45:00,2019-03-25 01:00:00
164,4,1,3,0.005129130541065074,2019-03-25 00:45:00,2019-03-25 01:00:00
169,2,1,1,0.024453425604026895,2019-03-25 00:45:00,2019-03-25 01:00:00
195,1,1,0,0.00639322636685696,2019-03-25 00:45:00,2019-03-25 01:00:00
196,1,0,1,0.0036756611412867763,2019-03-25 00:45:00,2019-03-25 01:00:00
1,2,1,1,0.02400438243983926,2019-03-25 01:00:00,2019-03-25 01:15:00
16,2,0,2,0.0036072595465250303,2019-03-25 01:00:00,2019-03-25 01:15:00
26,2,1,1,0.02400438243983926,2019-03-25 01:00:00,2019-03-25 01:15:00
46,4,1,3,0.005033671782471963,2019-03-25 01:00:00,2019-03-25 01:15:00
57,1,1,0,0.006673828248229386,2019-03-25 01:00:00,2019-03-25 01:15:00
66,2,1,1,0.02400438243983926,2019-03-25 01:00:00,2019-03-25 01:15:00
67,3,1,2,0.006274231612198725,2019-03-25 01:00:00,2019-03-25 01:15:00
87,8,4,4,0.008475056823225347,2019-03-25 01:00:00,2019-03-25 01:15:00
101,2,1,1,0.02400438243983926,2019-03-25 01:00:00,2019-03-25 01:15:00
111,3,0,3,0.0036072595465250303,2019-03-25 01:00:00,2019-03-25 01:15:00
114,2,2,0,0.006460084018418895,2019-03-25 01:00:00,2019-03-25 01:15:00
115,2,1,1,0.02400438243983926,2019-03-25 01:00:00,2019-03-25 01:15:00
122,4,2,2,0.02400438243983926,2019-03-25 01:00:00,2019-03-25 01:15:00
137,10,8,2,0.0793543943877416,2019-03-25 01:00:00,2019-03-25 01:15:00
138,2,2,0,0.006673828248229386,2019-03-25 01:00:00,2019-03-25 01:15:00
157,2,1,1,0.02400438243983926,2019-03-25 01:00:00,2019-03-25 01:15:00
164,5,1,4,0.004580819001865094,2019-03-25 01:00:00,2019-03-25 01:15:00
169,2,1,1,0.02400438243983926,2019-03-25 01:00:00,2019-03-25 01:15:00
195,1,1,0,0.006274231612198725,2019-03-25 01:00:00,2019-03-25 01:15:00
197,1,0,1,0.0036072595465250303,2019-03-25 01:00:00,2019-03-25 01:15:00
1,2,1,1,0.025427089358179618,2019-03-25 01:15:00,2019-03-25 01:30:00
16,2,0,2,0.003823698870501111,2019-03-25 01:15:00,2019-03-25 01:30:00
46,2,0,2,0.003823698870501111,2019-03-25 01:15:00,2019-03-25 01:30:00
57,1,1,0,0.007074200633479938,2019-03-25 01:15:00,2019-03-25 01:30:00
66,2,1,1,0.025427089358179618,2019-03-25 01:15:00,2019-03-25 01:30:00
67,3,1,2,0.0066505571980501,2019-03-25 01:15:00,2019-03-25 01:30:00
87,5,1,4,0.004855643943860807,2019-03-25 01:15:00,2019-03-25 01:30:00
101,2,1,1,0.025427089358179618,2019-03-25 01:15:00,2019-03-25 01:30:00
114,2,2,0,0.007074200633479938,2019-03-25 01:15:00,2019-03-25 01:30:00
115,2,1,1,0.025427089358179618,2019-03-25 01:15:00,2019-03-25 01:30:00
122,4,2,2,0.025427089358179618,2019-03-25 01:15:00,2019-03-25 01:30:00
137,11,8,3,0.023117919387277596,2019-03-25 01:15:00,2019-03-25 01:30:00
138,2,2,0,0.007074200633479938,2019-03-25 01:15:00,2019-03-25 01:30:00
157,3,2,1,0.04420362151830914,2019-03-25 01:15:00,2019-03-25 01:30:00
158,3,1,2,0.0066505571980501,2019-03-25 01:15:00,2019-03-25 01:30:00
164,5,1,4,0.004855643943860807,2019-03-25 01:15:00,2019-03-25 01:30:00
169,2,1,1,0.025427089358179618,2019-03-25 01:15:00,2019-03-25 01:30:00
189,1,1,0,0.010374973908810266,2019-03-25 01:15:00,2019-03-25 01:30:00
195,1,1,0,0.0066505571980501,2019-03-25 01:15:00,2019-03-25 01:30:00
197,1,0,1,0.003823698870501111,2019-03-25 01:15:00,2019-03-25 01:30:00
1,2,1,1,0.025852940273724454,2019-03-25 01:30:00,2019-03-25 01:45:00
16,2,0,2,0.0038875635526463823,2019-03-25 01:30:00,2019-03-25 01:45:00
66,2,1,1,0.025852940273724454,2019-03-25 01:30:00,2019-03-25 01:45:00
67,3,1,2,0.006761647055107537,2019-03-25 01:30:00,2019-03-25 01:45:00
87,2,1,1,0.025852940273724454,2019-03-25 01:30:00,2019-03-25 01:45:00
101,2,1,1,0.025852940273724454,2019-03-25 01:30:00,2019-03-25 01:45:00
110,2,1,1,0.025852940273724454,2019-03-25 01:30:00,2019-03-25 01:45:00
115,2,1,1,0.025852940273724454,2019-03-25 01:30:00,2019-03-25 01:45:00
122,4,2,2,0.025852940273724454,2019-03-25 01:30:00,2019-03-25 01:45:00
137,7,4,3,0.016069892293287,2019-03-25 01:30:00,2019-03-25 01:45:00
138,2,2,0,0.007192361375628052,2019-03-25 01:30:00,2019-03-25 01:45:00
164,4,1,3,0.005424769615043606,2019-03-25 01:30:00,2019-03-25 01:45:00
169,2,1,1,0.025852940273724454,2019-03-25 01:30:00,2019-03-25 01:45:00
189,1,1,0,0.008441521860569469,2019-03-25 01:30:00,2019-03-25 01:45:00
195,1,1,0,0.006761647055107537,2019-03-25 01:30:00,2019-03-25 01:45:00
1,2,1,1,0.025055721163165182,2019-03-25 01:45:00,2019-03-25 02:00:00
16,2,0,2,0.003765497480736561,2019-03-25 01:45:00,2019-03-25 02:00:00
19,1,0,1,0.003765497480736561,2019-03-25 01:45:00,2019-03-25 02:00:00
58,1,1,0,0.0069665266635437735,2019-03-25 01:45:00,2019-03-25 02:00:00
66,2,1,1,0.025055721163165182,2019-03-25 01:45:00,2019-03-25 02:00:00
67,3,1,2,0.006549343518882726,2019-03-25 01:45:00,2019-03-25 02:00:00
87,2,1,1,0.025055721163165182,2019-03-25 01:45:00,2019-03-25 02:00:00
101,2,1,1,0.025055721163165182,2019-03-25 01:45:00,2019-03-25 02:00:00
110,2,1,1,0.025055721163165182,2019-03-25 01:45:00,2019-03-25 02:00:00
115,2,1,1,0.025055721163165182,2019-03-25 01:45:00,2019-03-25 02:00:00
122,4,2,2,0.025055721163165182,2019-03-25 01:45:00,2019-03-25 02:00:00
137,6,4,2,0.04485700483423115,2019-03-25 01:45:00,2019-03-25 02:00:00
138,2,2,0,0.0069665266635437735,2019-03-25 01:45:00,2019-03-25 02:00:00
164,4,1,3,0.005254437492099225,2019-03-25 01:45:00,2019-03-25 02:00:00
169,2,1,1,0.025055721163165182,2019-03-25 01:45:00,2019-03-25 02:00:00
195,1,1,0,0.006549343518882726,2019-03-25 01:45:00,2019-03-25 02:00:00
201,1,1,0,0.0069665266635437735,2019-03-25 01:45:00,2019-03-25 02:00:00
203,1,0,1,0.003765497480736561,2019-03-25 01:45:00,2019-03-25 02:00:00
1,2,1,1,0.02798849158015276,2019-03-25 02:00:00,2019-03-25 02:15:00
16,4,2,2,0.007899966614440576,2019-03-25 02:00:00,2019-03-25 02:15:00
18,1,1,0,0.007804873257187377,2019-03-25 02:00:00,2019-03-25 02:15:00
19,1,0,1,0.004218645224850053,2019-03-25 02:00:00,2019-03-25 02:15:00
58,1,1,0,0.007804873257187377,2019-03-25 02:00:00,2019-03-25 02:15:00
66,2,1,1,0.02798849158015276,2019-03-25 02:00:00,2019-03-25 02:15:00
67,3,1,2,0.007337447037650371,2019-03-25 02:00:00,2019-03-25 02:15:00
90,1,1,0,0.005357171489440441,2019-03-25 02:00:00,2019-03-25 02:15:00
101,2,1,1,0.02798849158015276,2019-03-25 02:00:00,2019-03-25 02:15:00
110,2,2,0,0.008533408790823517,2019-03-25 02:00:00,2019-03-25 02:15:00
114,1,0,1,0.004218645224850053,2019-03-25 02:00:00,2019-03-25 02:15:00
115,7,3,4,0.01164095383838466,2019-03-25 02:00:00,2019-03-25 02:15:00
137,5,2,3,0.006495697754030831,2019-03-25 02:00:00,2019-03-25 02:15:00
138,2,2,0,0.010934430391644875,2019-03-25 02:00:00,2019-03-25 02:15:00
164,5,1,4,0.005357171489440441,2019-03-25 02:00:00,2019-03-25 02:15:00
169,2,1,1,0.02798849158015276,2019-03-25 02:00:00,2019-03-25 02:15:00
195,1,1,0,0.007337447037650371,2019-03-25 02:00:00,2019-03-25 02:15:00
1,2,1,1,0.027608573381736057,2019-03-25 02:15:00,2019-03-25 02:30:00
15,2,2,0,0.011559014226037754,2019-03-25 02:15:00,2019-03-25 02:30:00
16,4,2,2,0.009148549756520675,2019-03-25 02:15:00,2019-03-25 02:30:00
18,2,1,1,0.007699162238939094,2019-03-25 02:15:00,2019-03-25 02:30:00
28,1,0,1,0.004161509015354788,2019-03-25 02:15:00,2019-03-25 02:30:00
61,1,1,0,0.007699162238939094,2019-03-25 02:15:00,2019-03-25 02:30:00
66,2,1,1,0.027608573381736057,2019-03-25 02:15:00,2019-03-25 02:30:00
67,3,1,2,0.007238063465485711,2019-03-25 02:15:00,2019-03-25 02:30:00
90,1,1,0,0.005013978411829807,2019-03-25 02:15:00,2019-03-25 02:30:00
101,2,1,1,0.027608573381736057,2019-03-25 02:15:00,2019-03-25 02:30:00
110,1,1,0,0.007238063465485711,2019-03-25 02:15:00,2019-03-25 02:30:00
114,1,0,1,0.004161509015354788,2019-03-25 02:15:00,2019-03-25 02:30:00
115,3,1,2,0.007238063465485711,2019-03-25 02:15:00,2019-03-25 02:30:00
137,4,2,2,0.005866447808304826,2019-03-25 02:15:00,2019-03-25 02:30:00
138,3,2,1,0.011938717236223358,2019-03-25 02:15:00,2019-03-25 02:30:00
158,1,1,0,0.014310747395795138,2019-03-25 02:15:00,2019-03-25 02:30:00
164,6,1,5,0.005013978411829807,2019-03-25 02:15:00,2019-03-25 02:30:00
169,2,1,1,0.027608573381736057,2019-03-25 02:15:00,2019-03-25 02:30:00
195,1,1,0,0.007238063465485711,2019-03-25 02:15:00,2019-03-25 02:30:00
1,2,1,1,0.02796100112324878,2019-03-25 02:30:00,2019-03-25 02:45:00
15,1,1,0,0.007787220338008053,2019-03-25 02:30:00,2019-03-25 02:45:00
16,2,0,2,0.004209111713780225,2019-03-25 02:30:00,2019-03-25 02:45:00
18,1,0,1,0.004209111713780225,2019-03-25 02:30:00,2019-03-25 02:45:00
66,2,1,1,0.02796100112324878,2019-03-25 02:30:00,2019-03-25 02:45:00
67,3,1,2,0.00732084250625731,2019-03-25 02:30:00,2019-03-25 02:45:00
101,2,1,1,0.02796100112324878,2019-03-25 02:30:00,2019-03-25 02:45:00
115,2,1,1,0.02796100112324878,2019-03-25 02:30:00,2019-03-25 02:45:00
137,2,2,0,0.007537760243314627,2019-03-25 02:30:00,2019-03-25 02:45:00
138,2,2,0,0.007787220338008053,2019-03-25 02:30:00,2019-03-25 02:45:00
164,4,1,3,0.005873435978547426,2019-03-25 02:30:00,2019-03-25 02:45:00
169,2,1,1,0.02796100112324878,2019-03-25 02:30:00,2019-03-25 02:45:00
195,1,1,0,0.00732084250625731,2019-03-25 02:30:00,2019-03-25 02:45:00
1,2,1,1,0.02806159378598641,2019-03-25 02:45:00,2019-03-25 03:00:00
16,2,0,2,0.0042242218528113305,2019-03-25 02:45:00,2019-03-25 03:00:00
66,2,1,1,0.02806159378598641,2019-03-25 02:45:00,2019-03-25 03:00:00
67,3,1,2,0.007347125256103031,2019-03-25 02:45:00,2019-03-25 03:00:00
101,2,1,1,0.02806159378598641,2019-03-25 02:45:00,2019-03-25 03:00:00
115,2,1,1,0.02806159378598641,2019-03-25 02:45:00,2019-03-25 03:00:00
137,2,2,0,0.007564821267237237,2019-03-25 02:45:00,2019-03-25 03:00:00
138,2,2,0,0.007815176432389903,2019-03-25 02:45:00,2019-03-25 03:00:00
164,4,1,3,0.005894521560024284,2019-03-25 02:45:00,2019-03-25 03:00:00
169,2,1,1,0.02806159378598641,2019-03-25 02:45:00,2019-03-25 03:00:00
195,1,1,0,0.007347125256103031,2019-03-25 02:45:00,2019-03-25 03:00:00
1,2,1,1,0.027961001123248782,2019-03-25 03:00:00,2019-03-25 03:15:00
16,2,0,2,0.004209111713780225,2019-03-25 03:00:00,2019-03-25 03:15:00
23,1,0,1,0.004209111713780225,2019-03-25 03:00:00,2019-03-25 03:15:00
66,2,1,1,0.027961001123248782,2019-03-25 03:00:00,2019-03-25 03:15:00
67,3,1,2,0.007320842506257309,2019-03-25 03:00:00,2019-03-25 03:15:00
101,2,1,1,0.027961001123248782,2019-03-25 03:00:00,2019-03-25 03:15:00
104,1,1,0,0.007787220338008053,2019-03-25 03:00:00,2019-03-25 03:15:00
115,2,1,1,0.027961001123248782,2019-03-25 03:00:00,2019-03-25 03:15:00
137,2,2,0,0.007537760243314627,2019-03-25 03:00:00,2019-03-25 03:15:00
138,2,2,0,0.007787220338008053,2019-03-25 03:00:00,2019-03-25 03:15:00
164,4,1,3,0.005873435978547426,2019-03-25 03:00:00,2019-03-25 03:15:00
169,2,1,1,0.027961001123248782,2019-03-25 03:00:00,2019-03-25 03:15:00
195,1,1,0,0.007320842506257309,2019-03-25 03:00:00,2019-03-25 03:15:00
1,2,1,1,0.027961001123248782,2019-03-25 03:15:00,2019-03-25 03:30:00
16,2,0,2,0.004209111713780225,2019-03-25 03:15:00,2019-03-25 03:30:00
58,1,0,1,0.004209111713780225,2019-03-25 03:15:00,2019-03-25 03:30:00
66,2,1,1,0.027961001123248782,2019-03-25 03:15:00,2019-03-25 03:30:00
67,3,1,2,0.00732084250625731,2019-03-25 03:15:00,2019-03-25 03:30:00
101,2,1,1,0.027961001123248782,2019-03-25 03:15:00,2019-03-25 03:30:00
115,2,1,1,0.027961001123248782,2019-03-25 03:15:00,2019-03-25 03:30:00
137,2,2,0,0.007537760243314627,2019-03-25 03:15:00,2019-03-25 03:30:00
138,2,2,0,0.007787220338008053,2019-03-25 03:15:00,2019-03-25 03:30:00
164,4,1,3,0.005873435978547426,2019-03-25 03:15:00,2019-03-25 03:30:00
169,2,1,1,0.027961001123248782,2019-03-25 03:15:00,2019-03-25 03:30:00
191,1,1,0,0.007787220338008053,2019-03-25 03:15:00,2019-03-25 03:30:00
195,1,1,0,0.00732084250625731,2019-03-25 03:15:00,2019-03-25 03:30:00
1,2,1,1,0.027465247805746225,2019-03-25 03:30:00,2019-03-25 03:45:00
16,2,0,2,0.004134622916868768,2019-03-25 03:30:00,2019-03-25 03:45:00
58,1,0,1,0.004134622916868768,2019-03-25 03:30:00,2019-03-25 03:45:00
66,2,1,1,0.027465247805746225,2019-03-25 03:30:00,2019-03-25 03:45:00
67,3,1,2,0.007191273559881215,2019-03-25 03:30:00,2019-03-25 03:45:00
88,1,0,1,0.004134622916868768,2019-03-25 03:30:00,2019-03-25 03:45:00
101,2,1,1,0.027465247805746225,2019-03-25 03:30:00,2019-03-25 03:45:00
115,2,1,1,0.027465247805746225,2019-03-25 03:30:00,2019-03-25 03:45:00
120,1,1,0,0.007649403276578903,2019-03-25 03:30:00,2019-03-25 03:45:00
137,2,2,0,0.010183990935626545,2019-03-25 03:30:00,2019-03-25 03:45:00
138,2,2,0,0.007649403276578903,2019-03-25 03:30:00,2019-03-25 03:45:00
154,2,0,2,0.004134622916868768,2019-03-25 03:30:00,2019-03-25 03:45:00
164,6,3,3,0.010674087285957791,2019-03-25 03:30:00,2019-03-25 03:45:00
169,2,1,1,0.027465247805746225,2019-03-25 03:30:00,2019-03-25 03:45:00
190,1,1,0,0.010637325761379428,2019-03-25 03:30:00,2019-03-25 03:45:00
191,2,1,1,0.007649403276578903,2019-03-25 03:30:00,2019-03-25 03:45:00
195,1,1,0,0.007191273559881215,2019-03-25 03:30:00,2019-03-25 03:45:00
1,2,1,1,0.027206380057582778,2019-03-25 03:45:00,2019-03-25 04:00:00
16,2,0,2,0.004095711340160804,2019-03-25 03:45:00,2019-03-25 04:00:00
19,1,0,1,0.004095711340160804,2019-03-25 03:45:00,2019-03-25 04:00:00
66,2,1,1,0.027206380057582778,2019-03-25 03:45:00,2019-03-25 04:00:00
67,3,1,2,0.00712358765724946,2019-03-25 03:45:00,2019-03-25 04:00:00
88,1,0,1,0.004095711340160804,2019-03-25 03:45:00,2019-03-25 04:00:00
101,2,1,1,0.027206380057582778,2019-03-25 03:45:00,2019-03-25 04:00:00
115,2,1,1,0.027206380057582778,2019-03-25 03:45:00,2019-03-25 04:00:00
120,1,1,0,0.007577409360061857,2019-03-25 03:45:00,2019-03-25 04:00:00
137,4,4,0,0.009255378698411261,2019-03-25 03:45:00,2019-03-25 04:00:00
138,2,2,0,0.007577409360061857,2019-03-25 03:45:00,2019-03-25 04:00:00
154,1,0,1,0.004095711340160804,2019-03-25 03:45:00,2019-03-25 04:00:00
158,1,1,0,0.010938195130394925,2019-03-25 03:45:00,2019-03-25 04:00:00
164,6,1,5,0.004934696009335506,2019-03-25 03:45:00,2019-03-25 04:00:00
168,2,0,2,0.004095711340160804,2019-03-25 03:45:00,2019-03-25 04:00:00
169,2,1,1,0.027206380057582778,2019-03-25 03:45:00,2019-03-25 04:00:00
170,6,4,2,0.01609786248864538,2019-03-25 03:45:00,2019-03-25 04:00:00
190,1,1,0,0.007577409360061857,2019-03-25 03:45:00,2019-03-25 04:00:00
191,1,0,1,0.004095711340160804,2019-03-25 03:45:00,2019-03-25 04:00:00
195,1,1,0,0.00712358765724946,2019-03-25 03:45:00,2019-03-25 04:00:00
197,1,1,0,0.007577409360061857,2019-03-25 03:45:00,2019-03-25 04:00:00
1,2,1,1,0.02714307075523149,2019-03-25 04:00:00,2019-03-25 04:15:00
16,2,0,2,0.004086167367049129,2019-03-25 04:00:00,2019-03-25 04:15:00
19,1,0,1,0.004086167367049129,2019-03-25 04:00:00,2019-03-25 04:15:00
66,2,1,1,0.02714307075523149,2019-03-25 04:00:00,2019-03-25 04:15:00
67,3,1,2,0.007106982599151376,2019-03-25 04:00:00,2019-03-25 04:15:00
89,1,1,0,0.013363195196550895,2019-03-25 04:00:00,2019-03-25 04:15:00
101,2,1,1,0.02714307075523149,2019-03-25 04:00:00,2019-03-25 04:15:00
115,2,1,1,0.02714307075523149,2019-03-25 04:00:00,2019-03-25 04:15:00
137,4,4,0,0.009233806688128801,2019-03-25 04:00:00,2019-03-25 04:15:00
138,2,2,0,0.00755974922928296,2019-03-25 04:00:00,2019-03-25 04:15:00
154,1,0,1,0.004086167367049129,2019-03-25 04:00:00,2019-03-25 04:15:00
158,2,1,1,0.010912689079181968,2019-03-25 04:00:00,2019-03-25 04:15:00
164,6,1,5,0.004923196096472049,2019-03-25 04:00:00,2019-03-25 04:15:00
168,2,0,2,0.004086167367049129,2019-03-25 04:00:00,2019-03-25 04:15:00
169,2,1,1,0.02714307075523149,2019-03-25 04:00:00,2019-03-25 04:15:00
170,6,4,2,0.01606032840026164,2019-03-25 04:00:00,2019-03-25 04:15:00
195,1,1,0,0.007106982599151376,2019-03-25 04:00:00,2019-03-25 04:15:00
197,1,1,0,0.00755974922928296,2019-03-25 04:00:00,2019-03-25 04:15:00
1,2,1,1,0.02612402940526557,2019-03-25 04:15:00,2019-03-25 04:30:00
16,2,0,2,0.0039282275552673,2019-03-25 04:15:00,2019-03-25 04:30:00
57,1,1,0,0.007267600525483836,2019-03-25 04:15:00,2019-03-25 04:30:00
66,2,1,1,0.02612402940526557,2019-03-25 04:15:00,2019-03-25 04:30:00
67,3,1,2,0.006832387283477532,2019-03-25 04:15:00,2019-03-25 04:30:00
89,3,2,1,0.06470731364884165,2019-03-25 04:15:00,2019-03-25 04:30:00
101,2,1,1,0.02612402940526557,2019-03-25 04:15:00,2019-03-25 04:30:00
109,1,0,1,0.0039282275552673,2019-03-25 04:15:00,2019-03-25 04:30:00
115,2,1,1,0.02612402940526557,2019-03-25 04:15:00,2019-03-25 04:30:00
137,2,2,0,0.007034808204175192,2019-03-25 04:15:00,2019-03-25 04:30:00
138,2,2,0,0.007267600525483836,2019-03-25 04:15:00,2019-03-25 04:30:00
158,2,1,1,0.006832387283477532,2019-03-25 04:15:00,2019-03-25 04:30:00
164,4,1,3,0.005481517879721246,2019-03-25 04:15:00,2019-03-25 04:30:00
169,2,1,1,0.02612402940526557,2019-03-25 04:15:00,2019-03-25 04:30:00
170,3,1,2,0.006832387283477532,2019-03-25 04:15:00,2019-03-25 04:30:00
195,1,1,0,0.006832387283477532,2019-03-25 04:15:00,2019-03-25 04:30:00
1,2,1,1,0.026261482556083193,2019-03-25 04:30:00,2019-03-25 04:45:00
15,5,1,4,0.005016490773494996,2019-03-25 04:30:00,2019-03-25 04:45:00
19,1,1,0,0.010163374995378189,2019-03-25 04:30:00,2019-03-25 04:45:00
57,2,1,1,0.007308539736582219,2019-03-25 04:30:00,2019-03-25 04:45:00
66,2,1,1,0.026261482556083193,2019-03-25 04:30:00,2019-03-25 04:45:00
67,3,1,2,0.006870861556010027,2019-03-25 04:30:00,2019-03-25 04:45:00
89,2,1,1,0.026261482556083193,2019-03-25 04:30:00,2019-03-25 04:45:00
101,2,1,1,0.026261482556083193,2019-03-25 04:30:00,2019-03-25 04:45:00
109,1,0,1,0.003950361343458616,2019-03-25 04:30:00,2019-03-25 04:45:00
115,2,1,1,0.026261482556083193,2019-03-25 04:30:00,2019-03-25 04:45:00
137,2,2,0,0.00960393833493723,2019-03-25 04:30:00,2019-03-25 04:45:00
138,2,1,1,0.026261482556083193,2019-03-25 04:30:00,2019-03-25 04:45:00
158,1,1,0,0.006870861556010027,2019-03-25 04:30:00,2019-03-25 04:45:00
164,7,4,3,0.00997553812930706,2019-03-25 04:30:00,2019-03-25 04:45:00
169,2,1,1,0.026261482556083193,2019-03-25 04:30:00,2019-03-25 04:45:00
170,3,1,2,0.006870861556010027,2019-03-25 04:30:00,2019-03-25 04:45:00
195,1,1,0,0.006870861556010027,2019-03-25 04:30:00,2019-03-25 04:45:00
15,3,0,3,0.004165516970089626,2019-03-25 04:45:00,2019-03-25 05:00:00
19,1,1,0,0.0077065616317241944,2019-03-25 04:45:00,2019-03-25 05:00:00
57,1,0,1,0.004165516970089626,2019-03-25 04:45:00,2019-03-25 05:00:00
66,2,1,1,0.02767093599946452,2019-03-25 04:45:00,2019-03-25 05:00:00
67,3,1,2,0.00724501025625259,2019-03-25 04:45:00,2019-03-25 05:00:00
89,2,1,1,0.02767093599946452,2019-03-25 04:45:00,2019-03-25 05:00:00
101,2,1,1,0.02767093599946452,2019-03-25 04:45:00,2019-03-25 05:00:00
115,2,1,1,0.02767093599946452,2019-03-25 04:45:00,2019-03-25 05:00:00
137,2,2,0,0.010260092647976046,2019-03-25 04:45:00,2019-03-25 05:00:00
158,1,1,0,0.00724501025625259,2019-03-25 04:45:00,2019-03-25 05:00:00
164,7,4,3,0.010753849470667404,2019-03-25 04:45:00,2019-03-25 05:00:00
169,2,1,1,0.02767093599946452,2019-03-25 04:45:00,2019-03-25 05:00:00
170,3,1,2,0.00724501025625259,2019-03-25 04:45:00,2019-03-25 05:00:00
195,1,1,0,0.00724501025625259,2019-03-25 04:45:00,2019-03-25 05:00:00
19,2,2,0,0.007826693381511391,2019-03-25 05:00:00,2019-03-25 05:15:00
23,1,1,0,0.01048549035792096,2019-03-25 05:00:00,2019-03-25 05:15:00
46,1,1,0,0.007826693381511391,2019-03-25 05:00:00,2019-03-25 05:15:00
57,2,0,2,0.004230437159903763,2019-03-25 05:00:00,2019-03-25 05:15:00
66,2,1,1,0.02806644781875044,2019-03-25 05:00:00,2019-03-25 05:15:00
67,3,1,2,0.007357963758912361,2019-03-25 05:00:00,2019-03-25 05:15:00
69,1,0,1,0.004230437159903763,2019-03-25 05:00:00,2019-03-25 05:15:00
101,2,1,1,0.02806644781875044,2019-03-25 05:00:00,2019-03-25 05:15:00
115,2,1,1,0.02806644781875044,2019-03-25 05:00:00,2019-03-25 05:15:00
137,4,2,2,0.007575975775166116,2019-03-25 05:00:00,2019-03-25 05:15:00
158,2,1,1,0.007357963758912361,2019-03-25 05:00:00,2019-03-25 05:15:00
164,4,1,3,0.005903206467534939,2019-03-25 05:00:00,2019-03-25 05:15:00
168,2,2,0,0.010670796784083194,2019-03-25 05:00:00,2019-03-25 05:15:00
169,2,1,1,0.02806644781875044,2019-03-25 05:00:00,2019-03-25 05:15:00
170,3,1,2,0.007357963758912361,2019-03-25 05:00:00,2019-03-25 05:15:00
195,1,1,0,0.007357963758912361,2019-03-25 05:00:00,2019-03-25 05:15:00
19,3,3,0,0.011260984707946274,2019-03-25 05:15:00,2019-03-25 05:30:00
21,1,1,0,0.007715721332832763,2019-03-25 05:15:00,2019-03-25 05:30:00
23,1,1,0,0.010336808463809213,2019-03-25 05:15:00,2019-03-25 05:30:00
46,1,1,0,0.007715721332832763,2019-03-25 05:15:00,2019-03-25 05:30:00
57,2,0,2,0.004170457957719251,2019-03-25 05:15:00,2019-03-25 05:30:00
66,2,1,1,0.02766778495992021,2019-03-25 05:15:00,2019-03-25 05:30:00
67,3,1,2,0.007253633210764231,2019-03-25 05:15:00,2019-03-25 05:30:00
69,1,0,1,0.004170457957719251,2019-03-25 05:15:00,2019-03-25 05:30:00
85,1,1,0,0.007715721332832763,2019-03-25 05:15:00,2019-03-25 05:30:00
101,2,1,1,0.02766778495992021,2019-03-25 05:15:00,2019-03-25 05:30:00
113,1,0,1,0.004170457957719251,2019-03-25 05:15:00,2019-03-25 05:30:00
115,2,1,1,0.02766778495992021,2019-03-25 05:15:00,2019-03-25 05:30:00
120,1,0,1,0.004170457957719251,2019-03-25 05:15:00,2019-03-25 05:30:00
137,4,2,2,0.00746855623881146,2019-03-25 05:15:00,2019-03-25 05:30:00
138,1,1,0,0.007715721332832763,2019-03-25 05:15:00,2019-03-25 05:30:00
151,1,0,1,0.004170457957719251,2019-03-25 05:15:00,2019-03-25 05:30:00
157,1,0,1,0.004170457957719251,2019-03-25 05:15:00,2019-03-25 05:30:00
158,2,1,1,0.007253633210764231,2019-03-25 05:15:00,2019-03-25 05:30:00
164,4,1,3,0.005819507098265356,2019-03-25 05:15:00,2019-03-25 05:30:00
168,2,2,0,0.010519489425882364,2019-03-25 05:15:00,2019-03-25 05:30:00
169,2,1,1,0.02766778495992021,2019-03-25 05:15:00,2019-03-25 05:30:00
170,3,1,2,0.007253633210764231,2019-03-25 05:15:00,2019-03-25 05:30:00
195,1,1,0,0.007253633210764231,2019-03-25 05:15:00,2019-03-25 05:30:00
19,2,2,0,0.007711650578671967,2019-03-25 05:30:00,2019-03-25 05:45:00
21,1,1,0,0.007711650578671967,2019-03-25 05:30:00,2019-03-25 05:45:00
57,2,0,2,0.004168267024714447,2019-03-25 05:30:00,2019-03-25 05:45:00
66,2,1,1,0.027689163389976075,2019-03-25 05:30:00,2019-03-25 05:45:00
67,3,1,2,0.007249795400071262,2019-03-25 05:30:00,2019-03-25 05:45:00
101,2,1,1,0.027689163389976075,2019-03-25 05:30:00,2019-03-25 05:45:00
115,2,1,1,0.027689163389976075,2019-03-25 05:30:00,2019-03-25 05:45:00
120,1,0,1,0.004168267024714447,2019-03-25 05:30:00,2019-03-25 05:45:00
137,2,2,0,0.007464609653996291,2019-03-25 05:30:00,2019-03-25 05:45:00
138,1,1,0,0.007711650578671967,2019-03-25 05:30:00,2019-03-25 05:45:00
147,2,1,1,0.027689163389976075,2019-03-25 05:30:00,2019-03-25 05:45:00
151,1,0,1,0.004168267024714447,2019-03-25 05:30:00,2019-03-25 05:45:00
158,1,1,0,0.007249795400071262,2019-03-25 05:30:00,2019-03-25 05:45:00
164,4,1,3,0.005816438339355369,2019-03-25 05:30:00,2019-03-25 05:45:00
169,2,1,1,0.027689163389976075,2019-03-25 05:30:00,2019-03-25 05:45:00
170,3,1,2,0.007249795400071262,2019-03-25 05:30:00,2019-03-25 05:45:00
195,1,1,0,0.007249795400071262,2019-03-25 05:30:00,2019-03-25 05:45:00
16,5,2,3,0.009608287219000259,2019-03-25 05:45:00,2019-03-25 06:00:00
18,1,0,1,0.004162820662819591,2019-03-25 05:45:00,2019-03-25 06:00:00
19,2,2,0,0.006521999818761388,2019-03-25 05:45:00,2019-03-25 06:00:00
21,1,1,0,0.007701589396732287,2019-03-25 05:45:00,2019-03-25 06:00:00
57,3,0,3,0.004162820662819591,2019-03-25 05:45:00,2019-03-25 06:00:00
66,2,1,1,0.027617250348186174,2019-03-25 05:45:00,2019-03-25 06:00:00
67,3,1,2,0.007240345688802579,2019-03-25 05:45:00,2019-03-25 06:00:00
101,2,1,1,0.027617250348186174,2019-03-25 05:45:00,2019-03-25 06:00:00
104,1,0,1,0.004162820662819591,2019-03-25 05:45:00,2019-03-25 06:00:00
109,1,1,0,0.007240345688802579,2019-03-25 05:45:00,2019-03-25 06:00:00
110,1,0,1,0.004162820662819591,2019-03-25 05:45:00,2019-03-25 06:00:00
115,2,1,1,0.027617250348186174,2019-03-25 05:45:00,2019-03-25 06:00:00
120,1,0,1,0.004162820662819591,2019-03-25 05:45:00,2019-03-25 06:00:00
122,3,1,2,0.007240345688802579,2019-03-25 05:45:00,2019-03-25 06:00:00
126,1,1,0,0.007701589396732287,2019-03-25 05:45:00,2019-03-25 06:00:00
127,2,2,0,0.008881178974703186,2019-03-25 05:45:00,2019-03-25 06:00:00
133,1,1,0,0.007701589396732287,2019-03-25 05:45:00,2019-03-25 06:00:00
137,2,2,0,0.007454875987401667,2019-03-25 05:45:00,2019-03-25 06:00:00
138,1,1,0,0.007701589396732287,2019-03-25 05:45:00,2019-03-25 06:00:00
151,1,0,1,0.004162820662819591,2019-03-25 05:45:00,2019-03-25 06:00:00
157,1,1,0,0.0068855539409099255,2019-03-25 05:45:00,2019-03-25 06:00:00
158,1,1,0,0.007240345688802579,2019-03-25 05:45:00,2019-03-25 06:00:00
164,4,1,3,0.005808848325110629,2019-03-25 05:45:00,2019-03-25 06:00:00
169,2,1,1,0.027617250348186174,2019-03-25 05:45:00,2019-03-25 06:00:00
170,3,1,2,0.007240345688802579,2019-03-25 05:45:00,2019-03-25 06:00:00
195,1,1,0,0.007240345688802579,2019-03-25 05:45:00,2019-03-25 06:00:00
16,3,1,2,0.007080181122269416,2019-03-25 06:00:00,2019-03-25 06:15:00
18,2,0,2,0.004070755950831266,2019-03-25 06:00:00,2019-03-25 06:15:00
19,2,2,0,0.006377744422974329,2019-03-25 06:00:00,2019-03-25 06:15:00
35,1,0,1,0.004070755950831266,2019-03-25 06:00:00,2019-03-25 06:15:00
37,2,2,0,0.011819847647814862,2019-03-25 06:00:00,2019-03-25 06:15:00
46,1,1,0,0.0075312386590458595,2019-03-25 06:00:00,2019-03-25 06:15:00
57,3,0,3,0.004070755950831266,2019-03-25 06:00:00,2019-03-25 06:15:00
62,1,1,0,0.008511824762581444,2019-03-25 06:00:00,2019-03-25 06:15:00
66,3,2,1,0.05000968403001509,2019-03-25 06:00:00,2019-03-25 06:15:00
67,3,1,2,0.007080181122269416,2019-03-25 06:00:00,2019-03-25 06:15:00
70,1,0,1,0.004070755950831266,2019-03-25 06:00:00,2019-03-25 06:15:00
101,2,1,1,0.027040219990423185,2019-03-25 06:00:00,2019-03-25 06:15:00
104,1,0,1,0.004070755950831266,2019-03-25 06:00:00,2019-03-25 06:15:00
115,2,1,1,0.027040219990423185,2019-03-25 06:00:00,2019-03-25 06:15:00
120,1,0,1,0.004070755950831266,2019-03-25 06:00:00,2019-03-25 06:15:00
126,1,1,0,0.0075312386590458595,2019-03-25 06:00:00,2019-03-25 06:15:00
127,2,1,1,0.005224250186902797,2019-03-25 06:00:00,2019-03-25 06:15:00
137,3,3,0,0.00902021474313586,2019-03-25 06:00:00,2019-03-25 06:15:00
138,1,1,0,0.0075312386590458595,2019-03-25 06:00:00,2019-03-25 06:15:00
157,2,1,1,0.007080181122269416,2019-03-25 06:00:00,2019-03-25 06:15:00
158,1,1,0,0.007080181122269416,2019-03-25 06:00:00,2019-03-25 06:15:00
164,4,1,3,0.005680364669929916,2019-03-25 06:00:00,2019-03-25 06:15:00
169,2,1,1,0.027040219990423185,2019-03-25 06:00:00,2019-03-25 06:15:00
170,3,1,2,0.007080181122269416,2019-03-25 06:00:00,2019-03-25 06:15:00
195,1,1,0,0.007080181122269416,2019-03-25 06:00:00,2019-03-25 06:15:00
18,3,0,3,0.003918967742342811,2019-03-25 06:15:00,2019-03-25 06:30:00
19,4,2,2,0.0072504577690453605,2019-03-25 06:15:00,2019-03-25 06:30:00
37,2,2,0,0.010980885621714759,2019-03-25 06:15:00,2019-03-25 06:30:00
57,2,0,2,0.003918967742342811,2019-03-25 06:15:00,2019-03-25 06:30:00
62,1,1,0,0.0072504577690453605,2019-03-25 06:15:00,2019-03-25 06:30:00
66,2,1,1,0.026052193275841906,2019-03-25 06:15:00,2019-03-25 06:30:00
67,3,1,2,0.0068162569093282825,2019-03-25 06:15:00,2019-03-25 06:30:00
70,2,1,1,0.026052193275841906,2019-03-25 06:15:00,2019-03-25 06:30:00
101,2,1,1,0.026052193275841906,2019-03-25 06:15:00,2019-03-25 06:30:00
110,2,1,1,0.026052193275841906,2019-03-25 06:15:00,2019-03-25 06:30:00
115,2,1,1,0.026052193275841906,2019-03-25 06:15:00,2019-03-25 06:30:00
118,1,1,0,0.005029464417910327,2019-03-25 06:15:00,2019-03-25 06:30:00
120,1,0,1,0.003918967742342811,2019-03-25 06:15:00,2019-03-25 06:30:00
127,1,0,1,0.003918967742342811,2019-03-25 06:15:00,2019-03-25 06:30:00
133,2,1,1,0.026052193275841906,2019-03-25 06:15:00,2019-03-25 06:30:00
137,3,3,0,0.008128704411407398,2019-03-25 06:15:00,2019-03-25 06:30:00
138,1,1,0,0.0072504577690453605,2019-03-25 06:15:00,2019-03-25 06:30:00
153,1,1,0,0.007000785800557751,2019-03-25 06:15:00,2019-03-25 06:30:00
157,2,1,1,0.007000785800557751,2019-03-25 06:15:00,2019-03-25 06:30:00
158,1,1,0,0.0068162569093282825,2019-03-25 06:15:00,2019-03-25 06:30:00
164,4,1,3,0.005468587739091347,2019-03-25 06:15:00,2019-03-25 06:30:00
169,2,1,1,0.026052193275841906,2019-03-25 06:15:00,2019-03-25 06:30:00
170,3,1,2,0.0068162569093282825,2019-03-25 06:15:00,2019-03-25 06:30:00
195,1,1,0,0.0068162569093282825,2019-03-25 06:15:00,2019-03-25 06:30:00
1,1,0,1,0.003777911557978017,2019-03-25 06:30:00,2019-03-25 06:45:00
2,1,1,0,0.011349436954355117,2019-03-25 06:30:00,2019-03-25 06:45:00
10,1,1,0,0.006989469659530182,2019-03-25 06:30:00,2019-03-25 06:45:00
15,4,1,3,0.006989469659530182,2019-03-25 06:30:00,2019-03-25 06:45:00
18,3,1,2,0.004580801083366059,2019-03-25 06:30:00,2019-03-25 06:45:00
19,4,2,2,0.005383690608754099,2019-03-25 06:30:00,2019-03-25 06:45:00
20,1,1,0,0.006989469659530182,2019-03-25 06:30:00,2019-03-25 06:45:00
23,1,1,0,0.006225550705926366,2019-03-25 06:30:00,2019-03-25 06:45:00
26,1,1,0,0.006989469659530182,2019-03-25 06:30:00,2019-03-25 06:45:00
37,1,1,0,0.008644677301853648,2019-03-25 06:30:00,2019-03-25 06:45:00
40,2,2,0,0.006186580134142141,2019-03-25 06:30:00,2019-03-25 06:45:00
41,1,0,1,0.003777911557978017,2019-03-25 06:30:00,2019-03-25 06:45:00
46,2,1,1,0.005724961465235521,2019-03-25 06:30:00,2019-03-25 06:45:00
50,1,0,1,0.003777911557978017,2019-03-25 06:30:00,2019-03-25 06:45:00
57,4,0,4,0.003777911557978017,2019-03-25 06:30:00,2019-03-25 06:45:00
61,1,0,1,0.003777911557978017,2019-03-25 06:30:00,2019-03-25 06:45:00
66,2,1,1,0.025105486003312354,2019-03-25 06:30:00,2019-03-25 06:45:00
67,3,1,2,0.0065708770156532115,2019-03-25 06:30:00,2019-03-25 06:45:00
70,2,1,1,0.025105486003312354,2019-03-25 06:30:00,2019-03-25 06:45:00
74,1,1,0,0.006066232321716943,2019-03-25 06:30:00,2019-03-25 06:45:00
79,1,0,1,0.003777911557978017,2019-03-25 06:30:00,2019-03-25 06:45:00
90,3,0,3,0.003777911557978017,2019-03-25 06:30:00,2019-03-25 06:45:00
101,2,1,1,0.025105486003312354,2019-03-25 06:30:00,2019-03-25 06:45:00
109,2,1,1,0.004848430925162072,2019-03-25 06:30:00,2019-03-25 06:45:00
112,1,1,0,0.006989469659530182,2019-03-25 06:30:00,2019-03-25 06:45:00
113,1,1,0,0.0065708770156532115,2019-03-25 06:30:00,2019-03-25 06:45:00
114,1,0,1,0.003777911557978017,2019-03-25 06:30:00,2019-03-25 06:45:00
115,3,2,1,0.05247173256324076,2019-03-25 06:30:00,2019-03-25 06:45:00
118,2,2,0,0.007705536449703368,2019-03-25 06:30:00,2019-03-25 06:45:00
120,3,1,2,0.005758486542445864,2019-03-25 06:30:00,2019-03-25 06:45:00
127,1,0,1,0.003777911557978017,2019-03-25 06:30:00,2019-03-25 06:45:00
135,1,1,0,0.005758486542445864,2019-03-25 06:30:00,2019-03-25 06:45:00
137,5,4,1,0.008906607713466685,2019-03-25 06:30:00,2019-03-25 06:45:00
138,1,1,0,0.006225550705926366,2019-03-25 06:30:00,2019-03-25 06:45:00
140,1,0,1,0.003777911557978017,2019-03-25 06:30:00,2019-03-25 06:45:00
147,1,1,0,0.005383690608754099,2019-03-25 06:30:00,2019-03-25 06:45:00
151,2,0,2,0.003777911557978017,2019-03-25 06:30:00,2019-03-25 06:45:00
153,2,2,0,0.009277790423269108,2019-03-25 06:30:00,2019-03-25 06:45:00
158,1,1,0,0.0065708770156532115,2019-03-25 06:30:00,2019-03-25 06:45:00
160,3,1,2,0.0065708770156532115,2019-03-25 06:30:00,2019-03-25 06:45:00
164,4,1,3,0.005271740268538296,2019-03-25 06:30:00,2019-03-25 06:45:00
169,2,1,1,0.025105486003312354,2019-03-25 06:30:00,2019-03-25 06:45:00
170,3,1,2,0.0065708770156532115,2019-03-25 06:30:00,2019-03-25 06:45:00
172,1,1,0,0.006989469659530182,2019-03-25 06:30:00,2019-03-25 06:45:00
190,1,1,0,0.006989469659530182,2019-03-25 06:30:00,2019-03-25 06:45:00
195,1,1,0,0.0065708770156532115,2019-03-25 06:30:00,2019-03-25 06:45:00
197,1,0,1,0.003777911557978017,2019-03-25 06:30:00,2019-03-25 06:45:00
201,1,1,0,0.006989469659530182,2019-03-25 06:30:00,2019-03-25 06:45:00
2,2,2,0,0.013248461037317688,2019-03-25 06:45:00,2019-03-25 07:00:00
5,1,0,1,0.0036388925894572455,2019-03-25 06:45:00,2019-03-25 07:00:00
10,1,1,0,0.007628050831848011,2019-03-25 06:45:00,2019-03-25 07:00:00
15,4,1,3,0.006732261586862732,2019-03-25 06:45:00,2019-03-25 07:00:00
16,4,2,2,0.008122509785012746,2019-03-25 06:45:00,2019-03-25 07:00:00
18,3,1,2,0.004412234838808617,2019-03-25 06:45:00,2019-03-25 07:00:00
19,4,2,2,0.005185577088159988,2019-03-25 06:45:00,2019-03-25 07:00:00
26,2,2,0,0.007763384585997894,2019-03-25 06:45:00,2019-03-25 07:00:00
27,1,1,0,0.011648915238380433,2019-03-25 06:45:00,2019-03-25 07:00:00
40,2,2,0,0.00544335783794378,2019-03-25 06:45:00,2019-03-25 07:00:00
41,2,1,1,0.004620948477585086,2019-03-25 06:45:00,2019-03-25 07:00:00
46,2,1,1,0.005514287339942062,2019-03-25 06:45:00,2019-03-25 07:00:00
50,1,0,1,0.0036388925894572455,2019-03-25 06:45:00,2019-03-25 07:00:00
57,4,0,4,0.0036388925894572455,2019-03-25 06:45:00,2019-03-25 07:00:00
58,2,0,2,0.0036388925894572455,2019-03-25 06:45:00,2019-03-25 07:00:00
61,1,0,1,0.0036388925894572455,2019-03-25 06:45:00,2019-03-25 07:00:00
66,5,3,2,0.03102669489015794,2019-03-25 06:45:00,2019-03-25 07:00:00
67,3,1,2,0.006329062906790546,2019-03-25 06:45:00,2019-03-25 07:00:00
69,1,1,0,0.008326547138811027,2019-03-25 06:45:00,2019-03-25 07:00:00
70,2,1,1,0.02417974431498277,2019-03-25 06:45:00,2019-03-25 07:00:00
74,1,1,0,0.005842997591724135,2019-03-25 06:45:00,2019-03-25 07:00:00
79,1,0,1,0.0036388925894572455,2019-03-25 06:45:00,2019-03-25 07:00:00
86,2,1,1,0.02417974431498277,2019-03-25 06:45:00,2019-03-25 07:00:00
87,1,1,0,0.005185577088159988,2019-03-25 06:45:00,2019-03-25 07:00:00
88,3,0,3,0.0036388925894572455,2019-03-25 06:45:00,2019-03-25 07:00:00
90,3,0,3,0.0036388925894572455,2019-03-25 06:45:00,2019-03-25 07:00:00
101,2,1,1,0.02417974431498277,2019-03-25 06:45:00,2019-03-25 07:00:00
109,2,2,0,0.008122509785012746,2019-03-25 06:45:00,2019-03-25 07:00:00
112,1,1,0,0.006732261586862732,2019-03-25 06:45:00,2019-03-25 07:00:00
113,1,1,0,0.006732261586862732,2019-03-25 06:45:00,2019-03-25 07:00:00
114,1,0,1,0.0036388925894572455,2019-03-25 06:45:00,2019-03-25 07:00:00
115,2,1,1,0.02417974431498277,2019-03-25 06:45:00,2019-03-25 07:00:00
116,2,1,1,0.005842997591724135,2019-03-25 06:45:00,2019-03-25 07:00:00
118,1,1,0,0.005546576260011269,2019-03-25 06:45:00,2019-03-25 07:00:00
120,2,1,1,0.005546576260011269,2019-03-25 06:45:00,2019-03-25 07:00:00
135,1,1,0,0.005546576260011269,2019-03-25 06:45:00,2019-03-25 07:00:00
137,5,4,1,0.007665250363983249,2019-03-25 06:45:00,2019-03-25 07:00:00
138,4,2,2,0.009385130710270095,2019-03-25 06:45:00,2019-03-25 07:00:00
140,1,0,1,0.0036388925894572455,2019-03-25 06:45:00,2019-03-25 07:00:00
147,1,1,0,0.004670015588592407,2019-03-25 06:45:00,2019-03-25 07:00:00
151,3,0,3,0.0036388925894572455,2019-03-25 06:45:00,2019-03-25 07:00:00
153,3,2,1,0.009422431904196032,2019-03-25 06:45:00,2019-03-25 07:00:00
156,1,1,0,0.005185577088159988,2019-03-25 06:45:00,2019-03-25 07:00:00
158,3,3,0,0.009751142155978106,2019-03-25 06:45:00,2019-03-25 07:00:00
160,1,0,1,0.0036388925894572455,2019-03-25 06:45:00,2019-03-25 07:00:00
164,5,1,4,0.004620948477585086,2019-03-25 06:45:00,2019-03-25 07:00:00
169,2,1,1,0.02417974431498277,2019-03-25 06:45:00,2019-03-25 07:00:00
170,3,1,2,0.006329062906790546,2019-03-25 06:45:00,2019-03-25 07:00:00
172,2,2,0,0.012534215236142388,2019-03-25 06:45:00,2019-03-25 07:00:00
173,1,0,1,0.0036388925894572455,2019-03-25 06:45:00,2019-03-25 07:00:00
190,2,2,0,0.008278946085565475,2019-03-25 06:45:00,2019-03-25 07:00:00
191,3,1,2,0.006329062906790546,2019-03-25 06:45:00,2019-03-25 07:00:00
195,2,2,0,0.010318221149181312,2019-03-25 06:45:00,2019-03-25 07:00:00
197,2,0,2,0.0036388925894572455,2019-03-25 06:45:00,2019-03-25 07:00:00
201,1,1,0,0.006732261586862732,2019-03-25 06:45:00,2019-03-25 07:00:00
2,1,1,0,0.0072762440868552915,2019-03-25 07:00:00,2019-03-25 07:15:00
5,1,0,1,0.0030788219011415444,2019-03-25 07:00:00,2019-03-25 07:15:00
10,3,2,1,0.00914160866686211,2019-03-25 07:00:00,2019-03-25 07:15:00
15,1,0,1,0.0030788219011415444,2019-03-25 07:00:00,2019-03-25 07:15:00
16,3,0,3,0.0030788219011415444,2019-03-25 07:00:00,2019-03-25 07:15:00
18,7,3,4,0.01220444512715354,2019-03-25 07:00:00,2019-03-25 07:15:00
19,5,2,3,0.004387451858808849,2019-03-25 07:00:00,2019-03-25 07:15:00
23,1,0,1,0.0030788219011415444,2019-03-25 07:00:00,2019-03-25 07:15:00
26,1,1,0,0.004387451858808849,2019-03-25 07:00:00,2019-03-25 07:15:00
27,2,2,0,0.020433002785130393,2019-03-25 07:00:00,2019-03-25 07:15:00
37,3,1,2,0.003951241872919748,2019-03-25 07:00:00,2019-03-25 07:15:00
40,1,1,0,0.004387451858808849,2019-03-25 07:00:00,2019-03-25 07:15:00
41,1,1,0,0.004245653081463576,2019-03-25 07:00:00,2019-03-25 07:15:00
46,2,1,1,0.0056960818164761545,2019-03-25 07:00:00,2019-03-25 07:15:00
57,4,0,4,0.0030788219011415444,2019-03-25 07:00:00,2019-03-25 07:15:00
61,1,0,1,0.0030788219011415444,2019-03-25 07:00:00,2019-03-25 07:15:00
66,4,2,2,0.02049293765250594,2019-03-25 07:00:00,2019-03-25 07:15:00
67,3,1,2,0.005354953040498227,2019-03-25 07:00:00,2019-03-25 07:15:00
69,1,1,0,0.007921028042572385,2019-03-25 07:00:00,2019-03-25 07:15:00
70,2,1,1,0.02049293765250594,2019-03-25 07:00:00,2019-03-25 07:15:00
74,2,2,0,0.006939326159270396,2019-03-25 07:00:00,2019-03-25 07:15:00
85,1,1,0,0.003951241872919748,2019-03-25 07:00:00,2019-03-25 07:15:00
86,2,1,1,0.02049293765250594,2019-03-25 07:00:00,2019-03-25 07:15:00
87,4,3,1,0.055130394623885644,2019-03-25 07:00:00,2019-03-25 07:15:00
88,2,0,2,0.0030788219011415444,2019-03-25 07:00:00,2019-03-25 07:15:00
89,1,1,0,0.00567279701572521,2019-03-25 07:00:00,2019-03-25 07:15:00
101,2,1,1,0.02049293765250594,2019-03-25 07:00:00,2019-03-25 07:15:00
108,1,0,1,0.0030788219011415444,2019-03-25 07:00:00,2019-03-25 07:15:00
109,3,2,1,0.010355176500385612,2019-03-25 07:00:00,2019-03-25 07:15:00
111,1,1,0,0.004387451858808849,2019-03-25 07:00:00,2019-03-25 07:15:00
112,1,0,1,0.0030788219011415444,2019-03-25 07:00:00,2019-03-25 07:15:00
113,3,2,1,0.0075331606737243356,2019-03-25 07:00:00,2019-03-25 07:15:00
115,3,2,1,0.07903015643440872,2019-03-25 07:00:00,2019-03-25 07:15:00
116,3,1,2,0.004322066243935786,2019-03-25 07:00:00,2019-03-25 07:15:00
120,2,0,2,0.0030788219011415444,2019-03-25 07:00:00,2019-03-25 07:15:00
127,1,1,0,0.0056960818164761545,2019-03-25 07:00:00,2019-03-25 07:15:00
135,1,1,0,0.0056960818164761545,2019-03-25 07:00:00,2019-03-25 07:15:00
137,3,3,0,0.006721114219452913,2019-03-25 07:00:00,2019-03-25 07:15:00
138,6,4,2,0.008106157339592428,2019-03-25 07:00:00,2019-03-25 07:15:00
147,1,0,1,0.0030788219011415444,2019-03-25 07:00:00,2019-03-25 07:15:00
151,2,0,2,0.0030788219011415444,2019-03-25 07:00:00,2019-03-25 07:15:00
153,3,2,1,0.015476234269776264,2019-03-25 07:00:00,2019-03-25 07:15:00
156,1,1,0,0.0056960818164761545,2019-03-25 07:00:00,2019-03-25 07:15:00
157,1,0,1,0.0030788219011415444,2019-03-25 07:00:00,2019-03-25 07:15:00
158,5,3,2,0.013826261287676571,2019-03-25 07:00:00,2019-03-25 07:15:00
159,2,2,0,0.006437730558508231,2019-03-25 07:00:00,2019-03-25 07:15:00
160,1,0,1,0.0030788219011415444,2019-03-25 07:00:00,2019-03-25 07:15:00
162,1,0,1,0.0030788219011415444,2019-03-25 07:00:00,2019-03-25 07:15:00
164,7,2,5,0.006862912996798186,2019-03-25 07:00:00,2019-03-25 07:15:00
168,1,0,1,0.0030788219011415444,2019-03-25 07:00:00,2019-03-25 07:15:00
169,2,1,1,0.02049293765250594,2019-03-25 07:00:00,2019-03-25 07:15:00
170,3,1,2,0.005354953040498227,2019-03-25 07:00:00,2019-03-25 07:15:00
171,1,0,1,0.0030788219011415444,2019-03-25 07:00:00,2019-03-25 07:15:00
172,2,1,1,0.004915900758389725,2019-03-25 07:00:00,2019-03-25 07:15:00
173,4,2,2,0.009875070217845788,2019-03-25 07:00:00,2019-03-25 07:15:00
189,1,1,0,0.0056960818164761545,2019-03-25 07:00:00,2019-03-25 07:15:00
190,1,1,0,0.0056960818164761545,2019-03-25 07:00:00,2019-03-25 07:15:00
191,3,2,1,0.01150447279484124,2019-03-25 07:00:00,2019-03-25 07:15:00
195,2,2,0,0.008800479890884182,2019-03-25 07:00:00,2019-03-25 07:15:00
196,1,1,0,0.0056960818164761545,2019-03-25 07:00:00,2019-03-25 07:15:00
197,1,0,1,0.0030788219011415444,2019-03-25 07:00:00,2019-03-25 07:15:00
199,1,0,1,0.0030788219011415444,2019-03-25 07:00:00,2019-03-25 07:15:00
10,3,2,1,0.025755882856249968,2019-03-25 07:15:00,2019-03-25 07:30:00
16,4,1,3,0.004224372542982826,2019-03-25 07:15:00,2019-03-25 07:30:00
18,7,2,5,0.031315647675928135,2019-03-25 07:15:00,2019-03-25 07:30:00
19,8,4,4,0.005388440321494624,2019-03-25 07:15:00,2019-03-25 07:30:00
22,1,1,0,0.004314086925944443,2019-03-25 07:15:00,2019-03-25 07:30:00
23,3,2,1,0.006887569890132274,2019-03-25 07:15:00,2019-03-25 07:30:00
26,1,1,0,0.011221684002032006,2019-03-25 07:15:00,2019-03-25 07:30:00
28,1,1,0,0.0038443505429819253,2019-03-25 07:15:00,2019-03-25 07:30:00
37,7,3,4,0.005535456954605276,2019-03-25 07:15:00,2019-03-25 07:30:00
40,2,2,0,0.01245589105508342,2019-03-25 07:15:00,2019-03-25 07:30:00
41,1,0,1,0.003027345443850527,2019-03-25 07:15:00,2019-03-25 07:30:00
46,1,1,0,0.0065251897435645015,2019-03-25 07:15:00,2019-03-25 07:30:00
57,5,0,5,0.003027345443850527,2019-03-25 07:15:00,2019-03-25 07:30:00
61,5,1,4,0.0038443505429819253,2019-03-25 07:15:00,2019-03-25 07:30:00
66,3,2,1,0.028682251820526642,2019-03-25 07:15:00,2019-03-25 07:30:00
67,3,1,2,0.005265378100016701,2019-03-25 07:15:00,2019-03-25 07:30:00
69,2,0,2,0.003027345443850527,2019-03-25 07:15:00,2019-03-25 07:30:00
70,1,1,0,0.004314086925944443,2019-03-25 07:15:00,2019-03-25 07:30:00
85,1,1,0,0.004224372542982826,2019-03-25 07:15:00,2019-03-25 07:30:00
86,3,1,2,0.005265378100016701,2019-03-25 07:15:00,2019-03-25 07:30:00
87,7,6,1,0.08024248063254896,2019-03-25 07:15:00,2019-03-25 07:30:00
88,1,0,1,0.003027345443850527,2019-03-25 07:15:00,2019-03-25 07:30:00
89,1,1,0,0.00835201089000025,2019-03-25 07:15:00,2019-03-25 07:30:00
101,2,1,1,0.0201306163616346,2019-03-25 07:15:00,2019-03-25 07:30:00
104,2,0,2,0.003027345443850527,2019-03-25 07:15:00,2019-03-25 07:30:00
108,2,0,2,0.003027345443850527,2019-03-25 07:15:00,2019-03-25 07:30:00
109,2,1,1,0.008574450605973784,2019-03-25 07:15:00,2019-03-25 07:30:00
110,2,0,2,0.003027345443850527,2019-03-25 07:15:00,2019-03-25 07:30:00
111,2,2,0,0.005471273476284273,2019-03-25 07:15:00,2019-03-25 07:30:00
112,4,3,1,0.006134672915250007,2019-03-25 07:15:00,2019-03-25 07:30:00
113,2,1,1,0.0065251897435645015,2019-03-25 07:15:00,2019-03-25 07:30:00
114,3,2,1,0.009638752372094167,2019-03-25 07:15:00,2019-03-25 07:30:00
115,5,3,2,0.019365106720276345,2019-03-25 07:15:00,2019-03-25 07:30:00
116,1,1,0,0.004172506629984567,2019-03-25 07:15:00,2019-03-25 07:30:00
118,1,0,1,0.003027345443850527,2019-03-25 07:15:00,2019-03-25 07:30:00
119,1,1,0,0.00835201089000025,2019-03-25 07:15:00,2019-03-25 07:30:00
120,3,1,2,0.004538887975319687,2019-03-25 07:15:00,2019-03-25 07:30:00
126,1,0,1,0.003027345443850527,2019-03-25 07:15:00,2019-03-25 07:30:00
133,1,1,0,0.004203755262636311,2019-03-25 07:15:00,2019-03-25 07:30:00
135,1,1,0,0.005600828408038359,2019-03-25 07:15:00,2019-03-25 07:30:00
137,2,2,0,0.006050430506788848,2019-03-25 07:15:00,2019-03-25 07:30:00
138,7,6,1,0.02060159213188464,2019-03-25 07:15:00,2019-03-25 07:30:00
140,1,0,1,0.003027345443850527,2019-03-25 07:15:00,2019-03-25 07:30:00
141,5,1,4,0.0038443505429819253,2019-03-25 07:15:00,2019-03-25 07:30:00
147,2,0,2,0.003027345443850527,2019-03-25 07:15:00,2019-03-25 07:30:00
153,5,4,1,0.010959270840063434,2019-03-25 07:15:00,2019-03-25 07:30:00
154,1,1,0,0.004224372542982826,2019-03-25 07:15:00,2019-03-25 07:30:00
156,1,1,0,0.005600828408038359,2019-03-25 07:15:00,2019-03-25 07:30:00
157,1,0,1,0.003027345443850527,2019-03-25 07:15:00,2019-03-25 07:30:00
158,2,2,0,0.006797855507170657,2019-03-25 07:15:00,2019-03-25 07:30:00
159,2,2,0,0.005380165081422095,2019-03-25 07:15:00,2019-03-25 07:30:00
160,1,0,1,0.003027345443850527,2019-03-25 07:15:00,2019-03-25 07:30:00
162,3,1,2,0.004314086925944443,2019-03-25 07:15:00,2019-03-25 07:30:00
164,6,2,4,0.0071123709395075185,2019-03-25 07:15:00,2019-03-25 07:30:00
168,5,1,4,0.0038443505429819253,2019-03-25 07:15:00,2019-03-25 07:30:00
169,2,1,1,0.0201306163616346,2019-03-25 07:15:00,2019-03-25 07:30:00
170,4,1,3,0.004224372542982826,2019-03-25 07:15:00,2019-03-25 07:30:00
171,1,0,1,0.003027345443850527,2019-03-25 07:15:00,2019-03-25 07:30:00
172,1,0,1,0.003027345443850527,2019-03-25 07:15:00,2019-03-25 07:30:00
173,1,1,0,0.0038443505429819253,2019-03-25 07:15:00,2019-03-25 07:30:00
189,4,4,0,0.010747794336414021,2019-03-25 07:15:00,2019-03-25 07:30:00
191,3,2,1,0.030247546558119197,2019-03-25 07:15:00,2019-03-25 07:30:00
195,1,1,0,0.005265378100016701,2019-03-25 07:15:00,2019-03-25 07:30:00
196,1,1,0,0.004861013737615513,2019-03-25 07:15:00,2019-03-25 07:30:00
197,1,0,1,0.003027345443850527,2019-03-25 07:15:00,2019-03-25 07:30:00
199,4,1,3,0.012343776626564438,2019-03-25 07:15:00,2019-03-25 07:30:00
203,1,0,1,0.003027345443850527,2019-03-25 07:15:00,2019-03-25 07:30:00
1,1,0,1,0.0030303030756033866,2019-03-25 07:30:00,2019-03-25 07:45:00
2,2,2,0,0.007787436271104214,2019-03-25 07:30:00,2019-03-25 07:45:00
5,3,1,2,0.005270568140248728,2019-03-25 07:30:00,2019-03-25 07:45:00
10,1,1,0,0.003674308232610958,2019-03-25 07:30:00,2019-03-25 07:45:00
15,1,1,0,0.004865786071837525,2019-03-25 07:30:00,2019-03-25 07:45:00
16,4,1,3,0.006701269068071663,2019-03-25 07:30:00,2019-03-25 07:45:00
18,6,4,2,0.01764905008476017,2019-03-25 07:30:00,2019-03-25 07:45:00
19,6,3,3,0.007292771652757525,2019-03-25 07:30:00,2019-03-25 07:45:00
21,1,1,0,0.004929222009571451,2019-03-25 07:30:00,2019-03-25 07:45:00
22,1,1,0,0.007796214432509654,2019-03-25 07:30:00,2019-03-25 07:45:00
23,2,2,0,0.00836950674757083,2019-03-25 07:30:00,2019-03-25 07:45:00
26,5,4,1,0.07777705560178158,2019-03-25 07:30:00,2019-03-25 07:45:00
27,1,0,1,0.0030303030756033866,2019-03-25 07:30:00,2019-03-25 07:45:00
28,1,0,1,0.0030303030756033866,2019-03-25 07:30:00,2019-03-25 07:45:00
30,2,0,2,0.0030303030756033866,2019-03-25 07:30:00,2019-03-25 07:45:00
35,2,1,1,0.005606323703633672,2019-03-25 07:30:00,2019-03-25 07:45:00
37,5,2,3,0.005663415208065107,2019-03-25 07:30:00,2019-03-25 07:45:00
40,1,1,0,0.004929222009571451,2019-03-25 07:30:00,2019-03-25 07:45:00
41,2,0,2,0.0030303030756033866,2019-03-25 07:30:00,2019-03-25 07:45:00
46,2,2,0,0.010508173814860708,2019-03-25 07:30:00,2019-03-25 07:45:00
57,6,1,5,0.004318313389618529,2019-03-25 07:30:00,2019-03-25 07:45:00
58,1,1,0,0.004318313389618529,2019-03-25 07:30:00,2019-03-25 07:45:00
61,3,1,2,0.005270568140248728,2019-03-25 07:30:00,2019-03-25 07:45:00
62,1,1,0,0.005606323703633672,2019-03-25 07:30:00,2019-03-25 07:45:00
66,4,3,1,0.05312155599855563,2019-03-25 07:30:00,2019-03-25 07:45:00
67,4,2,2,0.00751083320489407,2019-03-25 07:30:00,2019-03-25 07:45:00
69,2,0,2,0.0030303030756033866,2019-03-25 07:30:00,2019-03-25 07:45:00
70,2,1,1,0.005606323703633672,2019-03-25 07:30:00,2019-03-25 07:45:00
74,1,0,1,0.0030303030756033866,2019-03-25 07:30:00,2019-03-25 07:45:00
79,1,0,1,0.0030303030756033866,2019-03-25 07:30:00,2019-03-25 07:45:00
86,2,0,2,0.0030303030756033866,2019-03-25 07:30:00,2019-03-25 07:45:00
87,3,2,1,0.004962318546626101,2019-03-25 07:30:00,2019-03-25 07:45:00
90,2,0,2,0.0030303030756033866,2019-03-25 07:30:00,2019-03-25 07:45:00
101,2,1,1,0.020156724154592513,2019-03-25 07:30:00,2019-03-25 07:45:00
104,3,0,3,0.0030303030756033866,2019-03-25 07:30:00,2019-03-25 07:45:00
108,1,0,1,0.0030303030756033866,2019-03-25 07:30:00,2019-03-25 07:45:00
109,4,4,0,0.025287451759851486,2019-03-25 07:30:00,2019-03-25 07:45:00
110,1,0,1,0.0030303030756033866,2019-03-25 07:30:00,2019-03-25 07:45:00
112,5,5,0,0.012938283196665524,2019-03-25 07:30:00,2019-03-25 07:45:00
113,1,1,0,0.00652394663174845,2019-03-25 07:30:00,2019-03-25 07:45:00
114,4,2,2,0.006464997246310434,2019-03-25 07:30:00,2019-03-25 07:45:00
115,3,2,1,0.024438329424339794,2019-03-25 07:30:00,2019-03-25 07:45:00
118,2,0,2,0.0030303030756033866,2019-03-25 07:30:00,2019-03-25 07:45:00
119,1,1,0,0.007248741750290659,2019-03-25 07:30:00,2019-03-25 07:45:00
120,2,0,2,0.0030303030756033866,2019-03-25 07:30:00,2019-03-25 07:45:00
126,2,1,1,0.005270568140248728,2019-03-25 07:30:00,2019-03-25 07:45:00
127,2,1,1,0.004318313389618529,2019-03-25 07:30:00,2019-03-25 07:45:00
133,1,1,0,0.00463513098817546,2019-03-25 07:30:00,2019-03-25 07:45:00
135,1,1,0,0.005606323703633672,2019-03-25 07:30:00,2019-03-25 07:45:00
137,4,3,1,0.007786303549284439,2019-03-25 07:30:00,2019-03-25 07:45:00
138,5,4,1,0.009720711740312325,2019-03-25 07:30:00,2019-03-25 07:45:00
141,4,0,4,0.0030303030756033866,2019-03-25 07:30:00,2019-03-25 07:45:00
147,3,1,2,0.005606323703633672,2019-03-25 07:30:00,2019-03-25 07:45:00
151,1,1,0,0.005606323703633672,2019-03-25 07:30:00,2019-03-25 07:45:00
153,6,4,2,0.012207718056774078,2019-03-25 07:30:00,2019-03-25 07:45:00
156,1,0,1,0.0030303030756033866,2019-03-25 07:30:00,2019-03-25 07:45:00
158,6,4,2,0.022591637980558642,2019-03-25 07:30:00,2019-03-25 07:45:00
159,2,2,0,0.006239958900747534,2019-03-25 07:30:00,2019-03-25 07:45:00
160,1,0,1,0.0030303030756033866,2019-03-25 07:30:00,2019-03-25 07:45:00
162,3,1,2,0.004318313389618529,2019-03-25 07:30:00,2019-03-25 07:45:00
164,6,3,3,0.0061192358344635865,2019-03-25 07:30:00,2019-03-25 07:45:00
169,2,1,1,0.020156724154592513,2019-03-25 07:30:00,2019-03-25 07:45:00
170,6,1,5,0.003651047556136975,2019-03-25 07:30:00,2019-03-25 07:45:00
171,1,0,1,0.0030303030756033866,2019-03-25 07:30:00,2019-03-25 07:45:00
172,2,0,2,0.0030303030756033866,2019-03-25 07:30:00,2019-03-25 07:45:00
173,1,0,1,0.0030303030756033866,2019-03-25 07:30:00,2019-03-25 07:45:00
191,2,1,1,0.005096843985104538,2019-03-25 07:30:00,2019-03-25 07:45:00
195,4,4,0,0.011374864146939497,2019-03-25 07:30:00,2019-03-25 07:45:00
196,2,1,1,0.004865786071837525,2019-03-25 07:30:00,2019-03-25 07:45:00
199,3,1,2,0.008219233606960911,2019-03-25 07:30:00,2019-03-25 07:45:00
203,3,1,2,0.004318313389618529,2019-03-25 07:30:00,2019-03-25 07:45:00
1,2,1,1,0.004896729236508742,2019-03-25 07:45:00,2019-03-25 08:00:00
2,3,3,0,0.011914437001192678,2019-03-25 07:45:00,2019-03-25 08:00:00
5,3,1,2,0.004896729236508742,2019-03-25 07:45:00,2019-03-25 08:00:00
10,2,1,1,0.005208723961066631,2019-03-25 07:45:00,2019-03-25 08:00:00
15,4,2,2,0.010383235410849474,2019-03-25 07:45:00,2019-03-25 08:00:00
16,4,2,2,0.007253087198099998,2019-03-25 07:45:00,2019-03-25 08:00:00
18,4,3,1,0.02846259735196565,2019-03-25 07:45:00,2019-03-25 08:00:00
19,10,4,6,0.00905934729684858,2019-03-25 07:45:00,2019-03-25 08:00:00
21,1,1,0,0.005898271858319816,2019-03-25 07:45:00,2019-03-25 08:00:00
22,1,1,0,0.005208723961066631,2019-03-25 07:45:00,2019-03-25 08:00:00
23,1,0,1,0.002815420206338824,2019-03-25 07:45:00,2019-03-25 08:00:00
26,4,2,2,0.01133989882752567,2019-03-25 07:45:00,2019-03-25 08:00:00
27,1,0,1,0.002815420206338824,2019-03-25 07:45:00,2019-03-25 08:00:00
28,2,2,0,0.010028751814974594,2019-03-25 07:45:00,2019-03-25 08:00:00
30,3,0,3,0.002815420206338824,2019-03-25 07:45:00,2019-03-25 08:00:00
35,2,1,1,0.005208723961066631,2019-03-25 07:45:00,2019-03-25 08:00:00
37,3,1,2,0.005898271858319816,2019-03-25 07:45:00,2019-03-25 08:00:00
41,1,0,1,0.002815420206338824,2019-03-25 07:45:00,2019-03-25 08:00:00
46,5,3,2,0.012547197478389872,2019-03-25 07:45:00,2019-03-25 08:00:00
50,1,0,1,0.002815420206338824,2019-03-25 07:45:00,2019-03-25 08:00:00
57,10,4,6,0.01928371964531545,2019-03-25 07:45:00,2019-03-25 08:00:00
58,4,1,3,0.005208723961066631,2019-03-25 07:45:00,2019-03-25 08:00:00
61,1,0,1,0.002815420206338824,2019-03-25 07:45:00,2019-03-25 08:00:00
62,4,3,1,0.013487158314783098,2019-03-25 07:45:00,2019-03-25 08:00:00
64,1,0,1,0.002815420206338824,2019-03-25 07:45:00,2019-03-25 08:00:00
66,3,2,1,0.0345167908235802,2019-03-25 07:45:00,2019-03-25 08:00:00
67,4,2,2,0.006978038266678661,2019-03-25 07:45:00,2019-03-25 08:00:00
68,5,1,4,0.003575220331353814,2019-03-25 07:45:00,2019-03-25 08:00:00
69,1,0,1,0.002815420206338824,2019-03-25 07:45:00,2019-03-25 08:00:00
70,1,0,1,0.002815420206338824,2019-03-25 07:45:00,2019-03-25 08:00:00
74,1,0,1,0.002815420206338824,2019-03-25 07:45:00,2019-03-25 08:00:00
79,1,0,1,0.002815420206338824,2019-03-25 07:45:00,2019-03-25 08:00:00
85,1,1,0,0.008148655544481924,2019-03-25 07:45:00,2019-03-25 08:00:00
86,2,0,2,0.002815420206338824,2019-03-25 07:45:00,2019-03-25 08:00:00
87,1,0,1,0.002815420206338824,2019-03-25 07:45:00,2019-03-25 08:00:00
88,1,0,1,0.002815420206338824,2019-03-25 07:45:00,2019-03-25 08:00:00
89,1,0,1,0.002815420206338824,2019-03-25 07:45:00,2019-03-25 08:00:00
90,1,0,1,0.002815420206338824,2019-03-25 07:45:00,2019-03-25 08:00:00
101,2,1,1,0.018666105514959508,2019-03-25 07:45:00,2019-03-25 08:00:00
104,1,0,1,0.002815420206338824,2019-03-25 07:45:00,2019-03-25 08:00:00
109,4,4,0,0.03521719359571552,2019-03-25 07:45:00,2019-03-25 08:00:00
110,1,0,1,0.002815420206338824,2019-03-25 07:45:00,2019-03-25 08:00:00
112,5,4,1,0.018046530309543257,2019-03-25 07:45:00,2019-03-25 08:00:00
113,1,0,1,0.002815420206338824,2019-03-25 07:45:00,2019-03-25 08:00:00
114,5,3,2,0.00773174794904556,2019-03-25 07:45:00,2019-03-25 08:00:00
115,2,1,1,0.018666105514959508,2019-03-25 07:45:00,2019-03-25 08:00:00
118,2,0,2,0.002815420206338824,2019-03-25 07:45:00,2019-03-25 08:00:00
119,2,2,0,0.0056873847120121925,2019-03-25 07:45:00,2019-03-25 08:00:00
120,2,0,2,0.002815420206338824,2019-03-25 07:45:00,2019-03-25 08:00:00
122,1,0,1,0.002815420206338824,2019-03-25 07:45:00,2019-03-25 08:00:00
126,3,1,2,0.004896729236508742,2019-03-25 07:45:00,2019-03-25 08:00:00
127,4,2,2,0.00480984000194533,2019-03-25 07:45:00,2019-03-25 08:00:00
133,1,1,0,0.004520698899504406,2019-03-25 07:45:00,2019-03-25 08:00:00
137,5,3,2,0.013792289916969146,2019-03-25 07:45:00,2019-03-25 08:00:00
138,5,4,1,0.02414009424995513,2019-03-25 07:45:00,2019-03-25 08:00:00
141,1,0,1,0.002815420206338824,2019-03-25 07:45:00,2019-03-25 08:00:00
147,3,2,1,0.009622184074097857,2019-03-25 07:45:00,2019-03-25 08:00:00
151,1,1,0,0.005208723961066631,2019-03-25 07:45:00,2019-03-25 08:00:00
153,6,4,2,0.013627494244586758,2019-03-25 07:45:00,2019-03-25 08:00:00
156,3,2,1,0.008395248185261776,2019-03-25 07:45:00,2019-03-25 08:00:00
157,4,3,1,0.010128923259629427,2019-03-25 07:45:00,2019-03-25 08:00:00
158,2,1,1,0.004687823182465487,2019-03-25 07:45:00,2019-03-25 08:00:00
159,2,2,0,0.007829441131442285,2019-03-25 07:45:00,2019-03-25 08:00:00
162,2,1,1,0.005208723961066631,2019-03-25 07:45:00,2019-03-25 08:00:00
164,10,6,4,0.019396699573411804,2019-03-25 07:45:00,2019-03-25 08:00:00
168,1,0,1,0.002815420206338824,2019-03-25 07:45:00,2019-03-25 08:00:00
169,2,1,1,0.018666105514959508,2019-03-25 07:45:00,2019-03-25 08:00:00
170,6,2,4,0.008810152277015338,2019-03-25 07:45:00,2019-03-25 08:00:00
171,1,0,1,0.002815420206338824,2019-03-25 07:45:00,2019-03-25 08:00:00
172,1,0,1,0.002815420206338824,2019-03-25 07:45:00,2019-03-25 08:00:00
173,5,0,5,0.002815420206338824,2019-03-25 07:45:00,2019-03-25 08:00:00
177,1,1,0,0.01428070691172729,2019-03-25 07:45:00,2019-03-25 08:00:00
189,1,1,0,0.005208723961066631,2019-03-25 07:45:00,2019-03-25 08:00:00
191,2,2,0,0.0053825024301934555,2019-03-25 07:45:00,2019-03-25 08:00:00
195,6,6,0,0.020403121622205717,2019-03-25 07:45:00,2019-03-25 08:00:00
196,5,3,2,0.011371201302846544,2019-03-25 07:45:00,2019-03-25 08:00:00
199,2,1,1,0.008607687305995051,2019-03-25 07:45:00,2019-03-25 08:00:00
203,3,1,2,0.004012072083702727,2019-03-25 07:45:00,2019-03-25 08:00:00
2,3,1,2,0.00507447709300032,2019-03-25 08:00:00,2019-03-25 08:15:00
5,2,1,1,0.019320293056625828,2019-03-25 08:00:00,2019-03-25 08:15:00
10,3,1,2,0.005397805637258815,2019-03-25 08:00:00,2019-03-25 08:15:00
15,5,3,2,0.015402373215048434,2019-03-25 08:00:00,2019-03-25 08:15:00
16,1,1,0,0.004157716440561926,2019-03-25 08:00:00,2019-03-25 08:15:00
18,4,3,1,0.028363415425166322,2019-03-25 08:00:00,2019-03-25 08:15:00
19,7,4,3,0.014733113149695705,2019-03-25 08:00:00,2019-03-25 08:15:00
23,2,0,2,0.0029176272438650383,2019-03-25 08:00:00,2019-03-25 08:15:00
26,1,0,1,0.0029176272438650383,2019-03-25 08:00:00,2019-03-25 08:15:00
28,2,1,1,0.005397805637258815,2019-03-25 08:00:00,2019-03-25 08:15:00
30,2,0,2,0.0029176272438650383,2019-03-25 08:00:00,2019-03-25 08:15:00
37,2,0,2,0.0029176272438650383,2019-03-25 08:00:00,2019-03-25 08:15:00
40,1,1,0,0.01185257017181063,2019-03-25 08:00:00,2019-03-25 08:15:00
41,1,0,1,0.0029176272438650383,2019-03-25 08:00:00,2019-03-25 08:15:00
46,3,3,0,0.007821243384359968,2019-03-25 08:00:00,2019-03-25 08:15:00
50,2,0,2,0.0029176272438650383,2019-03-25 08:00:00,2019-03-25 08:15:00
57,2,1,1,0.02232096940144325,2019-03-25 08:00:00,2019-03-25 08:15:00
58,7,2,5,0.005796697355768297,2019-03-25 08:00:00,2019-03-25 08:15:00
61,2,2,0,0.006637894833955702,2019-03-25 08:00:00,2019-03-25 08:15:00
62,4,3,1,0.00893215835298885,2019-03-25 08:00:00,2019-03-25 08:15:00
64,3,1,2,0.00507447709300032,2019-03-25 08:00:00,2019-03-25 08:15:00
66,4,2,2,0.009388176791270884,2019-03-25 08:00:00,2019-03-25 08:15:00
67,4,2,2,0.04504371568846737,2019-03-25 08:00:00,2019-03-25 08:15:00
68,3,1,2,0.005397805637258815,2019-03-25 08:00:00,2019-03-25 08:15:00
69,1,0,1,0.0029176272438650383,2019-03-25 08:00:00,2019-03-25 08:15:00
70,1,0,1,0.0029176272438650383,2019-03-25 08:00:00,2019-03-25 08:15:00
74,2,1,1,0.005397805637258815,2019-03-25 08:00:00,2019-03-25 08:15:00
85,3,1,2,0.004811159508090664,2019-03-25 08:00:00,2019-03-25 08:15:00
88,1,0,1,0.0029176272438650383,2019-03-25 08:00:00,2019-03-25 08:15:00
89,1,0,1,0.0029176272438650383,2019-03-25 08:00:00,2019-03-25 08:15:00
101,2,1,1,0.019320293056625828,2019-03-25 08:00:00,2019-03-25 08:15:00
104,3,1,2,0.00507447709300032,2019-03-25 08:00:00,2019-03-25 08:15:00
109,2,1,1,0.003996052168432679,2019-03-25 08:00:00,2019-03-25 08:15:00
111,2,2,0,0.007007509016758932,2019-03-25 08:00:00,2019-03-25 08:15:00
112,2,1,1,0.004823614591386156,2019-03-25 08:00:00,2019-03-25 08:15:00
113,1,0,1,0.0029176272438650383,2019-03-25 08:00:00,2019-03-25 08:15:00
114,3,2,1,0.007117878110419303,2019-03-25 08:00:00,2019-03-25 08:15:00
115,2,1,1,0.019320293056625828,2019-03-25 08:00:00,2019-03-25 08:15:00
118,3,2,1,0.008608829808730355,2019-03-25 08:00:00,2019-03-25 08:15:00
120,2,0,2,0.0029176272438650383,2019-03-25 08:00:00,2019-03-25 08:15:00
122,1,0,1,0.0029176272438650383,2019-03-25 08:00:00,2019-03-25 08:15:00
126,1,0,1,0.0029176272438650383,2019-03-25 08:00:00,2019-03-25 08:15:00
127,4,2,2,0.005397805637258815,2019-03-25 08:00:00,2019-03-25 08:15:00
133,2,2,0,0.006512376992423841,2019-03-25 08:00:00,2019-03-25 08:15:00
137,5,4,1,0.010077380215917078,2019-03-25 08:00:00,2019-03-25 08:15:00
138,5,5,0,0.01618677865880955,2019-03-25 08:00:00,2019-03-25 08:15:00
141,1,0,1,0.0029176272438650383,2019-03-25 08:00:00,2019-03-25 08:15:00
147,1,1,0,0.00946434994946313,2019-03-25 08:00:00,2019-03-25 08:15:00
153,3,3,0,0.008608829808730355,2019-03-25 08:00:00,2019-03-25 08:15:00
157,5,4,1,0.022824875917443505,2019-03-25 08:00:00,2019-03-25 08:15:00
158,2,1,1,0.00507447709300032,2019-03-25 08:00:00,2019-03-25 08:15:00
159,2,2,0,0.005397805637258815,2019-03-25 08:00:00,2019-03-25 08:15:00
162,1,0,1,0.0029176272438650383,2019-03-25 08:00:00,2019-03-25 08:15:00
164,9,4,5,0.011137254801252943,2019-03-25 08:00:00,2019-03-25 08:15:00
168,1,0,1,0.0029176272438650383,2019-03-25 08:00:00,2019-03-25 08:15:00
169,2,1,1,0.019320293056625828,2019-03-25 08:00:00,2019-03-25 08:15:00
170,3,1,2,0.00507447709300032,2019-03-25 08:00:00,2019-03-25 08:15:00
171,2,1,1,0.02702976244992259,2019-03-25 08:00:00,2019-03-25 08:15:00
172,1,1,0,0.004823614591386156,2019-03-25 08:00:00,2019-03-25 08:15:00
173,5,1,4,0.00896841736618649,2019-03-25 08:00:00,2019-03-25 08:15:00
177,2,1,1,0.010510650477801288,2019-03-25 08:00:00,2019-03-25 08:15:00
189,2,2,0,0.007692069156291963,2019-03-25 08:00:00,2019-03-25 08:15:00
195,4,4,0,0.034185741864625606,2019-03-25 08:00:00,2019-03-25 08:15:00
196,2,1,1,0.004823614591386156,2019-03-25 08:00:00,2019-03-25 08:15:00
197,6,2,4,0.00507447709300032,2019-03-25 08:00:00,2019-03-25 08:15:00
199,1,0,1,0.0029176272438650383,2019-03-25 08:00:00,2019-03-25 08:15:00
201,1,0,1,0.0029176272438650383,2019-03-25 08:00:00,2019-03-25 08:15:00
202,1,0,1,0.0029176272438650383,2019-03-25 08:00:00,2019-03-25 08:15:00
203,4,1,3,0.00507447709300032,2019-03-25 08:00:00,2019-03-25 08:15:00
1,1,1,0,0.005806005985032361,2019-03-25 08:15:00,2019-03-25 08:30:00
2,5,1,4,0.003985177686239108,2019-03-25 08:15:00,2019-03-25 08:30:00
5,3,1,2,0.005458277238106962,2019-03-25 08:15:00,2019-03-25 08:30:00
10,1,0,1,0.003138238503880207,2019-03-25 08:15:00,2019-03-25 08:30:00
15,2,0,2,0.003138238503880207,2019-03-25 08:15:00,2019-03-25 08:30:00
16,1,0,1,0.003138238503880207,2019-03-25 08:15:00,2019-03-25 08:30:00
18,4,2,2,0.008126044719259116,2019-03-25 08:15:00,2019-03-25 08:30:00
19,1,1,0,0.005806005985032361,2019-03-25 08:15:00,2019-03-25 08:30:00
23,4,2,2,0.0053190614268151856,2019-03-25 08:15:00,2019-03-25 08:30:00
28,1,0,1,0.003138238503880207,2019-03-25 08:15:00,2019-03-25 08:30:00
40,1,1,0,0.005806005985032361,2019-03-25 08:15:00,2019-03-25 08:30:00
41,1,0,1,0.003138238503880207,2019-03-25 08:15:00,2019-03-25 08:30:00
46,4,4,0,0.011464045141755072,2019-03-25 08:15:00,2019-03-25 08:30:00
50,1,0,1,0.003138238503880207,2019-03-25 08:15:00,2019-03-25 08:30:00
57,1,1,0,0.005806005985032361,2019-03-25 08:15:00,2019-03-25 08:30:00
58,5,3,2,0.020903724892762918,2019-03-25 08:15:00,2019-03-25 08:30:00
61,1,1,0,0.005806005985032361,2019-03-25 08:15:00,2019-03-25 08:30:00
62,1,1,0,0.005399085149382123,2019-03-25 08:15:00,2019-03-25 08:30:00
64,3,2,1,0.02646337498409142,2019-03-25 08:15:00,2019-03-25 08:30:00
66,3,1,2,0.005458277238106962,2019-03-25 08:15:00,2019-03-25 08:30:00
67,4,2,2,0.015205710219408758,2019-03-25 08:15:00,2019-03-25 08:30:00
68,3,1,2,0.004472122244456284,2019-03-25 08:15:00,2019-03-25 08:30:00
69,4,1,3,0.008011403482682419,2019-03-25 08:15:00,2019-03-25 08:30:00
70,2,1,1,0.005408520931167312,2019-03-25 08:15:00,2019-03-25 08:30:00
74,2,1,1,0.004472122244456284,2019-03-25 08:15:00,2019-03-25 08:30:00
75,2,0,2,0.003138238503880207,2019-03-25 08:15:00,2019-03-25 08:30:00
79,1,0,1,0.003138238503880207,2019-03-25 08:15:00,2019-03-25 08:30:00
87,1,1,0,0.005039090525240397,2019-03-25 08:15:00,2019-03-25 08:30:00
90,4,2,2,0.007662406390025252,2019-03-25 08:15:00,2019-03-25 08:30:00
101,2,1,1,0.02084382565962834,2019-03-25 08:15:00,2019-03-25 08:30:00
104,1,1,0,0.003985177686239108,2019-03-25 08:15:00,2019-03-25 08:30:00
109,4,1,3,0.004472122244456284,2019-03-25 08:15:00,2019-03-25 08:30:00
112,2,2,0,0.010272250128184335,2019-03-25 08:15:00,2019-03-25 08:30:00
114,4,0,4,0.003138238503880207,2019-03-25 08:15:00,2019-03-25 08:30:00
115,3,2,1,0.03854941281537648,2019-03-25 08:15:00,2019-03-25 08:30:00
118,5,3,2,0.011464223821036124,2019-03-25 08:15:00,2019-03-25 08:30:00
119,1,0,1,0.003138238503880207,2019-03-25 08:15:00,2019-03-25 08:30:00
120,5,1,4,0.003985177686239108,2019-03-25 08:15:00,2019-03-25 08:30:00
122,5,2,3,0.0072433693486125845,2019-03-25 08:15:00,2019-03-25 08:30:00
127,5,1,4,0.003985177686239108,2019-03-25 08:15:00,2019-03-25 08:30:00
133,1,1,0,0.003985177686239108,2019-03-25 08:15:00,2019-03-25 08:30:00
135,1,1,0,0.004472122244456284,2019-03-25 08:15:00,2019-03-25 08:30:00
137,13,12,1,0.028836297334117134,2019-03-25 08:15:00,2019-03-25 08:30:00
138,6,6,0,0.01742432879119019,2019-03-25 08:15:00,2019-03-25 08:30:00
141,1,0,1,0.003138238503880207,2019-03-25 08:15:00,2019-03-25 08:30:00
147,1,1,0,0.005408520931167312,2019-03-25 08:15:00,2019-03-25 08:30:00
153,3,2,1,0.036229374081149714,2019-03-25 08:15:00,2019-03-25 08:30:00
154,1,1,0,0.005806005985032361,2019-03-25 08:15:00,2019-03-25 08:30:00
157,1,0,1,0.003138238503880207,2019-03-25 08:15:00,2019-03-25 08:30:00
158,1,1,0,0.007070592601266593,2019-03-25 08:15:00,2019-03-25 08:30:00
159,2,2,0,0.014691913438872696,2019-03-25 08:15:00,2019-03-25 08:30:00
160,1,0,1,0.003138238503880207,2019-03-25 08:15:00,2019-03-25 08:30:00
162,2,0,2,0.003138238503880207,2019-03-25 08:15:00,2019-03-25 08:30:00
164,8,3,5,0.03653289113822485,2019-03-25 08:15:00,2019-03-25 08:30:00
168,1,0,1,0.003138238503880207,2019-03-25 08:15:00,2019-03-25 08:30:00
169,2,1,1,0.02084382565962834,2019-03-25 08:15:00,2019-03-25 08:30:00
170,5,3,2,0.00925141552420157,2019-03-25 08:15:00,2019-03-25 08:30:00
171,2,1,1,0.006592213799675187,2019-03-25 08:15:00,2019-03-25 08:30:00
173,2,0,2,0.003138238503880207,2019-03-25 08:15:00,2019-03-25 08:30:00
177,1,0,1,0.003138238503880207,2019-03-25 08:15:00,2019-03-25 08:30:00
189,2,2,0,0.008473773466184515,2019-03-25 08:15:00,2019-03-25 08:30:00
191,1,0,1,0.003138238503880207,2019-03-25 08:15:00,2019-03-25 08:30:00
195,2,2,0,0.013403352259698019,2019-03-25 08:15:00,2019-03-25 08:30:00
196,1,1,0,0.004472122244456284,2019-03-25 08:15:00,2019-03-25 08:30:00
197,2,0,2,0.003138238503880207,2019-03-25 08:15:00,2019-03-25 08:30:00
199,1,0,1,0.003138238503880207,2019-03-25 08:15:00,2019-03-25 08:30:00
201,2,0,2,0.003138238503880207,2019-03-25 08:15:00,2019-03-25 08:30:00
203,2,1,1,0.003985177686239108,2019-03-25 08:15:00,2019-03-25 08:30:00
1,1,1,0,0.0057838864071336985,2019-03-25 08:30:00,2019-03-25 08:45:00
2,2,1,1,0.005541512814450756,2019-03-25 08:30:00,2019-03-25 08:45:00
5,3,1,2,0.005437488869263129,2019-03-25 08:30:00,2019-03-25 08:45:00
10,3,2,1,0.029577243578772734,2019-03-25 08:30:00,2019-03-25 08:45:00
15,2,1,1,0.0055847046683491185,2019-03-25 08:30:00,2019-03-25 08:45:00
16,2,1,1,0.009462419299916142,2019-03-25 08:30:00,2019-03-25 08:45:00
18,6,3,3,0.0176801088332028,2019-03-25 08:30:00,2019-03-25 08:45:00
19,5,2,3,0.00528956198039947,2019-03-25 08:30:00,2019-03-25 08:45:00
21,2,2,0,0.006669755806337772,2019-03-25 08:30:00,2019-03-25 08:45:00
23,5,4,1,0.01521054098708173,2019-03-25 08:30:00,2019-03-25 08:45:00
26,1,1,0,0.004455082308327591,2019-03-25 08:30:00,2019-03-25 08:45:00
28,2,0,2,0.0031262782095214823,2019-03-25 08:30:00,2019-03-25 08:45:00
35,2,0,2,0.0031262782095214823,2019-03-25 08:30:00,2019-03-25 08:45:00
37,4,4,0,0.011380081546315212,2019-03-25 08:30:00,2019-03-25 08:45:00
40,1,1,0,0.0057838864071336985,2019-03-25 08:30:00,2019-03-25 08:45:00
41,4,0,4,0.0031262782095214823,2019-03-25 08:30:00,2019-03-25 08:45:00
46,3,3,0,0.010335109883562787,2019-03-25 08:30:00,2019-03-25 08:45:00
50,1,0,1,0.0031262782095214823,2019-03-25 08:30:00,2019-03-25 08:45:00
57,3,1,2,0.0057838864071336985,2019-03-25 08:30:00,2019-03-25 08:45:00
58,3,1,2,0.0057838864071336985,2019-03-25 08:30:00,2019-03-25 08:45:00
61,2,0,2,0.0031262782095214823,2019-03-25 08:30:00,2019-03-25 08:45:00
62,1,1,0,0.016057197918452573,2019-03-25 08:30:00,2019-03-25 08:45:00
64,1,1,0,0.00783714450850471,2019-03-25 08:30:00,2019-03-25 08:45:00
66,3,2,1,0.03839423203518981,2019-03-25 08:30:00,2019-03-25 08:45:00
67,3,1,2,0.005437488869263129,2019-03-25 08:30:00,2019-03-25 08:45:00
68,3,0,3,0.0031262782095214823,2019-03-25 08:30:00,2019-03-25 08:45:00
69,1,0,1,0.0031262782095214823,2019-03-25 08:30:00,2019-03-25 08:45:00
70,2,1,1,0.0057838864071336985,2019-03-25 08:30:00,2019-03-25 08:45:00
74,2,2,0,0.007112690505939807,2019-03-25 08:30:00,2019-03-25 08:45:00
75,2,0,2,0.0031262782095214823,2019-03-25 08:30:00,2019-03-25 08:45:00
87,2,2,0,0.004676549658128609,2019-03-25 08:30:00,2019-03-25 08:45:00
88,1,0,1,0.0031262782095214823,2019-03-25 08:30:00,2019-03-25 08:45:00
89,1,0,1,0.0031262782095214823,2019-03-25 08:30:00,2019-03-25 08:45:00
90,3,1,2,0.006913508767155227,2019-03-25 08:30:00,2019-03-25 08:45:00
101,2,1,1,0.02076025512235565,2019-03-25 08:30:00,2019-03-25 08:45:00
109,2,1,1,0.004455082308327591,2019-03-25 08:30:00,2019-03-25 08:45:00
110,5,2,3,0.008523291609918417,2019-03-25 08:30:00,2019-03-25 08:45:00
111,1,1,0,0.009462419299916142,2019-03-25 08:30:00,2019-03-25 08:45:00
112,1,1,0,0.008043131127176754,2019-03-25 08:30:00,2019-03-25 08:45:00
113,1,1,0,0.004455082308327591,2019-03-25 08:30:00,2019-03-25 08:45:00
114,5,2,3,0.008242312865961336,2019-03-25 08:30:00,2019-03-25 08:45:00
115,3,2,1,0.029577243578772734,2019-03-25 08:30:00,2019-03-25 08:45:00
116,1,0,1,0.0031262782095214823,2019-03-25 08:30:00,2019-03-25 08:45:00
118,1,0,1,0.0031262782095214823,2019-03-25 08:30:00,2019-03-25 08:45:00
120,2,0,2,0.0031262782095214823,2019-03-25 08:30:00,2019-03-25 08:45:00
122,1,0,1,0.0031262782095214823,2019-03-25 08:30:00,2019-03-25 08:45:00
126,2,1,1,0.0037906802589245366,2019-03-25 08:30:00,2019-03-25 08:45:00
127,4,3,1,0.010714387727130896,2019-03-25 08:30:00,2019-03-25 08:45:00
135,2,1,1,0.004455082308327591,2019-03-25 08:30:00,2019-03-25 08:45:00
137,10,10,0,0.022924019224193463,2019-03-25 08:30:00,2019-03-25 08:45:00
138,4,4,0,0.014780673674003944,2019-03-25 08:30:00,2019-03-25 08:45:00
140,1,0,1,0.0031262782095214823,2019-03-25 08:30:00,2019-03-25 08:45:00
141,2,0,2,0.0031262782095214823,2019-03-25 08:30:00,2019-03-25 08:45:00
147,1,0,1,0.0031262782095214823,2019-03-25 08:30:00,2019-03-25 08:45:00
153,1,1,0,0.005437488869263129,2019-03-25 08:30:00,2019-03-25 08:45:00
154,1,1,0,0.0057838864071336985,2019-03-25 08:30:00,2019-03-25 08:45:00
156,1,0,1,0.0031262782095214823,2019-03-25 08:30:00,2019-03-25 08:45:00
157,1,0,1,0.0031262782095214823,2019-03-25 08:30:00,2019-03-25 08:45:00
158,4,2,2,0.014905699562309218,2019-03-25 08:30:00,2019-03-25 08:45:00
159,1,1,0,0.0055847046683491185,2019-03-25 08:30:00,2019-03-25 08:45:00
160,1,0,1,0.0031262782095214823,2019-03-25 08:30:00,2019-03-25 08:45:00
162,2,0,2,0.0031262782095214823,2019-03-25 08:30:00,2019-03-25 08:45:00
164,7,3,4,0.008779353603431246,2019-03-25 08:30:00,2019-03-25 08:45:00
168,2,0,2,0.0031262782095214823,2019-03-25 08:30:00,2019-03-25 08:45:00
169,2,1,1,0.02076025512235565,2019-03-25 08:30:00,2019-03-25 08:45:00
170,9,5,4,0.03184912167714454,2019-03-25 08:30:00,2019-03-25 08:45:00
172,2,0,2,0.0031262782095214823,2019-03-25 08:30:00,2019-03-25 08:45:00
173,2,0,2,0.0031262782095214823,2019-03-25 08:30:00,2019-03-25 08:45:00
177,1,0,1,0.0031262782095214823,2019-03-25 08:30:00,2019-03-25 08:45:00
189,3,3,0,0.008369198634731798,2019-03-25 08:30:00,2019-03-25 08:45:00
191,1,0,1,0.0031262782095214823,2019-03-25 08:30:00,2019-03-25 08:45:00
195,1,1,0,0.005437488869263129,2019-03-25 08:30:00,2019-03-25 08:45:00
196,3,2,1,0.006320927144603611,2019-03-25 08:30:00,2019-03-25 08:45:00
197,1,1,0,0.0037906802589245366,2019-03-25 08:30:00,2019-03-25 08:45:00
201,2,0,2,0.0031262782095214823,2019-03-25 08:30:00,2019-03-25 08:45:00
203,1,0,1,0.0031262782095214823,2019-03-25 08:30:00,2019-03-25 08:45:00
1,1,1,0,0.004688035474019209,2019-03-25 08:45:00,2019-03-25 09:00:00
2,3,2,1,0.01600100484851599,2019-03-25 08:45:00,2019-03-25 09:00:00
5,3,1,2,0.0044071824690676146,2019-03-25 08:45:00,2019-03-25 09:00:00
10,3,2,1,0.03586696650998081,2019-03-25 08:45:00,2019-03-25 09:00:00
15,8,3,5,0.005471427891785944,2019-03-25 08:45:00,2019-03-25 09:00:00
16,4,2,2,0.019867962999121677,2019-03-25 08:45:00,2019-03-25 09:00:00
18,2,1,1,0.003916196130554694,2019-03-25 08:45:00,2019-03-25 09:00:00
19,4,2,2,0.003252018303888018,2019-03-25 08:45:00,2019-03-25 09:00:00
23,6,6,0,0.016885569379738636,2019-03-25 08:45:00,2019-03-25 09:00:00
26,2,1,1,0.0036110225964208157,2019-03-25 08:45:00,2019-03-25 09:00:00
28,5,1,4,0.003217840130300342,2019-03-25 08:45:00,2019-03-25 09:00:00
30,1,1,0,0.00289301401135522,2019-03-25 08:45:00,2019-03-25 09:00:00
35,1,0,1,0.002534009718822422,2019-03-25 08:45:00,2019-03-25 09:00:00
37,7,6,1,0.04210064157798682,2019-03-25 08:45:00,2019-03-25 09:00:00
40,2,2,0,0.0059135471012116934,2019-03-25 08:45:00,2019-03-25 09:00:00
41,6,0,6,0.002534009718822422,2019-03-25 08:45:00,2019-03-25 09:00:00
46,4,3,1,0.00768369267147833,2019-03-25 08:45:00,2019-03-25 09:00:00
57,2,0,2,0.002534009718822422,2019-03-25 08:45:00,2019-03-25 09:00:00
58,7,1,6,0.00295227179700249,2019-03-25 08:45:00,2019-03-25 09:00:00
61,2,0,2,0.002534009718822422,2019-03-25 08:45:00,2019-03-25 09:00:00
62,1,0,1,0.002534009718822422,2019-03-25 08:45:00,2019-03-25 09:00:00
66,2,1,1,0.016838403852041627,2019-03-25 08:45:00,2019-03-25 09:00:00
67,3,1,2,0.0044071824690676146,2019-03-25 08:45:00,2019-03-25 09:00:00
68,2,0,2,0.002534009718822422,2019-03-25 08:45:00,2019-03-25 09:00:00
69,2,2,0,0.008838586154726543,2019-03-25 08:45:00,2019-03-25 09:00:00
70,1,0,1,0.002534009718822422,2019-03-25 08:45:00,2019-03-25 09:00:00
74,2,1,1,0.005603556076420845,2019-03-25 08:45:00,2019-03-25 09:00:00
75,4,1,3,0.013096186118415658,2019-03-25 08:45:00,2019-03-25 09:00:00
85,5,4,1,0.009450359379915941,2019-03-25 08:45:00,2019-03-25 09:00:00
86,1,0,1,0.002534009718822422,2019-03-25 08:45:00,2019-03-25 09:00:00
87,2,2,0,0.005047039766552007,2019-03-25 08:45:00,2019-03-25 09:00:00
88,3,1,2,0.0036110225964208157,2019-03-25 08:45:00,2019-03-25 09:00:00
89,7,1,6,0.00295227179700249,2019-03-25 08:45:00,2019-03-25 09:00:00
90,1,0,1,0.002534009718822422,2019-03-25 08:45:00,2019-03-25 09:00:00
101,2,1,1,0.016838403852041627,2019-03-25 08:45:00,2019-03-25 09:00:00
104,1,1,0,0.003217840130300342,2019-03-25 08:45:00,2019-03-25 09:00:00
109,5,3,2,0.01746105637521506,2019-03-25 08:45:00,2019-03-25 09:00:00
110,4,2,2,0.02484711717856768,2019-03-25 08:45:00,2019-03-25 09:00:00
111,8,7,1,0.031680930265542424,2019-03-25 08:45:00,2019-03-25 09:00:00
112,7,4,3,0.007665309147715925,2019-03-25 08:45:00,2019-03-25 09:00:00
113,1,1,0,0.004688035474019209,2019-03-25 08:45:00,2019-03-25 09:00:00
114,2,1,1,0.004688035474019209,2019-03-25 08:45:00,2019-03-25 09:00:00
115,3,1,2,0.0044071824690676146,2019-03-25 08:45:00,2019-03-25 09:00:00
116,1,0,1,0.002534009718822422,2019-03-25 08:45:00,2019-03-25 09:00:00
118,1,0,1,0.002534009718822422,2019-03-25 08:45:00,2019-03-25 09:00:00
119,1,0,1,0.002534009718822422,2019-03-25 08:45:00,2019-03-25 09:00:00
120,2,0,2,0.002534009718822422,2019-03-25 08:45:00,2019-03-25 09:00:00
126,6,3,3,0.0061240526441504,2019-03-25 08:45:00,2019-03-25 09:00:00
127,8,7,1,0.024276137952922976,2019-03-25 08:45:00,2019-03-25 09:00:00
135,1,0,1,0.002534009718822422,2019-03-25 08:45:00,2019-03-25 09:00:00
137,12,12,0,0.021553718982564647,2019-03-25 08:45:00,2019-03-25 09:00:00
138,2,2,0,0.005765048351617602,2019-03-25 08:45:00,2019-03-25 09:00:00
140,3,0,3,0.002534009718822422,2019-03-25 08:45:00,2019-03-25 09:00:00
141,1,0,1,0.002534009718822422,2019-03-25 08:45:00,2019-03-25 09:00:00
147,4,1,3,0.005438828448922751,2019-03-25 08:45:00,2019-03-25 09:00:00
153,1,0,1,0.002534009718822422,2019-03-25 08:45:00,2019-03-25 09:00:00
154,2,2,0,0.007322403746850033,2019-03-25 08:45:00,2019-03-25 09:00:00
157,1,0,1,0.002534009718822422,2019-03-25 08:45:00,2019-03-25 09:00:00
158,3,1,2,0.008775280881400114,2019-03-25 08:45:00,2019-03-25 09:00:00
159,1,1,0,0.00295227179700249,2019-03-25 08:45:00,2019-03-25 09:00:00
160,1,0,1,0.002534009718822422,2019-03-25 08:45:00,2019-03-25 09:00:00
162,1,0,1,0.002534009718822422,2019-03-25 08:45:00,2019-03-25 09:00:00
164,7,3,4,0.005766736871295864,2019-03-25 08:45:00,2019-03-25 09:00:00
168,10,2,8,0.027333673830487938,2019-03-25 08:45:00,2019-03-25 09:00:00
169,2,1,1,0.016838403852041627,2019-03-25 08:45:00,2019-03-25 09:00:00
170,11,5,6,0.04404909532901008,2019-03-25 08:45:00,2019-03-25 09:00:00
172,1,0,1,0.002534009718822422,2019-03-25 08:45:00,2019-03-25 09:00:00
173,1,0,1,0.002534009718822422,2019-03-25 08:45:00,2019-03-25 09:00:00
177,1,0,1,0.002534009718822422,2019-03-25 08:45:00,2019-03-25 09:00:00
189,9,7,2,0.05150718907264454,2019-03-25 08:45:00,2019-03-25 09:00:00
190,2,2,0,0.0060045171165128055,2019-03-25 08:45:00,2019-03-25 09:00:00
195,1,1,0,0.0044071824690676146,2019-03-25 08:45:00,2019-03-25 09:00:00
196,1,1,0,0.004688035474019209,2019-03-25 08:45:00,2019-03-25 09:00:00
197,1,1,0,0.00289301401135522,2019-03-25 08:45:00,2019-03-25 09:00:00
201,1,0,1,0.002534009718822422,2019-03-25 08:45:00,2019-03-25 09:00:00
203,2,0,2,0.002534009718822422,2019-03-25 08:45:00,2019-03-25 09:00:00
1,2,0,2,0.0028121411110540477,2019-03-25 09:00:00,2019-03-25 09:15:00
2,4,3,1,0.008566629494083555,2019-03-25 09:00:00,2019-03-25 09:15:00
5,3,1,2,0.004891044132243131,2019-03-25 09:00:00,2019-03-25 09:15:00
10,3,2,1,0.02652691073634089,2019-03-25 09:00:00,2019-03-25 09:15:00
15,2,0,2,0.0028121411110540477,2019-03-25 09:00:00,2019-03-25 09:15:00
16,8,3,5,0.016155492369617767,2019-03-25 09:00:00,2019-03-25 09:15:00
18,2,1,1,0.0035710607425660183,2019-03-25 09:00:00,2019-03-25 09:15:00
19,2,1,1,0.0035710607425660183,2019-03-25 09:00:00,2019-03-25 09:15:00
23,7,5,2,0.01482899468928563,2019-03-25 09:00:00,2019-03-25 09:15:00
26,1,0,1,0.0028121411110540477,2019-03-25 09:00:00,2019-03-25 09:15:00
28,1,0,1,0.0028121411110540477,2019-03-25 09:00:00,2019-03-25 09:15:00
30,1,1,0,0.004469185648006042,2019-03-25 09:00:00,2019-03-25 09:15:00
35,3,0,3,0.0028121411110540477,2019-03-25 09:00:00,2019-03-25 09:15:00
37,6,5,1,0.014514343355107222,2019-03-25 09:00:00,2019-03-25 09:15:00
40,2,2,0,0.018635343052844852,2019-03-25 09:00:00,2019-03-25 09:15:00
41,4,1,3,0.005847819637101931,2019-03-25 09:00:00,2019-03-25 09:15:00
46,3,3,0,0.016348256600240745,2019-03-25 09:00:00,2019-03-25 09:15:00
58,3,1,2,0.003388184312934383,2019-03-25 09:00:00,2019-03-25 09:15:00
62,4,1,3,0.003924062991138666,2019-03-25 09:00:00,2019-03-25 09:15:00
64,1,0,1,0.0028121411110540477,2019-03-25 09:00:00,2019-03-25 09:15:00
66,3,1,2,0.004891044132243131,2019-03-25 09:00:00,2019-03-25 09:15:00
67,3,1,2,0.004891044132243131,2019-03-25 09:00:00,2019-03-25 09:15:00
68,3,2,1,0.01734146738519228,2019-03-25 09:00:00,2019-03-25 09:15:00
70,1,0,1,0.0028121411110540477,2019-03-25 09:00:00,2019-03-25 09:15:00
74,1,1,0,0.005202667942165897,2019-03-25 09:00:00,2019-03-25 09:15:00
75,2,1,1,0.012409966771649478,2019-03-25 09:00:00,2019-03-25 09:15:00
85,5,3,2,0.010413894464128107,2019-03-25 09:00:00,2019-03-25 09:15:00
86,1,0,1,0.0028121411110540477,2019-03-25 09:00:00,2019-03-25 09:15:00
87,3,3,0,0.013621300341468972,2019-03-25 09:00:00,2019-03-25 09:15:00
88,4,2,2,0.011446567121910878,2019-03-25 09:00:00,2019-03-25 09:15:00
89,5,0,5,0.0028121411110540477,2019-03-25 09:00:00,2019-03-25 09:15:00
90,4,1,3,0.005202667942165897,2019-03-25 09:00:00,2019-03-25 09:15:00
101,2,1,1,0.018627532166821448,2019-03-25 09:00:00,2019-03-25 09:15:00
104,4,2,2,0.009048850174621299,2019-03-25 09:00:00,2019-03-25 09:15:00
109,6,4,2,0.015574392267687146,2019-03-25 09:00:00,2019-03-25 09:15:00
110,2,1,1,0.011289975674448234,2019-03-25 09:00:00,2019-03-25 09:15:00
111,8,6,2,0.01606022330956112,2019-03-25 09:00:00,2019-03-25 09:15:00
112,7,5,2,0.006341047389433853,2019-03-25 09:00:00,2019-03-25 09:15:00
115,3,1,2,0.004891044132243131,2019-03-25 09:00:00,2019-03-25 09:15:00
116,1,0,1,0.0028121411110540477,2019-03-25 09:00:00,2019-03-25 09:15:00
118,3,1,2,0.005202667942165897,2019-03-25 09:00:00,2019-03-25 09:15:00
119,2,1,1,0.005202667942165897,2019-03-25 09:00:00,2019-03-25 09:15:00
120,4,1,3,0.009638639165953219,2019-03-25 09:00:00,2019-03-25 09:15:00
126,4,3,1,0.010665310456373863,2019-03-25 09:00:00,2019-03-25 09:15:00
127,10,7,3,0.04845947473555023,2019-03-25 09:00:00,2019-03-25 09:15:00
137,10,10,0,0.016437395446074046,2019-03-25 09:00:00,2019-03-25 09:15:00
138,4,4,0,0.010877570503329466,2019-03-25 09:00:00,2019-03-25 09:15:00
140,2,0,2,0.0028121411110540477,2019-03-25 09:00:00,2019-03-25 09:15:00
147,2,2,0,0.00480871159566576,2019-03-25 09:00:00,2019-03-25 09:15:00
153,3,1,2,0.004007404526609973,2019-03-25 09:00:00,2019-03-25 09:15:00
154,1,1,0,0.013362181848963949,2019-03-25 09:00:00,2019-03-25 09:15:00
156,2,1,1,0.018627532166821448,2019-03-25 09:00:00,2019-03-25 09:15:00
157,2,1,1,0.005558973330551466,2019-03-25 09:00:00,2019-03-25 09:15:00
158,3,2,1,0.01793445112009271,2019-03-25 09:00:00,2019-03-25 09:15:00
159,1,0,1,0.0028121411110540477,2019-03-25 09:00:00,2019-03-25 09:15:00
164,6,1,5,0.003388184312934383,2019-03-25 09:00:00,2019-03-25 09:15:00
168,9,1,8,0.011289975674448234,2019-03-25 09:00:00,2019-03-25 09:15:00
169,2,1,1,0.018627532166821448,2019-03-25 09:00:00,2019-03-25 09:15:00
170,10,2,8,0.0035710607425660183,2019-03-25 09:00:00,2019-03-25 09:15:00
172,5,1,4,0.0035710607425660183,2019-03-25 09:00:00,2019-03-25 09:15:00
173,1,0,1,0.0028121411110540477,2019-03-25 09:00:00,2019-03-25 09:15:00
189,7,5,2,0.019945195557146054,2019-03-25 09:00:00,2019-03-25 09:15:00
191,2,2,0,0.005680773308388267,2019-03-25 09:00:00,2019-03-25 09:15:00
195,2,1,1,0.004891044132243131,2019-03-25 09:00:00,2019-03-25 09:15:00
196,3,3,0,0.009807769806133269,2019-03-25 09:00:00,2019-03-25 09:15:00
197,1,0,1,0.0028121411110540477,2019-03-25 09:00:00,2019-03-25 09:15:00
201,1,0,1,0.0028121411110540477,2019-03-25 09:00:00,2019-03-25 09:15:00
202,1,0,1,0.0028121411110540477,2019-03-25 09:00:00,2019-03-25 09:15:00
203,7,3,4,0.008506900044158452,2019-03-25 09:00:00,2019-03-25 09:15:00
1,2,1,1,0.01086078218937822,2019-03-25 09:15:00,2019-03-25 09:30:00
2,2,2,0,0.007473457875688355,2019-03-25 09:15:00,2019-03-25 09:30:00
5,2,1,1,0.018230083883483968,2019-03-25 09:15:00,2019-03-25 09:30:00
10,2,1,1,0.018230083883483968,2019-03-25 09:15:00,2019-03-25 09:30:00
15,3,2,1,0.005808647045669623,2019-03-25 09:15:00,2019-03-25 09:30:00
16,6,1,5,0.011707415490135903,2019-03-25 09:15:00,2019-03-25 09:30:00
18,2,2,0,0.007822863946226251,2019-03-25 09:15:00,2019-03-25 09:30:00
19,2,2,0,0.004254340007225287,2019-03-25 09:15:00,2019-03-25 09:30:00
23,4,3,1,0.015039530332121612,2019-03-25 09:15:00,2019-03-25 09:30:00
27,1,1,0,0.005067400835819275,2019-03-25 09:15:00,2019-03-25 09:30:00
35,2,1,1,0.0032805324624941893,2019-03-25 09:15:00,2019-03-25 09:30:00
37,2,2,0,0.006461758452201646,2019-03-25 09:15:00,2019-03-25 09:30:00
41,1,0,1,0.0027390235921792754,2019-03-25 09:15:00,2019-03-25 09:30:00
46,1,1,0,0.004530450202706931,2019-03-25 09:15:00,2019-03-25 09:30:00
50,2,1,1,0.018230083883483968,2019-03-25 09:15:00,2019-03-25 09:30:00
57,2,1,1,0.018230083883483968,2019-03-25 09:15:00,2019-03-25 09:30:00
58,5,1,4,0.0034782142593452873,2019-03-25 09:15:00,2019-03-25 09:30:00
62,1,0,1,0.0027390235921792754,2019-03-25 09:15:00,2019-03-25 09:30:00
64,5,2,3,0.006321876813234587,2019-03-25 09:15:00,2019-03-25 09:30:00
66,4,2,2,0.00874279681273047,2019-03-25 09:15:00,2019-03-25 09:30:00
67,8,2,6,0.003822041332809103,2019-03-25 09:15:00,2019-03-25 09:30:00
68,3,2,1,0.014134204736981184,2019-03-25 09:15:00,2019-03-25 09:30:00
69,1,0,1,0.0027390235921792754,2019-03-25 09:15:00,2019-03-25 09:30:00
70,1,1,0,0.004133381208561646,2019-03-25 09:15:00,2019-03-25 09:30:00
75,1,0,1,0.0027390235921792754,2019-03-25 09:15:00,2019-03-25 09:30:00
79,1,1,0,0.0039032122139992754,2019-03-25 09:15:00,2019-03-25 09:30:00
85,1,0,1,0.0027390235921792754,2019-03-25 09:15:00,2019-03-25 09:30:00
86,1,0,1,0.0027390235921792754,2019-03-25 09:15:00,2019-03-25 09:30:00
88,3,2,1,0.010549332250339901,2019-03-25 09:15:00,2019-03-25 09:30:00
89,1,0,1,0.0027390235921792754,2019-03-25 09:15:00,2019-03-25 09:30:00
90,1,0,1,0.0027390235921792754,2019-03-25 09:15:00,2019-03-25 09:30:00
101,2,1,1,0.018230083883483968,2019-03-25 09:15:00,2019-03-25 09:30:00
104,1,0,1,0.0027390235921792754,2019-03-25 09:15:00,2019-03-25 09:30:00
109,5,2,3,0.017852831357550385,2019-03-25 09:15:00,2019-03-25 09:30:00
110,1,0,1,0.0027390235921792754,2019-03-25 09:15:00,2019-03-25 09:30:00
111,3,1,2,0.011919171088416485,2019-03-25 09:15:00,2019-03-25 09:30:00
112,8,5,3,0.008072941414138241,2019-03-25 09:15:00,2019-03-25 09:30:00
115,4,1,3,0.003822041332809103,2019-03-25 09:15:00,2019-03-25 09:30:00
118,3,1,2,0.0032805324624941893,2019-03-25 09:15:00,2019-03-25 09:30:00
119,1,1,0,0.0039032122139992754,2019-03-25 09:15:00,2019-03-25 09:30:00
120,9,2,7,0.00888452142032117,2019-03-25 09:15:00,2019-03-25 09:30:00
122,4,2,2,0.018230083883483968,2019-03-25 09:15:00,2019-03-25 09:30:00
126,5,4,1,0.009553810209780175,2019-03-25 09:15:00,2019-03-25 09:30:00
127,7,5,2,0.02553306715745452,2019-03-25 09:15:00,2019-03-25 09:30:00
133,1,1,0,0.005067400835819275,2019-03-25 09:15:00,2019-03-25 09:30:00
137,5,4,1,0.010798530342537208,2019-03-25 09:15:00,2019-03-25 09:30:00
138,5,4,1,0.05943862306104069,2019-03-25 09:15:00,2019-03-25 09:30:00
140,2,0,2,0.0027390235921792754,2019-03-25 09:15:00,2019-03-25 09:30:00
147,2,2,0,0.006691927446764017,2019-03-25 09:15:00,2019-03-25 09:30:00
153,3,3,0,0.014897593999154192,2019-03-25 09:15:00,2019-03-25 09:30:00
154,2,1,1,0.005067400835819275,2019-03-25 09:15:00,2019-03-25 09:30:00
156,2,1,1,0.018230083883483968,2019-03-25 09:15:00,2019-03-25 09:30:00
157,1,1,0,0.004729630980509172,2019-03-25 09:15:00,2019-03-25 09:30:00
158,5,5,0,0.01899847298338107,2019-03-25 09:15:00,2019-03-25 09:30:00
159,2,0,2,0.0027390235921792754,2019-03-25 09:15:00,2019-03-25 09:30:00
164,5,2,3,0.00659989203970319,2019-03-25 09:15:00,2019-03-25 09:30:00
168,2,0,2,0.0027390235921792754,2019-03-25 09:15:00,2019-03-25 09:30:00
169,3,2,1,0.0518389992635587,2019-03-25 09:15:00,2019-03-25 09:30:00
170,9,3,6,0.007071094554698586,2019-03-25 09:15:00,2019-03-25 09:30:00
172,3,0,3,0.0027390235921792754,2019-03-25 09:15:00,2019-03-25 09:30:00
189,2,2,0,0.006231589457639275,2019-03-25 09:15:00,2019-03-25 09:30:00
190,1,0,1,0.0027390235921792754,2019-03-25 09:15:00,2019-03-25 09:30:00
191,2,2,0,0.007395778079459275,2019-03-25 09:15:00,2019-03-25 09:30:00
195,2,1,1,0.0032805324624941893,2019-03-25 09:15:00,2019-03-25 09:30:00
196,3,2,1,0.005802737484017079,2019-03-25 09:15:00,2019-03-25 09:30:00
197,1,0,1,0.0027390235921792754,2019-03-25 09:15:00,2019-03-25 09:30:00
201,1,0,1,0.0027390235921792754,2019-03-25 09:15:00,2019-03-25 09:30:00
202,1,0,1,0.0027390235921792754,2019-03-25 09:15:00,2019-03-25 09:30:00
203,3,1,2,0.006455208668772668,2019-03-25 09:15:00,2019-03-25 09:30:00
1,2,1,1,0.008334270233902024,2019-03-25 09:30:00,2019-03-25 09:45:00
5,2,1,1,0.02153181192250413,2019-03-25 09:30:00,2019-03-25 09:45:00
10,3,1,2,0.0056343157247146294,2019-03-25 09:30:00,2019-03-25 09:45:00
15,1,0,1,0.00323946348270775,2019-03-25 09:30:00,2019-03-25 09:45:00
16,2,1,1,0.006773602268937317,2019-03-25 09:30:00,2019-03-25 09:45:00
18,2,2,0,0.01132276736667373,2019-03-25 09:30:00,2019-03-25 09:45:00
19,1,1,0,0.006227960615479458,2019-03-25 09:30:00,2019-03-25 09:45:00
23,3,3,0,0.010358667821100278,2019-03-25 09:30:00,2019-03-25 09:45:00
27,1,1,0,0.017818883936063453,2019-03-25 09:30:00,2019-03-25 09:45:00
28,1,0,1,0.00323946348270775,2019-03-25 09:30:00,2019-03-25 09:45:00
35,2,1,1,0.004157398417290154,2019-03-25 09:30:00,2019-03-25 09:45:00
46,1,1,0,0.0056343157247146294,2019-03-25 09:30:00,2019-03-25 09:45:00
50,2,1,1,0.02153181192250413,2019-03-25 09:30:00,2019-03-25 09:45:00
58,7,3,4,0.014061555502519807,2019-03-25 09:30:00,2019-03-25 09:45:00
62,1,0,1,0.00323946348270775,2019-03-25 09:30:00,2019-03-25 09:45:00
64,3,1,2,0.0056343157247146294,2019-03-25 09:30:00,2019-03-25 09:45:00
66,3,2,1,0.039782477967101916,2019-03-25 09:30:00,2019-03-25 09:45:00
67,3,0,3,0.00323946348270775,2019-03-25 09:30:00,2019-03-25 09:45:00
68,1,1,0,0.004157398417290154,2019-03-25 09:30:00,2019-03-25 09:45:00
69,2,1,1,0.004113715831983359,2019-03-25 09:30:00,2019-03-25 09:45:00
75,1,0,1,0.00323946348270775,2019-03-25 09:30:00,2019-03-25 09:45:00
79,1,1,0,0.004616365884581357,2019-03-25 09:30:00,2019-03-25 09:45:00
88,2,1,1,0.02153181192250413,2019-03-25 09:30:00,2019-03-25 09:45:00
90,1,1,0,0.00727360709074017,2019-03-25 09:30:00,2019-03-25 09:45:00
101,2,1,1,0.02153181192250413,2019-03-25 09:30:00,2019-03-25 09:45:00
104,3,2,1,0.017150001127799908,2019-03-25 09:30:00,2019-03-25 09:45:00
109,5,1,4,0.00535821038183182,2019-03-25 09:30:00,2019-03-25 09:45:00
111,3,1,2,0.0056343157247146294,2019-03-25 09:30:00,2019-03-25 09:45:00
112,6,3,3,0.00970678639299517,2019-03-25 09:30:00,2019-03-25 09:45:00
113,2,1,1,0.008029167966721509,2019-03-25 09:30:00,2019-03-25 09:45:00
114,4,0,4,0.00323946348270775,2019-03-25 09:30:00,2019-03-25 09:45:00
115,4,1,3,0.004520366070167576,2019-03-25 09:30:00,2019-03-25 09:45:00
116,1,0,1,0.00323946348270775,2019-03-25 09:30:00,2019-03-25 09:45:00
119,3,2,1,0.005755121572221285,2019-03-25 09:30:00,2019-03-25 09:45:00
120,4,1,3,0.008131851233664063,2019-03-25 09:30:00,2019-03-25 09:45:00
122,5,2,3,0.007476957280955892,2019-03-25 09:30:00,2019-03-25 09:45:00
126,2,1,1,0.005993268286454964,2019-03-25 09:30:00,2019-03-25 09:45:00
127,5,3,2,0.006797877445447432,2019-03-25 09:30:00,2019-03-25 09:45:00
133,1,1,0,0.005993268286454964,2019-03-25 09:30:00,2019-03-25 09:45:00
135,1,1,0,0.0039279146836445535,2019-03-25 09:30:00,2019-03-25 09:45:00
137,7,5,2,0.02348058878079512,2019-03-25 09:30:00,2019-03-25 09:45:00
138,3,3,0,0.011255030858455745,2019-03-25 09:30:00,2019-03-25 09:45:00
153,3,3,0,0.010958128638980724,2019-03-25 09:30:00,2019-03-25 09:45:00
154,2,1,1,0.005993268286454964,2019-03-25 09:30:00,2019-03-25 09:45:00
157,2,1,1,0.0056343157247146294,2019-03-25 09:30:00,2019-03-25 09:45:00
158,8,5,3,0.014236198893490669,2019-03-25 09:30:00,2019-03-25 09:45:00
159,2,0,2,0.00323946348270775,2019-03-25 09:30:00,2019-03-25 09:45:00
164,5,1,4,0.004113715831983359,2019-03-25 09:30:00,2019-03-25 09:45:00
168,2,0,2,0.00323946348270775,2019-03-25 09:30:00,2019-03-25 09:45:00
169,3,2,1,0.02908892596805927,2019-03-25 09:30:00,2019-03-25 09:45:00
170,5,2,3,0.007476957280955892,2019-03-25 09:30:00,2019-03-25 09:45:00
173,3,3,0,0.007011218126588236,2019-03-25 09:30:00,2019-03-25 09:45:00
189,1,1,0,0.004616365884581357,2019-03-25 09:30:00,2019-03-25 09:45:00
191,1,0,1,0.00323946348270775,2019-03-25 09:30:00,2019-03-25 09:45:00
195,1,1,0,0.004157398417290154,2019-03-25 09:30:00,2019-03-25 09:45:00
196,7,3,4,0.010418587418165407,2019-03-25 09:30:00,2019-03-25 09:45:00
201,1,0,1,0.00323946348270775,2019-03-25 09:30:00,2019-03-25 09:45:00
202,1,1,0,0.013220096950763217,2019-03-25 09:30:00,2019-03-25 09:45:00
1,1,0,1,0.002962962540375258,2019-03-25 09:45:00,2019-03-25 10:00:00
5,4,1,3,0.004134528673059519,2019-03-25 09:45:00,2019-03-25 10:00:00
10,3,1,2,0.005153389476937591,2019-03-25 09:45:00,2019-03-25 10:00:00
16,1,0,1,0.002962962540375258,2019-03-25 09:45:00,2019-03-25 10:00:00
18,1,1,0,0.009179812003017925,2019-03-25 09:45:00,2019-03-25 10:00:00
23,1,1,0,0.004222336225294041,2019-03-25 09:45:00,2019-03-25 10:00:00
28,1,0,1,0.002962962540375258,2019-03-25 09:45:00,2019-03-25 10:00:00
30,1,0,1,0.002962962540375258,2019-03-25 09:45:00,2019-03-25 10:00:00
35,1,0,1,0.002962962540375258,2019-03-25 09:45:00,2019-03-25 10:00:00
37,1,1,0,0.004900850012194674,2019-03-25 09:45:00,2019-03-25 10:00:00
40,1,1,0,0.005481709910212825,2019-03-25 09:45:00,2019-03-25 10:00:00
41,1,1,0,0.005481709910212825,2019-03-25 09:45:00,2019-03-25 10:00:00
46,1,1,0,0.005481709910212825,2019-03-25 09:45:00,2019-03-25 10:00:00
50,2,1,1,0.019696596681149307,2019-03-25 09:45:00,2019-03-25 10:00:00
58,3,2,1,0.007313094925044875,2019-03-25 09:45:00,2019-03-25 10:00:00
66,2,1,1,0.019696596681149307,2019-03-25 09:45:00,2019-03-25 10:00:00
67,2,1,1,0.014622188134609446,2019-03-25 09:45:00,2019-03-25 10:00:00
68,2,1,1,0.005481709910212825,2019-03-25 09:45:00,2019-03-25 10:00:00
69,1,1,0,0.003762590105236266,2019-03-25 09:45:00,2019-03-25 10:00:00
70,1,0,1,0.002962962540375258,2019-03-25 09:45:00,2019-03-25 10:00:00
75,1,0,1,0.002962962540375258,2019-03-25 09:45:00,2019-03-25 10:00:00
85,2,1,1,0.019696596681149307,2019-03-25 09:45:00,2019-03-25 10:00:00
87,4,2,2,0.011396349853349355,2019-03-25 09:45:00,2019-03-25 10:00:00
88,4,1,3,0.004134528673059519,2019-03-25 09:45:00,2019-03-25 10:00:00
90,4,4,0,0.016210483953482277,2019-03-25 09:45:00,2019-03-25 10:00:00
101,2,1,1,0.019696596681149307,2019-03-25 09:45:00,2019-03-25 10:00:00
104,6,4,2,0.02477374869767896,2019-03-25 09:45:00,2019-03-25 10:00:00
106,1,0,1,0.002962962540375258,2019-03-25 09:45:00,2019-03-25 10:00:00
109,4,0,4,0.002962962540375258,2019-03-25 09:45:00,2019-03-25 10:00:00
111,4,1,3,0.004134528673059519,2019-03-25 09:45:00,2019-03-25 10:00:00
112,5,4,1,0.01371415581007657,2019-03-25 09:45:00,2019-03-25 10:00:00
113,2,1,1,0.007343816413499924,2019-03-25 09:45:00,2019-03-25 10:00:00
114,5,1,4,0.017398415455044954,2019-03-25 09:45:00,2019-03-25 10:00:00
115,2,1,1,0.019696596681149307,2019-03-25 09:45:00,2019-03-25 10:00:00
116,1,0,1,0.002962962540375258,2019-03-25 09:45:00,2019-03-25 10:00:00
119,4,4,0,0.009259830964969176,2019-03-25 09:45:00,2019-03-25 10:00:00
120,3,0,3,0.002962962540375258,2019-03-25 09:45:00,2019-03-25 10:00:00
122,5,2,3,0.006838737484014091,2019-03-25 09:45:00,2019-03-25 10:00:00
126,1,1,0,0.004134528673059519,2019-03-25 09:45:00,2019-03-25 10:00:00
127,5,2,3,0.004222336225294041,2019-03-25 09:45:00,2019-03-25 10:00:00
133,2,2,0,0.0066532760428970866,2019-03-25 09:45:00,2019-03-25 10:00:00
135,1,1,0,0.006661348563547678,2019-03-25 09:45:00,2019-03-25 10:00:00
137,12,7,5,0.014389303251747554,2019-03-25 09:45:00,2019-03-25 10:00:00
138,5,4,1,0.04946132576256683,2019-03-25 09:45:00,2019-03-25 10:00:00
147,1,1,0,0.004134528673059519,2019-03-25 09:45:00,2019-03-25 10:00:00
154,1,1,0,0.005481709910212825,2019-03-25 09:45:00,2019-03-25 10:00:00
157,2,1,1,0.005153389476937591,2019-03-25 09:45:00,2019-03-25 10:00:00
158,7,5,2,0.008259179838644763,2019-03-25 09:45:00,2019-03-25 10:00:00
159,1,0,1,0.002962962540375258,2019-03-25 09:45:00,2019-03-25 10:00:00
164,5,1,4,0.003762590105236266,2019-03-25 09:45:00,2019-03-25 10:00:00
168,2,0,2,0.002962962540375258,2019-03-25 09:45:00,2019-03-25 10:00:00
169,2,1,1,0.019696596681149307,2019-03-25 09:45:00,2019-03-25 10:00:00
170,5,2,3,0.006838737484014091,2019-03-25 09:45:00,2019-03-25 10:00:00
171,1,0,1,0.002962962540375258,2019-03-25 09:45:00,2019-03-25 10:00:00
173,9,6,3,0.05093253758996055,2019-03-25 09:45:00,2019-03-25 10:00:00
189,2,1,1,0.004222336225294041,2019-03-25 09:45:00,2019-03-25 10:00:00
191,3,0,3,0.002962962540375258,2019-03-25 09:45:00,2019-03-25 10:00:00
195,2,2,0,0.017913042657981576,2019-03-25 09:45:00,2019-03-25 10:00:00
196,4,2,2,0.019696596681149307,2019-03-25 09:45:00,2019-03-25 10:00:00
197,1,0,1,0.002962962540375258,2019-03-25 09:45:00,2019-03-25 10:00:00
202,1,1,0,0.005409421116981883,2019-03-25 09:45:00,2019-03-25 10:00:00
203,1,0,1,0.002962962540375258,2019-03-25 09:45:00,2019-03-25 10:00:00
5,4,1,3,0.004731666965224006,2019-03-25 10:00:00,2019-03-25 10:15:00
10,6,2,4,0.011078259833009587,2019-03-25 10:00:00,2019-03-25 10:15:00
15,3,1,2,0.00589768444890785,2019-03-25 10:00:00,2019-03-25 10:15:00
16,2,0,2,0.0033908898788312346,2019-03-25 10:00:00,2019-03-25 10:15:00
18,1,1,0,0.003950615340239747,2019-03-25 10:00:00,2019-03-25 10:15:00
19,3,1,2,0.00589768444890785,2019-03-25 10:00:00,2019-03-25 10:15:00
20,2,2,0,0.008252094916144382,2019-03-25 10:00:00,2019-03-25 10:15:00
23,3,2,1,0.007714685197114639,2019-03-25 10:00:00,2019-03-25 10:15:00
30,1,1,0,0.007413221138009547,2019-03-25 10:00:00,2019-03-25 10:15:00
35,1,0,1,0.0033908898788312346,2019-03-25 10:00:00,2019-03-25 10:15:00
37,2,2,0,0.01701070418277963,2019-03-25 10:00:00,2019-03-25 10:15:00
40,2,2,0,0.006833145552428683,2019-03-25 10:00:00,2019-03-25 10:15:00
41,2,1,1,0.006273420091020171,2019-03-25 10:00:00,2019-03-25 10:15:00
46,1,1,0,0.004832154984925703,2019-03-25 10:00:00,2019-03-25 10:15:00
57,1,1,0,0.006273420091020171,2019-03-25 10:00:00,2019-03-25 10:15:00
66,2,1,1,0.022501347936700045,2019-03-25 10:00:00,2019-03-25 10:15:00
67,4,2,2,0.016213473867502683,2019-03-25 10:00:00,2019-03-25 10:15:00
68,2,1,1,0.006273420091020171,2019-03-25 10:00:00,2019-03-25 10:15:00
70,1,0,1,0.0033908898788312346,2019-03-25 10:00:00,2019-03-25 10:15:00
75,1,0,1,0.0033908898788312346,2019-03-25 10:00:00,2019-03-25 10:15:00
85,1,0,1,0.0033908898788312346,2019-03-25 10:00:00,2019-03-25 10:15:00
87,1,1,0,0.006273420091020171,2019-03-25 10:00:00,2019-03-25 10:15:00
88,7,1,6,0.003950615340239747,2019-03-25 10:00:00,2019-03-25 10:15:00
90,2,2,0,0.012123089705736641,2019-03-25 10:00:00,2019-03-25 10:15:00
101,2,1,1,0.022501347936700045,2019-03-25 10:00:00,2019-03-25 10:15:00
106,1,0,1,0.0033908898788312346,2019-03-25 10:00:00,2019-03-25 10:15:00
109,4,3,1,0.01263061817593504,2019-03-25 10:00:00,2019-03-25 10:15:00
111,3,1,2,0.008723849365773055,2019-03-25 10:00:00,2019-03-25 10:15:00
112,4,3,1,0.01169284040021927,2019-03-25 10:00:00,2019-03-25 10:15:00
113,2,1,1,0.004832154984925703,2019-03-25 10:00:00,2019-03-25 10:15:00
114,1,1,0,0.008639172614373927,2019-03-25 10:00:00,2019-03-25 10:15:00
115,4,1,3,0.004731666965224006,2019-03-25 10:00:00,2019-03-25 10:15:00
116,1,0,1,0.0033908898788312346,2019-03-25 10:00:00,2019-03-25 10:15:00
119,2,1,1,0.006273420091020171,2019-03-25 10:00:00,2019-03-25 10:15:00
120,1,0,1,0.0033908898788312346,2019-03-25 10:00:00,2019-03-25 10:15:00
122,1,0,1,0.0033908898788312346,2019-03-25 10:00:00,2019-03-25 10:15:00
126,2,1,1,0.004731666965224006,2019-03-25 10:00:00,2019-03-25 10:15:00
127,3,1,2,0.004832154984925703,2019-03-25 10:00:00,2019-03-25 10:15:00
133,2,2,0,0.007614197177412942,2019-03-25 10:00:00,2019-03-25 10:15:00
137,14,9,5,0.02567958041504182,2019-03-25 10:00:00,2019-03-25 10:15:00
138,5,5,0,0.017360862740229455,2019-03-25 10:00:00,2019-03-25 10:15:00
147,2,2,0,0.013990526053149334,2019-03-25 10:00:00,2019-03-25 10:15:00
151,1,0,1,0.0033908898788312346,2019-03-25 10:00:00,2019-03-25 10:15:00
153,2,0,2,0.0033908898788312346,2019-03-25 10:00:00,2019-03-25 10:15:00
157,1,1,0,0.0057453003460677665,2019-03-25 10:00:00,2019-03-25 10:15:00
158,4,3,1,0.009578033717325626,2019-03-25 10:00:00,2019-03-25 10:15:00
164,5,1,4,0.004306008488494763,2019-03-25 10:00:00,2019-03-25 10:15:00
168,1,0,1,0.0033908898788312346,2019-03-25 10:00:00,2019-03-25 10:15:00
169,2,1,1,0.022501347936700045,2019-03-25 10:00:00,2019-03-25 10:15:00
170,7,3,4,0.008404479018984464,2019-03-25 10:00:00,2019-03-25 10:15:00
171,2,0,2,0.0033908898788312346,2019-03-25 10:00:00,2019-03-25 10:15:00
173,4,2,2,0.012347226528124465,2019-03-25 10:00:00,2019-03-25 10:15:00
175,2,1,1,0.022501347936700045,2019-03-25 10:00:00,2019-03-25 10:15:00
177,1,1,0,0.0057453003460677665,2019-03-25 10:00:00,2019-03-25 10:15:00
189,1,0,1,0.0033908898788312346,2019-03-25 10:00:00,2019-03-25 10:15:00
191,3,1,2,0.005177051895860616,2019-03-25 10:00:00,2019-03-25 10:15:00
195,2,2,0,0.01316500235158773,2019-03-25 10:00:00,2019-03-25 10:15:00
196,4,2,2,0.022501347936700045,2019-03-25 10:00:00,2019-03-25 10:15:00
197,1,0,1,0.0033908898788312346,2019-03-25 10:00:00,2019-03-25 10:15:00
202,1,1,0,0.007756989792283938,2019-03-25 10:00:00,2019-03-25 10:15:00
203,1,0,1,0.0033908898788312346,2019-03-25 10:00:00,2019-03-25 10:15:00
2,2,1,1,0.022218503522218356,2019-03-25 10:15:00,2019-03-25 10:30:00
5,4,1,3,0.004661782708923547,2019-03-25 10:15:00,2019-03-25 10:30:00
10,6,3,3,0.007303760030804745,2019-03-25 10:15:00,2019-03-25 10:30:00
15,4,1,3,0.004661782708923547,2019-03-25 10:15:00,2019-03-25 10:30:00
18,2,2,0,0.007501752577277416,2019-03-25 10:15:00,2019-03-25 10:30:00
20,1,1,0,0.005410446785235499,2019-03-25 10:15:00,2019-03-25 10:30:00
23,4,3,1,0.05053506773357148,2019-03-25 10:15:00,2019-03-25 10:30:00
26,1,1,0,0.006180763916336818,2019-03-25 10:15:00,2019-03-25 10:30:00
37,1,1,0,0.005109254663569985,2019-03-25 10:15:00,2019-03-25 10:30:00
41,1,0,1,0.0033407940479829486,2019-03-25 10:15:00,2019-03-25 10:30:00
58,1,0,1,0.0033407940479829486,2019-03-25 10:15:00,2019-03-25 10:30:00
62,3,1,2,0.005810609111566883,2019-03-25 10:15:00,2019-03-25 10:30:00
66,2,1,1,0.022218503522218356,2019-03-25 10:15:00,2019-03-25 10:30:00
67,2,1,1,0.006180763916336818,2019-03-25 10:15:00,2019-03-25 10:30:00
88,4,1,3,0.004661782708923547,2019-03-25 10:15:00,2019-03-25 10:30:00
101,2,1,1,0.022218503522218356,2019-03-25 10:15:00,2019-03-25 10:30:00
104,1,0,1,0.0033407940479829486,2019-03-25 10:15:00,2019-03-25 10:30:00
109,4,1,3,0.006240805028030181,2019-03-25 10:15:00,2019-03-25 10:30:00
110,2,1,1,0.006180763916336818,2019-03-25 10:15:00,2019-03-25 10:30:00
111,1,0,1,0.0033407940479829486,2019-03-25 10:15:00,2019-03-25 10:30:00
112,4,2,2,0.009182034670051095,2019-03-25 10:15:00,2019-03-25 10:30:00
113,1,0,1,0.0033407940479829486,2019-03-25 10:15:00,2019-03-25 10:30:00
115,2,1,1,0.022218503522218356,2019-03-25 10:15:00,2019-03-25 10:30:00
116,1,1,0,0.014429444402125286,2019-03-25 10:15:00,2019-03-25 10:30:00
118,1,1,0,0.007243675296597504,2019-03-25 10:15:00,2019-03-25 10:30:00
119,2,2,0,0.008564663957538103,2019-03-25 10:15:00,2019-03-25 10:30:00
120,1,0,1,0.0033407940479829486,2019-03-25 10:15:00,2019-03-25 10:30:00
126,1,0,1,0.0033407940479829486,2019-03-25 10:15:00,2019-03-25 10:30:00
127,2,1,1,0.005810609111566883,2019-03-25 10:15:00,2019-03-25 10:30:00
133,1,1,0,0.006180763916336818,2019-03-25 10:15:00,2019-03-25 10:30:00
137,10,7,3,0.0256991151601253,2019-03-25 10:15:00,2019-03-25 10:30:00
138,6,5,1,0.013043740879205847,2019-03-25 10:15:00,2019-03-25 10:30:00
147,1,1,0,0.004760778982159883,2019-03-25 10:15:00,2019-03-25 10:30:00
151,1,0,1,0.0033407940479829486,2019-03-25 10:15:00,2019-03-25 10:30:00
154,1,0,1,0.0033407940479829486,2019-03-25 10:15:00,2019-03-25 10:30:00
157,1,1,0,0.004287450670767572,2019-03-25 10:15:00,2019-03-25 10:30:00
158,6,3,3,0.01023396219312282,2019-03-25 10:15:00,2019-03-25 10:30:00
164,5,1,4,0.004242404542883226,2019-03-25 10:15:00,2019-03-25 10:30:00
168,1,1,0,0.008595044080314262,2019-03-25 10:15:00,2019-03-25 10:30:00
169,2,1,1,0.022218503522218356,2019-03-25 10:15:00,2019-03-25 10:30:00
170,7,3,4,0.010750239238734752,2019-03-25 10:15:00,2019-03-25 10:30:00
171,2,0,2,0.0033407940479829486,2019-03-25 10:15:00,2019-03-25 10:30:00
173,2,1,1,0.022218503522218356,2019-03-25 10:15:00,2019-03-25 10:30:00
175,2,1,1,0.022218503522218356,2019-03-25 10:15:00,2019-03-25 10:30:00
177,1,1,0,0.005410446785235499,2019-03-25 10:15:00,2019-03-25 10:30:00
189,3,0,3,0.0033407940479829486,2019-03-25 10:15:00,2019-03-25 10:30:00
191,1,1,0,0.005625531709181916,2019-03-25 10:15:00,2019-03-25 10:30:00
195,1,1,0,0.008595044080314262,2019-03-25 10:15:00,2019-03-25 10:30:00
197,1,1,0,0.006180763916336818,2019-03-25 10:15:00,2019-03-25 10:30:00
202,1,1,0,0.010623613980866413,2019-03-25 10:15:00,2019-03-25 10:30:00
203,1,0,1,0.0033407940479829486,2019-03-25 10:15:00,2019-03-25 10:30:00
2,4,2,2,0.010393251946923546,2019-03-25 10:30:00,2019-03-25 10:45:00
5,4,1,3,0.004507004232478068,2019-03-25 10:30:00,2019-03-25 10:45:00
10,4,3,1,0.027534848305077766,2019-03-25 10:30:00,2019-03-25 10:45:00
15,4,1,3,0.004507004232478068,2019-03-25 10:30:00,2019-03-25 10:45:00
18,2,2,0,0.0068907766493906805,2019-03-25 10:30:00,2019-03-25 10:45:00
19,1,1,0,0.0036874940310589327,2019-03-25 10:30:00,2019-03-25 10:45:00
20,1,1,0,0.004145105833677754,2019-03-25 10:30:00,2019-03-25 10:45:00
22,2,1,1,0.021458606785918353,2019-03-25 10:30:00,2019-03-25 10:45:00
23,2,1,1,0.006753586016148053,2019-03-25 10:30:00,2019-03-25 10:45:00
26,3,3,0,0.005060329438915396,2019-03-25 10:30:00,2019-03-25 10:45:00
37,3,0,3,0.0032298822284401118,2019-03-25 10:30:00,2019-03-25 10:45:00
41,3,0,3,0.0032298822284401118,2019-03-25 10:30:00,2019-03-25 10:45:00
57,1,0,1,0.0032298822284401118,2019-03-25 10:30:00,2019-03-25 10:45:00
58,2,0,2,0.0032298822284401118,2019-03-25 10:30:00,2019-03-25 10:45:00
62,1,0,1,0.0032298822284401118,2019-03-25 10:30:00,2019-03-25 10:45:00
64,1,0,1,0.0032298822284401118,2019-03-25 10:30:00,2019-03-25 10:45:00
66,2,1,1,0.021458606785918353,2019-03-25 10:30:00,2019-03-25 10:45:00
67,1,0,1,0.0032298822284401118,2019-03-25 10:30:00,2019-03-25 10:45:00
69,1,1,0,0.005975553044153039,2019-03-25 10:30:00,2019-03-25 10:45:00
85,1,0,1,0.0032298822284401118,2019-03-25 10:30:00,2019-03-25 10:45:00
87,3,3,0,0.01350397871993604,2019-03-25 10:30:00,2019-03-25 10:45:00
88,3,2,1,0.027534848305077766,2019-03-25 10:30:00,2019-03-25 10:45:00
90,1,1,0,0.01742676428648008,2019-03-25 10:30:00,2019-03-25 10:45:00
101,2,1,1,0.021458606785918353,2019-03-25 10:30:00,2019-03-25 10:45:00
104,1,0,1,0.0032298822284401118,2019-03-25 10:30:00,2019-03-25 10:45:00
108,1,0,1,0.0032298822284401118,2019-03-25 10:30:00,2019-03-25 10:45:00
109,6,0,6,0.0032298822284401118,2019-03-25 10:30:00,2019-03-25 10:45:00
110,2,1,1,0.0063645695301505455,2019-03-25 10:30:00,2019-03-25 10:45:00
111,2,1,1,0.0036874940310589327,2019-03-25 10:30:00,2019-03-25 10:45:00
112,3,3,0,0.012748579353083666,2019-03-25 10:30:00,2019-03-25 10:45:00
113,2,1,1,0.004145105833677754,2019-03-25 10:30:00,2019-03-25 10:45:00
114,3,0,3,0.0032298822284401118,2019-03-25 10:30:00,2019-03-25 10:45:00
115,2,1,1,0.021458606785918353,2019-03-25 10:30:00,2019-03-25 10:45:00
116,2,1,1,0.009898433224401322,2019-03-25 10:30:00,2019-03-25 10:45:00
118,1,0,1,0.0032298822284401118,2019-03-25 10:30:00,2019-03-25 10:45:00
119,2,2,0,0.00496461603509689,2019-03-25 10:30:00,2019-03-25 10:45:00
120,2,1,1,0.007098460366914026,2019-03-25 10:30:00,2019-03-25 10:45:00
126,3,0,3,0.0032298822284401118,2019-03-25 10:30:00,2019-03-25 10:45:00
127,3,2,1,0.00689077664939068,2019-03-25 10:30:00,2019-03-25 10:45:00
133,1,1,0,0.005975553044153039,2019-03-25 10:30:00,2019-03-25 10:45:00
137,6,5,1,0.016699405473181154,2019-03-25 10:30:00,2019-03-25 10:45:00
138,6,4,2,0.015687578133951892,2019-03-25 10:30:00,2019-03-25 10:45:00
140,2,2,0,0.00496461603509689,2019-03-25 10:30:00,2019-03-25 10:45:00
153,2,2,0,0.01008975178732195,2019-03-25 10:30:00,2019-03-25 10:45:00
154,2,1,1,0.011645167276519772,2019-03-25 10:30:00,2019-03-25 10:45:00
157,2,2,0,0.00643316484677186,2019-03-25 10:30:00,2019-03-25 10:45:00
158,6,3,3,0.013650614807352832,2019-03-25 10:30:00,2019-03-25 10:45:00
164,5,2,3,0.008338370244591938,2019-03-25 10:30:00,2019-03-25 10:45:00
168,4,3,1,0.010470811012778358,2019-03-25 10:30:00,2019-03-25 10:45:00
169,2,1,1,0.021458606785918353,2019-03-25 10:30:00,2019-03-25 10:45:00
170,6,3,3,0.030310753629883468,2019-03-25 10:30:00,2019-03-25 10:45:00
173,6,2,4,0.00526378197653164,2019-03-25 10:30:00,2019-03-25 10:45:00
177,1,1,0,0.006294308466804377,2019-03-25 10:30:00,2019-03-25 10:45:00
189,6,0,6,0.0032298822284401118,2019-03-25 10:30:00,2019-03-25 10:45:00
190,1,1,0,0.004602717636296575,2019-03-25 10:30:00,2019-03-25 10:45:00
195,2,2,0,0.01264410404011425,2019-03-25 10:30:00,2019-03-25 10:45:00
196,2,2,0,0.005467234514147884,2019-03-25 10:30:00,2019-03-25 10:45:00
197,4,2,2,0.007209532072042019,2019-03-25 10:30:00,2019-03-25 10:45:00
203,1,0,1,0.0032298822284401118,2019-03-25 10:30:00,2019-03-25 10:45:00
1,3,0,3,0.002888044422803348,2019-03-25 10:45:00,2019-03-25 11:00:00
2,5,3,2,0.012092197445827905,2019-03-25 10:45:00,2019-03-25 11:00:00
5,2,1,1,0.019197784832067688,2019-03-25 10:45:00,2019-03-25 11:00:00
10,4,3,1,0.04138168905770377,2019-03-25 10:45:00,2019-03-25 11:00:00
15,3,2,1,0.009105229727490597,2019-03-25 10:45:00,2019-03-25 11:00:00
16,1,0,1,0.002888044422803348,2019-03-25 10:45:00,2019-03-25 11:00:00
18,4,2,2,0.008361043985336363,2019-03-25 10:45:00,2019-03-25 11:00:00
19,2,0,2,0.002888044422803348,2019-03-25 10:45:00,2019-03-25 11:00:00
22,2,1,1,0.019197784832067688,2019-03-25 10:45:00,2019-03-25 11:00:00
23,1,0,1,0.002888044422803348,2019-03-25 10:45:00,2019-03-25 11:00:00
26,2,2,0,0.004115558385529792,2019-03-25 10:45:00,2019-03-25 11:00:00
37,5,2,3,0.015093957721763474,2019-03-25 10:45:00,2019-03-25 11:00:00
40,2,2,0,0.014411667641259247,2019-03-25 10:45:00,2019-03-25 11:00:00
41,2,0,2,0.002888044422803348,2019-03-25 10:45:00,2019-03-25 11:00:00
46,1,1,0,0.010943302645030281,2019-03-25 10:45:00,2019-03-25 11:00:00
57,1,0,1,0.002888044422803348,2019-03-25 10:45:00,2019-03-25 11:00:00
58,1,0,1,0.002888044422803348,2019-03-25 10:45:00,2019-03-25 11:00:00
64,1,0,1,0.002888044422803348,2019-03-25 10:45:00,2019-03-25 11:00:00
66,2,1,1,0.019197784832067688,2019-03-25 10:45:00,2019-03-25 11:00:00
67,1,0,1,0.002888044422803348,2019-03-25 10:45:00,2019-03-25 11:00:00
68,1,0,1,0.002888044422803348,2019-03-25 10:45:00,2019-03-25 11:00:00
85,4,3,1,0.011909550433921787,2019-03-25 10:45:00,2019-03-25 11:00:00
87,8,5,3,0.014384772227718109,2019-03-25 10:45:00,2019-03-25 11:00:00
88,6,2,4,0.006785017832791625,2019-03-25 10:45:00,2019-03-25 11:00:00
90,9,5,4,0.02020466355173381,2019-03-25 10:45:00,2019-03-25 11:00:00
101,2,1,1,0.019197784832067688,2019-03-25 10:45:00,2019-03-25 11:00:00
109,4,0,4,0.002888044422803348,2019-03-25 10:45:00,2019-03-25 11:00:00
110,1,0,1,0.002888044422803348,2019-03-25 10:45:00,2019-03-25 11:00:00
111,2,1,1,0.00456323358046469,2019-03-25 10:45:00,2019-03-25 11:00:00
112,4,3,1,0.009475897174373329,2019-03-25 10:45:00,2019-03-25 11:00:00
113,4,3,1,0.00864559644935187,2019-03-25 10:45:00,2019-03-25 11:00:00
114,3,1,2,0.004515328465631856,2019-03-25 10:45:00,2019-03-25 11:00:00
115,5,3,2,0.017008131016155947,2019-03-25 10:45:00,2019-03-25 11:00:00
116,1,0,1,0.002888044422803348,2019-03-25 10:45:00,2019-03-25 11:00:00
118,2,0,2,0.002888044422803348,2019-03-25 10:45:00,2019-03-25 11:00:00
119,3,2,1,0.010851268326809396,2019-03-25 10:45:00,2019-03-25 11:00:00
120,2,1,1,0.009126805542064768,2019-03-25 10:45:00,2019-03-25 11:00:00
126,4,3,1,0.005343072348256235,2019-03-25 10:45:00,2019-03-25 11:00:00
127,3,0,3,0.002888044422803348,2019-03-25 10:45:00,2019-03-25 11:00:00
137,10,7,3,0.02105795318844445,2019-03-25 10:45:00,2019-03-25 11:00:00
138,4,2,2,0.016885699763204063,2019-03-25 10:45:00,2019-03-25 11:00:00
140,2,2,0,0.012070277428931821,2019-03-25 10:45:00,2019-03-25 11:00:00
141,1,1,0,0.004329989907338737,2019-03-25 10:45:00,2019-03-25 11:00:00
147,1,1,0,0.004115558385529792,2019-03-25 10:45:00,2019-03-25 11:00:00
153,4,4,0,0.009933080209787695,2019-03-25 10:45:00,2019-03-25 11:00:00
154,2,1,1,0.005343072348256235,2019-03-25 10:45:00,2019-03-25 11:00:00
157,1,1,0,0.01301244717578931,2019-03-25 10:45:00,2019-03-25 11:00:00
158,7,4,3,0.02201598415735798,2019-03-25 10:45:00,2019-03-25 11:00:00
164,5,2,3,0.007455721231691271,2019-03-25 10:45:00,2019-03-25 11:00:00
168,9,4,5,0.015804995781969353,2019-03-25 10:45:00,2019-03-25 11:00:00
169,2,1,1,0.019197784832067688,2019-03-25 10:45:00,2019-03-25 11:00:00
170,9,3,6,0.01235675082593152,2019-03-25 10:45:00,2019-03-25 11:00:00
171,1,1,0,0.005343072348256235,2019-03-25 10:45:00,2019-03-25 11:00:00
173,3,1,2,0.00502302435888192,2019-03-25 10:45:00,2019-03-25 11:00:00
177,3,1,2,0.004515328465631856,2019-03-25 10:45:00,2019-03-25 11:00:00
189,7,2,5,0.009852565861656844,2019-03-25 10:45:00,2019-03-25 11:00:00
190,1,1,0,0.005343072348256235,2019-03-25 10:45:00,2019-03-25 11:00:00
195,4,4,0,0.020516503993834173,2019-03-25 10:45:00,2019-03-25 11:00:00
197,5,2,3,0.0057428424283583,2019-03-25 10:45:00,2019-03-25 11:00:00
201,1,0,1,0.002888044422803348,2019-03-25 10:45:00,2019-03-25 11:00:00
202,1,0,1,0.002888044422803348,2019-03-25 10:45:00,2019-03-25 11:00:00
1,4,1,3,0.00399859080318173,2019-03-25 11:00:00,2019-03-25 11:15:00
2,5,3,2,0.013044487688072781,2019-03-25 11:00:00,2019-03-25 11:15:00
5,2,1,1,0.019063699451852538,2019-03-25 11:00:00,2019-03-25 11:15:00
10,6,2,4,0.014578213107395292,2019-03-25 11:00:00,2019-03-25 11:15:00
15,2,2,0,0.013915686744471294,2019-03-25 11:00:00,2019-03-25 11:15:00
16,2,1,1,0.006336869043440312,2019-03-25 11:00:00,2019-03-25 11:15:00
18,5,2,3,0.012675926216780185,2019-03-25 11:00:00,2019-03-25 11:15:00
19,3,0,3,0.002865540972148347,2019-03-25 11:00:00,2019-03-25 11:15:00
20,1,1,0,0.00596400430914998,2019-03-25 11:00:00,2019-03-25 11:15:00
22,7,4,3,0.039611978388537014,2019-03-25 11:00:00,2019-03-25 11:15:00
23,1,0,1,0.002865540972148347,2019-03-25 11:00:00,2019-03-25 11:15:00
26,3,3,0,0.010271674789770287,2019-03-25 11:00:00,2019-03-25 11:15:00
30,2,1,1,0.019063699451852538,2019-03-25 11:00:00,2019-03-25 11:15:00
37,7,6,1,0.017182307349111338,2019-03-25 11:00:00,2019-03-25 11:15:00
40,1,1,0,0.0056750898573141115,2019-03-25 11:00:00,2019-03-25 11:15:00
46,1,1,0,0.007372260140654643,2019-03-25 11:00:00,2019-03-25 11:15:00
50,1,1,0,0.00596400430914998,2019-03-25 11:00:00,2019-03-25 11:15:00
58,1,1,0,0.0048480148459185135,2019-03-25 11:00:00,2019-03-25 11:15:00
62,3,2,1,0.007737414920303617,2019-03-25 11:00:00,2019-03-25 11:15:00
66,2,1,1,0.019063699451852538,2019-03-25 11:00:00,2019-03-25 11:15:00
67,1,0,1,0.002865540972148347,2019-03-25 11:00:00,2019-03-25 11:15:00
68,1,0,1,0.002865540972148347,2019-03-25 11:00:00,2019-03-25 11:15:00
69,3,2,1,0.005819173494833147,2019-03-25 11:00:00,2019-03-25 11:15:00
85,3,2,1,0.009244919993884205,2019-03-25 11:00:00,2019-03-25 11:15:00
87,5,2,3,0.005698165549731805,2019-03-25 11:00:00,2019-03-25 11:15:00
88,4,2,2,0.006065983332957331,2019-03-25 11:00:00,2019-03-25 11:15:00
90,9,5,4,0.013219264293052521,2019-03-25 11:00:00,2019-03-25 11:15:00
101,2,1,1,0.019063699451852538,2019-03-25 11:00:00,2019-03-25 11:15:00
109,4,1,3,0.004339473981093262,2019-03-25 11:00:00,2019-03-25 11:15:00
110,1,0,1,0.002865540972148347,2019-03-25 11:00:00,2019-03-25 11:15:00
111,3,1,2,0.004083509459187165,2019-03-25 11:00:00,2019-03-25 11:15:00
112,2,1,1,0.004083509459187165,2019-03-25 11:00:00,2019-03-25 11:15:00
113,3,2,1,0.005301477946225982,2019-03-25 11:00:00,2019-03-25 11:15:00
114,1,1,0,0.004083509459187165,2019-03-25 11:00:00,2019-03-25 11:15:00
115,4,2,2,0.014628422893075928,2019-03-25 11:00:00,2019-03-25 11:15:00
118,2,0,2,0.002865540972148347,2019-03-25 11:00:00,2019-03-25 11:15:00
119,2,2,0,0.008846193149599559,2019-03-25 11:00:00,2019-03-25 11:15:00
120,3,0,3,0.002865540972148347,2019-03-25 11:00:00,2019-03-25 11:15:00
126,3,3,0,0.006349609121253931,2019-03-25 11:00:00,2019-03-25 11:15:00
127,2,0,2,0.002865540972148347,2019-03-25 11:00:00,2019-03-25 11:15:00
133,1,0,1,0.002865540972148347,2019-03-25 11:00:00,2019-03-25 11:15:00
137,8,4,4,0.00932797970494049,2019-03-25 11:00:00,2019-03-25 11:15:00
138,7,3,4,0.006541739400088129,2019-03-25 11:00:00,2019-03-25 11:15:00
140,2,0,2,0.002865540972148347,2019-03-25 11:00:00,2019-03-25 11:15:00
141,1,1,0,0.0054439007755247674,2019-03-25 11:00:00,2019-03-25 11:15:00
147,1,1,0,0.004083509459187165,2019-03-25 11:00:00,2019-03-25 11:15:00
153,4,4,0,0.010846183146702,2019-03-25 11:00:00,2019-03-25 11:15:00
154,1,0,1,0.002865540972148347,2019-03-25 11:00:00,2019-03-25 11:15:00
157,1,0,1,0.002865540972148347,2019-03-25 11:00:00,2019-03-25 11:15:00
158,9,4,5,0.0086691267219712,2019-03-25 11:00:00,2019-03-25 11:15:00
162,1,0,1,0.002865540972148347,2019-03-25 11:00:00,2019-03-25 11:15:00
164,7,3,4,0.005701115814961324,2019-03-25 11:00:00,2019-03-25 11:15:00
168,5,2,3,0.013915686744471294,2019-03-25 11:00:00,2019-03-25 11:15:00
169,4,3,1,0.03754001603708983,2019-03-25 11:00:00,2019-03-25 11:15:00
170,6,2,4,0.005177498392031559,2019-03-25 11:00:00,2019-03-25 11:15:00
171,2,1,1,0.005301477946225982,2019-03-25 11:00:00,2019-03-25 11:15:00
172,1,1,0,0.005301477946225982,2019-03-25 11:00:00,2019-03-25 11:15:00
173,1,0,1,0.002865540972148347,2019-03-25 11:00:00,2019-03-25 11:15:00
177,2,0,2,0.002865540972148347,2019-03-25 11:00:00,2019-03-25 11:15:00
189,9,6,3,0.03039788904531236,2019-03-25 11:00:00,2019-03-25 11:15:00
190,1,1,0,0.009443042335083304,2019-03-25 11:00:00,2019-03-25 11:15:00
191,1,0,1,0.002865540972148347,2019-03-25 11:00:00,2019-03-25 11:15:00
195,4,3,1,0.044500016224175376,2019-03-25 11:00:00,2019-03-25 11:15:00
197,2,0,2,0.002865540972148347,2019-03-25 11:00:00,2019-03-25 11:15:00
201,1,0,1,0.002865540972148347,2019-03-25 11:00:00,2019-03-25 11:15:00
202,2,0,2,0.002865540972148347,2019-03-25 11:00:00,2019-03-25 11:15:00
203,1,1,0,0.010724875224785872,2019-03-25 11:00:00,2019-03-25 11:15:00
1,2,0,2,0.002824294971013698,2019-03-25 11:15:00,2019-03-25 11:30:00
2,3,1,2,0.0045252281245651265,2019-03-25 11:15:00,2019-03-25 11:30:00
5,2,1,1,0.018794813318145382,2019-03-25 11:15:00,2019-03-25 11:30:00
10,3,0,3,0.002824294971013698,2019-03-25 11:15:00,2019-03-25 11:30:00
16,1,1,0,0.005225153274883425,2019-03-25 11:15:00,2019-03-25 11:30:00
18,3,2,1,0.008192198625610082,2019-03-25 11:15:00,2019-03-25 11:30:00
19,1,1,0,0.01122916721523339,2019-03-25 11:15:00,2019-03-25 11:30:00
20,1,1,0,0.003624581072303607,2019-03-25 11:15:00,2019-03-25 11:30:00
22,7,4,3,0.024118319433855933,2019-03-25 11:15:00,2019-03-25 11:30:00
23,1,0,1,0.002824294971013698,2019-03-25 11:15:00,2019-03-25 11:30:00
26,4,3,1,0.01645963878526445,2019-03-25 11:15:00,2019-03-25 11:30:00
30,2,1,1,0.018794813318145382,2019-03-25 11:15:00,2019-03-25 11:30:00
37,7,4,3,0.013543499399649819,2019-03-25 11:15:00,2019-03-25 11:30:00
41,2,2,0,0.0051051823805518416,2019-03-25 11:15:00,2019-03-25 11:30:00
46,1,1,0,0.005225153274883425,2019-03-25 11:15:00,2019-03-25 11:30:00
50,1,1,0,0.003624581072303607,2019-03-25 11:15:00,2019-03-25 11:30:00
58,4,3,1,0.009886512437137465,2019-03-25 11:15:00,2019-03-25 11:30:00
62,3,1,2,0.017121181284833066,2019-03-25 11:15:00,2019-03-25 11:30:00
66,3,1,2,0.004912193726070687,2019-03-25 11:15:00,2019-03-25 11:30:00
67,2,1,1,0.004912193726070687,2019-03-25 11:15:00,2019-03-25 11:30:00
68,1,0,1,0.002824294971013698,2019-03-25 11:15:00,2019-03-25 11:30:00
69,3,2,1,0.0063844716581313386,2019-03-25 11:15:00,2019-03-25 11:30:00
85,1,0,1,0.002824294971013698,2019-03-25 11:15:00,2019-03-25 11:30:00
88,1,1,0,0.006662207044305833,2019-03-25 11:15:00,2019-03-25 11:30:00
89,1,1,0,0.0045252281245651265,2019-03-25 11:15:00,2019-03-25 11:30:00
90,4,2,2,0.007716260380457476,2019-03-25 11:15:00,2019-03-25 11:30:00
101,2,1,1,0.018794813318145382,2019-03-25 11:15:00,2019-03-25 11:30:00
104,2,1,1,0.018794813318145382,2019-03-25 11:15:00,2019-03-25 11:30:00
109,4,2,2,0.00965498984645198,2019-03-25 11:15:00,2019-03-25 11:30:00
110,1,1,0,0.005454806424835263,2019-03-25 11:15:00,2019-03-25 11:30:00
111,5,1,4,0.005454806424835263,2019-03-25 11:15:00,2019-03-25 11:30:00
112,1,0,1,0.002824294971013698,2019-03-25 11:15:00,2019-03-25 11:30:00
113,2,2,0,0.005225153274883425,2019-03-25 11:15:00,2019-03-25 11:30:00
114,2,2,0,0.006341882848327003,2019-03-25 11:15:00,2019-03-25 11:30:00
115,3,1,2,0.004912193726070687,2019-03-25 11:15:00,2019-03-25 11:30:00
116,2,2,0,0.0063655969796524966,2019-03-25 11:15:00,2019-03-25 11:30:00
118,1,0,1,0.002824294971013698,2019-03-25 11:15:00,2019-03-25 11:30:00
119,5,2,3,0.009282527825799402,2019-03-25 11:15:00,2019-03-25 11:30:00
120,5,1,4,0.016443939305382252,2019-03-25 11:15:00,2019-03-25 11:30:00
126,6,5,1,0.016020584119752324,2019-03-25 11:15:00,2019-03-25 11:30:00
127,1,0,1,0.002824294971013698,2019-03-25 11:15:00,2019-03-25 11:30:00
133,2,1,1,0.006662207044305833,2019-03-25 11:15:00,2019-03-25 11:30:00
137,9,3,6,0.012004258493827597,2019-03-25 11:15:00,2019-03-25 11:30:00
138,4,2,2,0.007519671861544643,2019-03-25 11:15:00,2019-03-25 11:30:00
140,2,0,2,0.002824294971013698,2019-03-25 11:15:00,2019-03-25 11:30:00
147,2,0,2,0.002824294971013698,2019-03-25 11:15:00,2019-03-25 11:30:00
153,3,2,1,0.00667128945578841,2019-03-25 11:15:00,2019-03-25 11:30:00
157,3,1,2,0.009788715249754196,2019-03-25 11:15:00,2019-03-25 11:30:00
158,4,2,2,0.006971210829287016,2019-03-25 11:15:00,2019-03-25 11:30:00
162,2,1,1,0.016817070887013633,2019-03-25 11:15:00,2019-03-25 11:30:00
164,9,5,4,0.015407553249197858,2019-03-25 11:15:00,2019-03-25 11:30:00
168,1,1,0,0.006985150131651174,2019-03-25 11:15:00,2019-03-25 11:30:00
169,6,5,1,0.08381853767476685,2019-03-25 11:15:00,2019-03-25 11:30:00
170,7,3,4,0.011508288826421378,2019-03-25 11:15:00,2019-03-25 11:30:00
171,1,0,1,0.002824294971013698,2019-03-25 11:15:00,2019-03-25 11:30:00
172,1,0,1,0.002824294971013698,2019-03-25 11:15:00,2019-03-25 11:30:00
175,2,1,1,0.018794813318145382,2019-03-25 11:15:00,2019-03-25 11:30:00
177,2,0,2,0.002824294971013698,2019-03-25 11:15:00,2019-03-25 11:30:00
189,1,1,0,0.008487989990951123,2019-03-25 11:15:00,2019-03-25 11:30:00
190,1,1,0,0.01010213793856929,2019-03-25 11:15:00,2019-03-25 11:30:00
191,4,1,3,0.004024724122948561,2019-03-25 11:15:00,2019-03-25 11:30:00
195,1,1,0,0.007000092481127676,2019-03-25 11:15:00,2019-03-25 11:30:00
197,4,1,3,0.003941024544457277,2019-03-25 11:15:00,2019-03-25 11:30:00
203,1,1,0,0.005225153274883425,2019-03-25 11:15:00,2019-03-25 11:30:00
1,1,0,1,0.0030815822773859053,2019-03-25 11:30:00,2019-03-25 11:45:00
2,2,0,2,0.0030815822773859053,2019-03-25 11:30:00,2019-03-25 11:45:00
5,2,1,1,0.02043310622225892,2019-03-25 11:30:00,2019-03-25 11:45:00
10,5,0,5,0.0030815822773859053,2019-03-25 11:30:00,2019-03-25 11:45:00
16,3,2,1,0.005701179139075117,2019-03-25 11:30:00,2019-03-25 11:45:00
18,5,3,2,0.008690956348897336,2019-03-25 11:30:00,2019-03-25 11:45:00
20,2,2,0,0.007468933724506258,2019-03-25 11:30:00,2019-03-25 11:45:00
22,3,2,1,0.02390341101123352,2019-03-25 11:30:00,2019-03-25 11:45:00
23,2,0,2,0.0030815822773859053,2019-03-25 11:30:00,2019-03-25 11:45:00
26,3,1,2,0.0038754517011903066,2019-03-25 11:30:00,2019-03-25 11:45:00
30,7,2,5,0.004669321124994708,2019-03-25 11:30:00,2019-03-25 11:45:00
37,3,1,2,0.005359718401630381,2019-03-25 11:30:00,2019-03-25 11:45:00
40,3,1,2,0.003753962521537205,2019-03-25 11:30:00,2019-03-25 11:45:00
41,1,0,1,0.0030815822773859053,2019-03-25 11:30:00,2019-03-25 11:45:00
46,1,1,0,0.004391380708230511,2019-03-25 11:30:00,2019-03-25 11:45:00
57,1,1,0,0.006737013501275896,2019-03-25 11:30:00,2019-03-25 11:45:00
58,4,2,2,0.008163491426798413,2019-03-25 11:30:00,2019-03-25 11:45:00
62,1,0,1,0.0030815822773859053,2019-03-25 11:30:00,2019-03-25 11:45:00
66,4,2,2,0.013789341423718815,2019-03-25 11:30:00,2019-03-25 11:45:00
67,3,1,2,0.008942831484827746,2019-03-25 11:30:00,2019-03-25 11:45:00
68,4,3,1,0.006363767380130915,2019-03-25 11:30:00,2019-03-25 11:45:00
69,1,1,0,0.003753962521537205,2019-03-25 11:30:00,2019-03-25 11:45:00
74,4,2,2,0.011971478890576382,2019-03-25 11:30:00,2019-03-25 11:45:00
87,1,0,1,0.0030815822773859053,2019-03-25 11:30:00,2019-03-25 11:45:00
88,4,3,1,0.007627692908881057,2019-03-25 11:30:00,2019-03-25 11:45:00
89,1,1,0,0.0037441705184417034,2019-03-25 11:30:00,2019-03-25 11:45:00
90,4,1,3,0.005701179139075117,2019-03-25 11:30:00,2019-03-25 11:45:00
101,2,1,1,0.02043310622225892,2019-03-25 11:30:00,2019-03-25 11:45:00
109,2,2,0,0.012215891221882899,2019-03-25 11:30:00,2019-03-25 11:45:00
110,3,3,0,0.012054566200435393,2019-03-25 11:30:00,2019-03-25 11:45:00
111,6,1,5,0.003954781231282309,2019-03-25 11:30:00,2019-03-25 11:45:00
112,2,0,2,0.0030815822773859053,2019-03-25 11:30:00,2019-03-25 11:45:00
113,2,2,0,0.005701179139075117,2019-03-25 11:30:00,2019-03-25 11:45:00
114,1,1,0,0.008491368740803308,2019-03-25 11:30:00,2019-03-25 11:45:00
115,2,1,1,0.02043310622225892,2019-03-25 11:30:00,2019-03-25 11:45:00
116,3,2,1,0.016504214649159934,2019-03-25 11:30:00,2019-03-25 11:45:00
118,2,0,2,0.0030815822773859053,2019-03-25 11:30:00,2019-03-25 11:45:00
119,3,0,3,0.0030815822773859053,2019-03-25 11:30:00,2019-03-25 11:45:00
120,3,2,1,0.011910186339763814,2019-03-25 11:30:00,2019-03-25 11:45:00
126,4,3,1,0.00884469537310217,2019-03-25 11:30:00,2019-03-25 11:45:00
127,1,0,1,0.0030815822773859053,2019-03-25 11:30:00,2019-03-25 11:45:00
137,11,3,8,0.00623541519064158,2019-03-25 11:30:00,2019-03-25 11:45:00
138,7,5,2,0.031789556730198364,2019-03-25 11:30:00,2019-03-25 11:45:00
140,4,1,3,0.004300059352015903,2019-03-25 11:30:00,2019-03-25 11:45:00
141,1,1,0,0.0037441705184417034,2019-03-25 11:30:00,2019-03-25 11:45:00
147,2,0,2,0.0030815822773859053,2019-03-25 11:30:00,2019-03-25 11:45:00
153,6,5,1,0.00884469537310217,2019-03-25 11:30:00,2019-03-25 11:45:00
157,1,1,0,0.006775713466434911,2019-03-25 11:30:00,2019-03-25 11:45:00
158,8,5,3,0.013633715534066072,2019-03-25 11:30:00,2019-03-25 11:45:00
162,1,1,0,0.0047288182725637095,2019-03-25 11:30:00,2019-03-25 11:45:00
164,9,4,5,0.006706976725047775,2019-03-25 11:30:00,2019-03-25 11:45:00
168,3,3,0,0.028603267950339614,2019-03-25 11:30:00,2019-03-25 11:45:00
169,8,5,3,0.04386129667956065,2019-03-25 11:30:00,2019-03-25 11:45:00
170,5,2,3,0.005891292767802595,2019-03-25 11:30:00,2019-03-25 11:45:00
175,2,1,1,0.02043310622225892,2019-03-25 11:30:00,2019-03-25 11:45:00
177,2,0,2,0.0030815822773859053,2019-03-25 11:30:00,2019-03-25 11:45:00
189,2,1,1,0.004750975788122959,2019-03-25 11:30:00,2019-03-25 11:45:00
190,2,1,1,0.005701179139075117,2019-03-25 11:30:00,2019-03-25 11:45:00
191,4,3,1,0.01270784203333148,2019-03-25 11:30:00,2019-03-25 11:45:00
195,2,2,0,0.011971478890576382,2019-03-25 11:30:00,2019-03-25 11:45:00
196,1,1,0,0.0038754517011903066,2019-03-25 11:30:00,2019-03-25 11:45:00
197,1,1,0,0.007120360455752125,2019-03-25 11:30:00,2019-03-25 11:45:00
199,1,1,0,0.0038754517011903066,2019-03-25 11:30:00,2019-03-25 11:45:00
201,2,1,1,0.004300059352015903,2019-03-25 11:30:00,2019-03-25 11:45:00
203,2,0,2,0.0030815822773859053,2019-03-25 11:30:00,2019-03-25 11:45:00
2,2,0,2,0.0030368686634395102,2019-03-25 11:45:00,2019-03-25 12:00:00
5,2,1,1,0.020216649086422973,2019-03-25 11:45:00,2019-03-25 12:00:00
10,6,1,5,0.007677735856415962,2019-03-25 11:45:00,2019-03-25 12:00:00
16,2,2,0,0.00561845151198141,2019-03-25 11:45:00,2019-03-25 12:00:00
18,6,2,4,0.005514224248678541,2019-03-25 11:45:00,2019-03-25 12:00:00
20,4,2,2,0.010917896835504995,2019-03-25 11:45:00,2019-03-25 12:00:00
22,3,2,1,0.028893097135846136,2019-03-25 11:45:00,2019-03-25 12:00:00
23,1,1,0,0.00432766008771046,2019-03-25 11:45:00,2019-03-25 12:00:00
26,2,1,1,0.004237666637197253,2019-03-25 11:45:00,2019-03-25 12:00:00
30,4,1,3,0.004237666637197253,2019-03-25 11:45:00,2019-03-25 12:00:00
37,2,1,1,0.020216649086422973,2019-03-25 11:45:00,2019-03-25 12:00:00
40,2,0,2,0.0030368686634395102,2019-03-25 11:45:00,2019-03-25 12:00:00
57,2,2,0,0.008984985968115759,2019-03-25 11:45:00,2019-03-25 12:00:00
58,2,1,1,0.004208799538009818,2019-03-25 11:45:00,2019-03-25 12:00:00
66,2,1,1,0.020216649086422973,2019-03-25 11:45:00,2019-03-25 12:00:00
67,2,0,2,0.0030368686634395102,2019-03-25 11:45:00,2019-03-25 12:00:00
68,4,3,1,0.0071581989402617315,2019-03-25 11:45:00,2019-03-25 12:00:00
74,3,2,1,0.028806539297914706,2019-03-25 11:45:00,2019-03-25 12:00:00
87,1,0,1,0.0030368686634395102,2019-03-25 11:45:00,2019-03-25 12:00:00
88,4,3,1,0.04020220476119206,2019-03-25 11:45:00,2019-03-25 12:00:00
90,4,2,2,0.009772146002784374,2019-03-25 11:45:00,2019-03-25 12:00:00
101,2,1,1,0.020216649086422973,2019-03-25 11:45:00,2019-03-25 12:00:00
109,2,2,0,0.011763767406990954,2019-03-25 11:45:00,2019-03-25 12:00:00
110,2,1,1,0.037221703677403975,2019-03-25 11:45:00,2019-03-25 12:00:00
111,2,1,1,0.005023148927342366,2019-03-25 11:45:00,2019-03-25 12:00:00
112,2,0,2,0.0030368686634395102,2019-03-25 11:45:00,2019-03-25 12:00:00
114,2,2,0,0.010412929847722617,2019-03-25 11:45:00,2019-03-25 12:00:00
115,5,2,3,0.007009429191245222,2019-03-25 11:45:00,2019-03-25 12:00:00
116,1,0,1,0.0030368686634395102,2019-03-25 11:45:00,2019-03-25 12:00:00
118,2,0,2,0.0030368686634395102,2019-03-25 11:45:00,2019-03-25 12:00:00
119,1,1,0,0.004576616091719832,2019-03-25 11:45:00,2019-03-25 12:00:00
120,3,2,1,0.010407168489679354,2019-03-25 11:45:00,2019-03-25 12:00:00
126,3,2,1,0.005633084798379184,2019-03-25 11:45:00,2019-03-25 12:00:00
127,2,0,2,0.0030368686634395102,2019-03-25 11:45:00,2019-03-25 12:00:00
137,7,2,5,0.009055677516729851,2019-03-25 11:45:00,2019-03-25 12:00:00
138,4,4,0,0.01935886088511067,2019-03-25 11:45:00,2019-03-25 12:00:00
140,1,0,1,0.0030368686634395102,2019-03-25 11:45:00,2019-03-25 12:00:00
141,1,1,0,0.004576616091719832,2019-03-25 11:45:00,2019-03-25 12:00:00
147,2,0,2,0.0030368686634395102,2019-03-25 11:45:00,2019-03-25 12:00:00
153,8,5,3,0.016137947668375067,2019-03-25 11:45:00,2019-03-25 12:00:00
158,4,3,1,0.007734827230192996,2019-03-25 11:45:00,2019-03-25 12:00:00
164,5,2,3,0.010619477342833162,2019-03-25 11:45:00,2019-03-25 12:00:00
168,5,4,1,0.04642508588906162,2019-03-25 11:45:00,2019-03-25 12:00:00
169,4,1,3,0.004237666637197253,2019-03-25 11:45:00,2019-03-25 12:00:00
170,5,2,3,0.007009429191245222,2019-03-25 11:45:00,2019-03-25 12:00:00
189,1,0,1,0.0030368686634395102,2019-03-25 11:45:00,2019-03-25 12:00:00
191,3,3,0,0.010487134096159569,2019-03-25 11:45:00,2019-03-25 12:00:00
195,1,1,0,0.00432766008771046,2019-03-25 11:45:00,2019-03-25 12:00:00
196,1,0,1,0.0030368686634395102,2019-03-25 11:45:00,2019-03-25 12:00:00
197,1,1,0,0.00561845151198141,2019-03-25 11:45:00,2019-03-25 12:00:00
199,1,1,0,0.004237666637197253,2019-03-25 11:45:00,2019-03-25 12:00:00
201,2,1,1,0.00561845151198141,2019-03-25 11:45:00,2019-03-25 12:00:00
203,1,0,1,0.0030368686634395102,2019-03-25 11:45:00,2019-03-25 12:00:00
5,2,1,1,0.02275143377684955,2019-03-25 12:00:00,2019-03-25 12:15:00
10,1,0,1,0.0034233872010647117,2019-03-25 12:00:00,2019-03-25 12:15:00
16,3,3,0,0.014422923344141934,2019-03-25 12:00:00,2019-03-25 12:15:00
18,5,2,3,0.008308599874458556,2019-03-25 12:00:00,2019-03-25 12:15:00
19,2,1,1,0.00814583364445469,2019-03-25 12:00:00,2019-03-25 12:15:00
20,2,1,1,0.0063335422929090505,2019-03-25 12:00:00,2019-03-25 12:15:00
23,4,3,1,0.00924369738475339,2019-03-25 12:00:00,2019-03-25 12:15:00
30,2,1,1,0.004878464746986881,2019-03-25 12:00:00,2019-03-25 12:15:00
40,1,0,1,0.0034233872010647117,2019-03-25 12:00:00,2019-03-25 12:15:00
57,3,3,0,0.01231164059034085,2019-03-25 12:00:00,2019-03-25 12:15:00
58,2,2,0,0.012702598006591166,2019-03-25 12:00:00,2019-03-25 12:15:00
66,3,1,2,0.005954209564731748,2019-03-25 12:00:00,2019-03-25 12:15:00
67,2,0,2,0.0034233872010647117,2019-03-25 12:00:00,2019-03-25 12:15:00
68,2,2,0,0.0063335422929090505,2019-03-25 12:00:00,2019-03-25 12:15:00
74,2,1,1,0.02275143377684955,2019-03-25 12:00:00,2019-03-25 12:15:00
85,5,2,3,0.007901467491234809,2019-03-25 12:00:00,2019-03-25 12:15:00
88,5,3,2,0.019031042809704943,2019-03-25 12:00:00,2019-03-25 12:15:00
90,2,1,1,0.02275143377684955,2019-03-25 12:00:00,2019-03-25 12:15:00
101,2,1,1,0.02275143377684955,2019-03-25 12:00:00,2019-03-25 12:15:00
109,1,1,0,0.00814583364445469,2019-03-25 12:00:00,2019-03-25 12:15:00
110,2,1,1,0.011512768252297596,2019-03-25 12:00:00,2019-03-25 12:15:00
111,1,0,1,0.0034233872010647117,2019-03-25 12:00:00,2019-03-25 12:15:00
112,2,0,2,0.0034233872010647117,2019-03-25 12:00:00,2019-03-25 12:15:00
114,2,1,1,0.0063335422929090505,2019-03-25 12:00:00,2019-03-25 12:15:00
115,3,2,1,0.04207948035263439,2019-03-25 12:00:00,2019-03-25 12:15:00
116,2,0,2,0.0034233872010647117,2019-03-25 12:00:00,2019-03-25 12:15:00
118,2,0,2,0.0034233872010647117,2019-03-25 12:00:00,2019-03-25 12:15:00
119,1,1,0,0.006690318740839377,2019-03-25 12:00:00,2019-03-25 12:15:00
120,1,0,1,0.0034233872010647117,2019-03-25 12:00:00,2019-03-25 12:15:00
126,1,1,0,0.00880745722151807,2019-03-25 12:00:00,2019-03-25 12:15:00
127,1,0,1,0.0034233872010647117,2019-03-25 12:00:00,2019-03-25 12:15:00
137,8,4,4,0.015371469023169174,2019-03-25 12:00:00,2019-03-25 12:15:00
138,2,2,0,0.0104806548490579,2019-03-25 12:00:00,2019-03-25 12:15:00
147,1,0,1,0.0034233872010647117,2019-03-25 12:00:00,2019-03-25 12:15:00
153,5,2,3,0.016665442170580448,2019-03-25 12:00:00,2019-03-25 12:15:00
158,1,1,0,0.00468879838289823,2019-03-25 12:00:00,2019-03-25 12:15:00
164,5,2,3,0.011366888713077063,2019-03-25 12:00:00,2019-03-25 12:15:00
169,2,1,1,0.02275143377684955,2019-03-25 12:00:00,2019-03-25 12:15:00
170,6,2,4,0.005954209564731748,2019-03-25 12:00:00,2019-03-25 12:15:00
189,2,1,1,0.00468879838289823,2019-03-25 12:00:00,2019-03-25 12:15:00
191,2,2,0,0.012632144484547633,2019-03-25 12:00:00,2019-03-25 12:15:00
195,2,1,1,0.004878464746986881,2019-03-25 12:00:00,2019-03-25 12:15:00
196,1,0,1,0.0034233872010647117,2019-03-25 12:00:00,2019-03-25 12:15:00
197,2,1,1,0.007409287110653917,2019-03-25 12:00:00,2019-03-25 12:15:00
199,1,1,0,0.00757049975721356,2019-03-25 12:00:00,2019-03-25 12:15:00
202,1,0,1,0.0034233872010647117,2019-03-25 12:00:00,2019-03-25 12:15:00
5,2,1,1,0.025230074601873976,2019-03-25 12:15:00,2019-03-25 12:30:00
10,1,0,1,0.003795613945742886,2019-03-25 12:15:00,2019-03-25 12:30:00
15,2,2,0,0.014184612455292647,2019-03-25 12:15:00,2019-03-25 12:30:00
16,2,1,1,0.007022234627231027,2019-03-25 12:15:00,2019-03-25 12:30:00
18,1,1,0,0.006601694066683995,2019-03-25 12:15:00,2019-03-25 12:30:00
19,2,1,1,0.0046022691161149215,2019-03-25 12:15:00,2019-03-25 12:30:00
20,1,1,0,0.007022234627231027,2019-03-25 12:15:00,2019-03-25 12:30:00
30,1,1,0,0.005408924286486956,2019-03-25 12:15:00,2019-03-25 12:30:00
57,2,2,0,0.011030705208442973,2019-03-25 12:15:00,2019-03-25 12:30:00
58,1,1,0,0.007707981468825138,2019-03-25 12:15:00,2019-03-25 12:30:00
66,3,1,2,0.006601694066683995,2019-03-25 12:15:00,2019-03-25 12:30:00
67,2,0,2,0.003795613945742886,2019-03-25 12:15:00,2019-03-25 12:30:00
68,2,2,0,0.007022234627231027,2019-03-25 12:15:00,2019-03-25 12:30:00
74,2,1,1,0.025230074601873976,2019-03-25 12:15:00,2019-03-25 12:30:00
85,3,0,3,0.003795613945742886,2019-03-25 12:15:00,2019-03-25 12:30:00
88,1,0,1,0.003795613945742886,2019-03-25 12:15:00,2019-03-25 12:30:00
90,3,2,1,0.04666453525800507,2019-03-25 12:15:00,2019-03-25 12:30:00
101,2,1,1,0.025230074601873976,2019-03-25 12:15:00,2019-03-25 12:30:00
109,3,3,0,0.006753349570440348,2019-03-25 12:15:00,2019-03-25 12:30:00
110,1,0,1,0.003795613945742886,2019-03-25 12:15:00,2019-03-25 12:30:00
115,2,1,1,0.025230074601873976,2019-03-25 12:15:00,2019-03-25 12:30:00
118,2,0,2,0.003795613945742886,2019-03-25 12:15:00,2019-03-25 12:30:00
120,1,0,1,0.003795613945742886,2019-03-25 12:15:00,2019-03-25 12:30:00
127,1,1,0,0.0046022691161149215,2019-03-25 12:15:00,2019-03-25 12:30:00
137,5,3,2,0.008510779674655923,2019-03-25 12:15:00,2019-03-25 12:30:00
138,2,2,0,0.011620348991907389,2019-03-25 12:15:00,2019-03-25 12:30:00
153,4,0,4,0.003795613945742886,2019-03-25 12:15:00,2019-03-25 12:30:00
158,2,1,1,0.005198654006213441,2019-03-25 12:15:00,2019-03-25 12:30:00
164,5,2,3,0.006422081866990083,2019-03-25 12:15:00,2019-03-25 12:30:00
169,2,1,1,0.025230074601873976,2019-03-25 12:15:00,2019-03-25 12:30:00
170,6,2,4,0.006601694066683995,2019-03-25 12:15:00,2019-03-25 12:30:00
189,1,1,0,0.005198654006213441,2019-03-25 12:15:00,2019-03-25 12:30:00
191,2,2,0,0.010248855308719168,2019-03-25 12:15:00,2019-03-25 12:30:00
195,2,1,1,0.005408924286486956,2019-03-25 12:15:00,2019-03-25 12:30:00
196,1,0,1,0.003795613945742886,2019-03-25 12:15:00,2019-03-25 12:30:00
197,1,0,1,0.003795613945742886,2019-03-25 12:15:00,2019-03-25 12:30:00
5,2,1,1,0.02721243164228663,2019-03-25 12:30:00,2019-03-25 12:45:00
16,1,1,0,0.007579145087087888,2019-03-25 12:30:00,2019-03-25 12:45:00
23,1,1,0,0.005152023000836297,2019-03-25 12:30:00,2019-03-25 12:45:00
66,2,1,1,0.02721243164228663,2019-03-25 12:30:00,2019-03-25 12:45:00
67,1,0,1,0.004096648415305245,2019-03-25 12:30:00,2019-03-25 12:45:00
68,2,2,0,0.007579145087087888,2019-03-25 12:30:00,2019-03-25 12:45:00
88,2,2,0,0.008476333215024195,2019-03-25 12:30:00,2019-03-25 12:45:00
90,1,1,0,0.005837896751196566,2019-03-25 12:30:00,2019-03-25 12:45:00
101,2,1,1,0.02721243164228663,2019-03-25 12:30:00,2019-03-25 12:45:00
110,1,1,0,0.010333246327587475,2019-03-25 12:30:00,2019-03-25 12:45:00
111,1,0,1,0.004096648415305245,2019-03-25 12:30:00,2019-03-25 12:45:00
115,2,1,1,0.02721243164228663,2019-03-25 12:30:00,2019-03-25 12:45:00
118,2,0,2,0.004096648415305245,2019-03-25 12:30:00,2019-03-25 12:45:00
120,1,0,1,0.004096648415305245,2019-03-25 12:30:00,2019-03-25 12:45:00
127,1,1,0,0.005837896751196566,2019-03-25 12:30:00,2019-03-25 12:45:00
137,3,2,1,0.007336346609993536,2019-03-25 12:30:00,2019-03-25 12:45:00
138,2,2,0,0.014022117524003667,2019-03-25 12:30:00,2019-03-25 12:45:00
153,2,0,2,0.004096648415305245,2019-03-25 12:30:00,2019-03-25 12:45:00
158,1,1,0,0.005152023000836297,2019-03-25 12:30:00,2019-03-25 12:45:00
164,4,1,3,0.005716497512649391,2019-03-25 12:30:00,2019-03-25 12:45:00
169,2,1,1,0.02721243164228663,2019-03-25 12:30:00,2019-03-25 12:45:00
170,7,2,5,0.006207397586367348,2019-03-25 12:30:00,2019-03-25 12:45:00
189,3,1,2,0.005152023000836297,2019-03-25 12:30:00,2019-03-25 12:45:00
195,2,1,1,0.007579145087087888,2019-03-25 12:30:00,2019-03-25 12:45:00
2,3,1,2,0.00663309807460951,2019-03-25 12:45:00,2019-03-25 13:00:00
5,2,1,1,0.025340347070607446,2019-03-25 12:45:00,2019-03-25 13:00:00
10,1,0,1,0.0038136917194619806,2019-03-25 12:45:00,2019-03-25 13:00:00
15,1,0,1,0.0038136917194619806,2019-03-25 12:45:00,2019-03-25 13:00:00
16,2,2,0,0.00665384360332546,2019-03-25 12:45:00,2019-03-25 13:00:00
18,1,1,0,0.007055660465084091,2019-03-25 12:45:00,2019-03-25 13:00:00
19,2,2,0,0.005975004216543387,2019-03-25 12:45:00,2019-03-25 13:00:00
23,1,1,0,0.004842924382406598,2019-03-25 12:45:00,2019-03-25 13:00:00
26,1,1,0,0.007055660465084091,2019-03-25 12:45:00,2019-03-25 13:00:00
37,2,1,1,0.007974331423280013,2019-03-25 12:45:00,2019-03-25 13:00:00
40,1,1,0,0.0048943479680026835,2019-03-25 12:45:00,2019-03-25 13:00:00
46,1,1,0,0.00663309807460951,2019-03-25 12:45:00,2019-03-25 13:00:00
57,2,1,1,0.0048943479680026835,2019-03-25 12:45:00,2019-03-25 13:00:00
58,1,0,1,0.0038136917194619806,2019-03-25 12:45:00,2019-03-25 13:00:00
62,1,0,1,0.0038136917194619806,2019-03-25 12:45:00,2019-03-25 13:00:00
66,2,1,1,0.025340347070607446,2019-03-25 12:45:00,2019-03-25 13:00:00
67,1,0,1,0.0038136917194619806,2019-03-25 12:45:00,2019-03-25 13:00:00
68,1,0,1,0.0038136917194619806,2019-03-25 12:45:00,2019-03-25 13:00:00
79,1,0,1,0.0038136917194619806,2019-03-25 12:45:00,2019-03-25 13:00:00
85,2,2,0,0.007332682990107535,2019-03-25 12:45:00,2019-03-25 13:00:00
87,2,2,0,0.010297629210706202,2019-03-25 12:45:00,2019-03-25 13:00:00
88,2,2,0,0.010686635245828214,2019-03-25 12:45:00,2019-03-25 13:00:00
90,2,2,0,0.010054651275189029,2019-03-25 12:45:00,2019-03-25 13:00:00
101,2,1,1,0.025340347070607446,2019-03-25 12:45:00,2019-03-25 13:00:00
109,3,0,3,0.0038136917194619806,2019-03-25 12:45:00,2019-03-25 13:00:00
111,3,0,3,0.0038136917194619806,2019-03-25 12:45:00,2019-03-25 13:00:00
115,2,1,1,0.025340347070607446,2019-03-25 12:45:00,2019-03-25 13:00:00
120,1,0,1,0.0038136917194619806,2019-03-25 12:45:00,2019-03-25 13:00:00
126,1,1,0,0.007055660465084091,2019-03-25 12:45:00,2019-03-25 13:00:00
127,1,0,1,0.0038136917194619806,2019-03-25 12:45:00,2019-03-25 13:00:00
133,2,2,0,0.011673316010708461,2019-03-25 12:45:00,2019-03-25 13:00:00
137,9,4,5,0.010348627842471748,2019-03-25 12:45:00,2019-03-25 13:00:00
138,1,1,0,0.007055660465084091,2019-03-25 12:45:00,2019-03-25 13:00:00
153,3,1,2,0.007055660465084091,2019-03-25 12:45:00,2019-03-25 13:00:00
158,1,1,0,0.004842924382406598,2019-03-25 12:45:00,2019-03-25 13:00:00
164,4,1,3,0.0053216641456440865,2019-03-25 12:45:00,2019-03-25 13:00:00
168,1,0,1,0.0038136917194619806,2019-03-25 12:45:00,2019-03-25 13:00:00
169,2,1,1,0.025340347070607446,2019-03-25 12:45:00,2019-03-25 13:00:00
170,5,1,4,0.004842924382406598,2019-03-25 12:45:00,2019-03-25 13:00:00
189,4,2,2,0.008084893128028708,2019-03-25 12:45:00,2019-03-25 13:00:00
190,1,1,0,0.007055660465084091,2019-03-25 12:45:00,2019-03-25 13:00:00
191,1,1,0,0.006812682529566918,2019-03-25 12:45:00,2019-03-25 13:00:00
195,1,1,0,0.007055660465084091,2019-03-25 12:45:00,2019-03-25 13:00:00
201,1,0,1,0.0038136917194619806,2019-03-25 12:45:00,2019-03-25 13:00:00
203,2,1,1,0.025340347070607446,2019-03-25 12:45:00,2019-03-25 13:00:00
1,2,2,0,0.013191561163070693,2019-03-25 13:00:00,2019-03-25 13:15:00
2,3,1,2,0.006703171838632284,2019-03-25 13:00:00,2019-03-25 13:15:00
5,2,1,1,0.025578106265019326,2019-03-25 13:00:00,2019-03-25 13:15:00
10,1,0,1,0.0038539469944170444,2019-03-25 13:00:00,2019-03-25 13:15:00
15,3,0,3,0.0038539469944170444,2019-03-25 13:00:00,2019-03-25 13:15:00
16,1,1,0,0.005809699454011802,2019-03-25 13:00:00,2019-03-25 13:15:00
18,1,1,0,0.007130170688595616,2019-03-25 13:00:00,2019-03-25 13:15:00
19,3,3,0,0.009314319818047999,2019-03-25 13:00:00,2019-03-25 13:15:00
20,1,1,0,0.007130170688595616,2019-03-25 13:00:00,2019-03-25 13:15:00
26,2,1,1,0.007130170688595616,2019-03-25 13:00:00,2019-03-25 13:15:00
37,5,1,4,0.008058559615361118,2019-03-25 13:00:00,2019-03-25 13:15:00
41,1,0,1,0.0038539469944170444,2019-03-25 13:00:00,2019-03-25 13:15:00
46,1,1,0,0.006703171838632284,2019-03-25 13:00:00,2019-03-25 13:15:00
57,2,1,1,0.004946021559143235,2019-03-25 13:00:00,2019-03-25 13:15:00
62,1,0,1,0.0038539469944170444,2019-03-25 13:00:00,2019-03-25 13:15:00
66,2,1,1,0.025578106265019326,2019-03-25 13:00:00,2019-03-25 13:15:00
67,1,0,1,0.0038539469944170444,2019-03-25 13:00:00,2019-03-25 13:15:00
68,1,0,1,0.0038539469944170444,2019-03-25 13:00:00,2019-03-25 13:15:00
79,1,0,1,0.0038539469944170444,2019-03-25 13:00:00,2019-03-25 13:15:00
85,2,2,0,0.007765451913606558,2019-03-25 13:00:00,2019-03-25 13:15:00
86,3,1,2,0.006703171838632284,2019-03-25 13:00:00,2019-03-25 13:15:00
87,2,2,0,0.008222245253321808,2019-03-25 13:00:00,2019-03-25 13:15:00
90,1,1,0,0.007130170688595616,2019-03-25 13:00:00,2019-03-25 13:15:00
101,2,1,1,0.025578106265019326,2019-03-25 13:00:00,2019-03-25 13:15:00
109,3,0,3,0.0038539469944170444,2019-03-25 13:00:00,2019-03-25 13:15:00
111,2,2,0,0.008842833012522228,2019-03-25 13:00:00,2019-03-25 13:15:00
113,1,0,1,0.0038539469944170444,2019-03-25 13:00:00,2019-03-25 13:15:00
115,2,1,1,0.025578106265019326,2019-03-25 13:00:00,2019-03-25 13:15:00
119,1,0,1,0.0038539469944170444,2019-03-25 13:00:00,2019-03-25 13:15:00
120,1,0,1,0.0038539469944170444,2019-03-25 13:00:00,2019-03-25 13:15:00
126,1,0,1,0.0038539469944170444,2019-03-25 13:00:00,2019-03-25 13:15:00
127,1,1,0,0.005566609318343656,2019-03-25 13:00:00,2019-03-25 13:15:00
133,1,1,0,0.005566609318343656,2019-03-25 13:00:00,2019-03-25 13:15:00
135,1,1,0,0.006703171838632284,2019-03-25 13:00:00,2019-03-25 13:15:00
137,5,2,3,0.006901774018737992,2019-03-25 13:00:00,2019-03-25 13:15:00
138,1,1,0,0.007130170688595616,2019-03-25 13:00:00,2019-03-25 13:15:00
153,1,0,1,0.0038539469944170444,2019-03-25 13:00:00,2019-03-25 13:15:00
157,1,0,1,0.0038539469944170444,2019-03-25 13:00:00,2019-03-25 13:15:00
158,1,1,0,0.006241538401446084,2019-03-25 13:00:00,2019-03-25 13:15:00
162,1,1,0,0.007130170688595616,2019-03-25 13:00:00,2019-03-25 13:15:00
164,4,1,3,0.005377860506577519,2019-03-25 13:00:00,2019-03-25 13:15:00
168,1,0,1,0.0038539469944170444,2019-03-25 13:00:00,2019-03-25 13:15:00
169,2,1,1,0.025578106265019326,2019-03-25 13:00:00,2019-03-25 13:15:00
170,6,3,3,0.008425687530898465,2019-03-25 13:00:00,2019-03-25 13:15:00
189,3,3,0,0.011230424419551268,2019-03-25 13:00:00,2019-03-25 13:15:00
190,2,1,1,0.007130170688595616,2019-03-25 13:00:00,2019-03-25 13:15:00
195,1,1,0,0.007130170688595616,2019-03-25 13:00:00,2019-03-25 13:15:00
196,1,1,0,0.009915337468892121,2019-03-25 13:00:00,2019-03-25 13:15:00
2,1,0,1,0.0037745724320848396,2019-03-25 13:15:00,2019-03-25 13:30:00
5,2,1,1,0.025075405209507993,2019-03-25 13:15:00,2019-03-25 13:30:00
10,1,0,1,0.0037745724320848396,2019-03-25 13:15:00,2019-03-25 13:30:00
15,3,1,2,0.009710957217803684,2019-03-25 13:15:00,2019-03-25 13:30:00
18,2,2,0,0.01291964649615224,2019-03-25 13:15:00,2019-03-25 13:30:00
19,3,2,1,0.0069832617104333946,2019-03-25 13:15:00,2019-03-25 13:30:00
20,1,1,0,0.009710957217803686,2019-03-25 13:15:00,2019-03-25 13:30:00
26,1,0,1,0.0037745724320848396,2019-03-25 13:15:00,2019-03-25 13:30:00
37,2,0,2,0.0037745724320848396,2019-03-25 13:15:00,2019-03-25 13:30:00
40,1,0,1,0.0037745724320848396,2019-03-25 13:15:00,2019-03-25 13:30:00
41,2,1,1,0.0069832617104333946,2019-03-25 13:15:00,2019-03-25 13:30:00
46,1,1,0,0.0069832617104333946,2019-03-25 13:15:00,2019-03-25 13:30:00
57,1,1,0,0.0069832617104333946,2019-03-25 13:15:00,2019-03-25 13:30:00
58,1,1,0,0.015908178456804905,2019-03-25 13:15:00,2019-03-25 13:30:00
66,2,1,1,0.025075405209507993,2019-03-25 13:15:00,2019-03-25 13:30:00
67,1,0,1,0.0037745724320848396,2019-03-25 13:15:00,2019-03-25 13:30:00
85,1,0,1,0.0037745724320848396,2019-03-25 13:15:00,2019-03-25 13:30:00
101,2,1,1,0.025075405209507993,2019-03-25 13:15:00,2019-03-25 13:30:00
109,2,0,2,0.0037745724320848396,2019-03-25 13:15:00,2019-03-25 13:30:00
111,3,2,1,0.0069832617104333946,2019-03-25 13:15:00,2019-03-25 13:30:00
115,3,2,1,0.034330601540988714,2019-03-25 13:15:00,2019-03-25 13:30:00
119,2,0,2,0.0037745724320848396,2019-03-25 13:15:00,2019-03-25 13:30:00
120,1,0,1,0.0037745724320848396,2019-03-25 13:15:00,2019-03-25 13:30:00
122,1,1,0,0.0069832617104333946,2019-03-25 13:15:00,2019-03-25 13:30:00
127,2,1,1,0.005378917071259117,2019-03-25 13:15:00,2019-03-25 13:30:00
137,2,2,0,0.0067595453399808695,2019-03-25 13:15:00,2019-03-25 13:30:00
138,1,1,0,0.0069832617104333946,2019-03-25 13:15:00,2019-03-25 13:30:00
153,6,2,4,0.006565012546546532,2019-03-25 13:15:00,2019-03-25 13:30:00
157,1,0,1,0.0037745724320848396,2019-03-25 13:15:00,2019-03-25 13:30:00
158,3,2,1,0.014272749448176273,2019-03-25 13:15:00,2019-03-25 13:30:00
164,4,1,3,0.0052670588860328545,2019-03-25 13:15:00,2019-03-25 13:30:00
168,1,1,0,0.009710957217803686,2019-03-25 13:15:00,2019-03-25 13:30:00
169,2,1,1,0.025075405209507993,2019-03-25 13:15:00,2019-03-25 13:30:00
170,5,3,2,0.020923647464178328,2019-03-25 13:15:00,2019-03-25 13:30:00
173,2,2,0,0.009742329521349386,2019-03-25 13:15:00,2019-03-25 13:30:00
195,1,1,0,0.0069832617104333946,2019-03-25 13:15:00,2019-03-25 13:30:00
196,2,1,1,0.0069832617104333946,2019-03-25 13:15:00,2019-03-25 13:30:00
1,1,1,0,0.006379473345414643,2019-03-25 13:30:00,2019-03-25 13:45:00
5,2,1,1,0.02294535867769337,2019-03-25 13:30:00,2019-03-25 13:45:00
15,2,1,1,0.03251969600371978,2019-03-25 13:30:00,2019-03-25 13:45:00
19,2,0,2,0.0034481952520493213,2019-03-25 13:30:00,2019-03-25 13:45:00
23,1,1,0,0.011609604675103415,2019-03-25 13:30:00,2019-03-25 13:45:00
26,1,1,0,0.0044925039943203675,2019-03-25 13:30:00,2019-03-25 13:45:00
35,1,1,0,0.0049138342987319825,2019-03-25 13:30:00,2019-03-25 13:45:00
40,1,0,1,0.0034481952520493213,2019-03-25 13:30:00,2019-03-25 13:45:00
57,1,0,1,0.0034481952520493213,2019-03-25 13:30:00,2019-03-25 13:45:00
58,4,2,2,0.0191999919459008,2019-03-25 13:30:00,2019-03-25 13:45:00
61,1,1,0,0.008871387096852371,2019-03-25 13:30:00,2019-03-25 13:45:00
66,2,1,1,0.02294535867769337,2019-03-25 13:30:00,2019-03-25 13:45:00
67,1,0,1,0.0034481952520493213,2019-03-25 13:30:00,2019-03-25 13:45:00
87,1,0,1,0.0034481952520493213,2019-03-25 13:30:00,2019-03-25 13:45:00
88,1,1,0,0.006379473345414643,2019-03-25 13:30:00,2019-03-25 13:45:00
89,2,1,1,0.02294535867769337,2019-03-25 13:30:00,2019-03-25 13:45:00
101,2,1,1,0.02294535867769337,2019-03-25 13:30:00,2019-03-25 13:45:00
111,5,4,1,0.03420610092050452,2019-03-25 13:30:00,2019-03-25 13:45:00
115,3,2,1,0.04244252210333741,2019-03-25 13:30:00,2019-03-25 13:45:00
119,1,0,1,0.0034481952520493213,2019-03-25 13:30:00,2019-03-25 13:45:00
120,2,0,2,0.0034481952520493213,2019-03-25 13:30:00,2019-03-25 13:45:00
122,1,1,0,0.006379473345414643,2019-03-25 13:30:00,2019-03-25 13:45:00
126,1,1,0,0.0049138342987319825,2019-03-25 13:30:00,2019-03-25 13:45:00
127,1,0,1,0.0034481952520493213,2019-03-25 13:30:00,2019-03-25 13:45:00
137,6,4,2,0.04107905890506912,2019-03-25 13:30:00,2019-03-25 13:45:00
138,5,1,4,0.0049138342987319825,2019-03-25 13:30:00,2019-03-25 13:45:00
153,1,0,1,0.0034481952520493213,2019-03-25 13:30:00,2019-03-25 13:45:00
158,3,2,1,0.008928710105094474,2019-03-25 13:30:00,2019-03-25 13:45:00
164,4,1,3,0.004811658450317616,2019-03-25 13:30:00,2019-03-25 13:45:00
168,2,1,1,0.0049138342987319825,2019-03-25 13:30:00,2019-03-25 13:45:00
169,4,2,2,0.013263100957083154,2019-03-25 13:30:00,2019-03-25 13:45:00
170,3,1,2,0.005997432011729152,2019-03-25 13:30:00,2019-03-25 13:45:00
173,2,1,1,0.006379473345414643,2019-03-25 13:30:00,2019-03-25 13:45:00
189,1,1,0,0.009085865987998968,2019-03-25 13:30:00,2019-03-25 13:45:00
195,1,1,0,0.006379473345414643,2019-03-25 13:30:00,2019-03-25 13:45:00
199,1,0,1,0.0034481952520493213,2019-03-25 13:30:00,2019-03-25 13:45:00
201,1,1,0,0.006379473345414643,2019-03-25 13:30:00,2019-03-25 13:45:00
2,1,0,1,0.0037557816463283486,2019-03-25 13:45:00,2019-03-25 14:00:00
5,2,1,1,0.024955236450531576,2019-03-25 13:45:00,2019-03-25 14:00:00
15,1,0,1,0.0037557816463283486,2019-03-25 13:45:00,2019-03-25 14:00:00
19,2,0,2,0.0037557816463283486,2019-03-25 13:45:00,2019-03-25 14:00:00
23,1,1,0,0.006948511432159276,2019-03-25 13:45:00,2019-03-25 14:00:00
26,1,1,0,0.005571767966909667,2019-03-25 13:45:00,2019-03-25 14:00:00
35,1,1,0,0.005352146539243812,2019-03-25 13:45:00,2019-03-25 14:00:00
57,2,1,1,0.006532356867485199,2019-03-25 13:45:00,2019-03-25 14:00:00
58,1,0,1,0.0037557816463283486,2019-03-25 13:45:00,2019-03-25 14:00:00
61,1,1,0,0.009662655096488839,2019-03-25 13:45:00,2019-03-25 14:00:00
64,1,1,0,0.006948511432159276,2019-03-25 13:45:00,2019-03-25 14:00:00
66,2,1,1,0.024955236450531576,2019-03-25 13:45:00,2019-03-25 14:00:00
67,2,0,2,0.0037557816463283486,2019-03-25 13:45:00,2019-03-25 14:00:00
85,1,1,0,0.006948511432159276,2019-03-25 13:45:00,2019-03-25 14:00:00
87,1,0,1,0.0037557816463283486,2019-03-25 13:45:00,2019-03-25 14:00:00
88,1,1,0,0.006948511432159276,2019-03-25 13:45:00,2019-03-25 14:00:00
89,2,1,1,0.024955236450531576,2019-03-25 13:45:00,2019-03-25 14:00:00
90,1,0,1,0.0037557816463283486,2019-03-25 13:45:00,2019-03-25 14:00:00
101,2,1,1,0.024955236450531576,2019-03-25 13:45:00,2019-03-25 14:00:00
110,1,1,0,0.006532356867485199,2019-03-25 13:45:00,2019-03-25 14:00:00
111,4,4,0,0.012396470393903231,2019-03-25 13:45:00,2019-03-25 14:00:00
114,1,0,1,0.0037557816463283486,2019-03-25 13:45:00,2019-03-25 14:00:00
115,3,2,1,0.04615469125473481,2019-03-25 13:45:00,2019-03-25 14:00:00
120,2,0,2,0.0037557816463283486,2019-03-25 13:45:00,2019-03-25 14:00:00
126,1,1,0,0.005352146539243812,2019-03-25 13:45:00,2019-03-25 14:00:00
137,6,4,2,0.022714649633278208,2019-03-25 13:45:00,2019-03-25 14:00:00
138,6,2,4,0.00854487632507474,2019-03-25 13:45:00,2019-03-25 14:00:00
140,1,1,0,0.013410963580385231,2019-03-25 13:45:00,2019-03-25 14:00:00
153,1,0,1,0.0037557816463283486,2019-03-25 13:45:00,2019-03-25 14:00:00
157,1,0,1,0.0037557816463283486,2019-03-25 13:45:00,2019-03-25 14:00:00
158,2,1,1,0.006532356867485199,2019-03-25 13:45:00,2019-03-25 14:00:00
164,6,2,4,0.008823779237448915,2019-03-25 13:45:00,2019-03-25 14:00:00
168,1,1,0,0.005352146539243812,2019-03-25 13:45:00,2019-03-25 14:00:00
169,3,1,2,0.006532356867485199,2019-03-25 13:45:00,2019-03-25 14:00:00
170,3,1,2,0.006532356867485199,2019-03-25 13:45:00,2019-03-25 14:00:00
173,2,1,1,0.006948511432159276,2019-03-25 13:45:00,2019-03-25 14:00:00
189,3,1,2,0.006532356867485199,2019-03-25 13:45:00,2019-03-25 14:00:00
195,3,3,0,0.008823779237448915,2019-03-25 13:45:00,2019-03-25 14:00:00
196,1,0,1,0.0037557816463283486,2019-03-25 13:45:00,2019-03-25 14:00:00
201,1,1,0,0.00930893208864205,2019-03-25 13:45:00,2019-03-25 14:00:00
5,3,2,1,0.04340581906447901,2019-03-25 14:00:00,2019-03-25 14:15:00
15,3,1,2,0.006143952451918241,2019-03-25 14:00:00,2019-03-25 14:15:00
19,4,2,2,0.011533232559232384,2019-03-25 14:00:00,2019-03-25 14:15:00
21,1,0,1,0.0035324896010044374,2019-03-25 14:00:00,2019-03-25 14:15:00
23,1,0,1,0.0035324896010044374,2019-03-25 14:00:00,2019-03-25 14:15:00
26,1,1,0,0.008696156430822088,2019-03-25 14:00:00,2019-03-25 14:15:00
37,5,2,3,0.00815323662352711,2019-03-25 14:00:00,2019-03-25 14:15:00
40,1,0,1,0.0035324896010044374,2019-03-25 14:00:00,2019-03-25 14:15:00
41,2,1,1,0.005033935979826295,2019-03-25 14:00:00,2019-03-25 14:15:00
57,2,1,1,0.006535382358648153,2019-03-25 14:00:00,2019-03-25 14:15:00
58,1,1,0,0.007302476885757177,2019-03-25 14:00:00,2019-03-25 14:15:00
62,1,0,1,0.0035324896010044374,2019-03-25 14:00:00,2019-03-25 14:15:00
66,2,1,1,0.02346915433274172,2019-03-25 14:00:00,2019-03-25 14:15:00
67,2,0,2,0.0035324896010044374,2019-03-25 14:00:00,2019-03-25 14:15:00
68,1,1,0,0.009088124113805118,2019-03-25 14:00:00,2019-03-25 14:15:00
69,1,0,1,0.0035324896010044374,2019-03-25 14:00:00,2019-03-25 14:15:00
86,1,1,0,0.006535382358648153,2019-03-25 14:00:00,2019-03-25 14:15:00
88,3,1,2,0.006535382358648153,2019-03-25 14:00:00,2019-03-25 14:15:00
89,2,1,1,0.02346915433274172,2019-03-25 14:00:00,2019-03-25 14:15:00
90,1,0,1,0.0035324896010044374,2019-03-25 14:00:00,2019-03-25 14:15:00
101,2,1,1,0.02346915433274172,2019-03-25 14:00:00,2019-03-25 14:15:00
109,1,1,0,0.006143952451918241,2019-03-25 14:00:00,2019-03-25 14:15:00
111,3,3,0,0.019023490090457392,2019-03-25 14:00:00,2019-03-25 14:15:00
112,2,1,1,0.006535382358648153,2019-03-25 14:00:00,2019-03-25 14:15:00
115,4,2,2,0.008755415302832045,2019-03-25 14:00:00,2019-03-25 14:15:00
120,1,0,1,0.0035324896010044374,2019-03-25 14:00:00,2019-03-25 14:15:00
122,1,1,0,0.005842863112265773,2019-03-25 14:00:00,2019-03-25 14:15:00
126,3,3,0,0.01633977181306058,2019-03-25 14:00:00,2019-03-25 14:15:00
127,1,0,1,0.0035324896010044374,2019-03-25 14:00:00,2019-03-25 14:15:00
137,3,2,1,0.007059998639667614,2019-03-25 14:00:00,2019-03-25 14:15:00
138,7,3,4,0.024296425946051102,2019-03-25 14:00:00,2019-03-25 14:15:00
147,1,1,0,0.006535382358648153,2019-03-25 14:00:00,2019-03-25 14:15:00
151,1,1,0,0.006535382358648153,2019-03-25 14:00:00,2019-03-25 14:15:00
153,2,0,2,0.0035324896010044374,2019-03-25 14:00:00,2019-03-25 14:15:00
158,2,1,1,0.007302476885757177,2019-03-25 14:00:00,2019-03-25 14:15:00
164,6,2,4,0.008299136877979741,2019-03-25 14:00:00,2019-03-25 14:15:00
169,2,1,1,0.02346915433274172,2019-03-25 14:00:00,2019-03-25 14:15:00
170,5,2,3,0.01330413677245224,2019-03-25 14:00:00,2019-03-25 14:15:00
171,1,0,1,0.0035324896010044374,2019-03-25 14:00:00,2019-03-25 14:15:00
175,1,1,0,0.006310306857404777,2019-03-25 14:00:00,2019-03-25 14:15:00
189,1,0,1,0.0035324896010044374,2019-03-25 14:00:00,2019-03-25 14:15:00
195,4,3,1,0.008299136877979741,2019-03-25 14:00:00,2019-03-25 14:15:00
196,3,2,1,0.013590400435974506,2019-03-25 14:00:00,2019-03-25 14:15:00
197,1,0,1,0.0035324896010044374,2019-03-25 14:00:00,2019-03-25 14:15:00
201,1,1,0,0.009088124113805118,2019-03-25 14:00:00,2019-03-25 14:15:00
202,1,1,0,0.006310306857404777,2019-03-25 14:00:00,2019-03-25 14:15:00
2,1,1,0,0.006536666504077129,2019-03-25 14:15:00,2019-03-25 14:30:00
5,3,2,1,0.04341428722445142,2019-03-25 14:15:00,2019-03-25 14:30:00
15,2,1,1,0.008111263487537611,2019-03-25 14:15:00,2019-03-25 14:30:00
19,6,5,1,0.016875916909298037,2019-03-25 14:15:00,2019-03-25 14:30:00
20,1,1,0,0.025115368258725106,2019-03-25 14:15:00,2019-03-25 14:30:00
21,3,0,3,0.0035331835171748785,2019-03-25 14:15:00,2019-03-25 14:30:00
23,2,0,2,0.0035331835171748785,2019-03-25 14:15:00,2019-03-25 14:30:00
37,4,1,3,0.006536666504077129,2019-03-25 14:15:00,2019-03-25 14:30:00
40,1,0,1,0.0035331835171748785,2019-03-25 14:15:00,2019-03-25 14:30:00
41,1,0,1,0.0035331835171748785,2019-03-25 14:15:00,2019-03-25 14:30:00
46,2,1,1,0.004534344512808962,2019-03-25 14:15:00,2019-03-25 14:30:00
58,1,1,0,0.006758907141537563,2019-03-25 14:15:00,2019-03-25 14:30:00
62,2,1,1,0.008831731118175085,2019-03-25 14:15:00,2019-03-25 14:30:00
64,1,1,0,0.008831731118175085,2019-03-25 14:15:00,2019-03-25 14:30:00
66,2,1,1,0.02347373537081314,2019-03-25 14:15:00,2019-03-25 14:30:00
67,1,0,1,0.0035331835171748785,2019-03-25 14:15:00,2019-03-25 14:30:00
68,1,1,0,0.006311546943198895,2019-03-25 14:15:00,2019-03-25 14:30:00
74,1,1,0,0.006311546943198895,2019-03-25 14:15:00,2019-03-25 14:30:00
88,4,1,3,0.006536666504077129,2019-03-25 14:15:00,2019-03-25 14:30:00
89,2,1,1,0.02347373537081314,2019-03-25 14:15:00,2019-03-25 14:30:00
90,1,1,0,0.005385425801190889,2019-03-25 14:15:00,2019-03-25 14:30:00
101,2,1,1,0.02347373537081314,2019-03-25 14:15:00,2019-03-25 14:30:00
109,1,1,0,0.010428513212237145,2019-03-25 14:15:00,2019-03-25 14:30:00
110,1,1,0,0.005385425801190889,2019-03-25 14:15:00,2019-03-25 14:30:00
111,6,3,3,0.00908991036922291,2019-03-25 14:15:00,2019-03-25 14:30:00
112,3,1,2,0.006536666504077129,2019-03-25 14:15:00,2019-03-25 14:30:00
115,3,1,2,0.00614515998511209,2019-03-25 14:15:00,2019-03-25 14:30:00
116,2,2,0,0.006536666504077129,2019-03-25 14:15:00,2019-03-25 14:30:00
119,1,1,0,0.005385425801190889,2019-03-25 14:15:00,2019-03-25 14:30:00
120,1,0,1,0.0035331835171748785,2019-03-25 14:15:00,2019-03-25 14:30:00
122,2,1,1,0.005385425801190889,2019-03-25 14:15:00,2019-03-25 14:30:00
126,3,2,1,0.025387314587863107,2019-03-25 14:15:00,2019-03-25 14:30:00
127,1,0,1,0.0035331835171748785,2019-03-25 14:15:00,2019-03-25 14:30:00
137,3,2,1,0.005440217265620894,2019-03-25 14:15:00,2019-03-25 14:30:00
138,4,1,3,0.006536666504077129,2019-03-25 14:15:00,2019-03-25 14:30:00
151,2,2,0,0.005535505508443046,2019-03-25 14:15:00,2019-03-25 14:30:00
158,5,3,2,0.012465713700837752,2019-03-25 14:15:00,2019-03-25 14:30:00
164,5,1,4,0.004486700391397886,2019-03-25 14:15:00,2019-03-25 14:30:00
169,2,1,1,0.02347373537081314,2019-03-25 14:15:00,2019-03-25 14:30:00
170,5,2,3,0.011383559148419372,2019-03-25 14:15:00,2019-03-25 14:30:00
175,1,1,0,0.005385425801190889,2019-03-25 14:15:00,2019-03-25 14:30:00
189,1,0,1,0.0035331835171748785,2019-03-25 14:15:00,2019-03-25 14:30:00
195,3,2,1,0.007490183378300137,2019-03-25 14:15:00,2019-03-25 14:30:00
196,1,1,0,0.009900494879212692,2019-03-25 14:15:00,2019-03-25 14:30:00
197,1,0,1,0.0035331835171748785,2019-03-25 14:15:00,2019-03-25 14:30:00
202,1,0,1,0.0035331835171748785,2019-03-25 14:15:00,2019-03-25 14:30:00
2,1,1,0,0.005973764856739771,2019-03-25 14:30:00,2019-03-25 14:45:00
5,2,1,1,0.021438939914665944,2019-03-25 14:30:00,2019-03-25 14:45:00
10,3,2,1,0.011644165861418655,2019-03-25 14:30:00,2019-03-25 14:45:00
15,7,3,4,0.018778539150267858,2019-03-25 14:30:00,2019-03-25 14:45:00
16,2,0,2,0.0032289107266079966,2019-03-25 14:30:00,2019-03-25 14:45:00
18,5,4,1,0.01595679250176149,2019-03-25 14:30:00,2019-03-25 14:45:00
19,8,5,3,0.018259901198071492,2019-03-25 14:30:00,2019-03-25 14:45:00
20,2,1,1,0.011745004372463685,2019-03-25 14:30:00,2019-03-25 14:45:00
21,4,0,4,0.0032289107266079966,2019-03-25 14:30:00,2019-03-25 14:45:00
23,2,0,2,0.0032289107266079966,2019-03-25 14:30:00,2019-03-25 14:45:00
28,3,3,0,0.014950216617677899,2019-03-25 14:30:00,2019-03-25 14:45:00
37,6,2,4,0.008360848685984652,2019-03-25 14:30:00,2019-03-25 14:45:00
40,1,1,0,0.004601337791673883,2019-03-25 14:30:00,2019-03-25 14:45:00
41,3,1,2,0.016793993886658184,2019-03-25 14:30:00,2019-03-25 14:45:00
46,1,1,0,0.00391512425914094,2019-03-25 14:30:00,2019-03-25 14:45:00
57,1,1,0,0.004601337791673883,2019-03-25 14:30:00,2019-03-25 14:45:00
58,1,1,0,0.008403350139610005,2019-03-25 14:30:00,2019-03-25 14:45:00
62,2,1,1,0.006371284482572331,2019-03-25 14:30:00,2019-03-25 14:45:00
64,1,1,0,0.006371284482572331,2019-03-25 14:30:00,2019-03-25 14:45:00
66,2,1,1,0.021438939914665944,2019-03-25 14:30:00,2019-03-25 14:45:00
67,1,0,1,0.0032289107266079966,2019-03-25 14:30:00,2019-03-25 14:45:00
69,1,1,0,0.00391512425914094,2019-03-25 14:30:00,2019-03-25 14:45:00
74,3,2,1,0.030543954508694914,2019-03-25 14:30:00,2019-03-25 14:45:00
80,2,1,1,0.021438939914665944,2019-03-25 14:30:00,2019-03-25 14:45:00
87,1,0,1,0.0032289107266079966,2019-03-25 14:30:00,2019-03-25 14:45:00
88,2,1,1,0.014812522511347893,2019-03-25 14:30:00,2019-03-25 14:45:00
89,3,1,2,0.005615994555852878,2019-03-25 14:30:00,2019-03-25 14:45:00
90,2,0,2,0.0032289107266079966,2019-03-25 14:30:00,2019-03-25 14:45:00
101,2,1,1,0.021438939914665944,2019-03-25 14:30:00,2019-03-25 14:45:00
109,4,1,3,0.008307176878557119,2019-03-25 14:30:00,2019-03-25 14:45:00
111,3,0,3,0.0032289107266079966,2019-03-25 14:30:00,2019-03-25 14:45:00
112,2,0,2,0.0032289107266079966,2019-03-25 14:30:00,2019-03-25 14:45:00
115,3,1,2,0.005615994555852878,2019-03-25 14:30:00,2019-03-25 14:45:00
116,3,3,0,0.015958444521043853,2019-03-25 14:30:00,2019-03-25 14:45:00
119,3,2,1,0.0073597918163477,2019-03-25 14:30:00,2019-03-25 14:45:00
120,1,0,1,0.0032289107266079966,2019-03-25 14:30:00,2019-03-25 14:45:00
122,1,0,1,0.0032289107266079966,2019-03-25 14:30:00,2019-03-25 14:45:00
126,3,2,1,0.010017613821552012,2019-03-25 14:30:00,2019-03-25 14:45:00
133,1,1,0,0.005005805646684774,2019-03-25 14:30:00,2019-03-25 14:45:00
137,7,6,1,0.013626092304706048,2019-03-25 14:30:00,2019-03-25 14:45:00
138,2,2,0,0.007346191921805657,2019-03-25 14:30:00,2019-03-25 14:45:00
140,1,1,0,0.004505654300693787,2019-03-25 14:30:00,2019-03-25 14:45:00
147,1,1,0,0.00391512425914094,2019-03-25 14:30:00,2019-03-25 14:45:00
151,1,1,0,0.00391512425914094,2019-03-25 14:30:00,2019-03-25 14:45:00
154,3,3,0,0.015202205847308518,2019-03-25 14:30:00,2019-03-25 14:45:00
157,1,0,1,0.0032289107266079966,2019-03-25 14:30:00,2019-03-25 14:45:00
158,4,2,2,0.007392889475929655,2019-03-25 14:30:00,2019-03-25 14:45:00
164,4,1,3,0.004505654300693787,2019-03-25 14:30:00,2019-03-25 14:45:00
168,2,2,0,0.00637823271175066,2019-03-25 14:30:00,2019-03-25 14:45:00
169,2,1,1,0.021438939914665944,2019-03-25 14:30:00,2019-03-25 14:45:00
170,3,1,2,0.005615994555852878,2019-03-25 14:30:00,2019-03-25 14:45:00
173,1,0,1,0.0032289107266079966,2019-03-25 14:30:00,2019-03-25 14:45:00
175,1,1,0,0.01582129890763141,2019-03-25 14:30:00,2019-03-25 14:45:00
189,2,0,2,0.0032289107266079966,2019-03-25 14:30:00,2019-03-25 14:45:00
190,4,1,3,0.004505654300693787,2019-03-25 14:30:00,2019-03-25 14:45:00
191,2,1,1,0.010367422287332864,2019-03-25 14:30:00,2019-03-25 14:45:00
195,2,1,1,0.005973764856739771,2019-03-25 14:30:00,2019-03-25 14:45:00
196,2,0,2,0.0032289107266079966,2019-03-25 14:30:00,2019-03-25 14:45:00
202,1,0,1,0.0032289107266079966,2019-03-25 14:30:00,2019-03-25 14:45:00
1,1,0,1,0.0031643835494505343,2019-03-25 14:45:00,2019-03-25 15:00:00
2,1,1,0,0.006752717427389671,2019-03-25 14:45:00,2019-03-25 15:00:00
10,4,2,2,0.019618997378653413,2019-03-25 14:45:00,2019-03-25 15:00:00
15,5,2,3,0.005381291291634729,2019-03-25 14:45:00,2019-03-25 15:00:00
16,3,1,2,0.004415587459042625,2019-03-25 14:45:00,2019-03-25 15:00:00
18,6,5,1,0.015587725767703082,2019-03-25 14:45:00,2019-03-25 15:00:00
19,6,4,2,0.013521273103490198,2019-03-25 14:45:00,2019-03-25 15:00:00
20,4,1,3,0.008819231764579653,2019-03-25 14:45:00,2019-03-25 15:00:00
21,3,0,3,0.0031643835494505343,2019-03-25 14:45:00,2019-03-25 15:00:00
23,1,0,1,0.0031643835494505343,2019-03-25 14:45:00,2019-03-25 15:00:00
28,3,3,0,0.018492576418101262,2019-03-25 14:45:00,2019-03-25 15:00:00
30,1,1,0,0.005854348959297011,2019-03-25 14:45:00,2019-03-25 15:00:00
37,8,4,4,0.016883961963479452,2019-03-25 14:45:00,2019-03-25 15:00:00
41,2,1,1,0.01641580177195437,2019-03-25 14:45:00,2019-03-25 15:00:00
57,1,1,0,0.007237698621697096,2019-03-25 14:45:00,2019-03-25 15:00:00
58,1,1,0,0.005854348959297011,2019-03-25 14:45:00,2019-03-25 15:00:00
61,1,1,0,0.005854348959297011,2019-03-25 14:45:00,2019-03-25 15:00:00
62,2,1,1,0.004102786481644602,2019-03-25 14:45:00,2019-03-25 15:00:00
64,2,2,0,0.014266480326282416,2019-03-25 14:45:00,2019-03-25 15:00:00
66,2,1,1,0.021008236745482047,2019-03-25 14:45:00,2019-03-25 15:00:00
67,1,0,1,0.0031643835494505343,2019-03-25 14:45:00,2019-03-25 15:00:00
69,1,1,0,0.004061038686066026,2019-03-25 14:45:00,2019-03-25 15:00:00
74,2,1,1,0.021008236745482047,2019-03-25 14:45:00,2019-03-25 15:00:00
79,1,0,1,0.0031643835494505343,2019-03-25 14:45:00,2019-03-25 15:00:00
80,2,1,1,0.021008236745482047,2019-03-25 14:45:00,2019-03-25 15:00:00
85,3,2,1,0.008223251843389862,2019-03-25 14:45:00,2019-03-25 15:00:00
87,5,1,4,0.004102786481644602,2019-03-25 14:45:00,2019-03-25 15:00:00
88,3,2,1,0.010341051305328808,2019-03-25 14:45:00,2019-03-25 15:00:00
89,5,3,2,0.014686515941871637,2019-03-25 14:45:00,2019-03-25 15:00:00
90,2,0,2,0.0031643835494505343,2019-03-25 14:45:00,2019-03-25 15:00:00
101,2,1,1,0.021008236745482047,2019-03-25 14:45:00,2019-03-25 15:00:00
109,5,2,3,0.012214378382305973,2019-03-25 14:45:00,2019-03-25 15:00:00
110,2,1,1,0.0038368749019121536,2019-03-25 14:45:00,2019-03-25 15:00:00
111,4,0,4,0.0031643835494505343,2019-03-25 14:45:00,2019-03-25 15:00:00
112,2,1,1,0.004509366254373773,2019-03-25 14:45:00,2019-03-25 15:00:00
113,1,1,0,0.004509366254373773,2019-03-25 14:45:00,2019-03-25 15:00:00
115,3,1,2,0.00550369979566117,2019-03-25 14:45:00,2019-03-25 15:00:00
116,4,2,2,0.009850384796456287,2019-03-25 14:45:00,2019-03-25 15:00:00
119,5,2,3,0.009315557553160799,2019-03-25 14:45:00,2019-03-25 15:00:00
120,1,0,1,0.0031643835494505343,2019-03-25 14:45:00,2019-03-25 15:00:00
122,1,0,1,0.0031643835494505343,2019-03-25 14:45:00,2019-03-25 15:00:00
126,2,1,1,0.006652083698494358,2019-03-25 14:45:00,2019-03-25 15:00:00
133,1,1,0,0.004102786481644602,2019-03-25 14:45:00,2019-03-25 15:00:00
135,1,1,0,0.004061038686066026,2019-03-25 14:45:00,2019-03-25 15:00:00
137,8,8,0,0.024146607077045808,2019-03-25 14:45:00,2019-03-25 15:00:00
138,2,2,0,0.007731154823685148,2019-03-25 14:45:00,2019-03-25 15:00:00
140,1,1,0,0.005854348959297011,2019-03-25 14:45:00,2019-03-25 15:00:00
141,1,1,0,0.004036308586711491,2019-03-25 14:45:00,2019-03-25 15:00:00
147,1,1,0,0.004061038686066026,2019-03-25 14:45:00,2019-03-25 15:00:00
153,2,1,1,0.021008236745482047,2019-03-25 14:45:00,2019-03-25 15:00:00
154,3,3,0,0.007738926835998872,2019-03-25 14:45:00,2019-03-25 15:00:00
158,5,1,4,0.004415587459042625,2019-03-25 14:45:00,2019-03-25 15:00:00
160,1,1,0,0.005854348959297011,2019-03-25 14:45:00,2019-03-25 15:00:00
164,4,1,3,0.004415587459042625,2019-03-25 14:45:00,2019-03-25 15:00:00
168,3,1,2,0.006752717427389671,2019-03-25 14:45:00,2019-03-25 15:00:00
169,2,1,1,0.021008236745482047,2019-03-25 14:45:00,2019-03-25 15:00:00
170,4,1,3,0.004415587459042625,2019-03-25 14:45:00,2019-03-25 15:00:00
173,2,0,2,0.0031643835494505343,2019-03-25 14:45:00,2019-03-25 15:00:00
175,2,1,1,0.011955518393850149,2019-03-25 14:45:00,2019-03-25 15:00:00
189,5,2,3,0.014374074109666863,2019-03-25 14:45:00,2019-03-25 15:00:00
190,1,0,1,0.0031643835494505343,2019-03-25 14:45:00,2019-03-25 15:00:00
191,2,0,2,0.0031643835494505343,2019-03-25 14:45:00,2019-03-25 15:00:00
195,2,1,1,0.005854348959297011,2019-03-25 14:45:00,2019-03-25 15:00:00
196,1,0,1,0.0031643835494505343,2019-03-25 14:45:00,2019-03-25 15:00:00
1,2,2,0,0.0062186717335610715,2019-03-25 15:00:00,2019-03-25 15:15:00
2,3,3,0,0.014243588329683695,2019-03-25 15:00:00,2019-03-25 15:15:00
10,3,1,2,0.00554261940901727,2019-03-25 15:00:00,2019-03-25 15:15:00
15,3,3,0,0.01083681463859401,2019-03-25 15:00:00,2019-03-25 15:15:00
16,2,1,1,0.00521933336628587,2019-03-25 15:00:00,2019-03-25 15:15:00
18,5,5,0,0.01907037754849962,2019-03-25 15:00:00,2019-03-25 15:15:00
19,5,4,1,0.025500692401788393,2019-03-25 15:00:00,2019-03-25 15:15:00
20,3,1,2,0.004849930861993016,2019-03-25 15:00:00,2019-03-25 15:15:00
21,3,1,2,0.006054730155776459,2019-03-25 15:00:00,2019-03-25 15:15:00
23,1,0,1,0.0034811899904249608,2019-03-25 15:00:00,2019-03-25 15:15:00
26,1,0,1,0.0034811899904249608,2019-03-25 15:00:00,2019-03-25 15:15:00
37,3,2,1,0.009399766927262547,2019-03-25 15:00:00,2019-03-25 15:15:00
40,1,0,1,0.0034811899904249608,2019-03-25 15:00:00,2019-03-25 15:15:00
41,1,0,1,0.0034811899904249608,2019-03-25 15:00:00,2019-03-25 15:15:00
46,1,0,1,0.0034811899904249608,2019-03-25 15:00:00,2019-03-25 15:15:00
57,1,1,0,0.005135194511144935,2019-03-25 15:00:00,2019-03-25 15:15:00
58,1,1,0,0.006440478458843754,2019-03-25 15:00:00,2019-03-25 15:15:00
61,2,2,0,0.01131201068660263,2019-03-25 15:00:00,2019-03-25 15:15:00
62,2,0,2,0.0034811899904249608,2019-03-25 15:00:00,2019-03-25 15:15:00
64,1,1,0,0.006440478458843754,2019-03-25 15:00:00,2019-03-25 15:15:00
66,2,1,1,0.023028047666124835,2019-03-25 15:00:00,2019-03-25 15:15:00
67,2,0,2,0.0034811899904249608,2019-03-25 15:00:00,2019-03-25 15:15:00
68,1,0,1,0.0034811899904249608,2019-03-25 15:00:00,2019-03-25 15:15:00
71,1,1,0,0.006054730155776459,2019-03-25 15:00:00,2019-03-25 15:15:00
74,3,1,2,0.006054730155776459,2019-03-25 15:00:00,2019-03-25 15:15:00
79,2,2,0,0.009399766927262547,2019-03-25 15:00:00,2019-03-25 15:15:00
85,2,2,0,0.007697637895424474,2019-03-25 15:00:00,2019-03-25 15:15:00
86,1,1,0,0.004960834224634357,2019-03-25 15:00:00,2019-03-25 15:15:00
87,4,1,3,0.00521933336628587,2019-03-25 15:00:00,2019-03-25 15:15:00
89,1,1,0,0.006027816126764414,2019-03-25 15:00:00,2019-03-25 15:15:00
101,2,1,1,0.023028047666124835,2019-03-25 15:00:00,2019-03-25 15:15:00
104,1,1,0,0.004767960073100709,2019-03-25 15:00:00,2019-03-25 15:15:00
109,6,2,4,0.006521074428711476,2019-03-25 15:00:00,2019-03-25 15:15:00
110,1,0,1,0.0034811899904249608,2019-03-25 15:00:00,2019-03-25 15:15:00
111,5,2,3,0.02268185200195485,2019-03-25 15:00:00,2019-03-25 15:15:00
113,2,2,0,0.005454048969370823,2019-03-25 15:00:00,2019-03-25 15:15:00
114,2,1,1,0.006440478458843754,2019-03-25 15:00:00,2019-03-25 15:15:00
115,5,2,3,0.008987104595183208,2019-03-25 15:00:00,2019-03-25 15:15:00
116,3,1,2,0.006440478458843754,2019-03-25 15:00:00,2019-03-25 15:15:00
119,2,1,1,0.006440478458843754,2019-03-25 15:00:00,2019-03-25 15:15:00
120,6,2,4,0.006054730155776459,2019-03-25 15:00:00,2019-03-25 15:15:00
122,1,0,1,0.0034811899904249608,2019-03-25 15:00:00,2019-03-25 15:15:00
126,6,2,4,0.006440478458843753,2019-03-25 15:00:00,2019-03-25 15:15:00
135,1,1,0,0.006054730155776459,2019-03-25 15:00:00,2019-03-25 15:15:00
137,5,4,1,0.016146009264666514,2019-03-25 15:00:00,2019-03-25 15:15:00
138,2,2,0,0.007727248541519503,2019-03-25 15:00:00,2019-03-25 15:15:00
140,2,1,1,0.006440478458843754,2019-03-25 15:00:00,2019-03-25 15:15:00
141,1,1,0,0.004960156152288364,2019-03-25 15:00:00,2019-03-25 15:15:00
153,2,0,2,0.0034811899904249608,2019-03-25 15:00:00,2019-03-25 15:15:00
154,1,0,1,0.0034811899904249608,2019-03-25 15:00:00,2019-03-25 15:15:00
156,2,1,1,0.007698315967770468,2019-03-25 15:00:00,2019-03-25 15:15:00
158,2,1,1,0.00521933336628587,2019-03-25 15:00:00,2019-03-25 15:15:00
160,1,0,1,0.0034811899904249608,2019-03-25 15:00:00,2019-03-25 15:15:00
164,4,1,3,0.004857668641614523,2019-03-25 15:00:00,2019-03-25 15:15:00
168,1,0,1,0.0034811899904249608,2019-03-25 15:00:00,2019-03-25 15:15:00
169,2,1,1,0.023028047666124835,2019-03-25 15:00:00,2019-03-25 15:15:00
170,6,2,4,0.008178621834704664,2019-03-25 15:00:00,2019-03-25 15:15:00
172,2,2,0,0.026528549215466074,2019-03-25 15:00:00,2019-03-25 15:15:00
175,1,0,1,0.0034811899904249608,2019-03-25 15:00:00,2019-03-25 15:15:00
177,1,1,0,0.004960834224634357,2019-03-25 15:00:00,2019-03-25 15:15:00
189,4,1,3,0.005837047200330409,2019-03-25 15:00:00,2019-03-25 15:15:00
190,1,0,1,0.0034811899904249608,2019-03-25 15:00:00,2019-03-25 15:15:00
191,3,0,3,0.0034811899904249608,2019-03-25 15:00:00,2019-03-25 15:15:00
195,2,1,1,0.004960834224634357,2019-03-25 15:00:00,2019-03-25 15:15:00
196,4,2,2,0.011505100939511518,2019-03-25 15:00:00,2019-03-25 15:15:00
197,1,1,0,0.004867069907991502,2019-03-25 15:00:00,2019-03-25 15:15:00
2,3,3,0,0.008067265975990202,2019-03-25 15:15:00,2019-03-25 15:30:00
10,2,1,1,0.0058407426424585554,2019-03-25 15:15:00,2019-03-25 15:30:00
15,1,1,0,0.010363931563000531,2019-03-25 15:15:00,2019-03-25 15:30:00
16,1,1,0,0.004283843845162307,2019-03-25 15:15:00,2019-03-25 15:30:00
18,3,2,1,0.014005568890828355,2019-03-25 15:15:00,2019-03-25 15:30:00
19,9,7,2,0.025215024717480244,2019-03-25 15:15:00,2019-03-25 15:30:00
21,5,2,3,0.007704364608207334,2019-03-25 15:15:00,2019-03-25 15:30:00
23,1,1,0,0.004283843845162307,2019-03-25 15:15:00,2019-03-25 15:30:00
26,1,0,1,0.0033379883124553334,2019-03-25 15:15:00,2019-03-25 15:30:00
30,1,0,1,0.0033379883124553334,2019-03-25 15:15:00,2019-03-25 15:30:00
37,1,0,1,0.0033379883124553334,2019-03-25 15:15:00,2019-03-25 15:30:00
41,1,0,1,0.0033379883124553334,2019-03-25 15:15:00,2019-03-25 15:30:00
46,2,0,2,0.0033379883124553334,2019-03-25 15:15:00,2019-03-25 15:30:00
57,1,0,1,0.0033379883124553334,2019-03-25 15:15:00,2019-03-25 15:30:00
61,2,2,0,0.013552998551029666,2019-03-25 15:15:00,2019-03-25 15:30:00
62,2,0,2,0.0033379883124553334,2019-03-25 15:15:00,2019-03-25 15:30:00
66,2,1,1,0.02212729414739738,2019-03-25 15:15:00,2019-03-25 15:30:00
67,2,0,2,0.0033379883124553334,2019-03-25 15:15:00,2019-03-25 15:30:00
68,5,2,3,0.01689349964690641,2019-03-25 15:15:00,2019-03-25 15:30:00
70,1,1,0,0.008125192930590663,2019-03-25 15:15:00,2019-03-25 15:30:00
71,1,1,0,0.004283843845162307,2019-03-25 15:15:00,2019-03-25 15:30:00
74,3,0,3,0.0033379883124553334,2019-03-25 15:15:00,2019-03-25 15:30:00
79,3,1,2,0.008125192930590663,2019-03-25 15:15:00,2019-03-25 15:30:00
86,1,1,0,0.004283843845162307,2019-03-25 15:15:00,2019-03-25 15:30:00
88,1,1,0,0.006175554910576255,2019-03-25 15:15:00,2019-03-25 15:30:00
89,7,4,3,0.0302880986520066,2019-03-25 15:15:00,2019-03-25 15:30:00
90,1,0,1,0.0033379883124553334,2019-03-25 15:15:00,2019-03-25 15:30:00
101,2,1,1,0.02212729414739738,2019-03-25 15:15:00,2019-03-25 15:30:00
104,1,1,0,0.004657852462770763,2019-03-25 15:15:00,2019-03-25 15:30:00
109,3,0,3,0.0033379883124553334,2019-03-25 15:15:00,2019-03-25 15:30:00
110,1,1,0,0.005888083121941813,2019-03-25 15:15:00,2019-03-25 15:30:00
111,6,1,5,0.005888083121941813,2019-03-25 15:15:00,2019-03-25 15:30:00
112,2,1,1,0.004283843845162307,2019-03-25 15:15:00,2019-03-25 15:30:00
113,2,2,0,0.019359211174493414,2019-03-25 15:15:00,2019-03-25 15:30:00
114,2,1,1,0.006175554910576255,2019-03-25 15:15:00,2019-03-25 15:30:00
115,6,2,4,0.005805685138178935,2019-03-25 15:15:00,2019-03-25 15:30:00
116,2,1,1,0.0058407426424585554,2019-03-25 15:15:00,2019-03-25 15:30:00
118,2,2,0,0.0068807064915381265,2019-03-25 15:15:00,2019-03-25 15:30:00
119,8,4,4,0.011998769644083324,2019-03-25 15:15:00,2019-03-25 15:30:00
120,4,1,3,0.004657852462770763,2019-03-25 15:15:00,2019-03-25 15:30:00
126,4,1,3,0.0047567716115157945,2019-03-25 15:15:00,2019-03-25 15:30:00
133,2,1,1,0.02212729414739738,2019-03-25 15:15:00,2019-03-25 15:30:00
137,2,2,0,0.009901490731606497,2019-03-25 15:15:00,2019-03-25 15:30:00
138,5,2,3,0.007495419060891685,2019-03-25 15:15:00,2019-03-25 15:30:00
140,3,3,0,0.011137056388719507,2019-03-25 15:15:00,2019-03-25 15:30:00
147,1,0,1,0.0033379883124553334,2019-03-25 15:15:00,2019-03-25 15:30:00
153,3,0,3,0.0033379883124553334,2019-03-25 15:15:00,2019-03-25 15:30:00
154,3,1,2,0.005888083121941813,2019-03-25 15:15:00,2019-03-25 15:30:00
156,3,2,1,0.009564849153012606,2019-03-25 15:15:00,2019-03-25 15:30:00
159,2,2,0,0.010245402318087373,2019-03-25 15:15:00,2019-03-25 15:30:00
164,6,3,3,0.011581241000174165,2019-03-25 15:15:00,2019-03-25 15:30:00
169,4,1,3,0.004657852462770763,2019-03-25 15:15:00,2019-03-25 15:30:00
170,1,1,0,0.0047567716115157945,2019-03-25 15:15:00,2019-03-25 15:30:00
172,4,3,1,0.018241390544466836,2019-03-25 15:15:00,2019-03-25 15:30:00
177,1,1,0,0.0047567716115157945,2019-03-25 15:15:00,2019-03-25 15:30:00
190,1,0,1,0.0033379883124553334,2019-03-25 15:15:00,2019-03-25 15:30:00
191,3,1,2,0.018845450404791395,2019-03-25 15:15:00,2019-03-25 15:30:00
195,2,1,1,0.0047567716115157945,2019-03-25 15:15:00,2019-03-25 15:30:00
196,7,5,2,0.016529519174008293,2019-03-25 15:15:00,2019-03-25 15:30:00
197,1,1,0,0.004283843845162307,2019-03-25 15:15:00,2019-03-25 15:30:00
201,1,0,1,0.0033379883124553334,2019-03-25 15:15:00,2019-03-25 15:30:00
203,1,1,0,0.005888083121941813,2019-03-25 15:15:00,2019-03-25 15:30:00
1,2,2,0,0.008442684192661865,2019-03-25 15:30:00,2019-03-25 15:45:00
2,4,4,0,0.010025511738079574,2019-03-25 15:30:00,2019-03-25 15:45:00
5,2,2,0,0.008504224289855004,2019-03-25 15:30:00,2019-03-25 15:45:00
10,1,1,0,0.006306616147314238,2019-03-25 15:30:00,2019-03-25 15:45:00
16,1,1,0,0.005763020145395269,2019-03-25 15:30:00,2019-03-25 15:45:00
18,7,3,4,0.016719074349166016,2019-03-25 15:30:00,2019-03-25 15:45:00
19,11,7,4,0.012757597165842542,2019-03-25 15:30:00,2019-03-25 15:45:00
20,1,0,1,0.003408843081365177,2019-03-25 15:30:00,2019-03-25 15:45:00
21,2,0,2,0.003408843081365177,2019-03-25 15:30:00,2019-03-25 15:45:00
23,2,2,0,0.0071108826241763675,2019-03-25 15:30:00,2019-03-25 15:45:00
26,1,0,1,0.003408843081365177,2019-03-25 15:30:00,2019-03-25 15:45:00
27,2,0,2,0.003408843081365177,2019-03-25 15:30:00,2019-03-25 15:45:00
35,4,2,2,0.022616600183555928,2019-03-25 15:30:00,2019-03-25 15:45:00
37,1,0,1,0.003408843081365177,2019-03-25 15:30:00,2019-03-25 15:45:00
41,2,2,0,0.007552715309131471,2019-03-25 15:30:00,2019-03-25 15:45:00
46,4,1,3,0.006306616147314238,2019-03-25 15:30:00,2019-03-25 15:45:00
50,1,1,0,0.0048577296143397074,2019-03-25 15:30:00,2019-03-25 15:45:00
57,3,2,1,0.00967333752736838,2019-03-25 15:30:00,2019-03-25 15:45:00
58,1,1,0,0.006962051033944419,2019-03-25 15:30:00,2019-03-25 15:45:00
61,1,0,1,0.003408843081365177,2019-03-25 15:30:00,2019-03-25 15:45:00
62,1,0,1,0.003408843081365177,2019-03-25 15:30:00,2019-03-25 15:45:00
66,3,2,1,0.046129929768221646,2019-03-25 15:30:00,2019-03-25 15:45:00
67,3,1,2,0.006306616147314238,2019-03-25 15:30:00,2019-03-25 15:45:00
68,4,1,3,0.00612012957478914,2019-03-25 15:30:00,2019-03-25 15:45:00
69,1,1,0,0.006306616147314238,2019-03-25 15:30:00,2019-03-25 15:45:00
70,1,1,0,0.005143065861400187,2019-03-25 15:30:00,2019-03-25 15:45:00
71,2,1,1,0.005763020145395269,2019-03-25 15:30:00,2019-03-25 15:45:00
74,4,1,3,0.008307933378252124,2019-03-25 15:30:00,2019-03-25 15:45:00
79,3,1,2,0.005143065861400187,2019-03-25 15:30:00,2019-03-25 15:45:00
85,2,1,1,0.00612012957478914,2019-03-25 15:30:00,2019-03-25 15:45:00
86,1,1,0,0.0048577296143397074,2019-03-25 15:30:00,2019-03-25 15:45:00
87,1,1,0,0.008611511421470206,2019-03-25 15:30:00,2019-03-25 15:45:00
88,1,0,1,0.003408843081365177,2019-03-25 15:30:00,2019-03-25 15:45:00
89,4,1,3,0.004756705560146276,2019-03-25 15:30:00,2019-03-25 15:45:00
90,3,3,0,0.019400202717483925,2019-03-25 15:30:00,2019-03-25 15:45:00
101,2,1,1,0.022616600183555928,2019-03-25 15:30:00,2019-03-25 15:45:00
104,2,1,1,0.005544911126712805,2019-03-25 15:30:00,2019-03-25 15:45:00
109,3,0,3,0.003408843081365177,2019-03-25 15:30:00,2019-03-25 15:45:00
110,1,1,0,0.007811829394588552,2019-03-25 15:30:00,2019-03-25 15:45:00
111,5,0,5,0.003408843081365177,2019-03-25 15:30:00,2019-03-25 15:45:00
112,5,2,3,0.007755502680288769,2019-03-25 15:30:00,2019-03-25 15:45:00
114,2,2,0,0.010043263440610725,2019-03-25 15:30:00,2019-03-25 15:45:00
115,6,2,4,0.0059288758501287765,2019-03-25 15:30:00,2019-03-25 15:45:00
116,1,0,1,0.003408843081365177,2019-03-25 15:30:00,2019-03-25 15:45:00
118,2,2,0,0.007461202563852924,2019-03-25 15:30:00,2019-03-25 15:45:00
119,7,5,2,0.010358823587725982,2019-03-25 15:30:00,2019-03-25 15:45:00
120,5,2,3,0.006778499278317925,2019-03-25 15:30:00,2019-03-25 15:45:00
126,4,1,3,0.006306616147314238,2019-03-25 15:30:00,2019-03-25 15:45:00
137,6,4,2,0.017106434857477655,2019-03-25 15:30:00,2019-03-25 15:45:00
138,3,1,2,0.005329612745343394,2019-03-25 15:30:00,2019-03-25 15:45:00
140,1,1,0,0.005674155683720296,2019-03-25 15:30:00,2019-03-25 15:45:00
141,1,1,0,0.0056064512239059425,2019-03-25 15:30:00,2019-03-25 15:45:00
147,1,0,1,0.003408843081365177,2019-03-25 15:30:00,2019-03-25 15:45:00
151,1,0,1,0.003408843081365177,2019-03-25 15:30:00,2019-03-25 15:45:00
153,2,0,2,0.003408843081365177,2019-03-25 15:30:00,2019-03-25 15:45:00
154,1,0,1,0.003408843081365177,2019-03-25 15:30:00,2019-03-25 15:45:00
156,2,2,0,0.006306616147314238,2019-03-25 15:30:00,2019-03-25 15:45:00
159,2,2,0,0.00778089449544532,2019-03-25 15:30:00,2019-03-25 15:45:00
160,1,1,0,0.006306616147314238,2019-03-25 15:30:00,2019-03-25 15:45:00
164,5,2,3,0.016231778381597294,2019-03-25 15:30:00,2019-03-25 15:45:00
168,1,0,1,0.003408843081365177,2019-03-25 15:30:00,2019-03-25 15:45:00
169,4,1,3,0.004756705560146276,2019-03-25 15:30:00,2019-03-25 15:45:00
170,2,0,2,0.003408843081365177,2019-03-25 15:30:00,2019-03-25 15:45:00
172,4,1,3,0.00753829993453865,2019-03-25 15:30:00,2019-03-25 15:45:00
173,2,1,1,0.0048577296143397074,2019-03-25 15:30:00,2019-03-25 15:45:00
177,1,1,0,0.005765668428998843,2019-03-25 15:30:00,2019-03-25 15:45:00
189,1,0,1,0.003408843081365177,2019-03-25 15:30:00,2019-03-25 15:45:00
191,3,1,2,0.005544911126712805,2019-03-25 15:30:00,2019-03-25 15:45:00
195,1,1,0,0.006089413401564119,2019-03-25 15:30:00,2019-03-25 15:45:00
196,4,3,1,0.009663507161829375,2019-03-25 15:30:00,2019-03-25 15:45:00
197,1,1,0,0.004374767436681531,2019-03-25 15:30:00,2019-03-25 15:45:00
203,2,2,0,0.00915969187336965,2019-03-25 15:30:00,2019-03-25 15:45:00
1,2,2,0,0.006647602414148442,2019-03-25 15:45:00,2019-03-25 16:00:00
2,4,4,0,0.009980739345420516,2019-03-25 15:45:00,2019-03-25 16:00:00
5,3,3,0,0.008937114975733781,2019-03-25 15:45:00,2019-03-25 16:00:00
15,1,1,0,0.004347958518820959,2019-03-25 15:45:00,2019-03-25 16:00:00
16,3,1,2,0.005566140572669315,2019-03-25 15:45:00,2019-03-25 16:00:00
18,6,4,2,0.020997405504798946,2019-03-25 15:45:00,2019-03-25 16:00:00
19,7,5,2,0.013512039906793512,2019-03-25 15:45:00,2019-03-25 16:00:00
20,1,0,1,0.0031159233959474806,2019-03-25 15:45:00,2019-03-25 16:00:00
23,2,2,0,0.0078961183588192,2019-03-25 15:45:00,2019-03-25 16:00:00
26,1,0,1,0.0031159233959474806,2019-03-25 15:45:00,2019-03-25 16:00:00
27,1,0,1,0.0031159233959474806,2019-03-25 15:45:00,2019-03-25 16:00:00
28,1,1,0,0.006812028764567917,2019-03-25 15:45:00,2019-03-25 16:00:00
35,4,2,2,0.020708983958544487,2019-03-25 15:45:00,2019-03-25 16:00:00
37,1,0,1,0.0031159233959474806,2019-03-25 15:45:00,2019-03-25 16:00:00
40,5,1,4,0.003998843150497721,2019-03-25 15:45:00,2019-03-25 16:00:00
46,3,1,2,0.005764682659598202,2019-03-25 15:45:00,2019-03-25 16:00:00
50,3,2,1,0.006647602414148442,2019-03-25 15:45:00,2019-03-25 16:00:00
57,6,3,3,0.020248019236514238,2019-03-25 15:45:00,2019-03-25 16:00:00
58,1,1,0,0.012041313941511917,2019-03-25 15:45:00,2019-03-25 16:00:00
61,4,1,3,0.004347958518820959,2019-03-25 15:45:00,2019-03-25 16:00:00
62,1,0,1,0.0031159233959474806,2019-03-25 15:45:00,2019-03-25 16:00:00
66,5,3,2,0.024997067368301557,2019-03-25 15:45:00,2019-03-25 16:00:00
67,3,0,3,0.0031159233959474806,2019-03-25 15:45:00,2019-03-25 16:00:00
68,2,2,0,0.0048817629050479615,2019-03-25 15:45:00,2019-03-25 16:00:00
69,2,2,0,0.006996717782471681,2019-03-25 15:45:00,2019-03-25 16:00:00
71,1,0,1,0.0031159233959474806,2019-03-25 15:45:00,2019-03-25 16:00:00
74,3,1,2,0.005764682659598202,2019-03-25 15:45:00,2019-03-25 16:00:00
79,2,0,2,0.0031159233959474806,2019-03-25 15:45:00,2019-03-25 16:00:00
85,2,0,2,0.0031159233959474806,2019-03-25 15:45:00,2019-03-25 16:00:00
87,4,2,2,0.007722870600508471,2019-03-25 15:45:00,2019-03-25 16:00:00
88,3,0,3,0.0031159233959474806,2019-03-25 15:45:00,2019-03-25 16:00:00
89,3,1,2,0.0054817615576330985,2019-03-25 15:45:00,2019-03-25 16:00:00
90,3,3,0,0.014147525787556556,2019-03-25 15:45:00,2019-03-25 16:00:00
101,2,1,1,0.020708983958544487,2019-03-25 15:45:00,2019-03-25 16:00:00
104,1,1,0,0.003998843150497721,2019-03-25 15:45:00,2019-03-25 16:00:00
108,1,1,0,0.004249029271585826,2019-03-25 15:45:00,2019-03-25 16:00:00
109,3,0,3,0.0031159233959474806,2019-03-25 15:45:00,2019-03-25 16:00:00
110,1,0,1,0.0031159233959474806,2019-03-25 15:45:00,2019-03-25 16:00:00
111,4,0,4,0.0031159233959474806,2019-03-25 15:45:00,2019-03-25 16:00:00
112,3,1,2,0.004347958518820959,2019-03-25 15:45:00,2019-03-25 16:00:00
114,2,1,1,0.004347958518820959,2019-03-25 15:45:00,2019-03-25 16:00:00
115,2,1,1,0.020708983958544487,2019-03-25 15:45:00,2019-03-25 16:00:00
116,1,0,1,0.0031159233959474806,2019-03-25 15:45:00,2019-03-25 16:00:00
119,2,2,0,0.005579993641694438,2019-03-25 15:45:00,2019-03-25 16:00:00
120,4,1,3,0.004347958518820959,2019-03-25 15:45:00,2019-03-25 16:00:00
126,4,3,1,0.04375891321138103,2019-03-25 15:45:00,2019-03-25 16:00:00
135,3,1,2,0.005419396998227976,2019-03-25 15:45:00,2019-03-25 16:00:00
137,14,8,6,0.02560964482414989,2019-03-25 15:45:00,2019-03-25 16:00:00
138,4,1,3,0.004347958518820959,2019-03-25 15:45:00,2019-03-25 16:00:00
140,1,1,0,0.004347958518820959,2019-03-25 15:45:00,2019-03-25 16:00:00
141,1,1,0,0.004963976080257699,2019-03-25 15:45:00,2019-03-25 16:00:00
151,2,1,1,0.005764682659598202,2019-03-25 15:45:00,2019-03-25 16:00:00
153,2,1,1,0.008853646468169185,2019-03-25 15:45:00,2019-03-25 16:00:00
154,2,1,1,0.004440303027772841,2019-03-25 15:45:00,2019-03-25 16:00:00
156,1,0,1,0.0031159233959474806,2019-03-25 15:45:00,2019-03-25 16:00:00
157,3,3,0,0.014001431770540302,2019-03-25 15:45:00,2019-03-25 16:00:00
158,2,2,0,0.006143951373545779,2019-03-25 15:45:00,2019-03-25 16:00:00
159,1,1,0,0.004440303027772841,2019-03-25 15:45:00,2019-03-25 16:00:00
160,1,1,0,0.00801635774939115,2019-03-25 15:45:00,2019-03-25 16:00:00
162,1,1,0,0.005764682659598202,2019-03-25 15:45:00,2019-03-25 16:00:00
164,10,6,4,0.011198695421846884,2019-03-25 15:45:00,2019-03-25 16:00:00
168,1,0,1,0.0031159233959474806,2019-03-25 15:45:00,2019-03-25 16:00:00
169,4,1,3,0.004347958518820959,2019-03-25 15:45:00,2019-03-25 16:00:00
170,1,0,1,0.0031159233959474806,2019-03-25 15:45:00,2019-03-25 16:00:00
172,3,0,3,0.0031159233959474806,2019-03-25 15:45:00,2019-03-25 16:00:00
177,2,1,1,0.004440303027772841,2019-03-25 15:45:00,2019-03-25 16:00:00
189,1,0,1,0.0031159233959474806,2019-03-25 15:45:00,2019-03-25 16:00:00
190,2,1,1,0.0403173264803751,2019-03-25 15:45:00,2019-03-25 16:00:00
191,2,0,2,0.0031159233959474806,2019-03-25 15:45:00,2019-03-25 16:00:00
195,4,1,3,0.003998843150497721,2019-03-25 15:45:00,2019-03-25 16:00:00
196,3,3,0,0.011119858219445876,2019-03-25 15:45:00,2019-03-25 16:00:00
197,1,1,0,0.003998843150497721,2019-03-25 15:45:00,2019-03-25 16:00:00
199,1,1,0,0.004347958518820959,2019-03-25 15:45:00,2019-03-25 16:00:00
1,2,2,0,0.004991584281638588,2019-03-25 16:00:00,2019-03-25 16:15:00
2,1,1,0,0.005364435631477821,2019-03-25 16:00:00,2019-03-25 16:15:00
5,2,2,0,0.010435730635392753,2019-03-25 16:00:00,2019-03-25 16:15:00
10,2,2,0,0.005875120282496974,2019-03-25 16:00:00,2019-03-25 16:15:00
15,4,1,3,0.004046074933686099,2019-03-25 16:00:00,2019-03-25 16:15:00
16,5,2,3,0.018429911193935868,2019-03-25 16:00:00,2019-03-25 16:15:00
18,5,4,1,0.015189250650094617,2019-03-25 16:00:00,2019-03-25 16:15:00
19,9,8,1,0.014350154129134932,2019-03-25 16:00:00,2019-03-25 16:15:00
20,1,0,1,0.0028995721709875843,2019-03-25 16:00:00,2019-03-25 16:15:00
21,1,0,1,0.0028995721709875843,2019-03-25 16:00:00,2019-03-25 16:15:00
23,3,3,0,0.009887883778131313,2019-03-25 16:00:00,2019-03-25 16:15:00
26,2,1,1,0.0035157880361101437,2019-03-25 16:00:00,2019-03-25 16:15:00
27,3,2,1,0.005035864582201223,2019-03-25 16:00:00,2019-03-25 16:15:00
28,1,1,0,0.004419648717078664,2019-03-25 16:00:00,2019-03-25 16:15:00
35,4,2,2,0.019258656254600198,2019-03-25 16:00:00,2019-03-25 16:15:00
37,1,0,1,0.0028995721709875843,2019-03-25 16:00:00,2019-03-25 16:15:00
40,8,2,6,0.004814065470396752,2019-03-25 16:00:00,2019-03-25 16:15:00
41,2,2,0,0.007268130810475919,2019-03-25 16:00:00,2019-03-25 16:15:00
46,2,2,0,0.006719067085103305,2019-03-25 16:00:00,2019-03-25 16:15:00
57,4,1,3,0.00439932403696853,2019-03-25 16:00:00,2019-03-25 16:15:00
61,2,1,1,0.019258656254600198,2019-03-25 16:00:00,2019-03-25 16:15:00
62,3,2,1,0.0065109383941763365,2019-03-25 16:00:00,2019-03-25 16:15:00
66,4,2,2,0.01705480640437098,2019-03-25 16:00:00,2019-03-25 16:15:00
67,6,0,6,0.0028995721709875843,2019-03-25 16:00:00,2019-03-25 16:15:00
68,4,4,0,0.009274677707402193,2019-03-25 16:00:00,2019-03-25 16:15:00
69,3,3,0,0.010256835815411907,2019-03-25 16:00:00,2019-03-25 16:15:00
71,1,0,1,0.0028995721709875843,2019-03-25 16:00:00,2019-03-25 16:15:00
74,2,1,1,0.005364435631477821,2019-03-25 16:00:00,2019-03-25 16:15:00
75,1,0,1,0.0028995721709875843,2019-03-25 16:00:00,2019-03-25 16:15:00
79,1,0,1,0.0028995721709875843,2019-03-25 16:00:00,2019-03-25 16:15:00
85,1,1,0,0.006932980007814367,2019-03-25 16:00:00,2019-03-25 16:15:00
87,2,0,2,0.0028995721709875843,2019-03-25 16:00:00,2019-03-25 16:15:00
88,2,0,2,0.0028995721709875843,2019-03-25 16:00:00,2019-03-25 16:15:00
89,2,1,1,0.008122441747757458,2019-03-25 16:00:00,2019-03-25 16:15:00
90,4,2,2,0.018267559529003417,2019-03-25 16:00:00,2019-03-25 16:15:00
99,1,0,1,0.0028995721709875843,2019-03-25 16:00:00,2019-03-25 16:15:00
101,2,1,1,0.019258656254600198,2019-03-25 16:00:00,2019-03-25 16:15:00
108,1,1,0,0.003430553474278328,2019-03-25 16:00:00,2019-03-25 16:15:00
109,1,0,1,0.0028995721709875843,2019-03-25 16:00:00,2019-03-25 16:15:00
110,2,1,1,0.005364435631477821,2019-03-25 16:00:00,2019-03-25 16:15:00
111,4,0,4,0.0028995721709875843,2019-03-25 16:00:00,2019-03-25 16:15:00
112,2,0,2,0.0028995721709875843,2019-03-25 16:00:00,2019-03-25 16:15:00
113,1,0,1,0.0028995721709875843,2019-03-25 16:00:00,2019-03-25 16:15:00
114,4,1,3,0.005364435631477821,2019-03-25 16:00:00,2019-03-25 16:15:00
115,4,2,2,0.019258656254600198,2019-03-25 16:00:00,2019-03-25 16:15:00
116,4,1,3,0.004046074933686099,2019-03-25 16:00:00,2019-03-25 16:15:00
118,4,3,1,0.030164712310341943,2019-03-25 16:00:00,2019-03-25 16:15:00
119,2,1,1,0.0043753684165160275,2019-03-25 16:00:00,2019-03-25 16:15:00
120,3,1,2,0.005043138491945744,2019-03-25 16:00:00,2019-03-25 16:15:00
126,4,2,2,0.011930942932922621,2019-03-25 16:00:00,2019-03-25 16:15:00
127,1,1,0,0.006396068467044075,2019-03-25 16:00:00,2019-03-25 16:15:00
135,5,2,3,0.006692420841944373,2019-03-25 16:00:00,2019-03-25 16:15:00
137,10,5,5,0.02372277173622925,2019-03-25 16:00:00,2019-03-25 16:15:00
138,12,6,6,0.013436225713604014,2019-03-25 16:00:00,2019-03-25 16:15:00
140,1,1,0,0.004132003901232703,2019-03-25 16:00:00,2019-03-25 16:15:00
141,2,1,1,0.005364435631477821,2019-03-25 16:00:00,2019-03-25 16:15:00
147,1,1,0,0.004132003901232703,2019-03-25 16:00:00,2019-03-25 16:15:00
151,1,1,0,0.005364435631477821,2019-03-25 16:00:00,2019-03-25 16:15:00
153,5,2,3,0.005292680058814439,2019-03-25 16:00:00,2019-03-25 16:15:00
154,4,2,2,0.0057752462082261945,2019-03-25 16:00:00,2019-03-25 16:15:00
156,4,0,4,0.0028995721709875843,2019-03-25 16:00:00,2019-03-25 16:15:00
157,4,3,1,0.01499979568146793,2019-03-25 16:00:00,2019-03-25 16:15:00
158,2,2,0,0.008738657612880018,2019-03-25 16:00:00,2019-03-25 16:15:00
159,2,1,1,0.019258656254600198,2019-03-25 16:00:00,2019-03-25 16:15:00
162,1,1,0,0.0035157880361101437,2019-03-25 16:00:00,2019-03-25 16:15:00
164,13,7,6,0.00956093580591171,2019-03-25 16:00:00,2019-03-25 16:15:00
168,1,0,1,0.0028995721709875843,2019-03-25 16:00:00,2019-03-25 16:15:00
169,2,1,1,0.019258656254600198,2019-03-25 16:00:00,2019-03-25 16:15:00
170,1,0,1,0.0028995721709875843,2019-03-25 16:00:00,2019-03-25 16:15:00
173,1,1,0,0.005354300838272787,2019-03-25 16:00:00,2019-03-25 16:15:00
177,3,1,2,0.008225966446917364,2019-03-25 16:00:00,2019-03-25 16:15:00
189,1,0,1,0.0028995721709875843,2019-03-25 16:00:00,2019-03-25 16:15:00
190,4,2,2,0.012531096813175756,2019-03-25 16:00:00,2019-03-25 16:15:00
191,1,0,1,0.0028995721709875843,2019-03-25 16:00:00,2019-03-25 16:15:00
195,10,3,7,0.004372345354317443,2019-03-25 16:00:00,2019-03-25 16:15:00
196,6,3,3,0.00520813990269741,2019-03-25 16:00:00,2019-03-25 16:15:00
197,2,2,0,0.010690829907407601,2019-03-25 16:00:00,2019-03-25 16:15:00
203,3,3,0,0.021358005703388718,2019-03-25 16:00:00,2019-03-25 16:15:00
1,4,3,1,0.01679708258228408,2019-03-25 16:15:00,2019-03-25 16:30:00
2,4,2,2,0.005685253012072599,2019-03-25 16:15:00,2019-03-25 16:30:00
5,3,2,1,0.008974756676788674,2019-03-25 16:15:00,2019-03-25 16:30:00
10,4,3,1,0.011374961275631522,2019-03-25 16:15:00,2019-03-25 16:30:00
15,4,1,3,0.00359596878470956,2019-03-25 16:15:00,2019-03-25 16:30:00
16,2,2,0,0.004854331095337067,2019-03-25 16:15:00,2019-03-25 16:30:00
18,7,2,5,0.006198301673357832,2019-03-25 16:15:00,2019-03-25 16:30:00
19,10,8,2,0.01186732596372003,2019-03-25 16:15:00,2019-03-25 16:30:00
20,2,1,1,0.0029645892315765788,2019-03-25 16:15:00,2019-03-25 16:30:00
21,1,0,1,0.002577026645674536,2019-03-25 16:15:00,2019-03-25 16:30:00
23,3,2,1,0.003625847112190492,2019-03-25 16:15:00,2019-03-25 16:30:00
26,1,1,0,0.0031246863600048374,2019-03-25 16:15:00,2019-03-25 16:30:00
27,2,1,1,0.0036723460743351387,2019-03-25 16:15:00,2019-03-25 16:30:00
28,2,1,1,0.01713984522984063,2019-03-25 16:15:00,2019-03-25 16:30:00
35,4,2,2,0.01713984522984063,2019-03-25 16:15:00,2019-03-25 16:30:00
37,1,0,1,0.002577026645674536,2019-03-25 16:15:00,2019-03-25 16:30:00
41,1,1,0,0.0043401284064076276,2019-03-25 16:15:00,2019-03-25 16:30:00
46,2,1,1,0.0029645892315765788,2019-03-25 16:15:00,2019-03-25 16:30:00
50,1,1,0,0.0043401284064076276,2019-03-25 16:15:00,2019-03-25 16:30:00
57,2,1,1,0.0030151544171387774,2019-03-25 16:15:00,2019-03-25 16:30:00
58,2,2,0,0.008674949032298453,2019-03-25 16:15:00,2019-03-25 16:30:00
61,3,2,1,0.04501984487381333,2019-03-25 16:15:00,2019-03-25 16:30:00
62,3,2,1,0.006672722021573712,2019-03-25 16:15:00,2019-03-25 16:30:00
64,1,0,1,0.002577026645674536,2019-03-25 16:15:00,2019-03-25 16:30:00
66,5,2,3,0.006557612186442288,2019-03-25 16:15:00,2019-03-25 16:30:00
67,5,1,4,0.0031115525110687057,2019-03-25 16:15:00,2019-03-25 16:30:00
68,5,4,1,0.007758923943220582,2019-03-25 16:15:00,2019-03-25 16:30:00
69,1,1,0,0.004767665502995741,2019-03-25 16:15:00,2019-03-25 16:30:00
71,1,0,1,0.002577026645674536,2019-03-25 16:15:00,2019-03-25 16:30:00
74,2,1,1,0.004767665502995741,2019-03-25 16:15:00,2019-03-25 16:30:00
75,1,0,1,0.002577026645674536,2019-03-25 16:15:00,2019-03-25 16:30:00
79,1,0,1,0.002577026645674536,2019-03-25 16:15:00,2019-03-25 16:30:00
87,2,0,2,0.002577026645674536,2019-03-25 16:15:00,2019-03-25 16:30:00
88,2,2,0,0.00784989145138058,2019-03-25 16:15:00,2019-03-25 16:30:00
89,3,1,2,0.004993465522470875,2019-03-25 16:15:00,2019-03-25 16:30:00
90,5,2,3,0.004018406867941828,2019-03-25 16:15:00,2019-03-25 16:30:00
99,1,0,1,0.002577026645674536,2019-03-25 16:15:00,2019-03-25 16:30:00
101,2,1,1,0.01713984522984063,2019-03-25 16:15:00,2019-03-25 16:30:00
104,2,2,0,0.005155228088897784,2019-03-25 16:15:00,2019-03-25 16:30:00
108,1,1,0,0.0031115525110687057,2019-03-25 16:15:00,2019-03-25 16:30:00
109,1,0,1,0.002577026645674536,2019-03-25 16:15:00,2019-03-25 16:30:00
110,4,4,0,0.010095114684461894,2019-03-25 16:15:00,2019-03-25 16:30:00
111,4,0,4,0.002577026645674536,2019-03-25 16:15:00,2019-03-25 16:30:00
114,2,0,2,0.002577026645674536,2019-03-25 16:15:00,2019-03-25 16:30:00
115,2,1,1,0.01713984522984063,2019-03-25 16:15:00,2019-03-25 16:30:00
116,3,1,2,0.004482083164252507,2019-03-25 16:15:00,2019-03-25 16:30:00
118,4,3,1,0.028816438649924607,2019-03-25 16:15:00,2019-03-25 16:30:00
119,4,2,2,0.0057521208433044865,2019-03-25 16:15:00,2019-03-25 16:30:00
120,4,2,2,0.006078023162659099,2019-03-25 16:15:00,2019-03-25 16:30:00
122,1,1,0,0.004699438919492083,2019-03-25 16:15:00,2019-03-25 16:30:00
126,5,2,3,0.014846229456006117,2019-03-25 16:15:00,2019-03-25 16:30:00
127,2,2,0,0.009708428439833043,2019-03-25 16:15:00,2019-03-25 16:30:00
135,1,0,1,0.002577026645674536,2019-03-25 16:15:00,2019-03-25 16:30:00
137,18,9,9,0.018800702942351182,2019-03-25 16:15:00,2019-03-25 16:30:00
138,10,5,5,0.010370175302932461,2019-03-25 16:15:00,2019-03-25 16:30:00
140,3,2,1,0.02442125452192368,2019-03-25 16:15:00,2019-03-25 16:30:00
141,2,1,1,0.01224701424380872,2019-03-25 16:15:00,2019-03-25 16:30:00
147,2,1,1,0.022670084492638423,2019-03-25 16:15:00,2019-03-25 16:30:00
151,1,1,0,0.005663519899014069,2019-03-25 16:15:00,2019-03-25 16:30:00
153,5,0,5,0.002577026645674536,2019-03-25 16:15:00,2019-03-25 16:30:00
154,4,1,3,0.003238284526288449,2019-03-25 16:15:00,2019-03-25 16:30:00
156,4,0,4,0.002577026645674536,2019-03-25 16:15:00,2019-03-25 16:30:00
157,4,3,1,0.007904475827140689,2019-03-25 16:15:00,2019-03-25 16:30:00
158,1,1,0,0.0031246863600048374,2019-03-25 16:15:00,2019-03-25 16:30:00
159,1,1,0,0.02184994188083765,2019-03-25 16:15:00,2019-03-25 16:30:00
162,2,2,0,0.0035628141314690788,2019-03-25 16:15:00,2019-03-25 16:30:00
164,11,2,9,0.004103241456407844,2019-03-25 16:15:00,2019-03-25 16:30:00
170,2,1,1,0.003630844282039786,2019-03-25 16:15:00,2019-03-25 16:30:00
173,4,3,1,0.023635303075306046,2019-03-25 16:15:00,2019-03-25 16:30:00
177,3,1,2,0.015519209915513378,2019-03-25 16:15:00,2019-03-25 16:30:00
190,6,4,2,0.03044648670800508,2019-03-25 16:15:00,2019-03-25 16:30:00
191,1,1,0,0.003630844282039786,2019-03-25 16:15:00,2019-03-25 16:30:00
195,8,2,6,0.0037728103916826188,2019-03-25 16:15:00,2019-03-25 16:30:00
196,3,0,3,0.002577026645674536,2019-03-25 16:15:00,2019-03-25 16:30:00
197,4,3,1,0.02010152640612959,2019-03-25 16:15:00,2019-03-25 16:30:00
201,1,0,1,0.002577026645674536,2019-03-25 16:15:00,2019-03-25 16:30:00
202,1,1,0,0.009172783473231829,2019-03-25 16:15:00,2019-03-25 16:30:00
203,4,3,1,0.020726996990773065,2019-03-25 16:15:00,2019-03-25 16:30:00
1,3,2,1,0.00973667113475604,2019-03-25 16:30:00,2019-03-25 16:45:00
2,4,2,2,0.018997309364769285,2019-03-25 16:30:00,2019-03-25 16:45:00
5,4,3,1,0.005925038883920398,2019-03-25 16:30:00,2019-03-25 16:45:00
10,4,3,1,0.00926637314581312,2019-03-25 16:30:00,2019-03-25 16:45:00
15,4,2,2,0.02669361493439855,2019-03-25 16:30:00,2019-03-25 16:45:00
16,4,3,1,0.01519764778933106,2019-03-25 16:30:00,2019-03-25 16:45:00
18,5,3,2,0.007425831740647152,2019-03-25 16:30:00,2019-03-25 16:45:00
19,10,6,4,0.005753212678718955,2019-03-25 16:30:00,2019-03-25 16:45:00
20,3,2,1,0.0062258088592922305,2019-03-25 16:30:00,2019-03-25 16:45:00
21,3,0,3,0.002425617948196318,2019-03-25 16:30:00,2019-03-25 16:45:00
23,2,0,2,0.002425617948196318,2019-03-25 16:30:00,2019-03-25 16:45:00
26,3,2,1,0.0034565751794049795,2019-03-25 16:30:00,2019-03-25 16:45:00
28,2,1,1,0.01612712470671409,2019-03-25 16:30:00,2019-03-25 16:45:00
35,5,3,2,0.02634957416470799,2019-03-25 16:30:00,2019-03-25 16:45:00
37,1,0,1,0.002425617948196318,2019-03-25 16:30:00,2019-03-25 16:45:00
40,1,0,1,0.002425617948196318,2019-03-25 16:30:00,2019-03-25 16:45:00
46,2,0,2,0.002425617948196318,2019-03-25 16:30:00,2019-03-25 16:45:00
50,3,0,3,0.002425617948196318,2019-03-25 16:30:00,2019-03-25 16:45:00
58,6,5,1,0.008688219504103672,2019-03-25 16:30:00,2019-03-25 16:45:00
61,3,2,1,0.004585511681353067,2019-03-25 16:30:00,2019-03-25 16:45:00
62,4,1,3,0.0031129227690020926,2019-03-25 16:30:00,2019-03-25 16:45:00
64,1,0,1,0.002425617948196318,2019-03-25 16:30:00,2019-03-25 16:45:00
66,2,1,1,0.01612712470671409,2019-03-25 16:30:00,2019-03-25 16:45:00
67,5,2,3,0.011621107773902063,2019-03-25 16:30:00,2019-03-25 16:45:00
68,6,4,2,0.01800242036336907,2019-03-25 16:30:00,2019-03-25 16:45:00
69,1,1,0,0.004487532410613641,2019-03-25 16:30:00,2019-03-25 16:45:00
70,1,1,0,0.0034565751794049795,2019-03-25 16:30:00,2019-03-25 16:45:00
74,3,0,3,0.002425617948196318,2019-03-25 16:30:00,2019-03-25 16:45:00
75,1,0,1,0.002425617948196318,2019-03-25 16:30:00,2019-03-25 16:45:00
79,1,0,1,0.002425617948196318,2019-03-25 16:30:00,2019-03-25 16:45:00
87,1,0,1,0.002425617948196318,2019-03-25 16:30:00,2019-03-25 16:45:00
88,3,3,0,0.010635653819985297,2019-03-25 16:30:00,2019-03-25 16:45:00
89,1,1,0,0.003602639324007678,2019-03-25 16:30:00,2019-03-25 16:45:00
90,5,2,3,0.02132204475923779,2019-03-25 16:30:00,2019-03-25 16:45:00
99,1,0,1,0.002425617948196318,2019-03-25 16:30:00,2019-03-25 16:45:00
101,2,1,1,0.01612712470671409,2019-03-25 16:30:00,2019-03-25 16:45:00
104,4,4,0,0.010030082925825376,2019-03-25 16:30:00,2019-03-25 16:45:00
109,3,1,2,0.0027692703585992053,2019-03-25 16:30:00,2019-03-25 16:45:00
110,6,5,1,0.020182677355505507,2019-03-25 16:30:00,2019-03-25 16:45:00
111,6,0,6,0.002425617948196318,2019-03-25 16:30:00,2019-03-25 16:45:00
112,2,0,2,0.002425617948196318,2019-03-25 16:30:00,2019-03-25 16:45:00
113,1,0,1,0.002425617948196318,2019-03-25 16:30:00,2019-03-25 16:45:00
114,1,0,1,0.002425617948196318,2019-03-25 16:30:00,2019-03-25 16:45:00
115,2,1,1,0.01612712470671409,2019-03-25 16:30:00,2019-03-25 16:45:00
116,2,1,1,0.01612712470671409,2019-03-25 16:30:00,2019-03-25 16:45:00
118,5,3,2,0.02982863146523186,2019-03-25 16:30:00,2019-03-25 16:45:00
119,1,0,1,0.002425617948196318,2019-03-25 16:30:00,2019-03-25 16:45:00
120,3,1,2,0.004218713154538855,2019-03-25 16:30:00,2019-03-25 16:45:00
126,4,1,3,0.0033076749618056894,2019-03-25 16:30:00,2019-03-25 16:45:00
127,3,1,2,0.004487532410613641,2019-03-25 16:30:00,2019-03-25 16:45:00
133,2,2,0,0.007511832687535979,2019-03-25 16:30:00,2019-03-25 16:45:00
135,2,0,2,0.002425617948196318,2019-03-25 16:30:00,2019-03-25 16:45:00
137,12,6,6,0.036115205646853325,2019-03-25 16:30:00,2019-03-25 16:45:00
138,3,1,2,0.004218713154538855,2019-03-25 16:30:00,2019-03-25 16:45:00
141,3,2,1,0.011333660764600262,2019-03-25 16:30:00,2019-03-25 16:45:00
147,2,1,1,0.014941705265962347,2019-03-25 16:30:00,2019-03-25 16:45:00
151,1,1,0,0.007170578888954388,2019-03-25 16:30:00,2019-03-25 16:45:00
153,6,2,4,0.004338632193014351,2019-03-25 16:30:00,2019-03-25 16:45:00
154,3,2,1,0.017066270687496696,2019-03-25 16:30:00,2019-03-25 16:45:00
156,2,1,1,0.0039690338960622976,2019-03-25 16:30:00,2019-03-25 16:45:00
157,1,0,1,0.002425617948196318,2019-03-25 16:30:00,2019-03-25 16:45:00
158,1,1,0,0.0027692703585992053,2019-03-25 16:30:00,2019-03-25 16:45:00
159,1,1,0,0.015128744811279064,2019-03-25 16:30:00,2019-03-25 16:45:00
160,1,1,0,0.005363917278229828,2019-03-25 16:30:00,2019-03-25 16:45:00
162,4,3,1,0.00455042924230885,2019-03-25 16:30:00,2019-03-25 16:45:00
164,9,3,6,0.012268171369456715,2019-03-25 16:30:00,2019-03-25 16:45:00
169,1,1,0,0.004487532410613641,2019-03-25 16:30:00,2019-03-25 16:45:00
170,2,1,1,0.005581844839959507,2019-03-25 16:30:00,2019-03-25 16:45:00
173,3,2,1,0.014721855173608047,2019-03-25 16:30:00,2019-03-25 16:45:00
177,1,0,1,0.002425617948196318,2019-03-25 16:30:00,2019-03-25 16:45:00
190,3,2,1,0.004050164956733264,2019-03-25 16:30:00,2019-03-25 16:45:00
191,1,0,1,0.002425617948196318,2019-03-25 16:30:00,2019-03-25 16:45:00
195,6,2,4,0.007262153429059422,2019-03-25 16:30:00,2019-03-25 16:45:00
196,4,0,4,0.002425617948196318,2019-03-25 16:30:00,2019-03-25 16:45:00
197,3,3,0,0.015035735854270151,2019-03-25 16:30:00,2019-03-25 16:45:00
201,4,3,1,0.03667938484449074,2019-03-25 16:30:00,2019-03-25 16:45:00
202,2,2,0,0.010764996646841857,2019-03-25 16:30:00,2019-03-25 16:45:00
203,4,3,1,0.013250599691849775,2019-03-25 16:30:00,2019-03-25 16:45:00
1,1,1,0,0.006585816903873438,2019-03-25 16:45:00,2019-03-25 17:00:00
2,3,2,1,0.007698593420353951,2019-03-25 16:45:00,2019-03-25 17:00:00
5,4,4,0,0.022814546736555065,2019-03-25 16:45:00,2019-03-25 17:00:00
10,4,2,2,0.008312214752235583,2019-03-25 16:45:00,2019-03-25 17:00:00
15,4,1,3,0.003761321381995284,2019-03-25 16:45:00,2019-03-25 17:00:00
16,1,1,0,0.003841201803014163,2019-03-25 16:45:00,2019-03-25 17:00:00
19,7,5,2,0.0053687952643218665,2019-03-25 16:45:00,2019-03-25 17:00:00
20,1,0,1,0.0026955067070333844,2019-03-25 16:45:00,2019-03-25 17:00:00
21,2,0,2,0.0026955067070333844,2019-03-25 16:45:00,2019-03-25 17:00:00
23,2,1,1,0.003925304216779321,2019-03-25 16:45:00,2019-03-25 17:00:00
26,3,2,1,0.004165851768131689,2019-03-25 16:45:00,2019-03-25 17:00:00
28,2,1,1,0.003841201803014163,2019-03-25 16:45:00,2019-03-25 17:00:00
30,1,1,0,0.0062368371180467775,2019-03-25 16:45:00,2019-03-25 17:00:00
35,5,3,2,0.02771471120772264,2019-03-25 16:45:00,2019-03-25 17:00:00
37,2,1,1,0.00498689689899494,2019-03-25 16:45:00,2019-03-25 17:00:00
46,7,2,5,0.006008439658935303,2019-03-25 16:45:00,2019-03-25 17:00:00
50,3,0,3,0.0026955067070333844,2019-03-25 16:45:00,2019-03-25 17:00:00
57,1,0,1,0.0026955067070333844,2019-03-25 16:45:00,2019-03-25 17:00:00
58,4,3,1,0.01057307722446244,2019-03-25 16:45:00,2019-03-25 17:00:00
61,1,1,0,0.004977476680925505,2019-03-25 16:45:00,2019-03-25 17:00:00
62,3,0,3,0.0026955067070333844,2019-03-25 16:45:00,2019-03-25 17:00:00
64,1,0,1,0.0026955067070333844,2019-03-25 16:45:00,2019-03-25 17:00:00
66,2,1,1,0.01793616842664309,2019-03-25 16:45:00,2019-03-25 17:00:00
67,3,0,3,0.0026955067070333844,2019-03-25 16:45:00,2019-03-25 17:00:00
68,4,2,2,0.006216694408740877,2019-03-25 16:45:00,2019-03-25 17:00:00
70,2,2,0,0.005155101726525258,2019-03-25 16:45:00,2019-03-25 17:00:00
74,2,0,2,0.0026955067070333844,2019-03-25 16:45:00,2019-03-25 17:00:00
79,1,0,1,0.0026955067070333844,2019-03-25 16:45:00,2019-03-25 17:00:00
85,2,1,1,0.01793616842664309,2019-03-25 16:45:00,2019-03-25 17:00:00
86,2,1,1,0.005337893037499448,2019-03-25 16:45:00,2019-03-25 17:00:00
87,4,3,1,0.06735371999289815,2019-03-25 16:45:00,2019-03-25 17:00:00
88,3,3,0,0.009087566499875762,2019-03-25 16:45:00,2019-03-25 17:00:00
89,5,3,2,0.01104166610411006,2019-03-25 16:45:00,2019-03-25 17:00:00
90,3,3,0,0.021347896260000596,2019-03-25 16:45:00,2019-03-25 17:00:00
101,2,1,1,0.01793616842664309,2019-03-25 16:45:00,2019-03-25 17:00:00
104,1,1,0,0.004165851768131689,2019-03-25 16:45:00,2019-03-25 17:00:00
109,9,6,3,0.00928576410483988,2019-03-25 16:45:00,2019-03-25 17:00:00
110,3,2,1,0.01031658132404684,2019-03-25 16:45:00,2019-03-25 17:00:00
111,6,0,6,0.0026955067070333844,2019-03-25 16:45:00,2019-03-25 17:00:00
112,6,1,5,0.007233228491915929,2019-03-25 16:45:00,2019-03-25 17:00:00
113,2,0,2,0.0026955067070333844,2019-03-25 16:45:00,2019-03-25 17:00:00
114,1,1,0,0.003761321381995284,2019-03-25 16:45:00,2019-03-25 17:00:00
115,4,2,2,0.01793616842664309,2019-03-25 16:45:00,2019-03-25 17:00:00
116,3,2,1,0.03965146591007687,2019-03-25 16:45:00,2019-03-25 17:00:00
118,1,1,0,0.0037170494669737466,2019-03-25 16:45:00,2019-03-25 17:00:00
119,1,1,0,0.004688217749316532,2019-03-25 16:45:00,2019-03-25 17:00:00
120,6,3,3,0.011567468020278561,2019-03-25 16:45:00,2019-03-25 17:00:00
122,1,0,1,0.0026955067070333844,2019-03-25 16:45:00,2019-03-25 17:00:00
126,3,1,2,0.0034593034376872367,2019-03-25 16:45:00,2019-03-25 17:00:00
133,2,2,0,0.0059983267770726476,2019-03-25 16:45:00,2019-03-25 17:00:00
135,1,0,1,0.0026955067070333844,2019-03-25 16:45:00,2019-03-25 17:00:00
137,14,9,5,0.04257498900840469,2019-03-25 16:45:00,2019-03-25 17:00:00
138,3,1,2,0.005973391995885842,2019-03-25 16:45:00,2019-03-25 17:00:00
140,2,1,1,0.009934682958719913,2019-03-25 16:45:00,2019-03-25 17:00:00
141,6,3,3,0.014697598368844988,2019-03-25 16:45:00,2019-03-25 17:00:00
147,4,1,3,0.003761321381995284,2019-03-25 16:45:00,2019-03-25 17:00:00
153,4,3,1,0.015949873369206356,2019-03-25 16:45:00,2019-03-25 17:00:00
154,3,0,3,0.0026955067070333844,2019-03-25 16:45:00,2019-03-25 17:00:00
156,1,1,0,0.004165851768131689,2019-03-25 16:45:00,2019-03-25 17:00:00
158,2,1,1,0.005234530046418795,2019-03-25 16:45:00,2019-03-25 17:00:00
160,1,1,0,0.0062368371180467775,2019-03-25 16:45:00,2019-03-25 17:00:00
162,3,2,1,0.004576374333563315,2019-03-25 16:45:00,2019-03-25 17:00:00
164,5,1,4,0.0034229555686941743,2019-03-25 16:45:00,2019-03-25 17:00:00
168,1,0,1,0.0026955067070333844,2019-03-25 16:45:00,2019-03-25 17:00:00
170,2,1,1,0.005326763827334276,2019-03-25 16:45:00,2019-03-25 17:00:00
173,3,2,1,0.013491196535661427,2019-03-25 16:45:00,2019-03-25 17:00:00
189,3,1,2,0.004688217749316532,2019-03-25 16:45:00,2019-03-25 17:00:00
195,3,1,2,0.0034593034376872367,2019-03-25 16:45:00,2019-03-25 17:00:00
196,5,1,4,0.0034593034376872367,2019-03-25 16:45:00,2019-03-25 17:00:00
197,3,2,1,0.005708662192661202,2019-03-25 16:45:00,2019-03-25 17:00:00
199,2,1,1,0.004165851768131689,2019-03-25 16:45:00,2019-03-25 17:00:00
201,1,1,0,0.003841201803014163,2019-03-25 16:45:00,2019-03-25 17:00:00
202,1,1,0,0.003841201803014163,2019-03-25 16:45:00,2019-03-25 17:00:00
203,3,2,1,0.010003835292784547,2019-03-25 16:45:00,2019-03-25 17:00:00
1,1,1,0,0.009066513498738757,2019-03-25 17:00:00,2019-03-25 17:15:00
2,2,1,1,0.007556972713019707,2019-03-25 17:00:00,2019-03-25 17:15:00
5,1,1,0,0.005434331218245274,2019-03-25 17:00:00,2019-03-25 17:15:00
10,1,0,1,0.002937361535720024,2019-03-25 17:00:00,2019-03-25 17:15:00
15,4,1,3,0.004098793898251065,2019-03-25 17:00:00,2019-03-25 17:15:00
16,4,4,0,0.008181747244968748,2019-03-25 17:00:00,2019-03-25 17:15:00
18,2,2,0,0.005434331218245274,2019-03-25 17:00:00,2019-03-25 17:15:00
19,5,3,2,0.005658838815641149,2019-03-25 17:00:00,2019-03-25 17:15:00
20,1,1,0,0.007276759878170752,2019-03-25 17:00:00,2019-03-25 17:15:00
21,3,1,2,0.005108832896889746,2019-03-25 17:00:00,2019-03-25 17:15:00
22,3,1,2,0.005108832896889746,2019-03-25 17:00:00,2019-03-25 17:15:00
23,4,2,2,0.00723079463637372,2019-03-25 17:00:00,2019-03-25 17:15:00
26,2,1,1,0.006993309160430193,2019-03-25 17:00:00,2019-03-25 17:15:00
27,1,1,0,0.0035616039563513367,2019-03-25 17:00:00,2019-03-25 17:15:00
28,3,2,1,0.008918628305838396,2019-03-25 17:00:00,2019-03-25 17:15:00
30,5,3,2,0.01497060538096194,2019-03-25 17:00:00,2019-03-25 17:15:00
35,7,4,3,0.012429813775896026,2019-03-25 17:00:00,2019-03-25 17:15:00
37,2,1,1,0.005434331218245274,2019-03-25 17:00:00,2019-03-25 17:15:00
41,2,2,0,0.011815264364923528,2019-03-25 17:00:00,2019-03-25 17:15:00
46,10,3,7,0.00755040208974545,2019-03-25 17:00:00,2019-03-25 17:15:00
50,1,0,1,0.002937361535720024,2019-03-25 17:00:00,2019-03-25 17:15:00
57,3,3,0,0.01115938198772034,2019-03-25 17:00:00,2019-03-25 17:15:00
58,7,4,3,0.010927998972833888,2019-03-25 17:00:00,2019-03-25 17:15:00
62,7,3,4,0.008173798189792685,2019-03-25 17:00:00,2019-03-25 17:15:00
66,3,1,2,0.005108832896889746,2019-03-25 17:00:00,2019-03-25 17:15:00
67,5,1,4,0.009300677351763986,2019-03-25 17:00:00,2019-03-25 17:15:00
68,3,1,2,0.005026057179296884,2019-03-25 17:00:00,2019-03-25 17:15:00
69,2,2,0,0.007648600864866056,2019-03-25 17:00:00,2019-03-25 17:15:00
70,2,1,1,0.0041341897404590655,2019-03-25 17:00:00,2019-03-25 17:15:00
74,2,1,1,0.005026057179296884,2019-03-25 17:00:00,2019-03-25 17:15:00
80,2,0,2,0.002937361535720024,2019-03-25 17:00:00,2019-03-25 17:15:00
86,2,1,1,0.005073664336903266,2019-03-25 17:00:00,2019-03-25 17:15:00
87,3,2,1,0.033209110612801296,2019-03-25 17:00:00,2019-03-25 17:15:00
88,7,3,4,0.008497440989443033,2019-03-25 17:00:00,2019-03-25 17:15:00
89,2,1,1,0.00385429197006247,2019-03-25 17:00:00,2019-03-25 17:15:00
90,5,2,3,0.006272804774060996,2019-03-25 17:00:00,2019-03-25 17:15:00
101,2,1,1,0.019520883648373816,2019-03-25 17:00:00,2019-03-25 17:15:00
104,4,0,4,0.002937361535720024,2019-03-25 17:00:00,2019-03-25 17:15:00
109,9,6,3,0.01531373998062439,2019-03-25 17:00:00,2019-03-25 17:15:00
110,3,3,0,0.014521017064915267,2019-03-25 17:00:00,2019-03-25 17:15:00
111,7,2,5,0.0053356424100354845,2019-03-25 17:00:00,2019-03-25 17:15:00
112,8,2,6,0.008447250563231055,2019-03-25 17:00:00,2019-03-25 17:15:00
113,1,0,1,0.002937361535720024,2019-03-25 17:00:00,2019-03-25 17:15:00
114,2,1,1,0.004098793898251065,2019-03-25 17:00:00,2019-03-25 17:15:00
115,6,3,3,0.019520883648373816,2019-03-25 17:00:00,2019-03-25 17:15:00
116,3,2,1,0.018495530485057893,2019-03-25 17:00:00,2019-03-25 17:15:00
118,3,2,1,0.004771222404404916,2019-03-25 17:00:00,2019-03-25 17:15:00
119,2,1,1,0.004185846376982649,2019-03-25 17:00:00,2019-03-25 17:15:00
120,3,1,2,0.005108832896889746,2019-03-25 17:00:00,2019-03-25 17:15:00
126,6,2,4,0.008232783366140445,2019-03-25 17:00:00,2019-03-25 17:15:00
127,4,4,0,0.012093018472121858,2019-03-25 17:00:00,2019-03-25 17:15:00
137,16,7,9,0.012695295661049382,2019-03-25 17:00:00,2019-03-25 17:15:00
138,2,1,1,0.005108832896889746,2019-03-25 17:00:00,2019-03-25 17:15:00
140,1,1,0,0.004136501972877754,2019-03-25 17:00:00,2019-03-25 17:15:00
141,4,1,3,0.007280304258059468,2019-03-25 17:00:00,2019-03-25 17:15:00
147,4,2,2,0.006305661101628788,2019-03-25 17:00:00,2019-03-25 17:15:00
153,3,2,1,0.008385291550507455,2019-03-25 17:00:00,2019-03-25 17:15:00
158,1,0,1,0.002937361535720024,2019-03-25 17:00:00,2019-03-25 17:15:00
162,2,1,1,0.007209967138086507,2019-03-25 17:00:00,2019-03-25 17:15:00
164,9,2,7,0.003879647345469979,2019-03-25 17:00:00,2019-03-25 17:15:00
168,1,0,1,0.002937361535720024,2019-03-25 17:00:00,2019-03-25 17:15:00
169,1,0,1,0.002937361535720024,2019-03-25 17:00:00,2019-03-25 17:15:00
170,3,3,0,0.011549336114045083,2019-03-25 17:00:00,2019-03-25 17:15:00
171,2,2,0,0.022182876895522004,2019-03-25 17:00:00,2019-03-25 17:15:00
173,2,1,1,0.00385429197006247,2019-03-25 17:00:00,2019-03-25 17:15:00
177,1,1,0,0.0046744929362279785,2019-03-25 17:00:00,2019-03-25 17:15:00
189,2,0,2,0.002937361535720024,2019-03-25 17:00:00,2019-03-25 17:15:00
195,3,1,2,0.004914015351972935,2019-03-25 17:00:00,2019-03-25 17:15:00
196,1,0,1,0.002937361535720024,2019-03-25 17:00:00,2019-03-25 17:15:00
197,4,3,1,0.009383059408635524,2019-03-25 17:00:00,2019-03-25 17:15:00
199,4,3,1,0.0059354990037650025,2019-03-25 17:00:00,2019-03-25 17:15:00
201,5,4,1,0.05507619767529298,2019-03-25 17:00:00,2019-03-25 17:15:00
203,1,1,0,0.005434331218245274,2019-03-25 17:00:00,2019-03-25 17:15:00
1,2,2,0,0.013620079714959118,2019-03-25 17:15:00,2019-03-25 17:30:00
2,3,1,2,0.005401952770879386,2019-03-25 17:15:00,2019-03-25 17:30:00
5,2,2,0,0.017380085673857598,2019-03-25 17:15:00,2019-03-25 17:30:00
10,1,1,0,0.008417665403967935,2019-03-25 17:15:00,2019-03-25 17:30:00
15,2,1,1,0.005078383096676982,2019-03-25 17:15:00,2019-03-25 17:30:00
16,7,4,3,0.012812687732049695,2019-03-25 17:15:00,2019-03-25 17:30:00
18,3,3,0,0.006433918072250862,2019-03-25 17:15:00,2019-03-25 17:30:00
19,11,7,4,0.0374253654459439,2019-03-25 17:15:00,2019-03-25 17:30:00
20,4,3,1,0.015549836359985405,2019-03-25 17:15:00,2019-03-25 17:30:00
21,2,1,1,0.01933271046052809,2019-03-25 17:15:00,2019-03-25 17:30:00
22,3,2,1,0.005401952770879386,2019-03-25 17:15:00,2019-03-25 17:30:00
23,2,1,1,0.004173155630507761,2019-03-25 17:15:00,2019-03-25 17:30:00
26,7,3,4,0.00939542082653235,2019-03-25 17:15:00,2019-03-25 17:30:00
27,2,1,1,0.005401952770879386,2019-03-25 17:15:00,2019-03-25 17:30:00
28,2,2,0,0.00999402259537119,2019-03-25 17:15:00,2019-03-25 17:30:00
30,3,1,2,0.005078383096676982,2019-03-25 17:15:00,2019-03-25 17:30:00
35,3,1,2,0.004270428252782612,2019-03-25 17:15:00,2019-03-25 17:30:00
37,1,0,1,0.0029198642317492985,2019-03-25 17:15:00,2019-03-25 17:30:00
41,2,2,0,0.00600502083176965,2019-03-25 17:15:00,2019-03-25 17:30:00
46,7,3,4,0.008170279717274785,2019-03-25 17:15:00,2019-03-25 17:30:00
57,7,6,1,0.019894220064010572,2019-03-25 17:15:00,2019-03-25 17:30:00
58,6,2,4,0.005897270146338266,2019-03-25 17:15:00,2019-03-25 17:30:00
62,6,3,3,0.007120268011846967,2019-03-25 17:15:00,2019-03-25 17:30:00
64,1,1,0,0.005078383096676982,2019-03-25 17:15:00,2019-03-25 17:30:00
66,3,1,2,0.005078383096676982,2019-03-25 17:15:00,2019-03-25 17:30:00
67,6,2,4,0.006354956003975898,2019-03-25 17:15:00,2019-03-25 17:30:00
68,3,2,1,0.009182399126423053,2019-03-25 17:15:00,2019-03-25 17:30:00
69,1,1,0,0.003747227078125994,2019-03-25 17:15:00,2019-03-25 17:30:00
74,1,1,0,0.004196437139048215,2019-03-25 17:15:00,2019-03-25 17:30:00
80,2,0,2,0.0029198642317492985,2019-03-25 17:15:00,2019-03-25 17:30:00
87,3,1,2,0.005078383096676982,2019-03-25 17:15:00,2019-03-25 17:30:00
88,5,2,3,0.005302393554154088,2019-03-25 17:15:00,2019-03-25 17:30:00
90,2,1,1,0.010873889884753211,2019-03-25 17:15:00,2019-03-25 17:30:00
101,2,1,1,0.01933271046052809,2019-03-25 17:15:00,2019-03-25 17:30:00
104,1,0,1,0.0029198642317492985,2019-03-25 17:15:00,2019-03-25 17:30:00
109,5,3,2,0.015796488415209503,2019-03-25 17:15:00,2019-03-25 17:30:00
110,2,2,0,0.01193673915863939,2019-03-25 17:15:00,2019-03-25 17:30:00
111,7,1,6,0.004196437139048215,2019-03-25 17:15:00,2019-03-25 17:30:00
112,3,0,3,0.0029198642317492985,2019-03-25 17:15:00,2019-03-25 17:30:00
114,1,0,1,0.0029198642317492985,2019-03-25 17:15:00,2019-03-25 17:30:00
115,4,2,2,0.01933271046052809,2019-03-25 17:15:00,2019-03-25 17:30:00
116,6,3,3,0.009691365595561347,2019-03-25 17:15:00,2019-03-25 17:30:00
118,1,0,1,0.0029198642317492985,2019-03-25 17:15:00,2019-03-25 17:30:00
119,2,1,1,0.003514415380650628,2019-03-25 17:15:00,2019-03-25 17:30:00
120,7,3,4,0.012790287113346472,2019-03-25 17:15:00,2019-03-25 17:30:00
122,1,1,0,0.006550534832259685,2019-03-25 17:15:00,2019-03-25 17:30:00
126,9,3,6,0.009882270283459277,2019-03-25 17:15:00,2019-03-25 17:30:00
127,5,3,2,0.008672869219253225,2019-03-25 17:15:00,2019-03-25 17:30:00
133,4,2,2,0.01933271046052809,2019-03-25 17:15:00,2019-03-25 17:30:00
137,11,4,7,0.008497560858602546,2019-03-25 17:15:00,2019-03-25 17:30:00
138,5,3,2,0.011730082737214183,2019-03-25 17:15:00,2019-03-25 17:30:00
140,4,4,0,0.023375793147561948,2019-03-25 17:15:00,2019-03-25 17:30:00
141,2,1,1,0.007905826219124137,2019-03-25 17:15:00,2019-03-25 17:30:00
147,2,2,0,0.008339296902617798,2019-03-25 17:15:00,2019-03-25 17:30:00
153,2,1,1,0.005078383096676982,2019-03-25 17:15:00,2019-03-25 17:30:00
154,1,1,0,0.004173155630507761,2019-03-25 17:15:00,2019-03-25 17:30:00
156,2,0,2,0.0029198642317492985,2019-03-25 17:15:00,2019-03-25 17:30:00
158,3,1,2,0.009634393879881534,2019-03-25 17:15:00,2019-03-25 17:30:00
164,6,2,4,0.007159729428323368,2019-03-25 17:15:00,2019-03-25 17:30:00
168,1,1,0,0.003951829533120774,2019-03-25 17:15:00,2019-03-25 17:30:00
169,1,0,1,0.0029198642317492985,2019-03-25 17:15:00,2019-03-25 17:30:00
170,2,1,1,0.006550534832259685,2019-03-25 17:15:00,2019-03-25 17:30:00
171,2,2,0,0.007481156669941584,2019-03-25 17:15:00,2019-03-25 17:30:00
172,2,1,1,0.006467373193899487,2019-03-25 17:15:00,2019-03-25 17:30:00
173,2,1,1,0.004656225876773222,2019-03-25 17:15:00,2019-03-25 17:30:00
175,3,1,2,0.005078383096676982,2019-03-25 17:15:00,2019-03-25 17:30:00
177,2,2,0,0.007419577820494761,2019-03-25 17:15:00,2019-03-25 17:30:00
189,1,0,1,0.0029198642317492985,2019-03-25 17:15:00,2019-03-25 17:30:00
190,1,0,1,0.0029198642317492985,2019-03-25 17:15:00,2019-03-25 17:30:00
191,3,1,2,0.004604886238403761,2019-03-25 17:15:00,2019-03-25 17:30:00
195,6,2,4,0.006006789897806536,2019-03-25 17:15:00,2019-03-25 17:30:00
196,2,0,2,0.0029198642317492985,2019-03-25 17:15:00,2019-03-25 17:30:00
197,6,3,3,0.005946515275387993,2019-03-25 17:15:00,2019-03-25 17:30:00
201,5,3,2,0.010848699802585425,2019-03-25 17:15:00,2019-03-25 17:30:00
203,2,1,1,0.005215899143995201,2019-03-25 17:15:00,2019-03-25 17:30:00
1,1,1,0,0.005295840355820147,2019-03-25 17:30:00,2019-03-25 17:45:00
2,2,1,1,0.005883712394014303,2019-03-25 17:30:00,2019-03-25 17:45:00
5,4,4,0,0.023388041460565147,2019-03-25 17:30:00,2019-03-25 17:45:00
10,2,1,1,0.005883712394014303,2019-03-25 17:30:00,2019-03-25 17:45:00
15,2,2,0,0.00659327511585628,2019-03-25 17:30:00,2019-03-25 17:45:00
16,5,3,2,0.009375152465068608,2019-03-25 17:30:00,2019-03-25 17:45:00
18,5,5,0,0.010248292783019568,2019-03-25 17:30:00,2019-03-25 17:45:00
19,11,6,5,0.012443207678922449,2019-03-25 17:30:00,2019-03-25 17:45:00
20,3,2,1,0.00765537470325821,2019-03-25 17:30:00,2019-03-25 17:45:00
22,1,0,1,0.003180250465303313,2019-03-25 17:30:00,2019-03-25 17:45:00
23,4,1,3,0.014708109445967982,2019-03-25 17:30:00,2019-03-25 17:45:00
26,8,3,5,0.007447414083374879,2019-03-25 17:30:00,2019-03-25 17:45:00
30,2,0,2,0.003180250465303313,2019-03-25 17:30:00,2019-03-25 17:45:00
35,3,1,2,0.00408140444154031,2019-03-25 17:30:00,2019-03-25 17:45:00
37,1,0,1,0.003180250465303313,2019-03-25 17:30:00,2019-03-25 17:45:00
41,1,1,0,0.013412844880666564,2019-03-25 17:30:00,2019-03-25 17:45:00
46,2,1,1,0.005131132087335547,2019-03-25 17:30:00,2019-03-25 17:45:00
57,5,4,1,0.013560366116896531,2019-03-25 17:30:00,2019-03-25 17:45:00
58,2,0,2,0.003180250465303313,2019-03-25 17:30:00,2019-03-25 17:45:00
61,1,1,0,0.004446450637379817,2019-03-25 17:30:00,2019-03-25 17:45:00
62,3,0,3,0.003180250465303313,2019-03-25 17:30:00,2019-03-25 17:45:00
64,4,2,2,0.010233421009109598,2019-03-25 17:30:00,2019-03-25 17:45:00
66,4,2,2,0.00892455232768407,2019-03-25 17:30:00,2019-03-25 17:45:00
67,5,3,2,0.00976592000510049,2019-03-25 17:30:00,2019-03-25 17:45:00
68,1,0,1,0.003180250465303313,2019-03-25 17:30:00,2019-03-25 17:45:00
69,3,1,2,0.00408140444154031,2019-03-25 17:30:00,2019-03-25 17:45:00
70,2,2,0,0.008587174322725292,2019-03-25 17:30:00,2019-03-25 17:45:00
74,1,0,1,0.003180250465303313,2019-03-25 17:30:00,2019-03-25 17:45:00
80,2,0,2,0.003180250465303313,2019-03-25 17:30:00,2019-03-25 17:45:00
86,1,1,0,0.004915013739221872,2019-03-25 17:30:00,2019-03-25 17:45:00
87,3,1,2,0.005531307313238741,2019-03-25 17:30:00,2019-03-25 17:45:00
88,2,2,0,0.009282124450719994,2019-03-25 17:30:00,2019-03-25 17:45:00
90,2,1,1,0.005295840355820147,2019-03-25 17:30:00,2019-03-25 17:45:00
101,2,1,1,0.021012276466563645,2019-03-25 17:30:00,2019-03-25 17:45:00
109,5,1,4,0.004038519009344302,2019-03-25 17:30:00,2019-03-25 17:45:00
110,1,1,0,0.005131132087335547,2019-03-25 17:30:00,2019-03-25 17:45:00
111,5,1,4,0.006679425766826435,2019-03-25 17:30:00,2019-03-25 17:45:00
112,3,0,3,0.003180250465303313,2019-03-25 17:30:00,2019-03-25 17:45:00
113,3,0,3,0.003180250465303313,2019-03-25 17:30:00,2019-03-25 17:45:00
114,3,3,0,0.009601036512565145,2019-03-25 17:30:00,2019-03-25 17:45:00
115,4,2,2,0.021012276466563645,2019-03-25 17:30:00,2019-03-25 17:45:00
116,6,3,3,0.01057097370366067,2019-03-25 17:30:00,2019-03-25 17:45:00
119,2,2,0,0.005500947233842906,2019-03-25 17:30:00,2019-03-25 17:45:00
120,9,3,6,0.014143439078097592,2019-03-25 17:30:00,2019-03-25 17:45:00
126,7,6,1,0.02208802906567802,2019-03-25 17:30:00,2019-03-25 17:45:00
127,5,2,3,0.004939672985581298,2019-03-25 17:30:00,2019-03-25 17:45:00
133,4,2,2,0.021012276466563645,2019-03-25 17:30:00,2019-03-25 17:45:00
137,11,5,6,0.013769304424436841,2019-03-25 17:30:00,2019-03-25 17:45:00
138,4,4,0,0.010458172575816098,2019-03-25 17:30:00,2019-03-25 17:45:00
140,2,2,0,0.011685030971734272,2019-03-25 17:30:00,2019-03-25 17:45:00
141,2,2,0,0.008181906251392692,2019-03-25 17:30:00,2019-03-25 17:45:00
153,2,1,1,0.006973670705651836,2019-03-25 17:30:00,2019-03-25 17:45:00
154,1,1,0,0.004531981429658808,2019-03-25 17:30:00,2019-03-25 17:45:00
157,3,1,2,0.005883712394014303,2019-03-25 17:30:00,2019-03-25 17:45:00
162,1,1,0,0.009108609381287252,2019-03-25 17:30:00,2019-03-25 17:45:00
164,7,2,5,0.006246125580732945,2019-03-25 17:30:00,2019-03-25 17:45:00
168,2,1,1,0.005131132087335547,2019-03-25 17:30:00,2019-03-25 17:45:00
170,1,1,0,0.0071651529566721245,2019-03-25 17:30:00,2019-03-25 17:45:00
172,1,0,1,0.003180250465303313,2019-03-25 17:30:00,2019-03-25 17:45:00
173,2,0,2,0.003180250465303313,2019-03-25 17:30:00,2019-03-25 17:45:00
175,1,0,1,0.003180250465303313,2019-03-25 17:30:00,2019-03-25 17:45:00
177,2,2,0,0.006784866370251299,2019-03-25 17:30:00,2019-03-25 17:45:00
189,1,0,1,0.003180250465303313,2019-03-25 17:30:00,2019-03-25 17:45:00
190,1,0,1,0.003180250465303313,2019-03-25 17:30:00,2019-03-25 17:45:00
191,3,1,2,0.007348151571972652,2019-03-25 17:30:00,2019-03-25 17:45:00
195,4,2,2,0.008232396804924757,2019-03-25 17:30:00,2019-03-25 17:45:00
196,2,0,2,0.003180250465303313,2019-03-25 17:30:00,2019-03-25 17:45:00
197,4,2,2,0.02407315479638032,2019-03-25 17:30:00,2019-03-25 17:45:00
201,7,4,3,0.014125811334061038,2019-03-25 17:30:00,2019-03-25 17:45:00
202,1,0,1,0.003180250465303313,2019-03-25 17:30:00,2019-03-25 17:45:00
203,2,1,1,0.008181906251392692,2019-03-25 17:30:00,2019-03-25 17:45:00
1,1,1,0,0.00934708946548769,2019-03-25 17:45:00,2019-03-25 18:00:00
2,1,1,0,0.009107931620610552,2019-03-25 17:45:00,2019-03-25 18:00:00
5,2,2,0,0.009351902893634835,2019-03-25 17:45:00,2019-03-25 18:00:00
10,3,2,1,0.010526465397869144,2019-03-25 17:45:00,2019-03-25 18:00:00
15,4,3,1,0.007827055128931894,2019-03-25 17:45:00,2019-03-25 18:00:00
16,3,1,2,0.0047832816029004166,2019-03-25 17:45:00,2019-03-25 18:00:00
18,4,3,1,0.005545398569286151,2019-03-25 17:45:00,2019-03-25 18:00:00
19,5,1,4,0.005160439702571642,2019-03-25 17:45:00,2019-03-25 18:00:00
20,2,1,1,0.003919096768897253,2019-03-25 17:45:00,2019-03-25 18:00:00
23,8,4,4,0.012169309586626192,2019-03-25 17:45:00,2019-03-25 18:00:00
26,5,3,2,0.012791655443453571,2019-03-25 17:45:00,2019-03-25 18:00:00
28,4,2,2,0.01829858324006464,2019-03-25 17:45:00,2019-03-25 18:00:00
30,1,0,1,0.0027501703202188936,2019-03-25 17:45:00,2019-03-25 18:00:00
35,1,0,1,0.0027501703202188936,2019-03-25 17:45:00,2019-03-25 18:00:00
37,2,1,1,0.0074788566181065354,2019-03-25 17:45:00,2019-03-25 18:00:00
46,7,1,6,0.0032041308027787024,2019-03-25 17:45:00,2019-03-25 18:00:00
57,6,4,2,0.013557850153147763,2019-03-25 17:45:00,2019-03-25 18:00:00
58,3,3,0,0.01005362132536394,2019-03-25 17:45:00,2019-03-25 18:00:00
61,1,1,0,0.00818765196436358,2019-03-25 17:45:00,2019-03-25 18:00:00
62,3,0,3,0.0027501703202188936,2019-03-25 17:45:00,2019-03-25 18:00:00
64,3,1,2,0.0047832816029004166,2019-03-25 17:45:00,2019-03-25 18:00:00
66,3,2,1,0.04779642499006968,2019-03-25 17:45:00,2019-03-25 18:00:00
67,6,2,4,0.007425876114932331,2019-03-25 17:45:00,2019-03-25 18:00:00
68,6,3,3,0.00850590918934348,2019-03-25 17:45:00,2019-03-25 18:00:00
69,6,3,3,0.007993862450000331,2019-03-25 17:45:00,2019-03-25 18:00:00
70,3,1,2,0.005088023217575613,2019-03-25 17:45:00,2019-03-25 18:00:00
74,1,0,1,0.0027501703202188936,2019-03-25 17:45:00,2019-03-25 18:00:00
80,2,0,2,0.0027501703202188936,2019-03-25 17:45:00,2019-03-25 18:00:00
87,3,1,2,0.0047832816029004166,2019-03-25 17:45:00,2019-03-25 18:00:00
88,1,0,1,0.0027501703202188936,2019-03-25 17:45:00,2019-03-25 18:00:00
89,3,2,1,0.05431908412356653,2019-03-25 17:45:00,2019-03-25 18:00:00
90,1,1,0,0.007189391460451383,2019-03-25 17:45:00,2019-03-25 18:00:00
101,2,1,1,0.01829858324006464,2019-03-25 17:45:00,2019-03-25 18:00:00
104,1,1,0,0.0032041308027787024,2019-03-25 17:45:00,2019-03-25 18:00:00
109,3,0,3,0.0027501703202188936,2019-03-25 17:45:00,2019-03-25 18:00:00
110,2,1,1,0.007189391460451383,2019-03-25 17:45:00,2019-03-25 18:00:00
111,2,2,0,0.013608493400463394,2019-03-25 17:45:00,2019-03-25 18:00:00
112,6,2,4,0.005906487966471038,2019-03-25 17:45:00,2019-03-25 18:00:00
113,2,0,2,0.0027501703202188936,2019-03-25 17:45:00,2019-03-25 18:00:00
114,3,3,0,0.0076744213918965515,2019-03-25 17:45:00,2019-03-25 18:00:00
115,4,2,2,0.01829858324006464,2019-03-25 17:45:00,2019-03-25 18:00:00
116,7,3,4,0.007588632312182704,2019-03-25 17:45:00,2019-03-25 18:00:00
118,1,0,1,0.0027501703202188936,2019-03-25 17:45:00,2019-03-25 18:00:00
119,1,0,1,0.0027501703202188936,2019-03-25 17:45:00,2019-03-25 18:00:00
120,5,3,2,0.01699143467336165,2019-03-25 17:45:00,2019-03-25 18:00:00
126,6,4,2,0.015519092404260627,2019-03-25 17:45:00,2019-03-25 18:00:00
127,4,1,3,0.0035294546193378,2019-03-25 17:45:00,2019-03-25 18:00:00
133,1,0,1,0.0027501703202188936,2019-03-25 17:45:00,2019-03-25 18:00:00
137,19,14,5,0.02610987840060397,2019-03-25 17:45:00,2019-03-25 18:00:00
138,12,6,6,0.038379753522142256,2019-03-25 17:45:00,2019-03-25 18:00:00
140,3,2,1,0.005562565902019322,2019-03-25 17:45:00,2019-03-25 18:00:00
141,3,3,0,0.009413267312506116,2019-03-25 17:45:00,2019-03-25 18:00:00
151,2,2,0,0.0072805504113877435,2019-03-25 17:45:00,2019-03-25 18:00:00
153,2,1,1,0.0037502758635126645,2019-03-25 17:45:00,2019-03-25 18:00:00
157,3,1,2,0.005088023217575613,2019-03-25 17:45:00,2019-03-25 18:00:00
158,3,1,2,0.0047832816029004166,2019-03-25 17:45:00,2019-03-25 18:00:00
162,1,1,0,0.005938209972440969,2019-03-25 17:45:00,2019-03-25 18:00:00
164,10,2,8,0.004304259142934178,2019-03-25 17:45:00,2019-03-25 18:00:00
168,1,0,1,0.0027501703202188936,2019-03-25 17:45:00,2019-03-25 18:00:00
170,1,0,1,0.0027501703202188936,2019-03-25 17:45:00,2019-03-25 18:00:00
171,1,1,0,0.004912792367684145,2019-03-25 17:45:00,2019-03-25 18:00:00
172,1,0,1,0.0027501703202188936,2019-03-25 17:45:00,2019-03-25 18:00:00
173,2,0,2,0.0027501703202188936,2019-03-25 17:45:00,2019-03-25 18:00:00
177,1,1,0,0.0035294546193378,2019-03-25 17:45:00,2019-03-25 18:00:00
189,1,0,1,0.0027501703202188936,2019-03-25 17:45:00,2019-03-25 18:00:00
190,1,1,0,0.0038468837912236384,2019-03-25 17:45:00,2019-03-25 18:00:00
191,1,1,0,0.0053365684945398326,2019-03-25 17:45:00,2019-03-25 18:00:00
195,3,2,1,0.005583593067647583,2019-03-25 17:45:00,2019-03-25 18:00:00
196,2,1,1,0.01829858324006464,2019-03-25 17:45:00,2019-03-25 18:00:00
197,2,1,1,0.0038468837912236384,2019-03-25 17:45:00,2019-03-25 18:00:00
201,7,3,4,0.007063792454686716,2019-03-25 17:45:00,2019-03-25 18:00:00
202,2,1,1,0.007189391460451383,2019-03-25 17:45:00,2019-03-25 18:00:00
203,2,2,0,0.005752623425553681,2019-03-25 17:45:00,2019-03-25 18:00:00
1,4,1,3,0.004956225082732156,2019-03-25 18:00:00,2019-03-25 18:15:00
2,2,2,0,0.016957256024976455,2019-03-25 18:00:00,2019-03-25 18:15:00
5,2,1,1,0.006631326305156695,2019-03-25 18:00:00,2019-03-25 18:15:00
10,2,1,1,0.004457716513565808,2019-03-25 18:00:00,2019-03-25 18:15:00
15,2,1,1,0.003404750889483405,2019-03-25 18:00:00,2019-03-25 18:15:00
16,4,2,2,0.010930193315133806,2019-03-25 18:00:00,2019-03-25 18:15:00
18,5,4,1,0.014573066625153406,2019-03-25 18:00:00,2019-03-25 18:15:00
19,2,0,2,0.002841847967512736,2019-03-25 18:00:00,2019-03-25 18:15:00
20,1,1,0,0.004246239217386624,2019-03-25 18:00:00,2019-03-25 18:15:00
23,6,1,5,0.0033109337358216266,2019-03-25 18:00:00,2019-03-25 18:15:00
26,5,2,3,0.006873470923236475,2019-03-25 18:00:00,2019-03-25 18:15:00
27,2,1,1,0.004789533161660994,2019-03-25 18:00:00,2019-03-25 18:15:00
28,2,1,1,0.018845479303817143,2019-03-25 18:00:00,2019-03-25 18:15:00
30,1,0,1,0.002841847967512736,2019-03-25 18:00:00,2019-03-25 18:15:00
35,2,2,0,0.005406607634973786,2019-03-25 18:00:00,2019-03-25 18:15:00
37,2,1,1,0.012277512699503886,2019-03-25 18:00:00,2019-03-25 18:15:00
46,7,1,6,0.0033109337358216266,2019-03-25 18:00:00,2019-03-25 18:15:00
57,13,8,5,0.02733294288624518,2019-03-25 18:00:00,2019-03-25 18:15:00
58,3,2,1,0.0062186127799198545,2019-03-25 18:00:00,2019-03-25 18:15:00
62,6,3,3,0.0075264330713526225,2019-03-25 18:00:00,2019-03-25 18:15:00
64,4,1,3,0.003965498212448354,2019-03-25 18:00:00,2019-03-25 18:15:00
66,2,1,1,0.018845479303817143,2019-03-25 18:00:00,2019-03-25 18:15:00
67,4,1,3,0.004049725172348069,2019-03-25 18:00:00,2019-03-25 18:15:00
68,8,3,5,0.007504902867054638,2019-03-25 18:00:00,2019-03-25 18:15:00
69,3,1,2,0.004117792828461508,2019-03-25 18:00:00,2019-03-25 18:15:00
70,3,1,2,0.004942667918971083,2019-03-25 18:00:00,2019-03-25 18:15:00
74,1,1,0,0.004117792828461508,2019-03-25 18:00:00,2019-03-25 18:15:00
80,2,0,2,0.002841847967512736,2019-03-25 18:00:00,2019-03-25 18:15:00
87,7,3,4,0.01413711017982555,2019-03-25 18:00:00,2019-03-25 18:15:00
88,1,0,1,0.002841847967512736,2019-03-25 18:00:00,2019-03-25 18:15:00
89,6,2,4,0.004942667918971083,2019-03-25 18:00:00,2019-03-25 18:15:00
90,4,3,1,0.0086208979442306,2019-03-25 18:00:00,2019-03-25 18:15:00
101,2,1,1,0.018845479303817143,2019-03-25 18:00:00,2019-03-25 18:15:00
104,1,1,0,0.0033109337358216266,2019-03-25 18:00:00,2019-03-25 18:15:00
109,7,4,3,0.012746174707511276,2019-03-25 18:00:00,2019-03-25 18:15:00
110,2,1,1,0.006520077992772254,2019-03-25 18:00:00,2019-03-25 18:15:00
111,3,3,0,0.01289597412263478,2019-03-25 18:00:00,2019-03-25 18:15:00
112,6,4,2,0.015268059338346348,2019-03-25 18:00:00,2019-03-25 18:15:00
113,1,0,1,0.002841847967512736,2019-03-25 18:00:00,2019-03-25 18:15:00
114,3,3,0,0.01930335340710785,2019-03-25 18:00:00,2019-03-25 18:15:00
115,4,2,2,0.018845479303817143,2019-03-25 18:00:00,2019-03-25 18:15:00
116,3,1,2,0.004942667918971083,2019-03-25 18:00:00,2019-03-25 18:15:00
118,1,0,1,0.002841847967512736,2019-03-25 18:00:00,2019-03-25 18:15:00
119,2,0,2,0.002841847967512736,2019-03-25 18:00:00,2019-03-25 18:15:00
120,5,3,2,0.014005331262928205,2019-03-25 18:00:00,2019-03-25 18:15:00
122,3,3,0,0.013402168399164128,2019-03-25 18:00:00,2019-03-25 18:15:00
126,3,1,2,0.004974543349455079,2019-03-25 18:00:00,2019-03-25 18:15:00
127,8,4,4,0.009827962786264865,2019-03-25 18:00:00,2019-03-25 18:15:00
135,4,1,3,0.003965498212448354,2019-03-25 18:00:00,2019-03-25 18:15:00
137,18,11,7,0.030287661150742783,2019-03-25 18:00:00,2019-03-25 18:15:00
138,10,3,7,0.01330522736561339,2019-03-25 18:00:00,2019-03-25 18:15:00
140,3,2,1,0.01109949492396497,2019-03-25 18:00:00,2019-03-25 18:15:00
141,1,0,1,0.002841847967512736,2019-03-25 18:00:00,2019-03-25 18:15:00
151,3,3,0,0.012219181755801972,2019-03-25 18:00:00,2019-03-25 18:15:00
153,3,1,2,0.004930514127014913,2019-03-25 18:00:00,2019-03-25 18:15:00
154,2,0,2,0.002841847967512736,2019-03-25 18:00:00,2019-03-25 18:15:00
157,2,1,1,0.004049725172348069,2019-03-25 18:00:00,2019-03-25 18:15:00
158,3,1,2,0.004942667918971083,2019-03-25 18:00:00,2019-03-25 18:15:00
162,1,1,0,0.004457716513565808,2019-03-25 18:00:00,2019-03-25 18:15:00
164,9,3,6,0.006125448345674972,2019-03-25 18:00:00,2019-03-25 18:15:00
168,3,3,0,0.010667393786340663,2019-03-25 18:00:00,2019-03-25 18:15:00
170,1,0,1,0.002841847967512736,2019-03-25 18:00:00,2019-03-25 18:15:00
171,1,1,0,0.004942667918971083,2019-03-25 18:00:00,2019-03-25 18:15:00
173,6,4,2,0.031719815638933536,2019-03-25 18:00:00,2019-03-25 18:15:00
175,1,1,0,0.003965498212448354,2019-03-25 18:00:00,2019-03-25 18:15:00
191,1,1,0,0.003404750889483405,2019-03-25 18:00:00,2019-03-25 18:15:00
195,5,4,1,0.010016961362109332,2019-03-25 18:00:00,2019-03-25 18:15:00
196,2,1,1,0.018845479303817143,2019-03-25 18:00:00,2019-03-25 18:15:00
199,2,1,1,0.0069133386756813926,2019-03-25 18:00:00,2019-03-25 18:15:00
201,4,1,3,0.003965498212448354,2019-03-25 18:00:00,2019-03-25 18:15:00
202,1,1,0,0.006520077992772254,2019-03-25 18:00:00,2019-03-25 18:15:00
203,2,2,0,0.005089148457383973,2019-03-25 18:00:00,2019-03-25 18:15:00
1,3,0,3,0.0033355537625780825,2019-03-25 18:15:00,2019-03-25 18:30:00
2,1,1,0,0.005880301978340267,2019-03-25 18:15:00,2019-03-25 18:30:00
5,2,1,1,0.006171061697561448,2019-03-25 18:15:00,2019-03-25 18:30:00
10,1,0,1,0.0033355537625780825,2019-03-25 18:15:00,2019-03-25 18:30:00
16,1,1,0,0.007897821664560857,2019-03-25 18:15:00,2019-03-25 18:30:00
18,4,4,0,0.01396179597838404,2019-03-25 18:15:00,2019-03-25 18:30:00
19,1,0,1,0.0033355537625780825,2019-03-25 18:15:00,2019-03-25 18:30:00
20,1,1,0,0.004280723074239204,2019-03-25 18:15:00,2019-03-25 18:30:00
23,4,0,4,0.0033355537625780825,2019-03-25 18:15:00,2019-03-25 18:30:00
26,3,1,2,0.005928424008000846,2019-03-25 18:15:00,2019-03-25 18:30:00
28,2,1,1,0.022176902583018517,2019-03-25 18:15:00,2019-03-25 18:30:00
35,1,1,0,0.004753307730069765,2019-03-25 18:15:00,2019-03-25 18:30:00
40,1,0,1,0.0033355537625780825,2019-03-25 18:15:00,2019-03-25 18:30:00
46,1,0,1,0.0033355537625780825,2019-03-25 18:15:00,2019-03-25 18:30:00
57,4,3,1,0.009345863960296002,2019-03-25 18:15:00,2019-03-25 18:30:00
58,1,0,1,0.0033355537625780825,2019-03-25 18:15:00,2019-03-25 18:30:00
62,6,3,3,0.008611197531576773,2019-03-25 18:15:00,2019-03-25 18:30:00
64,1,0,1,0.0033355537625780825,2019-03-25 18:15:00,2019-03-25 18:30:00
66,2,1,1,0.022176902583018517,2019-03-25 18:15:00,2019-03-25 18:30:00
67,1,0,1,0.0033355537625780825,2019-03-25 18:15:00,2019-03-25 18:30:00
68,2,0,2,0.0033355537625780825,2019-03-25 18:15:00,2019-03-25 18:30:00
69,2,0,2,0.0033355537625780825,2019-03-25 18:15:00,2019-03-25 18:30:00
70,2,1,1,0.022176902583018517,2019-03-25 18:15:00,2019-03-25 18:30:00
80,2,0,2,0.0033355537625780825,2019-03-25 18:15:00,2019-03-25 18:30:00
85,1,0,1,0.0033355537625780825,2019-03-25 18:15:00,2019-03-25 18:30:00
87,4,2,2,0.010733329599544223,2019-03-25 18:15:00,2019-03-25 18:30:00
89,4,1,3,0.004654464704827755,2019-03-25 18:15:00,2019-03-25 18:30:00
90,2,2,0,0.005973375647077428,2019-03-25 18:15:00,2019-03-25 18:30:00
101,2,1,1,0.022176902583018517,2019-03-25 18:15:00,2019-03-25 18:30:00
109,4,2,2,0.008375448283718319,2019-03-25 18:15:00,2019-03-25 18:30:00
110,2,2,0,0.008715809913323633,2019-03-25 18:15:00,2019-03-25 18:30:00
111,2,2,0,0.007588815665053131,2019-03-25 18:15:00,2019-03-25 18:30:00
112,2,2,0,0.016611501910686798,2019-03-25 18:15:00,2019-03-25 18:30:00
113,2,0,2,0.0033355537625780825,2019-03-25 18:15:00,2019-03-25 18:30:00
114,2,2,0,0.005462184713815606,2019-03-25 18:15:00,2019-03-25 18:30:00
115,4,2,2,0.022176902583018517,2019-03-25 18:15:00,2019-03-25 18:30:00
116,3,1,2,0.005801479041566796,2019-03-25 18:15:00,2019-03-25 18:30:00
120,5,3,2,0.020853529494404947,2019-03-25 18:15:00,2019-03-25 18:30:00
122,2,2,0,0.008763931942984212,2019-03-25 18:15:00,2019-03-25 18:30:00
126,1,1,0,0.005775689596593407,2019-03-25 18:15:00,2019-03-25 18:30:00
127,2,2,0,0.005225892385900326,2019-03-25 18:15:00,2019-03-25 18:30:00
137,8,4,4,0.011973599368020643,2019-03-25 18:15:00,2019-03-25 18:30:00
138,5,1,4,0.012199704290085376,2019-03-25 18:15:00,2019-03-25 18:30:00
141,1,0,1,0.0033355537625780825,2019-03-25 18:15:00,2019-03-25 18:30:00
151,3,3,0,0.009006569632544814,2019-03-25 18:15:00,2019-03-25 18:30:00
153,2,0,2,0.0033355537625780825,2019-03-25 18:15:00,2019-03-25 18:30:00
154,2,0,2,0.0033355537625780825,2019-03-25 18:15:00,2019-03-25 18:30:00
157,1,1,0,0.006171061697561448,2019-03-25 18:15:00,2019-03-25 18:30:00
158,2,1,1,0.022176902583018517,2019-03-25 18:15:00,2019-03-25 18:30:00
162,1,1,0,0.005928424008000846,2019-03-25 18:15:00,2019-03-25 18:30:00
164,4,1,3,0.004654464704827755,2019-03-25 18:15:00,2019-03-25 18:30:00
168,1,1,0,0.006171061697561448,2019-03-25 18:15:00,2019-03-25 18:30:00
170,1,0,1,0.0033355537625780825,2019-03-25 18:15:00,2019-03-25 18:30:00
173,4,3,1,0.050438925813679175,2019-03-25 18:15:00,2019-03-25 18:30:00
175,1,1,0,0.006171061697561448,2019-03-25 18:15:00,2019-03-25 18:30:00
189,1,0,1,0.0033355537625780825,2019-03-25 18:15:00,2019-03-25 18:30:00
191,2,2,0,0.006589178962086108,2019-03-25 18:15:00,2019-03-25 18:30:00
195,5,4,1,0.012566657519472705,2019-03-25 18:15:00,2019-03-25 18:30:00
199,1,0,1,0.0033355537625780825,2019-03-25 18:15:00,2019-03-25 18:30:00
16,1,1,0,0.004822923547935105,2019-03-25 18:30:00,2019-03-25 18:45:00
18,3,3,0,0.009917461889515202,2019-03-25 18:30:00,2019-03-25 18:45:00
23,2,0,2,0.003797942175647796,2019-03-25 18:30:00,2019-03-25 18:45:00
26,2,0,2,0.003797942175647796,2019-03-25 18:30:00,2019-03-25 18:45:00
28,2,1,1,0.02523553491382778,2019-03-25 18:30:00,2019-03-25 18:45:00
37,2,0,2,0.003797942175647796,2019-03-25 18:30:00,2019-03-25 18:45:00
40,1,0,1,0.003797942175647796,2019-03-25 18:30:00,2019-03-25 18:45:00
57,2,2,0,0.010255098865444642,2019-03-25 18:30:00,2019-03-25 18:45:00
58,1,1,0,0.005412231348097008,2019-03-25 18:30:00,2019-03-25 18:45:00
62,5,3,2,0.012221220355163149,2019-03-25 18:30:00,2019-03-25 18:45:00
66,3,1,2,0.00660570156881958,2019-03-25 18:30:00,2019-03-25 18:45:00
67,2,0,2,0.003797942175647796,2019-03-25 18:30:00,2019-03-25 18:45:00
68,2,0,2,0.003797942175647796,2019-03-25 18:30:00,2019-03-25 18:45:00
69,2,0,2,0.003797942175647796,2019-03-25 18:30:00,2019-03-25 18:45:00
70,2,1,1,0.02523553491382778,2019-03-25 18:30:00,2019-03-25 18:45:00
80,2,0,2,0.003797942175647796,2019-03-25 18:30:00,2019-03-25 18:45:00
85,1,0,1,0.003797942175647796,2019-03-25 18:30:00,2019-03-25 18:45:00
87,5,1,4,0.004822923547935105,2019-03-25 18:30:00,2019-03-25 18:45:00
88,1,1,0,0.004822923547935105,2019-03-25 18:30:00,2019-03-25 18:45:00
89,1,1,0,0.007026520520546219,2019-03-25 18:30:00,2019-03-25 18:45:00
90,1,0,1,0.003797942175647796,2019-03-25 18:30:00,2019-03-25 18:45:00
101,2,1,1,0.02523553491382778,2019-03-25 18:30:00,2019-03-25 18:45:00
109,3,2,1,0.007026520520546219,2019-03-25 18:30:00,2019-03-25 18:45:00
110,1,1,0,0.007026520520546219,2019-03-25 18:30:00,2019-03-25 18:45:00
115,4,2,2,0.02523553491382778,2019-03-25 18:30:00,2019-03-25 18:45:00
116,1,0,1,0.003797942175647796,2019-03-25 18:30:00,2019-03-25 18:45:00
120,3,1,2,0.00660570156881958,2019-03-25 18:30:00,2019-03-25 18:45:00
122,1,1,0,0.007026520520546219,2019-03-25 18:30:00,2019-03-25 18:45:00
126,1,1,0,0.008992642010264725,2019-03-25 18:30:00,2019-03-25 18:45:00
137,4,2,2,0.006801429203259926,2019-03-25 18:30:00,2019-03-25 18:45:00
138,2,1,1,0.00660570156881958,2019-03-25 18:30:00,2019-03-25 18:45:00
141,1,1,0,0.004822923547935105,2019-03-25 18:30:00,2019-03-25 18:45:00
147,2,1,1,0.02523553491382778,2019-03-25 18:30:00,2019-03-25 18:45:00
153,1,0,1,0.003797942175647796,2019-03-25 18:30:00,2019-03-25 18:45:00
158,2,1,1,0.02523553491382778,2019-03-25 18:30:00,2019-03-25 18:45:00
162,1,1,0,0.009413460961991364,2019-03-25 18:30:00,2019-03-25 18:45:00
164,4,1,3,0.0052996856894538605,2019-03-25 18:30:00,2019-03-25 18:45:00
169,1,0,1,0.003797942175647796,2019-03-25 18:30:00,2019-03-25 18:45:00
172,1,1,0,0.005412231348097008,2019-03-25 18:30:00,2019-03-25 18:45:00
173,4,4,0,0.011869388037893853,2019-03-25 18:30:00,2019-03-25 18:45:00
189,1,0,1,0.003797942175647796,2019-03-25 18:30:00,2019-03-25 18:45:00
191,2,2,0,0.008303172717065991,2019-03-25 18:30:00,2019-03-25 18:45:00
195,2,2,0,0.011385437285871419,2019-03-25 18:30:00,2019-03-25 18:45:00
196,1,1,0,0.00660570156881958,2019-03-25 18:30:00,2019-03-25 18:45:00
202,2,2,0,0.008640809692995431,2019-03-25 18:30:00,2019-03-25 18:45:00
5,1,1,0,0.006669140379402818,2019-03-25 18:45:00,2019-03-25 19:00:00
16,1,0,1,0.0036047698301521626,2019-03-25 18:45:00,2019-03-25 19:00:00
18,4,4,0,0.011988559175657842,2019-03-25 18:45:00,2019-03-25 19:00:00
23,2,0,2,0.0036047698301521626,2019-03-25 18:45:00,2019-03-25 19:00:00
27,2,0,2,0.0036047698301521626,2019-03-25 18:45:00,2019-03-25 19:00:00
30,1,1,0,0.006669140379402818,2019-03-25 18:45:00,2019-03-25 19:00:00
37,3,1,2,0.006669140379402818,2019-03-25 18:45:00,2019-03-25 19:00:00
41,1,0,1,0.0036047698301521626,2019-03-25 18:45:00,2019-03-25 19:00:00
46,4,2,2,0.02395866913877615,2019-03-25 18:45:00,2019-03-25 19:00:00
57,2,1,1,0.006669140379402818,2019-03-25 18:45:00,2019-03-25 19:00:00
58,1,1,0,0.00513695510477749,2019-03-25 18:45:00,2019-03-25 19:00:00
62,6,2,4,0.007384377046142936,2019-03-25 18:45:00,2019-03-25 19:00:00
66,3,1,2,0.006269731145276594,2019-03-25 18:45:00,2019-03-25 19:00:00
67,2,0,2,0.0036047698301521626,2019-03-25 18:45:00,2019-03-25 19:00:00
68,4,1,3,0.006669140379402818,2019-03-25 18:45:00,2019-03-25 19:00:00
69,2,0,2,0.0036047698301521626,2019-03-25 18:45:00,2019-03-25 19:00:00
70,2,1,1,0.02395866913877615,2019-03-25 18:45:00,2019-03-25 19:00:00
80,2,0,2,0.0036047698301521626,2019-03-25 18:45:00,2019-03-25 19:00:00
85,2,0,2,0.0036047698301521626,2019-03-25 18:45:00,2019-03-25 19:00:00
87,4,1,3,0.005030135216993765,2019-03-25 18:45:00,2019-03-25 19:00:00
88,2,2,0,0.00809450576624442,2019-03-25 18:45:00,2019-03-25 19:00:00
89,1,1,0,0.006669140379402818,2019-03-25 18:45:00,2019-03-25 19:00:00
101,2,1,1,0.02395866913877615,2019-03-25 18:45:00,2019-03-25 19:00:00
104,1,1,0,0.00513695510477749,2019-03-25 18:45:00,2019-03-25 19:00:00
109,2,2,0,0.007796664502905002,2019-03-25 18:45:00,2019-03-25 19:00:00
110,1,1,0,0.006669140379402818,2019-03-25 18:45:00,2019-03-25 19:00:00
111,1,0,1,0.0036047698301521626,2019-03-25 18:45:00,2019-03-25 19:00:00
112,3,1,2,0.005494573438147549,2019-03-25 18:45:00,2019-03-25 19:00:00
115,4,2,2,0.02395866913877615,2019-03-25 18:45:00,2019-03-25 19:00:00
116,1,0,1,0.0036047698301521626,2019-03-25 18:45:00,2019-03-25 19:00:00
120,3,1,2,0.006269731145276594,2019-03-25 18:45:00,2019-03-25 19:00:00
126,1,1,0,0.0051741389996484595,2019-03-25 18:45:00,2019-03-25 19:00:00
127,1,0,1,0.0036047698301521626,2019-03-25 18:45:00,2019-03-25 19:00:00
137,7,3,4,0.012514478145537047,2019-03-25 18:45:00,2019-03-25 19:00:00
138,2,2,0,0.008605192952085556,2019-03-25 18:45:00,2019-03-25 19:00:00
140,1,0,1,0.0036047698301521626,2019-03-25 18:45:00,2019-03-25 19:00:00
141,1,1,0,0.005030135216993765,2019-03-25 18:45:00,2019-03-25 19:00:00
147,2,1,1,0.02395866913877615,2019-03-25 18:45:00,2019-03-25 19:00:00
153,3,2,1,0.01080636592876365,2019-03-25 18:45:00,2019-03-25 19:00:00
154,1,0,1,0.0036047698301521626,2019-03-25 18:45:00,2019-03-25 19:00:00
158,2,1,1,0.02395866913877615,2019-03-25 18:45:00,2019-03-25 19:00:00
164,7,4,3,0.011600000592929018,2019-03-25 18:45:00,2019-03-25 19:00:00
169,1,0,1,0.0036047698301521626,2019-03-25 18:45:00,2019-03-25 19:00:00
172,2,2,0,0.00797166051677057,2019-03-25 18:45:00,2019-03-25 19:00:00
173,4,4,0,0.017387875533748355,2019-03-25 18:45:00,2019-03-25 19:00:00
177,2,1,1,0.02395866913877615,2019-03-25 18:45:00,2019-03-25 19:00:00
189,1,0,1,0.0036047698301521626,2019-03-25 18:45:00,2019-03-25 19:00:00
191,2,2,0,0.007796664502905002,2019-03-25 18:45:00,2019-03-25 19:00:00
195,1,1,0,0.00513695510477749,2019-03-25 18:45:00,2019-03-25 19:00:00
196,1,1,0,0.006269731145276594,2019-03-25 18:45:00,2019-03-25 19:00:00
197,1,1,0,0.006669140379402818,2019-03-25 18:45:00,2019-03-25 19:00:00
202,1,1,0,0.006439475242145242,2019-03-25 18:45:00,2019-03-25 19:00:00
5,1,1,0,0.00657585433390706,2019-03-25 19:00:00,2019-03-25 19:15:00
15,3,1,2,0.006182006066805645,2019-03-25 19:00:00,2019-03-25 19:15:00
16,2,0,2,0.0035543619297110445,2019-03-25 19:00:00,2019-03-25 19:15:00
18,4,4,0,0.014263794761028747,2019-03-25 19:00:00,2019-03-25 19:15:00
19,1,0,1,0.0035543619297110445,2019-03-25 19:00:00,2019-03-25 19:15:00
23,1,0,1,0.0035543619297110445,2019-03-25 19:00:00,2019-03-25 19:15:00
27,2,0,2,0.0035543619297110445,2019-03-25 19:00:00,2019-03-25 19:15:00
30,1,1,0,0.00657585433390706,2019-03-25 19:00:00,2019-03-25 19:15:00
37,1,0,1,0.0035543619297110445,2019-03-25 19:00:00,2019-03-25 19:15:00
41,1,0,1,0.0035543619297110445,2019-03-25 19:00:00,2019-03-25 19:15:00
57,2,1,1,0.006182006066805645,2019-03-25 19:00:00,2019-03-25 19:15:00
62,4,0,4,0.0035543619297110445,2019-03-25 19:00:00,2019-03-25 19:15:00
66,3,1,2,0.006182006066805645,2019-03-25 19:00:00,2019-03-25 19:15:00
67,2,0,2,0.0035543619297110445,2019-03-25 19:00:00,2019-03-25 19:15:00
68,2,1,1,0.00657585433390706,2019-03-25 19:00:00,2019-03-25 19:15:00
69,2,0,2,0.0035543619297110445,2019-03-25 19:00:00,2019-03-25 19:15:00
70,1,1,0,0.00657585433390706,2019-03-25 19:00:00,2019-03-25 19:15:00
74,1,0,1,0.0035543619297110445,2019-03-25 19:00:00,2019-03-25 19:15:00
80,2,0,2,0.0035543619297110445,2019-03-25 19:00:00,2019-03-25 19:15:00
85,2,0,2,0.0035543619297110445,2019-03-25 19:00:00,2019-03-25 19:15:00
87,2,1,1,0.023614286016599543,2019-03-25 19:00:00,2019-03-25 19:15:00
89,1,0,1,0.0035543619297110445,2019-03-25 19:00:00,2019-03-25 19:15:00
101,2,1,1,0.023614286016599543,2019-03-25 19:00:00,2019-03-25 19:15:00
104,1,1,0,0.005065108131809052,2019-03-25 19:00:00,2019-03-25 19:15:00
108,1,1,0,0.005065108131809052,2019-03-25 19:00:00,2019-03-25 19:15:00
109,4,3,1,0.010419824547467904,2019-03-25 19:00:00,2019-03-25 19:15:00
111,1,0,1,0.0035543619297110445,2019-03-25 19:00:00,2019-03-25 19:15:00
112,3,1,2,0.009144414277827731,2019-03-25 19:00:00,2019-03-25 19:15:00
115,4,2,2,0.023614286016599543,2019-03-25 19:00:00,2019-03-25 19:15:00
116,3,1,2,0.006182006066805645,2019-03-25 19:00:00,2019-03-25 19:15:00
118,1,1,0,0.006182006066805645,2019-03-25 19:00:00,2019-03-25 19:15:00
120,3,1,2,0.006182006066805645,2019-03-25 19:00:00,2019-03-25 19:15:00
126,1,1,0,0.0043097350307600485,2019-03-25 19:00:00,2019-03-25 19:15:00
127,1,0,1,0.0035543619297110445,2019-03-25 19:00:00,2019-03-25 19:15:00
133,1,0,1,0.0035543619297110445,2019-03-25 19:00:00,2019-03-25 19:15:00
135,1,0,1,0.0035543619297110445,2019-03-25 19:00:00,2019-03-25 19:15:00
137,9,5,4,0.018087111537760443,2019-03-25 19:00:00,2019-03-25 19:15:00
138,2,2,0,0.010068819312744271,2019-03-25 19:00:00,2019-03-25 19:15:00
147,2,1,1,0.023614286016599543,2019-03-25 19:00:00,2019-03-25 19:15:00
153,3,3,0,0.01976328866999595,2019-03-25 19:00:00,2019-03-25 19:15:00
154,1,0,1,0.0035543619297110445,2019-03-25 19:00:00,2019-03-25 19:15:00
158,2,1,1,0.023614286016599543,2019-03-25 19:00:00,2019-03-25 19:15:00
159,1,1,0,0.00657585433390706,2019-03-25 19:00:00,2019-03-25 19:15:00
164,7,4,3,0.008121957009717427,2019-03-25 19:00:00,2019-03-25 19:15:00
168,1,1,0,0.006182006066805645,2019-03-25 19:00:00,2019-03-25 19:15:00
172,4,3,1,0.011108092940201084,2019-03-25 19:00:00,2019-03-25 19:15:00
173,3,3,0,0.008086600536005068,2019-03-25 19:00:00,2019-03-25 19:15:00
177,2,1,1,0.023614286016599543,2019-03-25 19:00:00,2019-03-25 19:15:00
191,4,3,1,0.01927772128615031,2019-03-25 19:00:00,2019-03-25 19:15:00
195,1,1,0,0.005065108131809052,2019-03-25 19:00:00,2019-03-25 19:15:00
197,2,2,0,0.02296403354784277,2019-03-25 19:00:00,2019-03-25 19:15:00
1,1,1,0,0.004895261513277611,2019-03-25 19:15:00,2019-03-25 19:30:00
16,3,0,3,0.003508108207090922,2019-03-25 19:15:00,2019-03-25 19:30:00
18,6,5,1,0.017749991926887365,2019-03-25 19:15:00,2019-03-25 19:30:00
19,3,2,1,0.006490321649287388,2019-03-25 19:15:00,2019-03-25 19:30:00
20,1,1,0,0.008260611337151346,2019-03-25 19:15:00,2019-03-25 19:30:00
23,4,1,3,0.004895261513277611,2019-03-25 19:15:00,2019-03-25 19:30:00
26,1,0,1,0.003508108207090922,2019-03-25 19:15:00,2019-03-25 19:30:00
28,1,1,0,0.006490321649287388,2019-03-25 19:15:00,2019-03-25 19:30:00
57,1,1,0,0.012489424115440028,2019-03-25 19:15:00,2019-03-25 19:30:00
62,3,0,3,0.003508108207090922,2019-03-25 19:15:00,2019-03-25 19:30:00
66,3,1,2,0.00610162956493388,2019-03-25 19:15:00,2019-03-25 19:30:00
67,1,0,1,0.003508108207090922,2019-03-25 19:15:00,2019-03-25 19:30:00
68,4,2,2,0.007830643803495853,2019-03-25 19:15:00,2019-03-25 19:30:00
74,1,0,1,0.003508108207090922,2019-03-25 19:15:00,2019-03-25 19:30:00
80,2,0,2,0.003508108207090922,2019-03-25 19:15:00,2019-03-25 19:30:00
87,2,1,1,0.02329121239678604,2019-03-25 19:15:00,2019-03-25 19:30:00
89,1,0,1,0.003508108207090922,2019-03-25 19:15:00,2019-03-25 19:30:00
90,1,0,1,0.003508108207090922,2019-03-25 19:15:00,2019-03-25 19:30:00
101,2,1,1,0.02329121239678604,2019-03-25 19:15:00,2019-03-25 19:30:00
108,1,1,0,0.004502179354489744,2019-03-25 19:15:00,2019-03-25 19:30:00
109,3,2,1,0.00748439279668621,2019-03-25 19:15:00,2019-03-25 19:30:00
112,1,1,0,0.006836572656097031,2019-03-25 19:15:00,2019-03-25 19:30:00
114,1,0,1,0.003508108207090922,2019-03-25 19:15:00,2019-03-25 19:30:00
115,4,2,2,0.02329121239678604,2019-03-25 19:15:00,2019-03-25 19:30:00
116,4,2,2,0.021128472679281092,2019-03-25 19:15:00,2019-03-25 19:30:00
120,3,1,2,0.00610162956493388,2019-03-25 19:15:00,2019-03-25 19:30:00
127,2,0,2,0.003508108207090922,2019-03-25 19:15:00,2019-03-25 19:30:00
133,1,0,1,0.003508108207090922,2019-03-25 19:15:00,2019-03-25 19:30:00
137,7,4,3,0.014605334656584434,2019-03-25 19:15:00,2019-03-25 19:30:00
138,1,1,0,0.00610162956493388,2019-03-25 19:15:00,2019-03-25 19:30:00
147,2,1,1,0.02329121239678604,2019-03-25 19:15:00,2019-03-25 19:30:00
153,3,1,2,0.011180796204115283,2019-03-25 19:15:00,2019-03-25 19:30:00
158,2,1,1,0.02329121239678604,2019-03-25 19:15:00,2019-03-25 19:30:00
159,1,1,0,0.006490321649287388,2019-03-25 19:15:00,2019-03-25 19:30:00
164,7,4,3,0.009056721431837677,2019-03-25 19:15:00,2019-03-25 19:30:00
168,1,1,0,0.00610162956493388,2019-03-25 19:15:00,2019-03-25 19:30:00
172,2,1,1,0.009025531704640365,2019-03-25 19:15:00,2019-03-25 19:30:00
177,2,1,1,0.02329121239678604,2019-03-25 19:15:00,2019-03-25 19:30:00
190,1,1,0,0.008260611337151346,2019-03-25 19:15:00,2019-03-25 19:30:00
191,7,4,3,0.030486080363385945,2019-03-25 19:15:00,2019-03-25 19:30:00
195,1,1,0,0.006490321649287388,2019-03-25 19:15:00,2019-03-25 19:30:00
196,1,1,0,0.012147156770931986,2019-03-25 19:15:00,2019-03-25 19:30:00
197,1,1,0,0.012147156770931986,2019-03-25 19:15:00,2019-03-25 19:30:00
1,2,1,1,0.004124459902430323,2019-03-25 19:30:00,2019-03-25 19:45:00
16,4,0,4,0.0034015557654225835,2019-03-25 19:30:00,2019-03-25 19:45:00
18,2,2,0,0.0062931723134535406,2019-03-25 19:30:00,2019-03-25 19:45:00
19,10,6,4,0.009417651247609723,2019-03-25 19:30:00,2019-03-25 19:45:00
20,1,0,1,0.0034015557654225835,2019-03-25 19:30:00,2019-03-25 19:45:00
23,4,0,4,0.0034015557654225835,2019-03-25 19:30:00,2019-03-25 19:45:00
35,1,1,0,0.004124459902430323,2019-03-25 19:30:00,2019-03-25 19:45:00
41,1,1,0,0.0062931723134535406,2019-03-25 19:30:00,2019-03-25 19:45:00
57,2,1,1,0.010979439751384767,2019-03-25 19:30:00,2019-03-25 19:45:00
66,4,2,2,0.010945746724476546,2019-03-25 19:30:00,2019-03-25 19:45:00
67,1,0,1,0.0034015557654225835,2019-03-25 19:30:00,2019-03-25 19:45:00
68,2,1,1,0.004124459902430323,2019-03-25 19:30:00,2019-03-25 19:45:00
70,1,1,0,0.0069077178148574305,2019-03-25 19:30:00,2019-03-25 19:45:00
74,1,0,1,0.0034015557654225835,2019-03-25 19:30:00,2019-03-25 19:45:00
80,2,0,2,0.0034015557654225835,2019-03-25 19:30:00,2019-03-25 19:45:00
86,1,1,0,0.004124459902430323,2019-03-25 19:30:00,2019-03-25 19:45:00
87,2,1,1,0.022633349263842348,2019-03-25 19:30:00,2019-03-25 19:45:00
88,1,1,0,0.0069077178148574305,2019-03-25 19:30:00,2019-03-25 19:45:00
90,2,1,1,0.003963046779694536,2019-03-25 19:30:00,2019-03-25 19:45:00
101,2,1,1,0.022633349263842348,2019-03-25 19:30:00,2019-03-25 19:45:00
108,1,1,0,0.004124459902430323,2019-03-25 19:30:00,2019-03-25 19:45:00
109,1,1,0,0.006770501851054299,2019-03-25 19:30:00,2019-03-25 19:45:00
115,5,3,2,0.03542181549560984,2019-03-25 19:30:00,2019-03-25 19:45:00
116,4,2,2,0.017825735370557382,2019-03-25 19:30:00,2019-03-25 19:45:00
120,5,3,2,0.0159600667453934,2019-03-25 19:30:00,2019-03-25 19:45:00
122,2,1,1,0.004124459902430323,2019-03-25 19:30:00,2019-03-25 19:45:00
126,1,1,0,0.0069077178148574305,2019-03-25 19:30:00,2019-03-25 19:45:00
127,3,0,3,0.0034015557654225835,2019-03-25 19:30:00,2019-03-25 19:45:00
137,4,2,2,0.004524537793966488,2019-03-25 19:30:00,2019-03-25 19:45:00
138,4,1,3,0.010186372424147147,2019-03-25 19:30:00,2019-03-25 19:45:00
147,1,0,1,0.0034015557654225835,2019-03-25 19:30:00,2019-03-25 19:45:00
153,5,3,2,0.009406046482259414,2019-03-25 19:30:00,2019-03-25 19:45:00
158,3,1,2,0.005916286085107237,2019-03-25 19:30:00,2019-03-25 19:45:00
159,1,1,0,0.0062931723134535406,2019-03-25 19:30:00,2019-03-25 19:45:00
164,7,1,6,0.003963046779694536,2019-03-25 19:30:00,2019-03-25 19:45:00
168,1,1,0,0.008054130176445589,2019-03-25 19:30:00,2019-03-25 19:45:00
173,4,2,2,0.022633349263842348,2019-03-25 19:30:00,2019-03-25 19:45:00
177,2,1,1,0.022633349263842348,2019-03-25 19:30:00,2019-03-25 19:45:00
189,1,1,0,0.005916286085107237,2019-03-25 19:30:00,2019-03-25 19:45:00
190,1,1,0,0.007399659029839673,2019-03-25 19:30:00,2019-03-25 19:45:00
191,6,4,2,0.016105334426307186,2019-03-25 19:30:00,2019-03-25 19:45:00
195,3,3,0,0.012071636022107625,2019-03-25 19:30:00,2019-03-25 19:45:00
196,3,2,1,0.06802725048809742,2019-03-25 19:30:00,2019-03-25 19:45:00
197,1,0,1,0.0034015557654225835,2019-03-25 19:30:00,2019-03-25 19:45:00
199,1,1,0,0.007399659029839673,2019-03-25 19:30:00,2019-03-25 19:45:00
5,1,0,1,0.0034845787286789296,2019-03-25 19:45:00,2019-03-25 20:00:00
16,3,1,2,0.006446788896520152,2019-03-25 19:45:00,2019-03-25 20:00:00
19,7,3,4,0.005648334463596573,2019-03-25 19:45:00,2019-03-25 20:00:00
20,1,0,1,0.0034845787286789296,2019-03-25 19:45:00,2019-03-25 20:00:00
23,3,0,3,0.0034845787286789296,2019-03-25 19:45:00,2019-03-25 20:00:00
35,1,1,0,0.006224790300974376,2019-03-25 19:45:00,2019-03-25 20:00:00
46,2,2,0,0.007927893980440763,2019-03-25 19:45:00,2019-03-25 20:00:00
57,4,2,2,0.010541610309114283,2019-03-25 19:45:00,2019-03-25 20:00:00
66,3,2,1,0.042892518500397235,2019-03-25 19:45:00,2019-03-25 20:00:00
67,1,1,0,0.004965683812599541,2019-03-25 19:45:00,2019-03-25 20:00:00
86,1,1,0,0.004471982117959337,2019-03-25 19:45:00,2019-03-25 20:00:00
87,2,1,1,0.02318854861453808,2019-03-25 19:45:00,2019-03-25 20:00:00
88,2,1,1,0.004965683812599541,2019-03-25 19:45:00,2019-03-25 20:00:00
90,2,2,0,0.004447917383502894,2019-03-25 19:45:00,2019-03-25 20:00:00
101,2,1,1,0.02318854861453808,2019-03-25 19:45:00,2019-03-25 20:00:00
109,1,0,1,0.0034845787286789296,2019-03-25 19:45:00,2019-03-25 20:00:00
110,2,0,2,0.0034845787286789296,2019-03-25 19:45:00,2019-03-25 20:00:00
111,1,0,1,0.0034845787286789296,2019-03-25 19:45:00,2019-03-25 20:00:00
112,2,1,1,0.02318854861453808,2019-03-25 19:45:00,2019-03-25 20:00:00
114,1,1,0,0.006446788896520152,2019-03-25 19:45:00,2019-03-25 20:00:00
115,4,2,2,0.02318854861453808,2019-03-25 19:45:00,2019-03-25 20:00:00
116,3,1,2,0.006060719859284915,2019-03-25 19:45:00,2019-03-25 20:00:00
119,1,0,1,0.0034845787286789296,2019-03-25 19:45:00,2019-03-25 20:00:00
120,5,3,2,0.05182477080123786,2019-03-25 19:45:00,2019-03-25 20:00:00
122,2,0,2,0.0034845787286789296,2019-03-25 19:45:00,2019-03-25 20:00:00
137,7,5,2,0.01289055069593501,2019-03-25 19:45:00,2019-03-25 20:00:00
138,4,2,2,0.030979891891749153,2019-03-25 19:45:00,2019-03-25 20:00:00
153,5,4,1,0.01004804013680119,2019-03-25 19:45:00,2019-03-25 20:00:00
158,3,1,2,0.006060719859284915,2019-03-25 19:45:00,2019-03-25 20:00:00
164,8,1,7,0.003966248056090912,2019-03-25 19:45:00,2019-03-25 20:00:00
189,1,1,0,0.006060719859284915,2019-03-25 19:45:00,2019-03-25 20:00:00
191,4,4,0,0.015419485273271175,2019-03-25 19:45:00,2019-03-25 20:00:00
196,2,1,1,0.02318854861453808,2019-03-25 19:45:00,2019-03-25 20:00:00
199,1,1,0,0.012026525586614382,2019-03-25 19:45:00,2019-03-25 20:00:00
5,2,0,2,0.0033437437722717675,2019-03-25 20:00:00,2019-03-25 20:15:00
19,3,2,1,0.004447663191381174,2019-03-25 20:00:00,2019-03-25 20:15:00
23,3,1,2,0.006186264477409218,2019-03-25 20:00:00,2019-03-25 20:15:00
35,1,1,0,0.008691903597843144,2019-03-25 20:00:00,2019-03-25 20:15:00
37,1,0,1,0.0033437437722717675,2019-03-25 20:00:00,2019-03-25 20:15:00
40,4,2,2,0.013407074346266326,2019-03-25 20:00:00,2019-03-25 20:15:00
46,2,2,0,0.007607524829977943,2019-03-25 20:00:00,2019-03-25 20:15:00
57,4,3,1,0.06628017562476282,2019-03-25 20:00:00,2019-03-25 20:15:00
66,3,1,2,0.005815826502396433,2019-03-25 20:00:00,2019-03-25 20:15:00
67,1,1,0,0.007394513465847482,2019-03-25 20:00:00,2019-03-25 20:15:00
86,1,1,0,0.0059732531132787575,2019-03-25 20:00:00,2019-03-25 20:15:00
87,2,1,1,0.02224407764151364,2019-03-25 20:00:00,2019-03-25 20:15:00
90,1,1,0,0.0038957034818264706,2019-03-25 20:00:00,2019-03-25 20:15:00
101,2,1,1,0.02224407764151364,2019-03-25 20:00:00,2019-03-25 20:15:00
109,3,2,1,0.038672328780630844,2019-03-25 20:00:00,2019-03-25 20:15:00
110,1,0,1,0.0033437437722717675,2019-03-25 20:00:00,2019-03-25 20:15:00
111,5,2,3,0.015396414103609958,2019-03-25 20:00:00,2019-03-25 20:15:00
112,2,1,1,0.02224407764151364,2019-03-25 20:00:00,2019-03-25 20:15:00
114,1,1,0,0.006186264477409218,2019-03-25 20:00:00,2019-03-25 20:15:00
115,6,4,2,0.049522999548757954,2019-03-25 20:00:00,2019-03-25 20:15:00
116,1,0,1,0.0033437437722717675,2019-03-25 20:00:00,2019-03-25 20:15:00
119,1,0,1,0.0033437437722717675,2019-03-25 20:00:00,2019-03-25 20:15:00
120,3,1,2,0.005815826502396433,2019-03-25 20:00:00,2019-03-25 20:15:00
122,2,1,1,0.004765004124840493,2019-03-25 20:00:00,2019-03-25 20:15:00
126,1,0,1,0.0033437437722717675,2019-03-25 20:00:00,2019-03-25 20:15:00
137,5,2,3,0.004447663191381174,2019-03-25 20:00:00,2019-03-25 20:15:00
138,3,2,1,0.007076158438902762,2019-03-25 20:00:00,2019-03-25 20:15:00
153,3,2,1,0.013722962070814405,2019-03-25 20:00:00,2019-03-25 20:15:00
158,2,1,1,0.02224407764151364,2019-03-25 20:00:00,2019-03-25 20:15:00
164,7,1,6,0.0038957034818264706,2019-03-25 20:00:00,2019-03-25 20:15:00
170,2,1,1,0.009043472391110583,2019-03-25 20:00:00,2019-03-25 20:15:00
172,1,1,0,0.015010853351546524,2019-03-25 20:00:00,2019-03-25 20:15:00
191,5,3,2,0.012581744875356462,2019-03-25 20:00:00,2019-03-25 20:15:00
5,2,0,2,0.003332592782575075,2019-03-25 20:15:00,2019-03-25 20:30:00
11,1,1,0,0.008573946508619153,2019-03-25 20:15:00,2019-03-25 20:30:00
19,1,0,1,0.003332592782575075,2019-03-25 20:15:00,2019-03-25 20:30:00
20,1,0,1,0.003332592782575075,2019-03-25 20:15:00,2019-03-25 20:30:00
23,3,2,1,0.009519687987330104,2019-03-25 20:15:00,2019-03-25 20:30:00
35,1,1,0,0.011780128440597693,2019-03-25 20:15:00,2019-03-25 20:30:00
41,2,1,1,0.006165590449195173,2019-03-25 20:15:00,2019-03-25 20:30:00
46,1,1,0,0.004749091615885124,2019-03-25 20:15:00,2019-03-25 20:30:00
57,3,2,1,0.008998588115815269,2019-03-25 20:15:00,2019-03-25 20:30:00
61,3,1,2,0.009654572536169359,2019-03-25 20:15:00,2019-03-25 20:30:00
66,2,1,1,0.022176875893779032,2019-03-25 20:15:00,2019-03-25 20:30:00
68,1,1,0,0.004749091615885124,2019-03-25 20:15:00,2019-03-25 20:30:00
87,3,2,1,0.041021159004982974,2019-03-25 20:15:00,2019-03-25 20:30:00
88,2,2,0,0.013163393619506438,2019-03-25 20:15:00,2019-03-25 20:30:00
90,4,3,1,0.034739731301248314,2019-03-25 20:15:00,2019-03-25 20:30:00
101,2,1,1,0.022176875893779032,2019-03-25 20:15:00,2019-03-25 20:30:00
104,1,0,1,0.003332592782575075,2019-03-25 20:15:00,2019-03-25 20:30:00
109,2,1,1,0.022176875893779032,2019-03-25 20:15:00,2019-03-25 20:30:00
111,3,2,1,0.041021159004982974,2019-03-25 20:15:00,2019-03-25 20:30:00
114,1,1,0,0.004749091615885124,2019-03-25 20:15:00,2019-03-25 20:30:00
115,4,2,2,0.022176875893779032,2019-03-25 20:15:00,2019-03-25 20:30:00
116,1,0,1,0.003332592782575075,2019-03-25 20:15:00,2019-03-25 20:30:00
119,2,0,2,0.003332592782575075,2019-03-25 20:15:00,2019-03-25 20:30:00
120,4,2,2,0.010723866017042094,2019-03-25 20:15:00,2019-03-25 20:30:00
122,1,1,0,0.004749091615885124,2019-03-25 20:15:00,2019-03-25 20:30:00
126,1,0,1,0.003332592782575075,2019-03-25 20:15:00,2019-03-25 20:30:00
127,1,1,0,0.007436454091249666,2019-03-25 20:15:00,2019-03-25 20:30:00
137,4,2,2,0.005131387724961752,2019-03-25 20:15:00,2019-03-25 20:30:00
138,3,1,2,0.007890868350421998,2019-03-25 20:15:00,2019-03-25 20:30:00
141,1,0,1,0.003332592782575075,2019-03-25 20:15:00,2019-03-25 20:30:00
153,2,2,0,0.007586087791903345,2019-03-25 20:15:00,2019-03-25 20:30:00
158,2,1,1,0.022176875893779032,2019-03-25 20:15:00,2019-03-25 20:30:00
160,2,1,1,0.022176875893779032,2019-03-25 20:15:00,2019-03-25 20:30:00
164,5,1,4,0.004231990253768414,2019-03-25 20:15:00,2019-03-25 20:30:00
168,2,2,0,0.006458016389578414,2019-03-25 20:15:00,2019-03-25 20:30:00
170,1,0,1,0.003332592782575075,2019-03-25 20:15:00,2019-03-25 20:30:00
189,3,0,3,0.003332592782575075,2019-03-25 20:15:00,2019-03-25 20:30:00
191,4,2,2,0.019872966761948437,2019-03-25 20:15:00,2019-03-25 20:30:00
199,2,1,1,0.007436454091249666,2019-03-25 20:15:00,2019-03-25 20:30:00
5,2,0,2,0.0031359070531997418,2019-03-25 20:30:00,2019-03-25 20:45:00
11,1,1,0,0.008068196610526346,2019-03-25 20:30:00,2019-03-25 20:45:00
16,1,1,0,0.007766740364388862,2019-03-25 20:30:00,2019-03-25 20:45:00
19,1,0,1,0.0031359070531997418,2019-03-25 20:30:00,2019-03-25 20:45:00
23,2,0,2,0.0031359070531997418,2019-03-25 20:30:00,2019-03-25 20:45:00
28,1,1,0,0.005801795663026599,2019-03-25 20:30:00,2019-03-25 20:45:00
41,2,1,1,0.005801795663026599,2019-03-25 20:30:00,2019-03-25 20:45:00
57,5,4,1,0.007007921761407377,2019-03-25 20:30:00,2019-03-25 20:45:00
58,1,0,1,0.0031359070531997418,2019-03-25 20:30:00,2019-03-25 20:45:00
61,1,0,1,0.0031359070531997418,2019-03-25 20:30:00,2019-03-25 20:45:00
66,2,1,1,0.02087388740982641,2019-03-25 20:30:00,2019-03-25 20:45:00
67,1,0,1,0.0031359070531997418,2019-03-25 20:30:00,2019-03-25 20:45:00
68,1,1,0,0.005801795663026599,2019-03-25 20:30:00,2019-03-25 20:45:00
69,1,0,1,0.0031359070531997418,2019-03-25 20:30:00,2019-03-25 20:45:00
87,5,2,3,0.008096082421258297,2019-03-25 20:30:00,2019-03-25 20:45:00
88,1,1,0,0.009093611920472724,2019-03-25 20:30:00,2019-03-25 20:45:00
89,5,1,4,0.00398226385429781,2019-03-25 20:30:00,2019-03-25 20:45:00
90,4,3,1,0.03269920764757753,2019-03-25 20:30:00,2019-03-25 20:45:00
101,2,1,1,0.02087388740982641,2019-03-25 20:30:00,2019-03-25 20:45:00
104,1,0,1,0.0031359070531997418,2019-03-25 20:30:00,2019-03-25 20:45:00
106,1,1,0,0.005801795663026599,2019-03-25 20:30:00,2019-03-25 20:45:00
109,5,2,3,0.00723870961175018,2019-03-25 20:30:00,2019-03-25 20:45:00
111,3,2,1,0.03861186776645309,2019-03-25 20:30:00,2019-03-25 20:45:00
114,1,1,0,0.0044688513581131704,2019-03-25 20:30:00,2019-03-25 20:45:00
115,5,3,2,0.04185819300933052,2019-03-25 20:30:00,2019-03-25 20:45:00
116,2,0,2,0.0031359070531997418,2019-03-25 20:30:00,2019-03-25 20:45:00
119,1,0,1,0.0031359070531997418,2019-03-25 20:30:00,2019-03-25 20:45:00
120,4,2,2,0.01009151629354908,2019-03-25 20:30:00,2019-03-25 20:45:00
122,1,1,0,0.0044688513581131704,2019-03-25 20:30:00,2019-03-25 20:45:00
126,1,1,0,0.005801795663026599,2019-03-25 20:30:00,2019-03-25 20:45:00
127,1,0,1,0.0031359070531997418,2019-03-25 20:30:00,2019-03-25 20:45:00
137,6,4,2,0.010894110686472357,2019-03-25 20:30:00,2019-03-25 20:45:00
138,3,1,2,0.007425627683722221,2019-03-25 20:30:00,2019-03-25 20:45:00
141,1,0,1,0.0031359070531997418,2019-03-25 20:30:00,2019-03-25 20:45:00
153,1,1,0,0.00398226385429781,2019-03-25 20:30:00,2019-03-25 20:45:00
158,3,2,1,0.034509065207902645,2019-03-25 20:30:00,2019-03-25 20:45:00
160,2,1,1,0.02087388740982641,2019-03-25 20:30:00,2019-03-25 20:45:00
164,5,1,4,0.00398226385429781,2019-03-25 20:30:00,2019-03-25 20:45:00
168,6,5,1,0.0880958214091632,2019-03-25 20:30:00,2019-03-25 20:45:00
170,1,0,1,0.0031359070531997418,2019-03-25 20:30:00,2019-03-25 20:45:00
171,1,1,0,0.005801795663026599,2019-03-25 20:30:00,2019-03-25 20:45:00
173,2,1,1,0.0062924272099723465,2019-03-25 20:30:00,2019-03-25 20:45:00
189,3,0,3,0.0031359070531997418,2019-03-25 20:30:00,2019-03-25 20:45:00
191,5,3,2,0.007134739967940028,2019-03-25 20:30:00,2019-03-25 20:45:00
199,2,2,0,0.01115140268459821,2019-03-25 20:30:00,2019-03-25 20:45:00
2,1,1,0,0.007093659118870893,2019-03-25 20:45:00,2019-03-25 21:00:00
11,1,1,0,0.009864532880463031,2019-03-25 20:45:00,2019-03-25 21:00:00
16,1,1,0,0.0061566601247534,2019-03-25 20:45:00,2019-03-25 21:00:00
19,1,0,1,0.0038342242498398365,2019-03-25 20:45:00,2019-03-25 21:00:00
20,2,2,0,0.007093659118870893,2019-03-25 20:45:00,2019-03-25 21:00:00
23,2,0,2,0.0038342242498398365,2019-03-25 20:45:00,2019-03-25 21:00:00
26,2,2,0,0.007093659118870893,2019-03-25 20:45:00,2019-03-25 21:00:00
41,2,1,1,0.007093659118870893,2019-03-25 20:45:00,2019-03-25 21:00:00
57,5,4,1,0.010353093987901948,2019-03-25 20:45:00,2019-03-25 21:00:00
58,1,0,1,0.0038342242498398365,2019-03-25 20:45:00,2019-03-25 21:00:00
66,2,1,1,0.02548141548670068,2019-03-25 20:45:00,2019-03-25 21:00:00
67,1,0,1,0.0038342242498398365,2019-03-25 20:45:00,2019-03-25 21:00:00
69,1,0,1,0.0038342242498398365,2019-03-25 20:45:00,2019-03-25 21:00:00
87,7,2,5,0.005809785188935798,2019-03-25 20:45:00,2019-03-25 21:00:00
88,1,1,0,0.012635406642055173,2019-03-25 20:45:00,2019-03-25 21:00:00
89,3,0,3,0.0038342242498398365,2019-03-25 20:45:00,2019-03-25 21:00:00
101,2,1,1,0.02548141548670068,2019-03-25 20:45:00,2019-03-25 21:00:00
106,1,1,0,0.007093659118870893,2019-03-25 20:45:00,2019-03-25 21:00:00
109,3,1,2,0.005463941684355364,2019-03-25 20:45:00,2019-03-25 21:00:00
111,2,2,0,0.005809785188935798,2019-03-25 20:45:00,2019-03-25 21:00:00
114,2,0,2,0.0038342242498398365,2019-03-25 20:45:00,2019-03-25 21:00:00
115,5,3,2,0.03802313750525114,2019-03-25 20:45:00,2019-03-25 21:00:00
116,1,0,1,0.0038342242498398365,2019-03-25 20:45:00,2019-03-25 21:00:00
120,3,1,2,0.006668832458874984,2019-03-25 20:45:00,2019-03-25 21:00:00
126,1,1,0,0.007093659118870893,2019-03-25 20:45:00,2019-03-25 21:00:00
127,2,2,0,0.0067587421188942684,2019-03-25 20:45:00,2019-03-25 21:00:00
137,4,4,0,0.010548654125728961,2019-03-25 20:45:00,2019-03-25 21:00:00
138,4,1,3,0.006668832458874984,2019-03-25 20:45:00,2019-03-25 21:00:00
153,2,0,2,0.0038342242498398365,2019-03-25 20:45:00,2019-03-25 21:00:00
158,3,2,1,0.04090195019708855,2019-03-25 20:45:00,2019-03-25 21:00:00
164,5,1,4,0.004869003312870836,2019-03-25 20:45:00,2019-03-25 21:00:00
168,2,1,1,0.02548141548670068,2019-03-25 20:45:00,2019-03-25 21:00:00
171,1,1,0,0.007093659118870893,2019-03-25 20:45:00,2019-03-25 21:00:00
173,2,1,1,0.005723963055863269,2019-03-25 20:45:00,2019-03-25 21:00:00
191,3,1,2,0.005463941684355364,2019-03-25 20:45:00,2019-03-25 21:00:00
199,1,1,0,0.00870018015156372,2019-03-25 20:45:00,2019-03-25 21:00:00
202,1,1,0,0.004822004719387817,2019-03-25 20:45:00,2019-03-25 21:00:00
203,1,0,1,0.0038342242498398365,2019-03-25 20:45:00,2019-03-25 21:00:00
2,1,1,0,0.007141238559263005,2019-03-25 21:00:00,2019-03-25 21:15:00
18,3,1,2,0.005028950021950957,2019-03-25 21:00:00,2019-03-25 21:15:00
20,2,2,0,0.008958387012474868,2019-03-25 21:00:00,2019-03-25 21:15:00
23,2,0,2,0.0038599462795939703,2019-03-25 21:00:00,2019-03-25 21:15:00
26,2,2,0,0.006047474466039994,2019-03-25 21:00:00,2019-03-25 21:15:00
27,1,1,0,0.004953710372816982,2019-03-25 21:00:00,2019-03-25 21:15:00
35,1,0,1,0.0038599462795939703,2019-03-25 21:00:00,2019-03-25 21:15:00
57,4,4,0,0.01042253083893204,2019-03-25 21:00:00,2019-03-25 21:15:00
66,4,3,1,0.06637163092858231,2019-03-25 21:00:00,2019-03-25 21:15:00
69,1,0,1,0.0038599462795939703,2019-03-25 21:00:00,2019-03-25 21:15:00
86,1,0,1,0.0038599462795939703,2019-03-25 21:00:00,2019-03-25 21:15:00
87,3,1,2,0.006713553856728344,2019-03-25 21:00:00,2019-03-25 21:15:00
88,1,0,1,0.0038599462795939703,2019-03-25 21:00:00,2019-03-25 21:15:00
89,3,0,3,0.0038599462795939703,2019-03-25 21:00:00,2019-03-25 21:15:00
101,4,2,2,0.02564837702163487,2019-03-25 21:00:00,2019-03-25 21:15:00
106,1,1,0,0.007141238559263005,2019-03-25 21:00:00,2019-03-25 21:15:00
109,3,3,0,0.00995088844145451,2019-03-25 21:00:00,2019-03-25 21:15:00
112,2,0,2,0.0038599462795939703,2019-03-25 21:00:00,2019-03-25 21:15:00
114,3,0,3,0.0038599462795939703,2019-03-25 21:00:00,2019-03-25 21:15:00
115,2,1,1,0.02564837702163487,2019-03-25 21:00:00,2019-03-25 21:15:00
116,1,0,1,0.0038599462795939703,2019-03-25 21:00:00,2019-03-25 21:15:00
120,3,1,2,0.006713553856728344,2019-03-25 21:00:00,2019-03-25 21:15:00
122,1,1,0,0.00599748463898379,2019-03-25 21:00:00,2019-03-25 21:15:00
127,3,3,0,0.020438337591181195,2019-03-25 21:00:00,2019-03-25 21:15:00
137,5,4,1,0.00828138802636316,2019-03-25 21:00:00,2019-03-25 21:15:00
138,4,3,1,0.00999484613639738,2019-03-25 21:00:00,2019-03-25 21:15:00
147,1,1,0,0.007141238559263005,2019-03-25 21:00:00,2019-03-25 21:15:00
153,3,1,2,0.00599748463898379,2019-03-25 21:00:00,2019-03-25 21:15:00
157,1,0,1,0.0038599462795939703,2019-03-25 21:00:00,2019-03-25 21:15:00
158,2,1,1,0.02564837702163487,2019-03-25 21:00:00,2019-03-25 21:15:00
164,5,1,4,0.00490166341062158,2019-03-25 21:00:00,2019-03-25 21:15:00
168,3,1,2,0.006713553856728344,2019-03-25 21:00:00,2019-03-25 21:15:00
191,5,1,4,0.005500592419428488,2019-03-25 21:00:00,2019-03-25 21:15:00
201,1,1,0,0.007141238559263005,2019-03-25 21:00:00,2019-03-25 21:15:00
202,1,1,0,0.006713553856728344,2019-03-25 21:00:00,2019-03-25 21:15:00
203,1,0,1,0.0038599462795939703,2019-03-25 21:00:00,2019-03-25 21:15:00
5,1,1,0,0.009416489335006398,2019-03-25 21:15:00,2019-03-25 21:30:00
16,2,1,1,0.0067714706753392116,2019-03-25 21:15:00,2019-03-25 21:30:00
18,3,1,2,0.0065382838738738255,2019-03-25 21:15:00,2019-03-25 21:30:00
19,3,1,2,0.006365937291049022,2019-03-25 21:15:00,2019-03-25 21:30:00
22,1,1,0,0.0067714706753392116,2019-03-25 21:15:00,2019-03-25 21:30:00
23,1,0,1,0.003660078412741253,2019-03-25 21:15:00,2019-03-25 21:30:00
46,1,0,1,0.003660078412741253,2019-03-25 21:15:00,2019-03-25 21:30:00
57,1,1,0,0.0067714706753392116,2019-03-25 21:15:00,2019-03-25 21:30:00
58,1,1,0,0.007955700071775346,2019-03-25 21:15:00,2019-03-25 21:30:00
62,1,1,0,0.006365937291049022,2019-03-25 21:15:00,2019-03-25 21:30:00
66,3,2,1,0.04499409065263239,2019-03-25 21:15:00,2019-03-25 21:30:00
68,2,1,1,0.009416489335006398,2019-03-25 21:15:00,2019-03-25 21:30:00
69,1,1,0,0.0067714706753392116,2019-03-25 21:15:00,2019-03-25 21:30:00
70,1,1,0,0.0067714706753392116,2019-03-25 21:15:00,2019-03-25 21:30:00
74,1,0,1,0.003660078412741253,2019-03-25 21:15:00,2019-03-25 21:30:00
86,1,0,1,0.003660078412741253,2019-03-25 21:15:00,2019-03-25 21:30:00
87,2,1,1,0.024327084532686814,2019-03-25 21:15:00,2019-03-25 21:30:00
88,1,0,1,0.003660078412741253,2019-03-25 21:15:00,2019-03-25 21:30:00
101,2,1,1,0.024327084532686814,2019-03-25 21:15:00,2019-03-25 21:30:00
109,2,2,0,0.009649676136471785,2019-03-25 21:15:00,2019-03-25 21:30:00
110,2,1,1,0.005053087832175052,2019-03-25 21:15:00,2019-03-25 21:30:00
114,1,1,0,0.01622179370417605,2019-03-25 21:15:00,2019-03-25 21:30:00
115,2,1,1,0.024327084532686814,2019-03-25 21:15:00,2019-03-25 21:30:00
116,1,0,1,0.003660078412741253,2019-03-25 21:15:00,2019-03-25 21:30:00
120,3,1,2,0.006365937291049022,2019-03-25 21:15:00,2019-03-25 21:30:00
122,1,1,0,0.0064391819605474,2019-03-25 21:15:00,2019-03-25 21:30:00
127,1,1,0,0.005053087832175052,2019-03-25 21:15:00,2019-03-25 21:30:00
137,6,2,4,0.006554555059518973,2019-03-25 21:15:00,2019-03-25 21:30:00
138,1,1,0,0.006365937291049022,2019-03-25 21:15:00,2019-03-25 21:30:00
140,1,0,1,0.003660078412741253,2019-03-25 21:15:00,2019-03-25 21:30:00
141,2,2,0,0.006446097251608853,2019-03-25 21:15:00,2019-03-25 21:30:00
147,3,2,1,0.01477649260396584,2019-03-25 21:15:00,2019-03-25 21:30:00
153,3,1,2,0.0064391819605474,2019-03-25 21:15:00,2019-03-25 21:30:00
156,1,0,1,0.003660078412741253,2019-03-25 21:15:00,2019-03-25 21:30:00
157,1,0,1,0.003660078412741253,2019-03-25 21:15:00,2019-03-25 21:30:00
158,2,1,1,0.024327084532686814,2019-03-25 21:15:00,2019-03-25 21:30:00
160,2,1,1,0.024327084532686814,2019-03-25 21:15:00,2019-03-25 21:30:00
164,4,1,3,0.005107316736130112,2019-03-25 21:15:00,2019-03-25 21:30:00
168,1,0,1,0.003660078412741253,2019-03-25 21:15:00,2019-03-25 21:30:00
171,2,1,1,0.0067714706753392116,2019-03-25 21:15:00,2019-03-25 21:30:00
172,2,2,0,0.009134051432548421,2019-03-25 21:15:00,2019-03-25 21:30:00
191,3,1,2,0.0067714706753392116,2019-03-25 21:15:00,2019-03-25 21:30:00
195,1,0,1,0.003660078412741253,2019-03-25 21:15:00,2019-03-25 21:30:00
201,1,1,0,0.0067714706753392116,2019-03-25 21:15:00,2019-03-25 21:30:00
1,1,1,0,0.006754273990022567,2019-03-25 21:30:00,2019-03-25 21:45:00
5,2,2,0,0.02265387959490494,2019-03-25 21:30:00,2019-03-25 21:45:00
16,3,2,1,0.009857765164600983,2019-03-25 21:30:00,2019-03-25 21:45:00
19,1,0,1,0.0036507828154441514,2019-03-25 21:30:00,2019-03-25 21:45:00
22,1,1,0,0.006754273990022567,2019-03-25 21:30:00,2019-03-25 21:45:00
23,1,0,1,0.0036507828154441514,2019-03-25 21:30:00,2019-03-25 21:45:00
35,1,1,0,0.005450108496634838,2019-03-25 21:30:00,2019-03-25 21:45:00
46,1,0,1,0.0036507828154441514,2019-03-25 21:30:00,2019-03-25 21:45:00
57,3,2,1,0.012496068073206988,2019-03-25 21:30:00,2019-03-25 21:45:00
58,1,1,0,0.006754273990022567,2019-03-25 21:30:00,2019-03-25 21:45:00
62,1,1,0,0.006754273990022567,2019-03-25 21:30:00,2019-03-25 21:45:00
66,2,1,1,0.024265068415739117,2019-03-25 21:30:00,2019-03-25 21:45:00
68,1,1,0,0.010922234144624334,2019-03-25 21:30:00,2019-03-25 21:45:00
70,1,0,1,0.0036507828154441514,2019-03-25 21:30:00,2019-03-25 21:45:00
75,1,0,1,0.0036507828154441514,2019-03-25 21:30:00,2019-03-25 21:45:00
87,2,1,1,0.024265068415739117,2019-03-25 21:30:00,2019-03-25 21:45:00
90,1,0,1,0.0036507828154441514,2019-03-25 21:30:00,2019-03-25 21:45:00
101,2,1,1,0.024265068415739117,2019-03-25 21:30:00,2019-03-25 21:45:00
104,1,0,1,0.0036507828154441514,2019-03-25 21:30:00,2019-03-25 21:45:00
109,3,1,2,0.006349771337230182,2019-03-25 21:30:00,2019-03-25 21:45:00
110,1,0,1,0.0036507828154441514,2019-03-25 21:30:00,2019-03-25 21:45:00
114,2,1,1,0.006754273990022567,2019-03-25 21:30:00,2019-03-25 21:45:00
115,2,1,1,0.024265068415739117,2019-03-25 21:30:00,2019-03-25 21:45:00
116,1,0,1,0.0036507828154441514,2019-03-25 21:30:00,2019-03-25 21:45:00
120,3,1,2,0.006349771337230182,2019-03-25 21:30:00,2019-03-25 21:45:00
126,1,1,0,0.00939257689862857,2019-03-25 21:30:00,2019-03-25 21:45:00
127,2,2,0,0.012312163453204523,2019-03-25 21:30:00,2019-03-25 21:45:00
133,1,1,0,0.006349771337230182,2019-03-25 21:30:00,2019-03-25 21:45:00
135,1,1,0,0.006754273990022567,2019-03-25 21:30:00,2019-03-25 21:45:00
137,3,2,1,0.006537909694697608,2019-03-25 21:30:00,2019-03-25 21:45:00
138,4,1,3,0.006349771337230182,2019-03-25 21:30:00,2019-03-25 21:45:00
140,1,0,1,0.0036507828154441514,2019-03-25 21:30:00,2019-03-25 21:45:00
147,1,0,1,0.0036507828154441514,2019-03-25 21:30:00,2019-03-25 21:45:00
153,2,0,2,0.0036507828154441514,2019-03-25 21:30:00,2019-03-25 21:45:00
156,1,0,1,0.0036507828154441514,2019-03-25 21:30:00,2019-03-25 21:45:00
157,1,1,0,0.005450108496634838,2019-03-25 21:30:00,2019-03-25 21:45:00
158,2,1,1,0.024265068415739117,2019-03-25 21:30:00,2019-03-25 21:45:00
160,2,1,1,0.024265068415739117,2019-03-25 21:30:00,2019-03-25 21:45:00
164,4,1,3,0.00509434625507088,2019-03-25 21:30:00,2019-03-25 21:45:00
168,1,1,0,0.006754273990022567,2019-03-25 21:30:00,2019-03-25 21:45:00
171,3,2,1,0.008553599671213254,2019-03-25 21:30:00,2019-03-25 21:45:00
172,2,2,0,0.006754273990022567,2019-03-25 21:30:00,2019-03-25 21:45:00
175,2,1,1,0.024265068415739117,2019-03-25 21:30:00,2019-03-25 21:45:00
191,2,1,1,0.006754273990022567,2019-03-25 21:30:00,2019-03-25 21:45:00
199,1,0,1,0.0036507828154441514,2019-03-25 21:30:00,2019-03-25 21:45:00
1,1,1,0,0.007332743403564143,2019-03-25 21:45:00,2019-03-25 22:00:00
5,1,1,0,0.014565383874273863,2019-03-25 21:45:00,2019-03-25 22:00:00
23,1,0,1,0.0039634706390345035,2019-03-25 21:45:00,2019-03-25 22:00:00
35,1,1,0,0.006893566420913389,2019-03-25 21:45:00,2019-03-25 22:00:00
41,1,1,0,0.004805788830166914,2019-03-25 21:45:00,2019-03-25 22:00:00
57,3,2,1,0.012471379204674608,2019-03-25 21:45:00,2019-03-25 22:00:00
66,2,1,1,0.026326283360330133,2019-03-25 21:45:00,2019-03-25 22:00:00
68,1,1,0,0.005648107021299323,2019-03-25 21:45:00,2019-03-25 22:00:00
70,2,0,2,0.0039634706390345035,2019-03-25 21:45:00,2019-03-25 22:00:00
75,1,0,1,0.0039634706390345035,2019-03-25 21:45:00,2019-03-25 22:00:00
86,1,1,0,0.008764849273556828,2019-03-25 21:45:00,2019-03-25 22:00:00
87,2,1,1,0.026326283360330133,2019-03-25 21:45:00,2019-03-25 22:00:00
88,1,0,1,0.0039634706390345035,2019-03-25 21:45:00,2019-03-25 22:00:00
101,2,1,1,0.026326283360330133,2019-03-25 21:45:00,2019-03-25 22:00:00
104,1,0,1,0.0039634706390345035,2019-03-25 21:45:00,2019-03-25 22:00:00
109,1,0,1,0.0039634706390345035,2019-03-25 21:45:00,2019-03-25 22:00:00
114,1,0,1,0.0039634706390345035,2019-03-25 21:45:00,2019-03-25 22:00:00
115,2,1,1,0.026326283360330133,2019-03-25 21:45:00,2019-03-25 22:00:00
116,4,0,4,0.0039634706390345035,2019-03-25 21:45:00,2019-03-25 22:00:00
120,3,1,2,0.006893566420913389,2019-03-25 21:45:00,2019-03-25 22:00:00
126,1,1,0,0.007332743403564143,2019-03-25 21:45:00,2019-03-25 22:00:00
127,1,1,0,0.007332743403564143,2019-03-25 21:45:00,2019-03-25 22:00:00
133,1,1,0,0.007332743403564143,2019-03-25 21:45:00,2019-03-25 22:00:00
135,2,1,1,0.005648107021299323,2019-03-25 21:45:00,2019-03-25 22:00:00
137,3,3,0,0.010467105786988264,2019-03-25 21:45:00,2019-03-25 22:00:00
138,3,1,2,0.006893566420913389,2019-03-25 21:45:00,2019-03-25 22:00:00
157,1,1,0,0.006893566420913389,2019-03-25 21:45:00,2019-03-25 22:00:00
158,3,1,2,0.006893566420913389,2019-03-25 21:45:00,2019-03-25 22:00:00
160,2,1,1,0.026326283360330133,2019-03-25 21:45:00,2019-03-25 22:00:00
164,4,1,3,0.005530651830746564,2019-03-25 21:45:00,2019-03-25 22:00:00
168,1,1,0,0.007332743403564143,2019-03-25 21:45:00,2019-03-25 22:00:00
171,1,1,0,0.006893566420913389,2019-03-25 21:45:00,2019-03-25 22:00:00
191,4,3,1,0.009017379785828963,2019-03-25 21:45:00,2019-03-25 22:00:00
199,1,0,1,0.0039634706390345035,2019-03-25 21:45:00,2019-03-25 22:00:00
1,2,1,1,0.024771637806169505,2019-03-25 22:00:00,2019-03-25 22:15:00
5,1,1,0,0.009581381628625998,2019-03-25 22:00:00,2019-03-25 22:15:00
21,1,0,1,0.0037241430863007687,2019-03-25 22:00:00,2019-03-25 22:15:00
23,1,0,1,0.0037241430863007687,2019-03-25 22:00:00,2019-03-25 22:15:00
57,2,1,1,0.006890018612854277,2019-03-25 22:00:00,2019-03-25 22:15:00
58,1,1,0,0.008513137955792312,2019-03-25 22:00:00,2019-03-25 22:15:00
66,2,1,1,0.024771637806169505,2019-03-25 22:00:00,2019-03-25 22:15:00
70,1,1,0,0.004729222520468059,2019-03-25 22:00:00,2019-03-25 22:15:00
74,1,0,1,0.0037241430863007687,2019-03-25 22:00:00,2019-03-25 22:15:00
86,1,1,0,0.006890018612854277,2019-03-25 22:00:00,2019-03-25 22:15:00
87,2,1,1,0.024771637806169505,2019-03-25 22:00:00,2019-03-25 22:15:00
88,1,0,1,0.0037241430863007687,2019-03-25 22:00:00,2019-03-25 22:15:00
101,2,1,1,0.024771637806169505,2019-03-25 22:00:00,2019-03-25 22:15:00
104,1,0,1,0.0037241430863007687,2019-03-25 22:00:00,2019-03-25 22:15:00
115,2,1,1,0.024771637806169505,2019-03-25 22:00:00,2019-03-25 22:15:00
116,1,0,1,0.0037241430863007687,2019-03-25 22:00:00,2019-03-25 22:15:00
119,1,0,1,0.0037241430863007687,2019-03-25 22:00:00,2019-03-25 22:15:00
120,5,1,4,0.004729222520468059,2019-03-25 22:00:00,2019-03-25 22:15:00
127,1,1,0,0.006890018612854277,2019-03-25 22:00:00,2019-03-25 22:15:00
135,1,0,1,0.0037241430863007687,2019-03-25 22:00:00,2019-03-25 22:15:00
137,5,4,1,0.06539403938302397,2019-03-25 22:00:00,2019-03-25 22:15:00
138,1,1,0,0.004729222520468059,2019-03-25 22:00:00,2019-03-25 22:15:00
157,4,2,2,0.01126640801862587,2019-03-25 22:00:00,2019-03-25 22:15:00
158,3,1,2,0.006477413149134327,2019-03-25 22:00:00,2019-03-25 22:15:00
164,4,1,3,0.00519673094918378,2019-03-25 22:00:00,2019-03-25 22:15:00
171,1,1,0,0.006890018612854277,2019-03-25 22:00:00,2019-03-25 22:15:00
191,1,1,0,0.006890018612854277,2019-03-25 22:00:00,2019-03-25 22:15:00
195,1,1,0,0.004729222520468059,2019-03-25 22:00:00,2019-03-25 22:15:00
199,2,1,1,0.024771637806169505,2019-03-25 22:00:00,2019-03-25 22:15:00
201,1,1,0,0.006890018612854277,2019-03-25 22:00:00,2019-03-25 22:15:00
202,1,1,0,0.006890018612854277,2019-03-25 22:00:00,2019-03-25 22:15:00
1,1,0,1,0.00417623011987552,2019-03-25 22:15:00,2019-03-25 22:30:00
16,1,1,0,0.007133539629854273,2019-03-25 22:15:00,2019-03-25 22:30:00
23,1,0,1,0.00417623011987552,2019-03-25 22:15:00,2019-03-25 22:30:00
46,1,0,1,0.00417623011987552,2019-03-25 22:15:00,2019-03-25 22:30:00
57,1,1,0,0.010744430623293772,2019-03-25 22:15:00,2019-03-25 22:30:00
58,2,2,0,0.007726401751076885,2019-03-25 22:15:00,2019-03-25 22:30:00
62,1,1,0,0.007726401751076885,2019-03-25 22:15:00,2019-03-25 22:30:00
66,2,1,1,0.027706025083324086,2019-03-25 22:15:00,2019-03-25 22:30:00
70,1,1,0,0.0053033095120074356,2019-03-25 22:15:00,2019-03-25 22:30:00
74,1,0,1,0.00417623011987552,2019-03-25 22:15:00,2019-03-25 22:30:00
87,2,1,1,0.027706025083324086,2019-03-25 22:15:00,2019-03-25 22:30:00
101,2,1,1,0.027706025083324086,2019-03-25 22:15:00,2019-03-25 22:30:00
110,1,1,0,0.007133539629854273,2019-03-25 22:15:00,2019-03-25 22:30:00
115,2,1,1,0.027706025083324086,2019-03-25 22:15:00,2019-03-25 22:30:00
116,2,1,1,0.007726401751076885,2019-03-25 22:15:00,2019-03-25 22:30:00
119,1,0,1,0.00417623011987552,2019-03-25 22:15:00,2019-03-25 22:30:00
120,5,1,4,0.0053033095120074356,2019-03-25 22:15:00,2019-03-25 22:30:00
126,1,0,1,0.00417623011987552,2019-03-25 22:15:00,2019-03-25 22:30:00
137,6,3,3,0.010436204664138738,2019-03-25 22:15:00,2019-03-25 22:30:00
138,1,1,0,0.0053033095120074356,2019-03-25 22:15:00,2019-03-25 22:30:00
157,2,0,2,0.00417623011987552,2019-03-25 22:15:00,2019-03-25 22:30:00
164,4,1,3,0.005827562637017752,2019-03-25 22:15:00,2019-03-25 22:30:00
191,1,1,0,0.007726401751076885,2019-03-25 22:15:00,2019-03-25 22:30:00
195,1,1,0,0.0053033095120074356,2019-03-25 22:15:00,2019-03-25 22:30:00
199,1,1,0,0.007726401751076885,2019-03-25 22:15:00,2019-03-25 22:30:00
201,1,1,0,0.007726401751076885,2019-03-25 22:15:00,2019-03-25 22:30:00
202,1,1,0,0.007726401751076885,2019-03-25 22:15:00,2019-03-25 22:30:00
16,1,1,0,0.0063435611599944874,2019-03-25 22:30:00,2019-03-25 22:45:00
18,1,0,1,0.003981850527261414,2019-03-25 22:30:00,2019-03-25 22:45:00
20,1,1,0,0.0073667821391391,2019-03-25 22:30:00,2019-03-25 22:45:00
23,2,1,1,0.005556324282416796,2019-03-25 22:30:00,2019-03-25 22:45:00
46,1,0,1,0.003981850527261414,2019-03-25 22:30:00,2019-03-25 22:45:00
57,2,2,0,0.013629274315698546,2019-03-25 22:30:00,2019-03-25 22:45:00
58,2,2,0,0.0073667821391391,2019-03-25 22:30:00,2019-03-25 22:45:00
62,1,1,0,0.0073667821391391,2019-03-25 22:30:00,2019-03-25 22:45:00
66,2,1,1,0.026460174425568316,2019-03-25 22:30:00,2019-03-25 22:45:00
74,1,0,1,0.003981850527261414,2019-03-25 22:30:00,2019-03-25 22:45:00
87,2,1,1,0.026460174425568316,2019-03-25 22:30:00,2019-03-25 22:45:00
101,2,1,1,0.026460174425568316,2019-03-25 22:30:00,2019-03-25 22:45:00
111,1,0,1,0.003981850527261414,2019-03-25 22:30:00,2019-03-25 22:45:00
114,1,1,0,0.0073667821391391,2019-03-25 22:30:00,2019-03-25 22:45:00
115,2,1,1,0.026460174425568316,2019-03-25 22:30:00,2019-03-25 22:45:00
116,2,1,1,0.0073667821391391,2019-03-25 22:30:00,2019-03-25 22:45:00
120,4,1,3,0.005556324282416796,2019-03-25 22:30:00,2019-03-25 22:45:00
126,1,0,1,0.003981850527261414,2019-03-25 22:30:00,2019-03-25 22:45:00
137,3,1,2,0.005556324282416796,2019-03-25 22:30:00,2019-03-25 22:45:00
138,4,1,3,0.005556324282416796,2019-03-25 22:30:00,2019-03-25 22:45:00
140,1,1,0,0.0063435611599944874,2019-03-25 22:30:00,2019-03-25 22:45:00
157,2,0,2,0.003981850527261414,2019-03-25 22:30:00,2019-03-25 22:45:00
164,2,1,1,0.026460174425568316,2019-03-25 22:30:00,2019-03-25 22:45:00
175,4,2,2,0.026460174425568316,2019-03-25 22:30:00,2019-03-25 22:45:00
190,1,0,1,0.003981850527261414,2019-03-25 22:30:00,2019-03-25 22:45:00
191,1,1,0,0.008705271792727561,2019-03-25 22:30:00,2019-03-25 22:45:00
195,1,1,0,0.005556324282416796,2019-03-25 22:30:00,2019-03-25 22:45:00
196,1,1,0,0.005556324282416796,2019-03-25 22:30:00,2019-03-25 22:45:00
201,1,1,0,0.0073667821391391,2019-03-25 22:30:00,2019-03-25 22:45:00
10,1,1,0,0.007117834720495348,2019-03-25 22:45:00,2019-03-25 23:00:00
18,2,1,1,0.007117834720495348,2019-03-25 22:45:00,2019-03-25 23:00:00
20,1,1,0,0.007117834720495348,2019-03-25 22:45:00,2019-03-25 23:00:00
23,2,1,1,0.005743481974179192,2019-03-25 22:45:00,2019-03-25 23:00:00
57,2,2,0,0.01038838904222552,2019-03-25 22:45:00,2019-03-25 23:00:00
58,2,2,0,0.011794386663910188,2019-03-25 22:45:00,2019-03-25 23:00:00
66,2,1,1,0.025580947976570782,2019-03-25 22:45:00,2019-03-25 23:00:00
68,1,0,1,0.0038472803987651765,2019-03-25 22:45:00,2019-03-25 23:00:00
74,1,0,1,0.0038472803987651765,2019-03-25 22:45:00,2019-03-25 23:00:00
87,2,1,1,0.025580947976570782,2019-03-25 22:45:00,2019-03-25 23:00:00
88,1,1,0,0.007117834720495348,2019-03-25 22:45:00,2019-03-25 23:00:00
89,1,0,1,0.0038472803987651765,2019-03-25 22:45:00,2019-03-25 23:00:00
101,2,1,1,0.025580947976570782,2019-03-25 22:45:00,2019-03-25 23:00:00
109,1,1,0,0.007117834720495348,2019-03-25 22:45:00,2019-03-25 23:00:00
111,1,0,1,0.0038472803987651765,2019-03-25 22:45:00,2019-03-25 23:00:00
115,2,1,1,0.025580947976570782,2019-03-25 22:45:00,2019-03-25 23:00:00
116,1,0,1,0.0038472803987651765,2019-03-25 22:45:00,2019-03-25 23:00:00
120,3,1,2,0.006691582761886201,2019-03-25 22:45:00,2019-03-25 23:00:00
137,1,0,1,0.0038472803987651765,2019-03-25 22:45:00,2019-03-25 23:00:00
138,4,1,3,0.006691582761886201,2019-03-25 22:45:00,2019-03-25 23:00:00
153,1,0,1,0.0038472803987651765,2019-03-25 22:45:00,2019-03-25 23:00:00
164,3,2,1,0.05801132412208543,2019-03-25 22:45:00,2019-03-25 23:00:00
175,6,3,3,0.025580947976570782,2019-03-25 22:45:00,2019-03-25 23:00:00
190,1,0,1,0.0038472803987651765,2019-03-25 22:45:00,2019-03-25 23:00:00
191,1,1,0,0.008729868323503266,2019-03-25 22:45:00,2019-03-25 23:00:00
196,2,1,1,0.005743481974179192,2019-03-25 22:45:00,2019-03-25 23:00:00
201,1,1,0,0.007117834720495348,2019-03-25 22:45:00,2019-03-25 23:00:00
10,1,1,0,0.006800392765019056,2019-03-25 23:00:00,2019-03-25 23:15:00
18,1,1,0,0.006800392765019056,2019-03-25 23:00:00,2019-03-25 23:15:00
23,2,0,2,0.0036756611412867755,2019-03-25 23:00:00,2019-03-25 23:15:00
57,1,1,0,0.006393226366856958,2019-03-25 23:00:00,2019-03-25 23:15:00
58,5,3,2,0.060573824078366784,2019-03-25 23:00:00,2019-03-25 23:15:00
66,2,1,1,0.02445342560402689,2019-03-25 23:00:00,2019-03-25 23:15:00
68,1,0,1,0.0036756611412867755,2019-03-25 23:00:00,2019-03-25 23:15:00
87,2,1,1,0.02445342560402689,2019-03-25 23:00:00,2019-03-25 23:15:00
101,2,1,1,0.02445342560402689,2019-03-25 23:00:00,2019-03-25 23:15:00
115,2,1,1,0.02445342560402689,2019-03-25 23:00:00,2019-03-25 23:15:00
116,3,1,2,0.006393226366856958,2019-03-25 23:00:00,2019-03-25 23:15:00
120,3,1,2,0.006393226366856958,2019-03-25 23:00:00,2019-03-25 23:15:00
138,2,1,1,0.006393226366856958,2019-03-25 23:00:00,2019-03-25 23:15:00
141,1,1,0,0.006800392765019056,2019-03-25 23:00:00,2019-03-25 23:15:00
153,1,0,1,0.0036756611412867755,2019-03-25 23:00:00,2019-03-25 23:15:00
154,2,1,1,0.02445342560402689,2019-03-25 23:00:00,2019-03-25 23:15:00
164,3,2,1,0.04523119006676702,2019-03-25 23:00:00,2019-03-25 23:15:00
168,1,0,1,0.0036756611412867755,2019-03-25 23:00:00,2019-03-25 23:15:00
173,1,1,0,0.005238026953152916,2019-03-25 23:00:00,2019-03-25 23:15:00
175,2,1,1,0.02445342560402689,2019-03-25 23:00:00,2019-03-25 23:15:00
191,1,1,0,0.005238026953152916,2019-03-25 23:00:00,2019-03-25 23:15:00
196,1,0,1,0.0036756611412867755,2019-03-25 23:00:00,2019-03-25 23:15:00
20,2,0,2,0.004028187123773802,2019-03-25 23:15:00,2019-03-25 23:30:00
23,2,0,2,0.004028187123773802,2019-03-25 23:15:00,2019-03-25 23:30:00
57,1,1,0,0.007452533975287316,2019-03-25 23:15:00,2019-03-25 23:30:00
58,3,1,2,0.007006232606481307,2019-03-25 23:15:00,2019-03-25 23:30:00
66,2,1,1,0.026738445590656645,2019-03-25 23:15:00,2019-03-25 23:30:00
87,2,1,1,0.026738445590656645,2019-03-25 23:15:00,2019-03-25 23:30:00
101,2,1,1,0.026738445590656645,2019-03-25 23:15:00,2019-03-25 23:30:00
109,2,1,1,0.007006232606481307,2019-03-25 23:15:00,2019-03-25 23:30:00
111,2,2,0,0.007452533975287316,2019-03-25 23:15:00,2019-03-25 23:30:00
115,2,1,1,0.026738445590656645,2019-03-25 23:15:00,2019-03-25 23:30:00
116,1,0,1,0.004028187123773802,2019-03-25 23:15:00,2019-03-25 23:30:00
120,4,2,2,0.017366094054351102,2019-03-25 23:15:00,2019-03-25 23:30:00
122,1,1,0,0.012464586710391027,2019-03-25 23:15:00,2019-03-25 23:30:00
138,4,2,2,0.019846402675553314,2019-03-25 23:15:00,2019-03-25 23:30:00
141,1,1,0,0.007452533975287316,2019-03-25 23:15:00,2019-03-25 23:30:00
162,2,2,0,0.007452533975287316,2019-03-25 23:15:00,2019-03-25 23:30:00
164,2,1,1,0.026738445590656645,2019-03-25 23:15:00,2019-03-25 23:30:00
168,1,0,1,0.004028187123773802,2019-03-25 23:15:00,2019-03-25 23:30:00
173,1,1,0,0.005740360549530559,2019-03-25 23:15:00,2019-03-25 23:30:00
191,1,1,0,0.005740360549530559,2019-03-25 23:15:00,2019-03-25 23:30:00
196,2,0,2,0.004028187123773802,2019-03-25 23:15:00,2019-03-25 23:30:00
5,1,1,0,0.007574517236052521,2019-03-25 23:30:00,2019-03-25 23:45:00
18,1,0,1,0.004094148393900501,2019-03-25 23:30:00,2019-03-25 23:45:00
20,4,0,4,0.004094148393900501,2019-03-25 23:30:00,2019-03-25 23:45:00
23,1,0,1,0.004094148393900501,2019-03-25 23:30:00,2019-03-25 23:45:00
41,2,2,0,0.005834332814976511,2019-03-25 23:30:00,2019-03-25 23:45:00
57,2,1,1,0.007574517236052521,2019-03-25 23:30:00,2019-03-25 23:45:00
66,2,1,1,0.02719602002948143,2019-03-25 23:30:00,2019-03-25 23:45:00
87,2,1,1,0.02719602002948143,2019-03-25 23:30:00,2019-03-25 23:45:00
88,1,1,0,0.005607508332482956,2019-03-25 23:30:00,2019-03-25 23:45:00
101,2,1,1,0.02719602002948143,2019-03-25 23:30:00,2019-03-25 23:45:00
109,6,2,4,0.00712086827106541,2019-03-25 23:30:00,2019-03-25 23:45:00
111,2,2,0,0.007574517236052521,2019-03-25 23:30:00,2019-03-25 23:45:00
115,2,1,1,0.02719602002948143,2019-03-25 23:30:00,2019-03-25 23:45:00
116,1,0,1,0.004094148393900501,2019-03-25 23:30:00,2019-03-25 23:45:00
120,4,2,2,0.009753118215754607,2019-03-25 23:30:00,2019-03-25 23:45:00
122,1,1,0,0.011098832704354907,2019-03-25 23:30:00,2019-03-25 23:45:00
138,2,1,1,0.008239758277172153,2019-03-25 23:30:00,2019-03-25 23:45:00
154,1,1,0,0.010533181424306471,2019-03-25 23:30:00,2019-03-25 23:45:00
162,2,2,0,0.005834332814976511,2019-03-25 23:30:00,2019-03-25 23:45:00
164,2,1,1,0.02719602002948143,2019-03-25 23:30:00,2019-03-25 23:45:00
191,1,1,0,0.007574517236052521,2019-03-25 23:30:00,2019-03-25 23:45:00
196,2,0,2,0.004094148393900501,2019-03-25 23:30:00,2019-03-25 23:45:00
5,1,1,0,0.0075534297628047295,2019-03-25 23:45:00,2019-03-26 00:00:00
15,1,1,0,0.0075534297628047295,2019-03-25 23:45:00,2019-03-26 00:00:00
16,1,0,1,0.004082750242644668,2019-03-25 23:45:00,2019-03-26 00:00:00
18,1,0,1,0.004082750242644668,2019-03-25 23:45:00,2019-03-26 00:00:00
20,2,0,2,0.004082750242644668,2019-03-25 23:45:00,2019-03-26 00:00:00
23,1,0,1,0.004082750242644668,2019-03-25 23:45:00,2019-03-26 00:00:00
57,2,2,0,0.013590016835496273,2019-03-25 23:45:00,2019-03-26 00:00:00
66,2,1,1,0.027120077666053184,2019-03-25 23:45:00,2019-03-26 00:00:00
86,1,1,0,0.0075534297628047295,2019-03-25 23:45:00,2019-03-26 00:00:00
87,2,1,1,0.027120077666053184,2019-03-25 23:45:00,2019-03-26 00:00:00
88,1,1,0,0.0067530678540233795,2019-03-25 23:45:00,2019-03-26 00:00:00
90,1,1,0,0.0075534297628047295,2019-03-25 23:45:00,2019-03-26 00:00:00
101,2,1,1,0.027120077666053184,2019-03-25 23:45:00,2019-03-26 00:00:00
109,5,2,3,0.009423385465402091,2019-03-25 23:45:00,2019-03-26 00:00:00
115,2,1,1,0.027120077666053184,2019-03-25 23:45:00,2019-03-26 00:00:00
116,1,0,1,0.004082750242644668,2019-03-25 23:45:00,2019-03-26 00:00:00
120,3,1,2,0.0071010437789904395,2019-03-25 23:45:00,2019-03-26 00:00:00
133,1,1,0,0.0075534297628047295,2019-03-25 23:45:00,2019-03-26 00:00:00
138,2,1,1,0.0071010437789904395,2019-03-25 23:45:00,2019-03-26 00:00:00
140,1,0,1,0.004082750242644668,2019-03-25 23:45:00,2019-03-26 00:00:00
154,1,0,1,0.004082750242644668,2019-03-25 23:45:00,2019-03-26 00:00:00
162,2,2,0,0.0075534297628047295,2019-03-25 23:45:00,2019-03-26 00:00:00
164,2,1,1,0.027120077666053184,2019-03-25 23:45:00,2019-03-26 00:00:00
191,1,1,0,0.0075534297628047295,2019-03-25 23:45:00,2019-03-26 00:00:00
195,1,0,1,0.004082750242644668,2019-03-25 23:45:00,2019-03-26 00:00:00
15,1,1,0,0.007374019523903968,2019-03-26 00:00:00,2019-03-26 00:15:00
16,1,0,1,0.003985752072941364,2019-03-26 00:00:00,2019-03-26 00:15:00
23,1,0,1,0.003985752072941364,2019-03-26 00:00:00,2019-03-26 00:15:00
57,1,1,0,0.007374019523903968,2019-03-26 00:00:00,2019-03-26 00:15:00
66,2,1,1,0.026497333410487038,2019-03-26 00:00:00,2019-03-26 00:15:00
69,2,1,1,0.026497333410487038,2019-03-26 00:00:00,2019-03-26 00:15:00
85,2,2,0,0.006244597040249766,2019-03-26 00:00:00,2019-03-26 00:15:00
87,2,1,1,0.026497333410487038,2019-03-26 00:00:00,2019-03-26 00:15:00
101,2,1,1,0.026497333410487038,2019-03-26 00:00:00,2019-03-26 00:15:00
109,4,2,2,0.026497333410487038,2019-03-26 00:00:00,2019-03-26 00:15:00
115,2,1,1,0.026497333410487038,2019-03-26 00:00:00,2019-03-26 00:15:00
116,1,0,1,0.003985752072941364,2019-03-26 00:00:00,2019-03-26 00:15:00
120,3,1,2,0.006932423543029382,2019-03-26 00:00:00,2019-03-26 00:15:00
133,1,1,0,0.005115174556595565,2019-03-26 00:00:00,2019-03-26 00:15:00
138,2,1,1,0.006932423543029382,2019-03-26 00:00:00,2019-03-26 00:15:00
154,3,0,3,0.003985752072941364,2019-03-26 00:00:00,2019-03-26 00:15:00
164,2,1,1,0.026497333410487038,2019-03-26 00:00:00,2019-03-26 00:15:00
168,1,1,0,0.009879095013117399,2019-03-26 00:00:00,2019-03-26 00:15:00
191,1,1,0,0.007374019523903968,2019-03-26 00:00:00,2019-03-26 00:15:00
23,1,0,1,0.004046683136656299,2019-03-26 00:15:00,2019-03-26 00:30:00
57,4,2,2,0.013021729604044574,2019-03-26 00:15:00,2019-03-26 00:30:00
66,2,1,1,0.026892197902014664,2019-03-26 00:15:00,2019-03-26 00:30:00
69,4,2,2,0.026892197902014664,2019-03-26 00:15:00,2019-03-26 00:30:00
85,2,2,0,0.007486729972006886,2019-03-26 00:15:00,2019-03-26 00:30:00
87,2,1,1,0.026892197902014664,2019-03-26 00:15:00,2019-03-26 00:30:00
101,2,1,1,0.026892197902014664,2019-03-26 00:15:00,2019-03-26 00:30:00
115,2,1,1,0.026892197902014664,2019-03-26 00:15:00,2019-03-26 00:30:00
116,1,0,1,0.004046683136656299,2019-03-26 00:15:00,2019-03-26 00:30:00
120,3,1,2,0.007038365292452392,2019-03-26 00:15:00,2019-03-26 00:30:00
138,2,1,1,0.007038365292452392,2019-03-26 00:15:00,2019-03-26 00:30:00
154,2,0,2,0.004046683136656299,2019-03-26 00:15:00,2019-03-26 00:30:00
164,2,1,1,0.026892197902014664,2019-03-26 00:15:00,2019-03-26 00:30:00
168,1,1,0,0.010030047448248484,2019-03-26 00:15:00,2019-03-26 00:30:00
190,1,1,0,0.009581682768693988,2019-03-26 00:15:00,2019-03-26 00:30:00
191,1,1,0,0.007486729972006886,2019-03-26 00:15:00,2019-03-26 00:30:00
18,1,0,1,0.004121284336924638,2019-03-26 00:30:00,2019-03-26 00:45:00
23,1,0,1,0.004121284336924638,2019-03-26 00:30:00,2019-03-26 00:45:00
37,1,0,1,0.004121284336924638,2019-03-26 00:30:00,2019-03-26 00:45:00
57,5,3,2,0.01935520889507511,2019-03-26 00:30:00,2019-03-26 00:45:00
66,2,1,1,0.027376614913314407,2019-03-26 00:30:00,2019-03-26 00:45:00
67,1,1,0,0.007624723161937511,2019-03-26 00:30:00,2019-03-26 00:45:00
87,2,1,1,0.027376614913314407,2019-03-26 00:30:00,2019-03-26 00:45:00
101,2,1,1,0.027376614913314407,2019-03-26 00:30:00,2019-03-26 00:45:00
115,2,1,1,0.027376614913314407,2019-03-26 00:30:00,2019-03-26 00:45:00
116,1,0,1,0.004121284336924638,2019-03-26 00:30:00,2019-03-26 00:45:00
120,4,1,3,0.005750874372653463,2019-03-26 00:30:00,2019-03-26 00:45:00
138,1,1,0,0.005750874372653463,2019-03-26 00:30:00,2019-03-26 00:45:00
147,1,0,1,0.004121284336924638,2019-03-26 00:30:00,2019-03-26 00:45:00
157,1,1,0,0.007624723161937511,2019-03-26 00:30:00,2019-03-26 00:45:00
164,2,1,1,0.027376614913314407,2019-03-26 00:30:00,2019-03-26 00:45:00
190,1,1,0,0.012348331245049367,2019-03-26 00:30:00,2019-03-26 00:45:00
191,1,1,0,0.007624723161937511,2019-03-26 00:30:00,2019-03-26 00:45:00
203,1,1,0,0.005750874372653463,2019-03-26 00:30:00,2019-03-26 00:45:00
5,1,1,0,0.007645170521986366,2019-03-26 00:45:00,2019-03-26 01:00:00
18,1,0,1,0.00413233489238875,2019-03-26 00:45:00,2019-03-26 01:00:00
20,1,0,1,0.00413233489238875,2019-03-26 00:45:00,2019-03-26 01:00:00
23,1,0,1,0.00413233489238875,2019-03-26 00:45:00,2019-03-26 01:00:00
37,1,0,1,0.00413233489238875,2019-03-26 00:45:00,2019-03-26 01:00:00
41,1,1,0,0.010242254207886638,2019-03-26 00:45:00,2019-03-26 01:00:00
57,3,3,0,0.017657111339164224,2019-03-26 00:45:00,2019-03-26 01:00:00
66,2,1,1,0.027449979911137956,2019-03-26 00:45:00,2019-03-26 01:00:00
87,2,1,1,0.027449979911137956,2019-03-26 00:45:00,2019-03-26 01:00:00
101,2,1,1,0.027449979911137956,2019-03-26 00:45:00,2019-03-26 01:00:00
115,2,1,1,0.027449979911137956,2019-03-26 00:45:00,2019-03-26 01:00:00
116,1,0,1,0.00413233489238875,2019-03-26 00:45:00,2019-03-26 01:00:00
120,3,1,2,0.007187294550137694,2019-03-26 00:45:00,2019-03-26 01:00:00
138,2,1,1,0.007187294550137694,2019-03-26 00:45:00,2019-03-26 01:00:00
157,1,1,0,0.007645170521986366,2019-03-26 00:45:00,2019-03-26 01:00:00
164,2,1,1,0.027449979911137956,2019-03-26 00:45:00,2019-03-26 01:00:00
191,2,1,1,0.007645170521986366,2019-03-26 00:45:00,2019-03-26 01:00:00
5,1,1,0,0.007324409468687791,2019-03-26 01:00:00,2019-03-26 01:15:00
15,2,1,1,0.026318584135487974,2019-03-26 01:00:00,2019-03-26 01:15:00
20,1,0,1,0.003958937882366264,2019-03-26 01:00:00,2019-03-26 01:15:00
23,1,0,1,0.003958937882366264,2019-03-26 01:00:00,2019-03-26 01:15:00
35,1,0,1,0.003958937882366264,2019-03-26 01:00:00,2019-03-26 01:15:00
41,1,1,0,0.009812628294933252,2019-03-26 01:00:00,2019-03-26 01:15:00
57,2,2,0,0.010689881055009318,2019-03-26 01:00:00,2019-03-26 01:15:00
66,2,1,1,0.026318584135487974,2019-03-26 01:00:00,2019-03-26 01:15:00
87,2,1,1,0.026318584135487974,2019-03-26 01:00:00,2019-03-26 01:15:00
101,2,1,1,0.026318584135487974,2019-03-26 01:00:00,2019-03-26 01:15:00
110,4,2,2,0.026318584135487974,2019-03-26 01:00:00,2019-03-26 01:15:00
115,2,1,1,0.026318584135487974,2019-03-26 01:00:00,2019-03-26 01:15:00
116,1,0,1,0.003958937882366264,2019-03-26 01:00:00,2019-03-26 01:15:00
120,3,1,2,0.006885783088649758,2019-03-26 01:00:00,2019-03-26 01:15:00
138,2,1,1,0.006885783088649758,2019-03-26 01:00:00,2019-03-26 01:15:00
140,1,1,0,0.007324409468687791,2019-03-26 01:00:00,2019-03-26 01:15:00
162,1,1,0,0.007324409468687791,2019-03-26 01:00:00,2019-03-26 01:15:00
164,2,1,1,0.026318584135487974,2019-03-26 01:00:00,2019-03-26 01:15:00
173,1,0,1,0.003958937882366264,2019-03-26 01:00:00,2019-03-26 01:15:00
190,1,0,1,0.003958937882366264,2019-03-26 01:00:00,2019-03-26 01:15:00
191,1,1,0,0.007324409468687791,2019-03-26 01:00:00,2019-03-26 01:15:00
15,1,1,0,0.00753747407217155,2019-03-26 01:15:00,2019-03-26 01:30:00
19,1,0,1,0.004074108460745389,2019-03-26 01:15:00,2019-03-26 01:30:00
23,1,0,1,0.004074108460745389,2019-03-26 01:15:00,2019-03-26 01:30:00
35,1,0,1,0.004074108460745389,2019-03-26 01:15:00,2019-03-26 01:30:00
57,1,1,0,0.00753747407217155,2019-03-26 01:15:00,2019-03-26 01:30:00
58,1,1,0,0.00753747407217155,2019-03-26 01:15:00,2019-03-26 01:30:00
66,2,1,1,0.027074714993424176,2019-03-26 01:15:00,2019-03-26 01:30:00
87,2,1,1,0.027074714993424176,2019-03-26 01:15:00,2019-03-26 01:30:00
101,2,1,1,0.027074714993424176,2019-03-26 01:15:00,2019-03-26 01:30:00
104,1,1,0,0.00753747407217155,2019-03-26 01:15:00,2019-03-26 01:30:00
110,4,2,2,0.027074714993424176,2019-03-26 01:15:00,2019-03-26 01:30:00
111,1,0,1,0.004074108460745389,2019-03-26 01:15:00,2019-03-26 01:30:00
115,2,1,1,0.027074714993424176,2019-03-26 01:15:00,2019-03-26 01:30:00
116,1,0,1,0.004074108460745389,2019-03-26 01:15:00,2019-03-26 01:30:00
119,1,0,1,0.004074108460745389,2019-03-26 01:15:00,2019-03-26 01:30:00
120,3,1,2,0.007086074802029098,2019-03-26 01:15:00,2019-03-26 01:30:00
138,1,1,0,0.007086074802029098,2019-03-26 01:15:00,2019-03-26 01:30:00
140,1,1,0,0.00753747407217155,2019-03-26 01:15:00,2019-03-26 01:30:00
164,2,1,1,0.027074714993424176,2019-03-26 01:15:00,2019-03-26 01:30:00
191,1,1,0,0.00753747407217155,2019-03-26 01:15:00,2019-03-26 01:30:00
5,2,0,2,0.004074108460745389,2019-03-26 01:30:00,2019-03-26 01:45:00
19,1,0,1,0.004074108460745389,2019-03-26 01:30:00,2019-03-26 01:45:00
23,1,0,1,0.004074108460745389,2019-03-26 01:30:00,2019-03-26 01:45:00
57,1,1,0,0.007537474072171551,2019-03-26 01:30:00,2019-03-26 01:45:00
58,1,1,0,0.007537474072171551,2019-03-26 01:30:00,2019-03-26 01:45:00
66,2,1,1,0.02707471499342418,2019-03-26 01:30:00,2019-03-26 01:45:00
67,2,2,0,0.007537474072171551,2019-03-26 01:30:00,2019-03-26 01:45:00
68,1,1,0,0.007537474072171551,2019-03-26 01:30:00,2019-03-26 01:45:00
87,2,1,1,0.02707471499342418,2019-03-26 01:30:00,2019-03-26 01:45:00
101,2,1,1,0.02707471499342418,2019-03-26 01:30:00,2019-03-26 01:45:00
104,1,1,0,0.007537474072171551,2019-03-26 01:30:00,2019-03-26 01:45:00
110,4,2,2,0.02707471499342418,2019-03-26 01:30:00,2019-03-26 01:45:00
111,1,0,1,0.004074108460745389,2019-03-26 01:30:00,2019-03-26 01:45:00
115,2,1,1,0.02707471499342418,2019-03-26 01:30:00,2019-03-26 01:45:00
116,1,0,1,0.004074108460745389,2019-03-26 01:30:00,2019-03-26 01:45:00
120,3,1,2,0.007086074802029099,2019-03-26 01:30:00,2019-03-26 01:45:00
138,1,1,0,0.007086074802029099,2019-03-26 01:30:00,2019-03-26 01:45:00
140,1,0,1,0.004074108460745389,2019-03-26 01:30:00,2019-03-26 01:45:00
164,2,1,1,0.02707471499342418,2019-03-26 01:30:00,2019-03-26 01:45:00
191,1,1,0,0.007537474072171551,2019-03-26 01:30:00,2019-03-26 01:45:00
5,2,0,2,0.0046056966959823285,2019-03-26 01:45:00,2019-03-26 02:00:00
23,1,0,1,0.0046056966959823285,2019-03-26 01:45:00,2019-03-26 02:00:00
46,2,0,2,0.0046056966959823285,2019-03-26 01:45:00,2019-03-26 02:00:00
57,1,1,0,0.008520940727567436,2019-03-26 01:45:00,2019-03-26 02:00:00
67,2,2,0,0.008520940727567436,2019-03-26 01:45:00,2019-03-26 02:00:00
68,1,1,0,0.008520940727567436,2019-03-26 01:45:00,2019-03-26 02:00:00
69,2,2,0,0.008520940727567436,2019-03-26 01:45:00,2019-03-26 02:00:00
87,2,1,1,0.030136584316296955,2019-03-26 01:45:00,2019-03-26 02:00:00
104,2,0,2,0.0046056966959823285,2019-03-26 01:45:00,2019-03-26 02:00:00
109,2,2,0,0.008520940727567436,2019-03-26 01:45:00,2019-03-26 02:00:00
116,1,0,1,0.0046056966959823285,2019-03-26 01:45:00,2019-03-26 02:00:00
120,3,1,2,0.008010609452881016,2019-03-26 01:45:00,2019-03-26 02:00:00
138,1,1,0,0.008010609452881016,2019-03-26 01:45:00,2019-03-26 02:00:00
140,1,0,1,0.0046056966959823285,2019-03-26 01:45:00,2019-03-26 02:00:00
191,1,1,0,0.008520940727567436,2019-03-26 01:45:00,2019-03-26 02:00:00
5,2,0,2,0.004590415820822384,2019-03-26 02:00:00,2019-03-26 02:15:00
18,1,1,0,0.011809981546301068,2019-03-26 02:00:00,2019-03-26 02:15:00
23,1,0,1,0.004590415820822384,2019-03-26 02:00:00,2019-03-26 02:15:00
46,2,0,2,0.004590415820822384,2019-03-26 02:00:00,2019-03-26 02:15:00
57,1,1,0,0.008492667506411289,2019-03-26 02:00:00,2019-03-26 02:15:00
67,2,2,0,0.008492667506411289,2019-03-26 02:00:00,2019-03-26 02:15:00
69,2,2,0,0.008492667506411289,2019-03-26 02:00:00,2019-03-26 02:15:00
87,2,1,1,0.030037124624252676,2019-03-26 02:00:00,2019-03-26 02:15:00
104,2,0,2,0.004590415820822384,2019-03-26 02:00:00,2019-03-26 02:15:00
109,3,2,1,0.008492667506411289,2019-03-26 02:00:00,2019-03-26 02:15:00
116,1,0,1,0.004590415820822384,2019-03-26 02:00:00,2019-03-26 02:15:00
120,3,1,2,0.007984027708102387,2019-03-26 02:00:00,2019-03-26 02:15:00
138,1,1,0,0.007984027708102387,2019-03-26 02:00:00,2019-03-26 02:15:00
191,1,1,0,0.008492667506411289,2019-03-26 02:00:00,2019-03-26 02:15:00
5,2,0,2,0.004642047692086273,2019-03-26 02:15:00,2019-03-26 02:30:00
23,1,0,1,0.004642047692086273,2019-03-26 02:15:00,2019-03-26 02:30:00
57,1,1,0,0.00858819737024604,2019-03-26 02:15:00,2019-03-26 02:30:00
67,2,2,0,0.00858819737024604,2019-03-26 02:15:00,2019-03-26 02:30:00
69,2,2,0,0.00858819737024604,2019-03-26 02:15:00,2019-03-26 02:30:00
87,2,1,1,0.030374084757071228,2019-03-26 02:15:00,2019-03-26 02:30:00
104,2,0,2,0.004642047692086273,2019-03-26 02:15:00,2019-03-26 02:30:00
116,1,0,1,0.004642047692086273,2019-03-26 02:15:00,2019-03-26 02:30:00
120,3,1,2,0.008073841364428971,2019-03-26 02:15:00,2019-03-26 02:30:00
138,1,1,0,0.008073841364428971,2019-03-26 02:15:00,2019-03-26 02:30:00
191,1,1,0,0.00858819737024604,2019-03-26 02:15:00,2019-03-26 02:30:00
23,1,0,1,0.004678977167901702,2019-03-26 02:30:00,2019-03-26 02:45:00
57,1,1,0,0.00865652440193215,2019-03-26 02:30:00,2019-03-26 02:45:00
87,2,1,1,0.030615358252511972,2019-03-26 02:30:00,2019-03-26 02:45:00
116,1,0,1,0.004678977167901702,2019-03-26 02:30:00,2019-03-26 02:45:00
120,3,1,2,0.00813807968164419,2019-03-26 02:30:00,2019-03-26 02:45:00
138,1,1,0,0.00813807968164419,2019-03-26 02:30:00,2019-03-26 02:45:00
191,1,1,0,0.00865652440193215,2019-03-26 02:30:00,2019-03-26 02:45:00
23,1,0,1,0.004678977167901702,2019-03-26 02:45:00,2019-03-26 03:00:00
57,1,1,0,0.00865652440193215,2019-03-26 02:45:00,2019-03-26 03:00:00
87,2,1,1,0.030615358252511972,2019-03-26 02:45:00,2019-03-26 03:00:00
116,1,0,1,0.004678977167901702,2019-03-26 02:45:00,2019-03-26 03:00:00
120,3,1,2,0.00813807968164419,2019-03-26 02:45:00,2019-03-26 03:00:00
138,1,1,0,0.00813807968164419,2019-03-26 02:45:00,2019-03-26 03:00:00
191,1,1,0,0.00865652440193215,2019-03-26 02:45:00,2019-03-26 03:00:00
23,1,0,1,0.0046604392602147245,2019-03-26 03:00:00,2019-03-26 03:15:00
57,1,1,0,0.008622225496342888,2019-03-26 03:00:00,2019-03-26 03:15:00
87,2,1,1,0.030494244275874386,2019-03-26 03:00:00,2019-03-26 03:15:00
110,2,2,0,0.008622225496342888,2019-03-26 03:00:00,2019-03-26 03:15:00
116,1,0,1,0.0046604392602147245,2019-03-26 03:00:00,2019-03-26 03:15:00
120,3,1,2,0.008105833226183657,2019-03-26 03:00:00,2019-03-26 03:15:00
137,2,0,2,0.0046604392602147245,2019-03-26 03:00:00,2019-03-26 03:15:00
138,1,1,0,0.008105833226183657,2019-03-26 03:00:00,2019-03-26 03:15:00
191,1,1,0,0.008622225496342888,2019-03-26 03:00:00,2019-03-26 03:15:00
23,1,0,1,0.004642047692086272,2019-03-26 03:15:00,2019-03-26 03:30:00
26,1,1,0,0.008588197370246037,2019-03-26 03:15:00,2019-03-26 03:30:00
57,1,1,0,0.008588197370246037,2019-03-26 03:15:00,2019-03-26 03:30:00
86,1,0,1,0.004642047692086272,2019-03-26 03:15:00,2019-03-26 03:30:00
87,2,1,1,0.030374084757071235,2019-03-26 03:15:00,2019-03-26 03:30:00
110,2,2,0,0.008588197370246037,2019-03-26 03:15:00,2019-03-26 03:30:00
116,1,0,1,0.004642047692086272,2019-03-26 03:15:00,2019-03-26 03:30:00
120,3,1,2,0.008073841364428971,2019-03-26 03:15:00,2019-03-26 03:30:00
137,2,0,2,0.004642047692086272,2019-03-26 03:15:00,2019-03-26 03:30:00
138,1,1,0,0.008073841364428971,2019-03-26 03:15:00,2019-03-26 03:30:00
191,1,1,0,0.008588197370246037,2019-03-26 03:15:00,2019-03-26 03:30:00
23,1,0,1,0.004642047692086272,2019-03-26 03:30:00,2019-03-26 03:45:00
26,1,1,0,0.008588197370246037,2019-03-26 03:30:00,2019-03-26 03:45:00
57,1,1,0,0.008588197370246037,2019-03-26 03:30:00,2019-03-26 03:45:00
69,1,1,0,0.008588197370246037,2019-03-26 03:30:00,2019-03-26 03:45:00
86,1,0,1,0.004642047692086272,2019-03-26 03:30:00,2019-03-26 03:45:00
87,2,1,1,0.030374084757071228,2019-03-26 03:30:00,2019-03-26 03:45:00
112,1,0,1,0.004642047692086272,2019-03-26 03:30:00,2019-03-26 03:45:00
116,1,0,1,0.004642047692086272,2019-03-26 03:30:00,2019-03-26 03:45:00
120,3,1,2,0.008073841364428971,2019-03-26 03:30:00,2019-03-26 03:45:00
138,1,1,0,0.008073841364428971,2019-03-26 03:30:00,2019-03-26 03:45:00
191,1,1,0,0.008588197370246037,2019-03-26 03:30:00,2019-03-26 03:45:00
23,1,0,1,0.004505555214860408,2019-03-26 03:45:00,2019-03-26 04:00:00
26,1,1,0,0.00833564406635414,2019-03-26 03:45:00,2019-03-26 04:00:00
57,1,1,0,0.00833564406635414,2019-03-26 03:45:00,2019-03-26 04:00:00
58,1,0,1,0.004505555214860408,2019-03-26 03:45:00,2019-03-26 04:00:00
69,1,1,0,0.00833564406635414,2019-03-26 03:45:00,2019-03-26 04:00:00
86,1,0,1,0.004505555214860408,2019-03-26 03:45:00,2019-03-26 04:00:00
87,2,1,1,0.029780086325303344,2019-03-26 03:45:00,2019-03-26 04:00:00
112,1,0,1,0.004505555214860408,2019-03-26 03:45:00,2019-03-26 04:00:00
116,1,0,1,0.004505555214860408,2019-03-26 03:45:00,2019-03-26 04:00:00
120,3,1,2,0.007836392452492338,2019-03-26 03:45:00,2019-03-26 04:00:00
138,1,1,0,0.007836392452492338,2019-03-26 03:45:00,2019-03-26 04:00:00
158,2,1,1,0.029780086325303344,2019-03-26 03:45:00,2019-03-26 04:00:00
191,2,2,0,0.012165732917847874,2019-03-26 03:45:00,2019-03-26 04:00:00
16,1,1,0,0.008622225496342888,2019-03-26 04:00:00,2019-03-26 04:15:00
23,1,0,1,0.0046604392602147245,2019-03-26 04:00:00,2019-03-26 04:15:00
57,1,1,0,0.008622225496342888,2019-03-26 04:00:00,2019-03-26 04:15:00
87,2,1,1,0.030494244275874383,2019-03-26 04:00:00,2019-03-26 04:15:00
116,1,0,1,0.0046604392602147245,2019-03-26 04:00:00,2019-03-26 04:15:00
120,3,1,2,0.008105833226183657,2019-03-26 04:00:00,2019-03-26 04:15:00
138,1,1,0,0.008105833226183657,2019-03-26 04:00:00,2019-03-26 04:15:00
158,1,0,1,0.0046604392602147245,2019-03-26 04:00:00,2019-03-26 04:15:00
191,1,1,0,0.008622225496342888,2019-03-26 04:00:00,2019-03-26 04:15:00
20,1,0,1,0.004642047692086273,2019-03-26 04:15:00,2019-03-26 04:30:00
23,1,0,1,0.004642047692086273,2019-03-26 04:15:00,2019-03-26 04:30:00
57,1,1,0,0.00858819737024604,2019-03-26 04:15:00,2019-03-26 04:30:00
85,1,1,0,0.00858819737024604,2019-03-26 04:15:00,2019-03-26 04:30:00
87,2,1,1,0.030374084757071228,2019-03-26 04:15:00,2019-03-26 04:30:00
116,1,0,1,0.004642047692086273,2019-03-26 04:15:00,2019-03-26 04:30:00
120,3,1,2,0.008073841364428971,2019-03-26 04:15:00,2019-03-26 04:30:00
138,1,1,0,0.008073841364428971,2019-03-26 04:15:00,2019-03-26 04:30:00
191,2,2,0,0.012534347048405805,2019-03-26 04:15:00,2019-03-26 04:30:00
203,1,0,1,0.004642047692086273,2019-03-26 04:15:00,2019-03-26 04:30:00
19,1,1,0,0.011809981546301068,2019-03-26 04:30:00,2019-03-26 04:45:00
20,1,0,1,0.004590415820822384,2019-03-26 04:30:00,2019-03-26 04:45:00
23,1,0,1,0.004590415820822384,2019-03-26 04:30:00,2019-03-26 04:45:00
57,2,1,1,0.008492667506411289,2019-03-26 04:30:00,2019-03-26 04:45:00
85,1,1,0,0.008492667506411289,2019-03-26 04:30:00,2019-03-26 04:45:00
87,2,1,1,0.030037124624252644,2019-03-26 04:30:00,2019-03-26 04:45:00
89,1,1,0,0.008492667506411289,2019-03-26 04:30:00,2019-03-26 04:45:00
116,1,0,1,0.004590415820822384,2019-03-26 04:30:00,2019-03-26 04:45:00
120,3,1,2,0.007984027708102385,2019-03-26 04:30:00,2019-03-26 04:45:00
138,1,1,0,0.007984027708102385,2019-03-26 04:30:00,2019-03-26 04:45:00
140,1,0,1,0.004590415820822384,2019-03-26 04:30:00,2019-03-26 04:45:00
191,2,2,0,0.012394919192000193,2019-03-26 04:30:00,2019-03-26 04:45:00
203,1,0,1,0.004590415820822384,2019-03-26 04:30:00,2019-03-26 04:45:00
19,2,2,0,0.017864135866772383,2019-03-26 04:45:00,2019-03-26 05:00:00
23,1,0,1,0.004533477637874907,2019-03-26 04:45:00,2019-03-26 05:00:00
57,2,1,1,0.008387317889051423,2019-03-26 04:45:00,2019-03-26 05:00:00
85,1,1,0,0.008387317889051423,2019-03-26 04:45:00,2019-03-26 05:00:00
87,2,1,1,0.02966702932946975,2019-03-26 04:45:00,2019-03-26 05:00:00
89,1,1,0,0.008387317889051423,2019-03-26 04:45:00,2019-03-26 05:00:00
110,1,0,1,0.004533477637874907,2019-03-26 04:45:00,2019-03-26 05:00:00
111,1,1,0,0.008387317889051423,2019-03-26 04:45:00,2019-03-26 05:00:00
116,1,0,1,0.004533477637874907,2019-03-26 04:45:00,2019-03-26 05:00:00
120,3,1,2,0.007884980299965687,2019-03-26 04:45:00,2019-03-26 05:00:00
138,1,1,0,0.007884980299965687,2019-03-26 04:45:00,2019-03-26 05:00:00
140,1,0,1,0.004533477637874907,2019-03-26 04:45:00,2019-03-26 05:00:00
191,4,2,2,0.014587985624147249,2019-03-26 04:45:00,2019-03-26 05:00:00
203,1,0,1,0.004533477637874907,2019-03-26 04:45:00,2019-03-26 05:00:00
23,1,0,1,0.004642047692086272,2019-03-26 05:00:00,2019-03-26 05:15:00
57,1,1,0,0.008588197370246037,2019-03-26 05:00:00,2019-03-26 05:15:00
85,1,1,0,0.008588197370246037,2019-03-26 05:00:00,2019-03-26 05:15:00
87,2,1,1,0.030374084757071235,2019-03-26 05:00:00,2019-03-26 05:15:00
110,1,0,1,0.004642047692086272,2019-03-26 05:00:00,2019-03-26 05:15:00
111,1,1,0,0.008588197370246037,2019-03-26 05:00:00,2019-03-26 05:15:00
116,1,0,1,0.004642047692086272,2019-03-26 05:00:00,2019-03-26 05:15:00
120,3,1,2,0.008073841364428971,2019-03-26 05:00:00,2019-03-26 05:15:00
138,1,1,0,0.008073841364428971,2019-03-26 05:00:00,2019-03-26 05:15:00
191,1,1,0,0.008588197370246037,2019-03-26 05:00:00,2019-03-26 05:15:00
203,1,0,1,0.004642047692086272,2019-03-26 05:00:00,2019-03-26 05:15:00
21,1,1,0,0.008431784156532873,2019-03-26 05:15:00,2019-03-26 05:30:00
23,1,0,1,0.004557509704461377,2019-03-26 05:15:00,2019-03-26 05:30:00
41,1,1,0,0.011725310463111,2019-03-26 05:15:00,2019-03-26 05:30:00
57,2,1,1,0.008431784156532873,2019-03-26 05:15:00,2019-03-26 05:30:00
62,1,1,0,0.011725310463111,2019-03-26 05:15:00,2019-03-26 05:30:00
85,1,1,0,0.008431784156532873,2019-03-26 05:15:00,2019-03-26 05:30:00
87,2,1,1,0.029822491205450434,2019-03-26 05:15:00,2019-03-26 05:30:00
116,1,0,1,0.004557509704461377,2019-03-26 05:15:00,2019-03-26 05:30:00
120,3,1,2,0.00792678735784964,2019-03-26 05:15:00,2019-03-26 05:30:00
138,1,1,0,0.00792678735784964,2019-03-26 05:15:00,2019-03-26 05:30:00
151,1,0,1,0.004557509704461377,2019-03-26 05:15:00,2019-03-26 05:30:00
153,2,1,1,0.008431784156532873,2019-03-26 05:15:00,2019-03-26 05:30:00
172,1,0,1,0.004557509704461377,2019-03-26 05:15:00,2019-03-26 05:30:00
191,1,1,0,0.008431784156532873,2019-03-26 05:15:00,2019-03-26 05:30:00
203,1,0,1,0.004557509704461377,2019-03-26 05:15:00,2019-03-26 05:30:00
18,1,1,0,0.00836213049449781,2019-03-26 05:30:00,2019-03-26 05:45:00
21,2,2,0,0.012204398236269232,2019-03-26 05:30:00,2019-03-26 05:45:00
23,1,0,1,0.004519862752726388,2019-03-26 05:30:00,2019-03-26 05:45:00
26,1,1,0,0.00836213049449781,2019-03-26 05:30:00,2019-03-26 05:45:00
41,1,1,0,0.00836213049449781,2019-03-26 05:30:00,2019-03-26 05:45:00
57,2,1,1,0.00836213049449781,2019-03-26 05:30:00,2019-03-26 05:45:00
62,1,1,0,0.011628444247870528,2019-03-26 05:30:00,2019-03-26 05:45:00
69,1,0,1,0.004519862752726388,2019-03-26 05:30:00,2019-03-26 05:45:00
85,1,1,0,0.00836213049449781,2019-03-26 05:30:00,2019-03-26 05:45:00
87,2,1,1,0.029576127806680678,2019-03-26 05:30:00,2019-03-26 05:45:00
116,1,0,1,0.004519862752726388,2019-03-26 05:30:00,2019-03-26 05:45:00
120,3,1,2,0.007861302485754573,2019-03-26 05:30:00,2019-03-26 05:45:00
122,1,1,0,0.00836213049449781,2019-03-26 05:30:00,2019-03-26 05:45:00
138,1,1,0,0.007861302485754573,2019-03-26 05:30:00,2019-03-26 05:45:00
151,1,0,1,0.004519862752726388,2019-03-26 05:30:00,2019-03-26 05:45:00
153,1,0,1,0.004519862752726388,2019-03-26 05:30:00,2019-03-26 05:45:00
157,1,0,1,0.004519862752726388,2019-03-26 05:30:00,2019-03-26 05:45:00
173,1,0,1,0.004519862752726388,2019-03-26 05:30:00,2019-03-26 05:45:00
191,1,1,0,0.00836213049449781,2019-03-26 05:30:00,2019-03-26 05:45:00
201,1,0,1,0.004519862752726388,2019-03-26 05:30:00,2019-03-26 05:45:00
203,1,0,1,0.004519862752726388,2019-03-26 05:30:00,2019-03-26 05:45:00
21,3,3,0,0.01604666597804065,2019-03-26 05:45:00,2019-03-26 06:00:00
23,1,0,1,0.004519862752726387,2019-03-26 05:45:00,2019-03-26 06:00:00
26,1,1,0,0.008362130494497808,2019-03-26 05:45:00,2019-03-26 06:00:00
50,1,0,1,0.004519862752726387,2019-03-26 05:45:00,2019-03-26 06:00:00
57,3,1,2,0.008362130494497808,2019-03-26 05:45:00,2019-03-26 06:00:00
62,1,1,0,0.008074153500298456,2019-03-26 05:45:00,2019-03-26 06:00:00
69,1,0,1,0.004519862752726387,2019-03-26 05:45:00,2019-03-26 06:00:00
85,1,1,0,0.008362130494497808,2019-03-26 05:45:00,2019-03-26 06:00:00
87,2,1,1,0.029576127806680667,2019-03-26 05:45:00,2019-03-26 06:00:00
109,1,1,0,0.008362130494497808,2019-03-26 05:45:00,2019-03-26 06:00:00
116,1,0,1,0.004519862752726387,2019-03-26 05:45:00,2019-03-26 06:00:00
120,3,1,2,0.00786130248575457,2019-03-26 05:45:00,2019-03-26 06:00:00
122,1,0,1,0.004519862752726387,2019-03-26 05:45:00,2019-03-26 06:00:00
127,1,1,0,0.008074153500298456,2019-03-26 05:45:00,2019-03-26 06:00:00
138,1,1,0,0.00786130248575457,2019-03-26 05:45:00,2019-03-26 06:00:00
147,1,0,1,0.004519862752726387,2019-03-26 05:45:00,2019-03-26 06:00:00
151,1,0,1,0.004519862752726387,2019-03-26 05:45:00,2019-03-26 06:00:00
173,1,0,1,0.004519862752726387,2019-03-26 05:45:00,2019-03-26 06:00:00
190,1,1,0,0.008362130494497808,2019-03-26 05:45:00,2019-03-26 06:00:00
191,1,1,0,0.008362130494497808,2019-03-26 05:45:00,2019-03-26 06:00:00
203,1,0,1,0.004519862752726387,2019-03-26 05:45:00,2019-03-26 06:00:00
18,3,0,3,0.004485931754403261,2019-03-26 06:00:00,2019-03-26 06:15:00
22,1,0,1,0.004485931754403261,2019-03-26 06:00:00,2019-03-26 06:15:00
23,4,1,3,0.00625970260504077,2019-03-26 06:00:00,2019-03-26 06:15:00
46,1,1,0,0.00625970260504077,2019-03-26 06:00:00,2019-03-26 06:15:00
57,2,1,1,0.00829934977920237,2019-03-26 06:00:00,2019-03-26 06:15:00
62,1,1,0,0.014297027919493189,2019-03-26 06:00:00,2019-03-26 06:15:00
70,1,1,0,0.00829934977920237,2019-03-26 06:00:00,2019-03-26 06:15:00
85,1,1,0,0.00829934977920237,2019-03-26 06:00:00,2019-03-26 06:15:00
87,2,1,1,0.029355694831622453,2019-03-26 06:00:00,2019-03-26 06:15:00
88,2,0,2,0.004485931754403261,2019-03-26 06:00:00,2019-03-26 06:15:00
109,1,1,0,0.00829934977920237,2019-03-26 06:00:00,2019-03-26 06:15:00
115,1,1,0,0.005757071096002964,2019-03-26 06:00:00,2019-03-26 06:15:00
116,1,0,1,0.004485931754403261,2019-03-26 06:00:00,2019-03-26 06:15:00
118,1,1,0,0.005757071096002964,2019-03-26 06:00:00,2019-03-26 06:15:00
120,3,1,2,0.007802277398236463,2019-03-26 06:00:00,2019-03-26 06:15:00
122,1,0,1,0.004485931754403261,2019-03-26 06:00:00,2019-03-26 06:15:00
127,2,1,1,0.01154113284625127,2019-03-26 06:00:00,2019-03-26 06:15:00
137,2,2,0,0.00829934977920237,2019-03-26 06:00:00,2019-03-26 06:15:00
138,1,1,0,0.007802277398236463,2019-03-26 06:00:00,2019-03-26 06:15:00
151,1,1,0,0.00829934977920237,2019-03-26 06:00:00,2019-03-26 06:15:00
158,1,1,0,0.005757071096002964,2019-03-26 06:00:00,2019-03-26 06:15:00
171,1,0,1,0.004485931754403261,2019-03-26 06:00:00,2019-03-26 06:15:00
191,1,1,0,0.00625970260504077,2019-03-26 06:00:00,2019-03-26 06:15:00
203,1,0,1,0.004485931754403261,2019-03-26 06:00:00,2019-03-26 06:15:00
1,2,0,2,0.004354118461727516,2019-03-26 06:15:00,2019-03-26 06:30:00
5,1,0,1,0.004354118461727516,2019-03-26 06:15:00,2019-03-26 06:30:00
10,1,1,0,0.006204789194510854,2019-03-26 06:15:00,2019-03-26 06:30:00
18,3,0,3,0.004354118461727516,2019-03-26 06:15:00,2019-03-26 06:30:00
19,1,1,0,0.008055459927294192,2019-03-26 06:15:00,2019-03-26 06:30:00
22,1,0,1,0.004354118461727516,2019-03-26 06:15:00,2019-03-26 06:30:00
23,1,0,1,0.004354118461727516,2019-03-26 06:15:00,2019-03-26 06:30:00
41,1,1,0,0.008055459927294192,2019-03-26 06:15:00,2019-03-26 06:30:00
57,1,1,0,0.009628701991632037,2019-03-26 06:15:00,2019-03-26 06:30:00
62,1,1,0,0.008055459927294192,2019-03-26 06:15:00,2019-03-26 06:30:00
69,1,1,0,0.008055459927294192,2019-03-26 06:15:00,2019-03-26 06:30:00
70,2,1,1,0.028778513079434416,2019-03-26 06:15:00,2019-03-26 06:30:00
85,1,1,0,0.008055459927294192,2019-03-26 06:15:00,2019-03-26 06:30:00
87,2,1,1,0.028778513079434416,2019-03-26 06:15:00,2019-03-26 06:30:00
88,2,0,2,0.004354118461727516,2019-03-26 06:15:00,2019-03-26 06:30:00
90,1,0,1,0.004354118461727516,2019-03-26 06:15:00,2019-03-26 06:30:00
113,1,1,0,0.008055459927294192,2019-03-26 06:15:00,2019-03-26 06:30:00
114,1,0,1,0.004354118461727516,2019-03-26 06:15:00,2019-03-26 06:30:00
115,1,1,0,0.005587898950249742,2019-03-26 06:15:00,2019-03-26 06:30:00
116,2,1,1,0.006204789194510854,2019-03-26 06:15:00,2019-03-26 06:30:00
118,1,1,0,0.005587898950249742,2019-03-26 06:15:00,2019-03-26 06:30:00
119,1,1,0,0.008055459927294192,2019-03-26 06:15:00,2019-03-26 06:30:00
120,4,1,3,0.006075752971118866,2019-03-26 06:15:00,2019-03-26 06:30:00
127,1,0,1,0.004354118461727516,2019-03-26 06:15:00,2019-03-26 06:30:00
137,2,2,0,0.008055459927294192,2019-03-26 06:15:00,2019-03-26 06:30:00
138,1,1,0,0.006075752971118866,2019-03-26 06:15:00,2019-03-26 06:30:00
151,1,1,0,0.008055459927294192,2019-03-26 06:15:00,2019-03-26 06:30:00
154,1,1,0,0.006075752971118866,2019-03-26 06:15:00,2019-03-26 06:30:00
158,1,1,0,0.005587898950249742,2019-03-26 06:15:00,2019-03-26 06:30:00
160,1,0,1,0.004354118461727516,2019-03-26 06:15:00,2019-03-26 06:30:00
164,1,1,0,0.008055459927294192,2019-03-26 06:15:00,2019-03-26 06:30:00
173,1,0,1,0.004354118461727516,2019-03-26 06:15:00,2019-03-26 06:30:00
190,1,0,1,0.004354118461727516,2019-03-26 06:15:00,2019-03-26 06:30:00
191,1,1,0,0.008055459927294192,2019-03-26 06:15:00,2019-03-26 06:30:00
203,1,0,1,0.004354118461727516,2019-03-26 06:15:00,2019-03-26 06:30:00
1,1,0,1,0.004044121975767064,2019-03-26 06:30:00,2019-03-26 06:45:00
5,1,0,1,0.004044121975767064,2019-03-26 06:30:00,2019-03-26 06:45:00
10,2,2,0,0.008341424450941534,2019-03-26 06:30:00,2019-03-26 06:45:00
19,4,0,4,0.004044121975767064,2019-03-26 06:30:00,2019-03-26 06:45:00
20,1,0,1,0.004044121975767064,2019-03-26 06:30:00,2019-03-26 06:45:00
21,1,1,0,0.00748196395590664,2019-03-26 06:30:00,2019-03-26 06:45:00
23,3,1,2,0.007033851588964251,2019-03-26 06:30:00,2019-03-26 06:45:00
35,1,1,0,0.00748196395590664,2019-03-26 06:30:00,2019-03-26 06:45:00
37,1,1,0,0.00748196395590664,2019-03-26 06:30:00,2019-03-26 06:45:00
41,1,1,0,0.00748196395590664,2019-03-26 06:30:00,2019-03-26 06:45:00
46,1,0,1,0.004044121975767064,2019-03-26 06:30:00,2019-03-26 06:45:00
57,1,1,0,0.008212591034628187,2019-03-26 06:30:00,2019-03-26 06:45:00
61,1,0,1,0.004044121975767064,2019-03-26 06:30:00,2019-03-26 06:45:00
66,2,1,1,0.02678464660161336,2019-03-26 06:30:00,2019-03-26 06:45:00
69,1,1,0,0.00748196395590664,2019-03-26 06:30:00,2019-03-26 06:45:00
70,2,1,1,0.02678464660161336,2019-03-26 06:30:00,2019-03-26 06:45:00
74,2,2,0,0.008341424450941534,2019-03-26 06:30:00,2019-03-26 06:45:00
85,1,1,0,0.00748196395590664,2019-03-26 06:30:00,2019-03-26 06:45:00
87,2,1,1,0.02678464660161336,2019-03-26 06:30:00,2019-03-26 06:45:00
88,1,0,1,0.004044121975767064,2019-03-26 06:30:00,2019-03-26 06:45:00
89,1,0,1,0.004044121975767064,2019-03-26 06:30:00,2019-03-26 06:45:00
90,1,0,1,0.004044121975767064,2019-03-26 06:30:00,2019-03-26 06:45:00
109,5,2,3,0.014518590080094092,2019-03-26 06:30:00,2019-03-26 06:45:00
112,2,1,1,0.00748196395590664,2019-03-26 06:30:00,2019-03-26 06:45:00
113,2,1,1,0.00748196395590664,2019-03-26 06:30:00,2019-03-26 06:45:00
114,1,0,1,0.004044121975767064,2019-03-26 06:30:00,2019-03-26 06:45:00
116,2,1,1,0.004903582470801958,2019-03-26 06:30:00,2019-03-26 06:45:00
119,2,1,1,0.00748196395590664,2019-03-26 06:30:00,2019-03-26 06:45:00
120,4,1,3,0.0056431984407475065,2019-03-26 06:30:00,2019-03-26 06:45:00
127,2,2,0,0.013842314250932406,2019-03-26 06:30:00,2019-03-26 06:45:00
133,1,1,0,0.008158239785068326,2019-03-26 06:30:00,2019-03-26 06:45:00
137,1,1,0,0.00748196395590664,2019-03-26 06:30:00,2019-03-26 06:45:00
138,2,2,0,0.012003548735773273,2019-03-26 06:30:00,2019-03-26 06:45:00
147,1,0,1,0.004044121975767064,2019-03-26 06:30:00,2019-03-26 06:45:00
154,2,1,1,0.0056431984407475065,2019-03-26 06:30:00,2019-03-26 06:45:00
156,1,0,1,0.004044121975767064,2019-03-26 06:30:00,2019-03-26 06:45:00
157,1,1,0,0.004903582470801958,2019-03-26 06:30:00,2019-03-26 06:45:00
160,1,0,1,0.004044121975767064,2019-03-26 06:30:00,2019-03-26 06:45:00
164,1,1,0,0.00748196395590664,2019-03-26 06:30:00,2019-03-26 06:45:00
170,1,1,0,0.008158239785068326,2019-03-26 06:30:00,2019-03-26 06:45:00
173,1,0,1,0.004044121975767064,2019-03-26 06:30:00,2019-03-26 06:45:00
191,1,1,0,0.007033851588964251,2019-03-26 06:30:00,2019-03-26 06:45:00
195,1,1,0,0.008841351370708392,2019-03-26 06:30:00,2019-03-26 06:45:00
203,1,0,1,0.004044121975767064,2019-03-26 06:30:00,2019-03-26 06:45:00
2,1,1,0,0.007059042216447388,2019-03-26 06:45:00,2019-03-26 07:00:00
10,1,1,0,0.004626399079625813,2019-03-26 06:45:00,2019-03-26 07:00:00
15,1,0,1,0.0038155180340186208,2019-03-26 06:45:00,2019-03-26 07:00:00
18,2,0,2,0.0038155180340186208,2019-03-26 06:45:00,2019-03-26 07:00:00
19,4,0,4,0.0038155180340186208,2019-03-26 06:45:00,2019-03-26 07:00:00
20,1,0,1,0.0038155180340186208,2019-03-26 06:45:00,2019-03-26 07:00:00
23,1,0,1,0.0038155180340186208,2019-03-26 06:45:00,2019-03-26 07:00:00
26,1,1,0,0.007059042216447388,2019-03-26 06:45:00,2019-03-26 07:00:00
30,2,0,2,0.0038155180340186208,2019-03-26 06:45:00,2019-03-26 07:00:00
35,1,1,0,0.007059042216447388,2019-03-26 06:45:00,2019-03-26 07:00:00
37,1,1,0,0.009457026738118643,2019-03-26 06:45:00,2019-03-26 07:00:00
41,1,1,0,0.005437280125233005,2019-03-26 06:45:00,2019-03-26 07:00:00
46,3,2,1,0.006636272386068632,2019-03-26 06:45:00,2019-03-26 07:00:00
57,1,1,0,0.00774837573566337,2019-03-26 06:45:00,2019-03-26 07:00:00
61,2,1,1,0.007059042216447388,2019-03-26 06:45:00,2019-03-26 07:00:00
66,2,0,2,0.0038155180340186208,2019-03-26 06:45:00,2019-03-26 07:00:00
69,1,0,1,0.0038155180340186208,2019-03-26 06:45:00,2019-03-26 07:00:00
70,6,2,4,0.006636272386068632,2019-03-26 06:45:00,2019-03-26 07:00:00
74,3,3,0,0.011113447444483348,2019-03-26 06:45:00,2019-03-26 07:00:00
79,1,0,1,0.0038155180340186208,2019-03-26 06:45:00,2019-03-26 07:00:00
85,2,2,0,0.015817234552604007,2019-03-26 06:45:00,2019-03-26 07:00:00
87,3,2,1,0.03600866521430684,2019-03-26 06:45:00,2019-03-26 07:00:00
88,2,0,2,0.0038155180340186208,2019-03-26 06:45:00,2019-03-26 07:00:00
89,1,0,1,0.0038155180340186208,2019-03-26 06:45:00,2019-03-26 07:00:00
90,1,0,1,0.0038155180340186208,2019-03-26 06:45:00,2019-03-26 07:00:00
104,2,2,0,0.007059042216447388,2019-03-26 06:45:00,2019-03-26 07:00:00
108,1,0,1,0.0038155180340186208,2019-03-26 06:45:00,2019-03-26 07:00:00
109,3,1,2,0.012160453514009541,2019-03-26 06:45:00,2019-03-26 07:00:00
110,3,1,2,0.005437280125233005,2019-03-26 06:45:00,2019-03-26 07:00:00
112,2,1,1,0.009816376293311314,2019-03-26 06:45:00,2019-03-26 07:00:00
115,1,1,0,0.005437280125233005,2019-03-26 06:45:00,2019-03-26 07:00:00
116,2,1,1,0.004626399079625813,2019-03-26 06:45:00,2019-03-26 07:00:00
120,3,1,2,0.006636272386068632,2019-03-26 06:45:00,2019-03-26 07:00:00
127,1,1,0,0.007059042216447388,2019-03-26 06:45:00,2019-03-26 07:00:00
133,1,1,0,0.008984392620370882,2019-03-26 06:45:00,2019-03-26 07:00:00
135,1,1,0,0.007059042216447388,2019-03-26 06:45:00,2019-03-26 07:00:00
137,4,3,1,0.010991899918092136,2019-03-26 06:45:00,2019-03-26 07:00:00
138,2,2,0,0.009879796568497398,2019-03-26 06:45:00,2019-03-26 07:00:00
141,2,1,1,0.013159729675349795,2019-03-26 06:45:00,2019-03-26 07:00:00
147,1,0,1,0.0038155180340186208,2019-03-26 06:45:00,2019-03-26 07:00:00
153,2,1,1,0.02527761615421076,2019-03-26 06:45:00,2019-03-26 07:00:00
154,1,0,1,0.0038155180340186208,2019-03-26 06:45:00,2019-03-26 07:00:00
157,1,1,0,0.004626399079625813,2019-03-26 06:45:00,2019-03-26 07:00:00
158,1,0,1,0.0038155180340186208,2019-03-26 06:45:00,2019-03-26 07:00:00
159,1,0,1,0.0038155180340186208,2019-03-26 06:45:00,2019-03-26 07:00:00
164,2,2,0,0.007059042216447388,2019-03-26 06:45:00,2019-03-26 07:00:00
170,2,2,0,0.02017160874423843,2019-03-26 06:45:00,2019-03-26 07:00:00
172,2,1,1,0.02527761615421076,2019-03-26 06:45:00,2019-03-26 07:00:00
189,2,2,0,0.0077483757356633706,2019-03-26 06:45:00,2019-03-26 07:00:00
190,2,0,2,0.0038155180340186208,2019-03-26 06:45:00,2019-03-26 07:00:00
191,2,1,1,0.007059042216447388,2019-03-26 06:45:00,2019-03-26 07:00:00
195,1,1,0,0.007059042216447388,2019-03-26 06:45:00,2019-03-26 07:00:00
202,1,0,1,0.0038155180340186208,2019-03-26 06:45:00,2019-03-26 07:00:00
203,2,1,1,0.007059042216447388,2019-03-26 06:45:00,2019-03-26 07:00:00
1,1,1,0,0.0066639105329692125,2019-03-26 07:00:00,2019-03-26 07:15:00
2,1,1,0,0.00708845545937704,2019-03-26 07:00:00,2019-03-26 07:15:00
5,1,1,0,0.00708845545937704,2019-03-26 07:00:00,2019-03-26 07:15:00
11,1,0,1,0.003831423123082389,2019-03-26 07:00:00,2019-03-26 07:15:00
15,2,0,2,0.003831423123082389,2019-03-26 07:00:00,2019-03-26 07:15:00
16,3,1,2,0.0068443407392764985,2019-03-26 07:00:00,2019-03-26 07:15:00
18,5,1,4,0.006036185752509447,2019-03-26 07:00:00,2019-03-26 07:15:00
19,4,0,4,0.003831423123082389,2019-03-26 07:00:00,2019-03-26 07:15:00
21,1,1,0,0.009857258355470608,2019-03-26 07:00:00,2019-03-26 07:15:00
23,3,1,2,0.0066639105329692125,2019-03-26 07:00:00,2019-03-26 07:15:00
26,1,1,0,0.00708845545937704,2019-03-26 07:00:00,2019-03-26 07:15:00
28,1,0,1,0.003831423123082389,2019-03-26 07:00:00,2019-03-26 07:15:00
35,1,0,1,0.003831423123082389,2019-03-26 07:00:00,2019-03-26 07:15:00
37,2,2,0,0.012766427903534279,2019-03-26 07:00:00,2019-03-26 07:15:00
41,1,1,0,0.005459939291229714,2019-03-26 07:00:00,2019-03-26 07:15:00
46,2,2,0,0.0066639105329692125,2019-03-26 07:00:00,2019-03-26 07:15:00
57,4,1,3,0.007780656183400432,2019-03-26 07:00:00,2019-03-26 07:15:00
61,1,1,0,0.005346397882270208,2019-03-26 07:00:00,2019-03-26 07:15:00
62,1,0,1,0.003831423123082389,2019-03-26 07:00:00,2019-03-26 07:15:00
66,3,1,2,0.00708845545937704,2019-03-26 07:00:00,2019-03-26 07:15:00
67,2,1,1,0.00708845545937704,2019-03-26 07:00:00,2019-03-26 07:15:00
70,6,2,4,0.0066639105329692125,2019-03-26 07:00:00,2019-03-26 07:15:00
74,1,1,0,0.0046456812071560515,2019-03-26 07:00:00,2019-03-26 07:15:00
79,1,0,1,0.003831423123082389,2019-03-26 07:00:00,2019-03-26 07:15:00
85,3,3,0,0.0179849795015975,2019-03-26 07:00:00,2019-03-26 07:15:00
87,4,3,1,0.04823261849141235,2019-03-26 07:00:00,2019-03-26 07:15:00
89,1,1,0,0.00708845545937704,2019-03-26 07:00:00,2019-03-26 07:15:00
90,2,0,2,0.003831423123082389,2019-03-26 07:00:00,2019-03-26 07:15:00
108,1,0,1,0.003831423123082389,2019-03-26 07:00:00,2019-03-26 07:15:00
109,2,1,1,0.00708845545937704,2019-03-26 07:00:00,2019-03-26 07:15:00
110,1,0,1,0.003831423123082389,2019-03-26 07:00:00,2019-03-26 07:15:00
112,1,1,0,0.011145150296739414,2019-03-26 07:00:00,2019-03-26 07:15:00
113,1,0,1,0.003831423123082389,2019-03-26 07:00:00,2019-03-26 07:15:00
115,1,1,0,0.005114254624771126,2019-03-26 07:00:00,2019-03-26 07:15:00
116,2,1,1,0.0046456812071560515,2019-03-26 07:00:00,2019-03-26 07:15:00
119,2,1,1,0.005114254624771126,2019-03-26 07:00:00,2019-03-26 07:15:00
120,3,1,2,0.0066639105329692125,2019-03-26 07:00:00,2019-03-26 07:15:00
135,1,1,0,0.005459939291229714,2019-03-26 07:00:00,2019-03-26 07:15:00
137,2,2,0,0.00708845545937704,2019-03-26 07:00:00,2019-03-26 07:15:00
138,4,4,0,0.022404056348125295,2019-03-26 07:00:00,2019-03-26 07:15:00
140,2,1,1,0.00708845545937704,2019-03-26 07:00:00,2019-03-26 07:15:00
141,1,0,1,0.003831423123082389,2019-03-26 07:00:00,2019-03-26 07:15:00
147,3,2,1,0.00860343021856486,2019-03-26 07:00:00,2019-03-26 07:15:00
151,1,0,1,0.003831423123082389,2019-03-26 07:00:00,2019-03-26 07:15:00
153,1,1,0,0.00708845545937704,2019-03-26 07:00:00,2019-03-26 07:15:00
158,2,0,2,0.003831423123082389,2019-03-26 07:00:00,2019-03-26 07:15:00
159,4,1,3,0.005346397882270208,2019-03-26 07:00:00,2019-03-26 07:15:00
162,1,0,1,0.003831423123082389,2019-03-26 07:00:00,2019-03-26 07:15:00
164,4,3,1,0.011485774523617934,2019-03-26 07:00:00,2019-03-26 07:15:00
168,1,0,1,0.003831423123082389,2019-03-26 07:00:00,2019-03-26 07:15:00
170,3,3,0,0.01276860602530667,2019-03-26 07:00:00,2019-03-26 07:15:00
172,1,0,1,0.003831423123082389,2019-03-26 07:00:00,2019-03-26 07:15:00
173,1,0,1,0.003831423123082389,2019-03-26 07:00:00,2019-03-26 07:15:00
189,2,2,0,0.008716971627524366,2019-03-26 07:00:00,2019-03-26 07:15:00
190,2,0,2,0.003831423123082389,2019-03-26 07:00:00,2019-03-26 07:15:00
191,4,3,1,0.009682931246469932,2019-03-26 07:00:00,2019-03-26 07:15:00
195,1,1,0,0.00708845545937704,2019-03-26 07:00:00,2019-03-26 07:15:00
196,3,3,0,0.011159745879745355,2019-03-26 07:00:00,2019-03-26 07:15:00
199,3,1,2,0.0066639105329692125,2019-03-26 07:00:00,2019-03-26 07:15:00
202,1,0,1,0.003831423123082389,2019-03-26 07:00:00,2019-03-26 07:15:00
203,3,1,2,0.00708845545937704,2019-03-26 07:00:00,2019-03-26 07:15:00
1,1,1,0,0.004362941645531037,2019-03-26 07:15:00,2019-03-26 07:30:00
5,4,1,3,0.005664260872748435,2019-03-26 07:15:00,2019-03-26 07:30:00
10,3,1,2,0.004666672000586372,2019-03-26 07:15:00,2019-03-26 07:30:00
11,1,0,1,0.00306162241831364,2019-03-26 07:15:00,2019-03-26 07:30:00
15,2,0,2,0.00306162241831364,2019-03-26 07:15:00,2019-03-26 07:30:00
16,4,1,3,0.005325026595800085,2019-03-26 07:15:00,2019-03-26 07:30:00
18,7,4,3,0.01978191084064567,2019-03-26 07:15:00,2019-03-26 07:30:00
19,9,3,6,0.00790399341039908,2019-03-26 07:15:00,2019-03-26 07:30:00
20,2,2,0,0.006271721582859104,2019-03-26 07:15:00,2019-03-26 07:30:00
21,3,3,0,0.009219907048044144,2019-03-26 07:15:00,2019-03-26 07:30:00
22,1,1,0,0.010559508912905096,2019-03-26 07:15:00,2019-03-26 07:30:00
23,1,0,1,0.00306162241831364,2019-03-26 07:15:00,2019-03-26 07:30:00
26,1,0,1,0.00306162241831364,2019-03-26 07:15:00,2019-03-26 07:30:00
28,1,0,1,0.00306162241831364,2019-03-26 07:15:00,2019-03-26 07:30:00
35,3,1,2,0.004362941645531037,2019-03-26 07:15:00,2019-03-26 07:30:00
37,2,2,0,0.005438104688116201,2019-03-26 07:15:00,2019-03-26 07:30:00
40,1,1,0,0.006867155544579612,2019-03-26 07:15:00,2019-03-26 07:30:00
41,3,0,3,0.00306162241831364,2019-03-26 07:15:00,2019-03-26 07:30:00
46,3,3,0,0.010141736656865696,2019-03-26 07:15:00,2019-03-26 07:30:00
57,4,1,3,0.006616285305815307,2019-03-26 07:15:00,2019-03-26 07:30:00
58,3,2,1,0.00811674264781644,2019-03-26 07:15:00,2019-03-26 07:30:00
61,1,1,0,0.004362941645531037,2019-03-26 07:15:00,2019-03-26 07:30:00
62,3,2,1,0.005664260872748435,2019-03-26 07:15:00,2019-03-26 07:30:00
64,1,1,0,0.005664260872748435,2019-03-26 07:15:00,2019-03-26 07:30:00
66,1,1,0,0.005664260872748435,2019-03-26 07:15:00,2019-03-26 07:30:00
67,3,1,2,0.007876771165131836,2019-03-26 07:15:00,2019-03-26 07:30:00
68,1,1,0,0.0041814886871389635,2019-03-26 07:15:00,2019-03-26 07:30:00
70,4,2,2,0.020356158913839805,2019-03-26 07:15:00,2019-03-26 07:30:00
75,2,1,1,0.020356158913839805,2019-03-26 07:15:00,2019-03-26 07:30:00
85,3,3,0,0.010639495840390352,2019-03-26 07:15:00,2019-03-26 07:30:00
86,2,0,2,0.00306162241831364,2019-03-26 07:15:00,2019-03-26 07:30:00
87,4,3,1,0.054221561746978515,2019-03-26 07:15:00,2019-03-26 07:30:00
89,1,1,0,0.005664260872748435,2019-03-26 07:15:00,2019-03-26 07:30:00
90,3,0,3,0.00306162241831364,2019-03-26 07:15:00,2019-03-26 07:30:00
108,3,1,2,0.005325026595800085,2019-03-26 07:15:00,2019-03-26 07:30:00
109,4,2,2,0.009851834950772971,2019-03-26 07:15:00,2019-03-26 07:30:00
111,3,2,1,0.026121004412348523,2019-03-26 07:15:00,2019-03-26 07:30:00
113,1,0,1,0.00306162241831364,2019-03-26 07:15:00,2019-03-26 07:30:00
115,4,2,2,0.007588430773286527,2019-03-26 07:15:00,2019-03-26 07:30:00
116,2,1,1,0.0041814886871389635,2019-03-26 07:15:00,2019-03-26 07:30:00
118,1,0,1,0.00306162241831364,2019-03-26 07:15:00,2019-03-26 07:30:00
119,1,1,0,0.008667237621354431,2019-03-26 07:15:00,2019-03-26 07:30:00
120,4,1,3,0.004272215166335001,2019-03-26 07:15:00,2019-03-26 07:30:00
126,1,1,0,0.010429797688116001,2019-03-26 07:15:00,2019-03-26 07:30:00
127,1,0,1,0.00306162241831364,2019-03-26 07:15:00,2019-03-26 07:30:00
135,1,0,1,0.00306162241831364,2019-03-26 07:15:00,2019-03-26 07:30:00
137,4,3,1,0.008505608321896665,2019-03-26 07:15:00,2019-03-26 07:30:00
138,5,4,1,0.047338792165497225,2019-03-26 07:15:00,2019-03-26 07:30:00
140,2,1,1,0.004362941645531037,2019-03-26 07:15:00,2019-03-26 07:30:00
141,5,1,4,0.01790560280969186,2019-03-26 07:15:00,2019-03-26 07:30:00
147,4,3,1,0.008820026900279079,2019-03-26 07:15:00,2019-03-26 07:30:00
151,2,0,2,0.00306162241831364,2019-03-26 07:15:00,2019-03-26 07:30:00
153,4,4,0,0.009068490510197086,2019-03-26 07:15:00,2019-03-26 07:30:00
154,2,1,1,0.008667237621354431,2019-03-26 07:15:00,2019-03-26 07:30:00
157,2,1,1,0.005664260872748435,2019-03-26 07:15:00,2019-03-26 07:30:00
158,3,0,3,0.00306162241831364,2019-03-26 07:15:00,2019-03-26 07:30:00
159,2,0,2,0.00306162241831364,2019-03-26 07:15:00,2019-03-26 07:30:00
162,2,1,1,0.004362941645531037,2019-03-26 07:15:00,2019-03-26 07:30:00
164,2,2,0,0.005482807914356361,2019-03-26 07:15:00,2019-03-26 07:30:00
168,2,0,2,0.00306162241831364,2019-03-26 07:15:00,2019-03-26 07:30:00
170,3,3,0,0.010745376520854057,2019-03-26 07:15:00,2019-03-26 07:30:00
171,4,1,3,0.004272215166335001,2019-03-26 07:15:00,2019-03-26 07:30:00
172,1,0,1,0.00306162241831364,2019-03-26 07:15:00,2019-03-26 07:30:00
173,1,0,1,0.00306162241831364,2019-03-26 07:15:00,2019-03-26 07:30:00
175,1,0,1,0.00306162241831364,2019-03-26 07:15:00,2019-03-26 07:30:00
177,2,0,2,0.00306162241831364,2019-03-26 07:15:00,2019-03-26 07:30:00
189,6,5,1,0.017461099302732465,2019-03-26 07:15:00,2019-03-26 07:30:00
190,2,2,0,0.005230487797009302,2019-03-26 07:15:00,2019-03-26 07:30:00
191,3,2,1,0.006784127141573758,2019-03-26 07:15:00,2019-03-26 07:30:00
195,2,2,0,0.010215184828768424,2019-03-26 07:15:00,2019-03-26 07:30:00
196,3,3,0,0.014971976540617672,2019-03-26 07:15:00,2019-03-26 07:30:00
199,2,0,2,0.00306162241831364,2019-03-26 07:15:00,2019-03-26 07:30:00
201,1,0,1,0.00306162241831364,2019-03-26 07:15:00,2019-03-26 07:30:00
202,1,0,1,0.00306162241831364,2019-03-26 07:15:00,2019-03-26 07:30:00
203,3,1,2,0.005325026595800085,2019-03-26 07:15:00,2019-03-26 07:30:00
1,1,0,1,0.003298546885968984,2019-03-26 07:30:00,2019-03-26 07:45:00
5,5,0,5,0.003298546885968984,2019-03-26 07:30:00,2019-03-26 07:45:00
10,3,1,2,0.0038593476268734515,2019-03-26 07:30:00,2019-03-26 07:45:00
16,2,0,2,0.003298546885968984,2019-03-26 07:30:00,2019-03-26 07:45:00
18,4,3,1,0.026130906655017303,2019-03-26 07:30:00,2019-03-26 07:45:00
19,5,3,2,0.0061025505904913225,2019-03-26 07:30:00,2019-03-26 07:45:00
20,3,3,0,0.004980949108682387,2019-03-26 07:30:00,2019-03-26 07:45:00
21,1,1,0,0.004700548738230153,2019-03-26 07:30:00,2019-03-26 07:45:00
23,1,1,0,0.0061903263962862776,2019-03-26 07:30:00,2019-03-26 07:45:00
26,1,0,1,0.003298546885968984,2019-03-26 07:30:00,2019-03-26 07:45:00
28,2,1,1,0.004700548738230153,2019-03-26 07:30:00,2019-03-26 07:45:00
35,3,2,1,0.00993428195574489,2019-03-26 07:30:00,2019-03-26 07:45:00
37,3,3,0,0.008439220344259937,2019-03-26 07:30:00,2019-03-26 07:45:00
40,1,1,0,0.003999547812099568,2019-03-26 07:30:00,2019-03-26 07:45:00
41,2,0,2,0.003298546885968984,2019-03-26 07:30:00,2019-03-26 07:45:00
46,4,4,0,0.013670161706274244,2019-03-26 07:30:00,2019-03-26 07:45:00
57,4,2,2,0.006803551516621907,2019-03-26 07:30:00,2019-03-26 07:45:00
58,2,1,1,0.0046027909918994496,2019-03-26 07:30:00,2019-03-26 07:45:00
61,2,0,2,0.003298546885968984,2019-03-26 07:30:00,2019-03-26 07:45:00
62,5,3,2,0.00890655429501366,2019-03-26 07:30:00,2019-03-26 07:45:00
64,2,1,1,0.0061025505904913225,2019-03-26 07:30:00,2019-03-26 07:45:00
67,3,1,2,0.007084192991119953,2019-03-26 07:30:00,2019-03-26 07:45:00
68,2,1,1,0.005892370864675053,2019-03-26 07:30:00,2019-03-26 07:45:00
70,5,3,2,0.013412699318363664,2019-03-26 07:30:00,2019-03-26 07:45:00
74,1,0,1,0.003298546885968984,2019-03-26 07:30:00,2019-03-26 07:45:00
75,2,1,1,0.02182144361447079,2019-03-26 07:30:00,2019-03-26 07:45:00
85,2,2,0,0.007995373643066806,2019-03-26 07:30:00,2019-03-26 07:45:00
86,2,0,2,0.003298546885968984,2019-03-26 07:30:00,2019-03-26 07:45:00
87,3,2,1,0.04034434034297259,2019-03-26 07:30:00,2019-03-26 07:45:00
88,3,0,3,0.003298546885968984,2019-03-26 07:30:00,2019-03-26 07:45:00
89,1,0,1,0.003298546885968984,2019-03-26 07:30:00,2019-03-26 07:45:00
90,2,0,2,0.003298546885968984,2019-03-26 07:30:00,2019-03-26 07:45:00
108,2,0,2,0.003298546885968984,2019-03-26 07:30:00,2019-03-26 07:45:00
110,1,1,0,0.00423321478747643,2019-03-26 07:30:00,2019-03-26 07:45:00
111,4,1,3,0.0046027909918994496,2019-03-26 07:30:00,2019-03-26 07:45:00
112,3,2,1,0.018158694283058274,2019-03-26 07:30:00,2019-03-26 07:45:00
113,1,1,0,0.007084192991119953,2019-03-26 07:30:00,2019-03-26 07:45:00
115,1,0,1,0.003298546885968984,2019-03-26 07:30:00,2019-03-26 07:45:00
116,1,0,1,0.003298546885968984,2019-03-26 07:30:00,2019-03-26 07:45:00
118,2,0,2,0.003298546885968984,2019-03-26 07:30:00,2019-03-26 07:45:00
119,2,2,0,0.006004792844160618,2019-03-26 07:30:00,2019-03-26 07:45:00
120,5,1,4,0.004188732386283644,2019-03-26 07:30:00,2019-03-26 07:45:00
126,3,3,0,0.02709005894291492,2019-03-26 07:30:00,2019-03-26 07:45:00
127,5,2,3,0.007613154374115583,2019-03-26 07:30:00,2019-03-26 07:45:00
133,2,2,0,0.009420862744888568,2019-03-26 07:30:00,2019-03-26 07:45:00
135,2,1,1,0.0061025505904913225,2019-03-26 07:30:00,2019-03-26 07:45:00
137,3,2,1,0.005401549664360738,2019-03-26 07:30:00,2019-03-26 07:45:00
138,7,5,2,0.02336195227763329,2019-03-26 07:30:00,2019-03-26 07:45:00
141,4,0,4,0.003298546885968984,2019-03-26 07:30:00,2019-03-26 07:45:00
147,4,3,1,0.011588418713865983,2019-03-26 07:30:00,2019-03-26 07:45:00
151,1,0,1,0.003298546885968984,2019-03-26 07:30:00,2019-03-26 07:45:00
153,6,6,0,0.02218179077569864,2019-03-26 07:30:00,2019-03-26 07:45:00
154,2,1,1,0.025512466474894135,2019-03-26 07:30:00,2019-03-26 07:45:00
156,3,1,2,0.006309630297834037,2019-03-26 07:30:00,2019-03-26 07:45:00
157,1,1,0,0.0061025505904913225,2019-03-26 07:30:00,2019-03-26 07:45:00
158,3,2,1,0.0072943727169362226,2019-03-26 07:30:00,2019-03-26 07:45:00
160,1,0,1,0.003298546885968984,2019-03-26 07:30:00,2019-03-26 07:45:00
162,3,1,2,0.004700548738230153,2019-03-26 07:30:00,2019-03-26 07:45:00
164,2,2,0,0.0051678826889838755,2019-03-26 07:30:00,2019-03-26 07:45:00
168,1,0,1,0.003298546885968984,2019-03-26 07:30:00,2019-03-26 07:45:00
170,1,1,0,0.004188732386283644,2019-03-26 07:30:00,2019-03-26 07:45:00
171,3,0,3,0.003298546885968984,2019-03-26 07:30:00,2019-03-26 07:45:00
172,4,0,4,0.003298546885968984,2019-03-26 07:30:00,2019-03-26 07:45:00
175,1,0,1,0.003298546885968984,2019-03-26 07:30:00,2019-03-26 07:45:00
177,2,0,2,0.003298546885968984,2019-03-26 07:30:00,2019-03-26 07:45:00
189,3,3,0,0.008960855260695207,2019-03-26 07:30:00,2019-03-26 07:45:00
190,1,1,0,0.004700548738230153,2019-03-26 07:30:00,2019-03-26 07:45:00
195,2,2,0,0.006541212045725774,2019-03-26 07:30:00,2019-03-26 07:45:00
196,4,4,0,0.021943229131511095,2019-03-26 07:30:00,2019-03-26 07:45:00
199,2,0,2,0.003298546885968984,2019-03-26 07:30:00,2019-03-26 07:45:00
201,1,0,1,0.003298546885968984,2019-03-26 07:30:00,2019-03-26 07:45:00
202,1,0,1,0.003298546885968984,2019-03-26 07:30:00,2019-03-26 07:45:00
203,2,1,1,0.004700548738230153,2019-03-26 07:30:00,2019-03-26 07:45:00
1,1,0,1,0.003674090749272773,2019-03-26 07:45:00,2019-03-26 08:00:00
5,3,0,3,0.003674090749272773,2019-03-26 07:45:00,2019-03-26 08:00:00
10,2,2,0,0.006823502009933131,2019-03-26 07:45:00,2019-03-26 08:00:00
16,3,1,2,0.006797338600431364,2019-03-26 07:45:00,2019-03-26 08:00:00
18,7,3,4,0.013915990958668637,2019-03-26 07:45:00,2019-03-26 08:00:00
19,3,1,2,0.006797338600431364,2019-03-26 07:45:00,2019-03-26 08:00:00
20,1,1,0,0.004715173366325636,2019-03-26 07:45:00,2019-03-26 08:00:00
21,1,1,0,0.005235714674852068,2019-03-26 07:45:00,2019-03-26 08:00:00
23,3,3,0,0.009946749861091722,2019-03-26 07:45:00,2019-03-26 08:00:00
26,1,1,0,0.005600184486870868,2019-03-26 07:45:00,2019-03-26 08:00:00
28,3,0,3,0.003674090749272773,2019-03-26 07:45:00,2019-03-26 08:00:00
35,4,2,2,0.0067973386004313635,2019-03-26 07:45:00,2019-03-26 08:00:00
37,2,2,0,0.00812485528124921,2019-03-26 07:45:00,2019-03-26 08:00:00
46,5,5,0,0.02255277494701621,2019-03-26 07:45:00,2019-03-26 08:00:00
57,6,2,4,0.009920586451589955,2019-03-26 07:45:00,2019-03-26 08:00:00
58,2,0,2,0.003674090749272773,2019-03-26 07:45:00,2019-03-26 08:00:00
61,1,0,1,0.003674090749272773,2019-03-26 07:45:00,2019-03-26 08:00:00
62,4,1,3,0.006797338600431364,2019-03-26 07:45:00,2019-03-26 08:00:00
64,1,0,1,0.003674090749272773,2019-03-26 07:45:00,2019-03-26 08:00:00
66,2,2,0,0.007838421217484227,2019-03-26 07:45:00,2019-03-26 08:00:00
67,2,1,1,0.005600184486870868,2019-03-26 07:45:00,2019-03-26 08:00:00
68,1,0,1,0.003674090749272773,2019-03-26 07:45:00,2019-03-26 08:00:00
70,2,0,2,0.003674090749272773,2019-03-26 07:45:00,2019-03-26 08:00:00
74,1,0,1,0.003674090749272773,2019-03-26 07:45:00,2019-03-26 08:00:00
75,2,1,1,0.024246417584373507,2019-03-26 07:45:00,2019-03-26 08:00:00
79,1,0,1,0.003674090749272773,2019-03-26 07:45:00,2019-03-26 08:00:00
85,1,1,0,0.006797338600431364,2019-03-26 07:45:00,2019-03-26 08:00:00
86,2,0,2,0.003674090749272773,2019-03-26 07:45:00,2019-03-26 08:00:00
87,2,1,1,0.024246417584373507,2019-03-26 07:45:00,2019-03-26 08:00:00
88,1,1,0,0.014333052984828766,2019-03-26 07:45:00,2019-03-26 08:00:00
89,2,0,2,0.003674090749272773,2019-03-26 07:45:00,2019-03-26 08:00:00
90,1,0,1,0.003674090749272773,2019-03-26 07:45:00,2019-03-26 08:00:00
104,1,0,1,0.003674090749272773,2019-03-26 07:45:00,2019-03-26 08:00:00
109,1,1,0,0.006631539883332305,2019-03-26 07:45:00,2019-03-26 08:00:00
112,2,1,1,0.005235714674852068,2019-03-26 07:45:00,2019-03-26 08:00:00
113,1,1,0,0.005600184486870868,2019-03-26 07:45:00,2019-03-26 08:00:00
114,2,2,0,0.0076726225003851695,2019-03-26 07:45:00,2019-03-26 08:00:00
116,1,0,1,0.003674090749272773,2019-03-26 07:45:00,2019-03-26 08:00:00
118,1,1,0,0.006563231355669915,2019-03-26 07:45:00,2019-03-26 08:00:00
119,4,4,0,0.010441127760116386,2019-03-26 07:45:00,2019-03-26 08:00:00
120,5,1,4,0.004665626929801539,2019-03-26 07:45:00,2019-03-26 08:00:00
122,1,0,1,0.003674090749272773,2019-03-26 07:45:00,2019-03-26 08:00:00
126,1,1,0,0.006797338600431364,2019-03-26 07:45:00,2019-03-26 08:00:00
127,1,0,1,0.003674090749272773,2019-03-26 07:45:00,2019-03-26 08:00:00
133,1,1,0,0.006797338600431364,2019-03-26 07:45:00,2019-03-26 08:00:00
135,1,1,0,0.006797338600431364,2019-03-26 07:45:00,2019-03-26 08:00:00
137,4,3,1,0.012538608772332387,2019-03-26 07:45:00,2019-03-26 08:00:00
138,6,5,1,0.013869571766178253,2019-03-26 07:45:00,2019-03-26 08:00:00
140,1,0,1,0.003674090749272773,2019-03-26 07:45:00,2019-03-26 08:00:00
141,2,1,1,0.005782419392880267,2019-03-26 07:45:00,2019-03-26 08:00:00
147,4,3,1,0.01305033783171015,2019-03-26 07:45:00,2019-03-26 08:00:00
151,1,1,0,0.006797338600431364,2019-03-26 07:45:00,2019-03-26 08:00:00
153,6,6,0,0.019394983643072797,2019-03-26 07:45:00,2019-03-26 08:00:00
154,1,0,1,0.003674090749272773,2019-03-26 07:45:00,2019-03-26 08:00:00
156,3,1,2,0.008434700732245795,2019-03-26 07:45:00,2019-03-26 08:00:00
157,1,1,0,0.006797338600431364,2019-03-26 07:45:00,2019-03-26 08:00:00
158,2,0,2,0.003674090749272773,2019-03-26 07:45:00,2019-03-26 08:00:00
160,1,0,1,0.003674090749272773,2019-03-26 07:45:00,2019-03-26 08:00:00
162,2,1,1,0.005235714674852068,2019-03-26 07:45:00,2019-03-26 08:00:00
164,3,0,3,0.003674090749272773,2019-03-26 07:45:00,2019-03-26 08:00:00
168,1,0,1,0.003674090749272773,2019-03-26 07:45:00,2019-03-26 08:00:00
170,4,2,2,0.006276797291904931,2019-03-26 07:45:00,2019-03-26 08:00:00
171,2,0,2,0.003674090749272773,2019-03-26 07:45:00,2019-03-26 08:00:00
172,1,0,1,0.003674090749272773,2019-03-26 07:45:00,2019-03-26 08:00:00
173,3,0,3,0.003674090749272773,2019-03-26 07:45:00,2019-03-26 08:00:00
189,3,3,0,0.012809727057987098,2019-03-26 07:45:00,2019-03-26 08:00:00
195,3,3,0,0.00934136738839645,2019-03-26 07:45:00,2019-03-26 08:00:00
196,2,2,0,0.0165055198261068,2019-03-26 07:45:00,2019-03-26 08:00:00
199,1,0,1,0.003674090749272773,2019-03-26 07:45:00,2019-03-26 08:00:00
201,1,0,1,0.003674090749272773,2019-03-26 07:45:00,2019-03-26 08:00:00
202,1,0,1,0.003674090749272773,2019-03-26 07:45:00,2019-03-26 08:00:00
203,1,0,1,0.003674090749272773,2019-03-26 07:45:00,2019-03-26 08:00:00
1,1,0,1,0.0035597433705770233,2019-03-26 08:00:00,2019-03-26 08:15:00
2,1,0,1,0.0035597433705770233,2019-03-26 08:00:00,2019-03-26 08:15:00
5,1,0,1,0.0035597433705770233,2019-03-26 08:00:00,2019-03-26 08:15:00
10,1,1,0,0.00499717486319556,2019-03-26 08:00:00,2019-03-26 08:15:00
15,6,3,3,0.013920140617812191,2019-03-26 08:00:00,2019-03-26 08:15:00
16,3,1,2,0.008502033735664995,2019-03-26 08:00:00,2019-03-26 08:15:00
18,5,2,3,0.011572133504909992,2019-03-26 08:00:00,2019-03-26 08:15:00
19,1,0,1,0.0035597433705770233,2019-03-26 08:00:00,2019-03-26 08:15:00
21,1,1,0,0.006585812928198539,2019-03-26 08:00:00,2019-03-26 08:15:00
23,2,2,0,0.006182433892678972,2019-03-26 08:00:00,2019-03-26 08:15:00
26,3,2,1,0.008023244420817074,2019-03-26 08:00:00,2019-03-26 08:15:00
27,1,0,1,0.0035597433705770233,2019-03-26 08:00:00,2019-03-26 08:15:00
28,3,0,3,0.0035597433705770233,2019-03-26 08:00:00,2019-03-26 08:15:00
30,5,2,3,0.009189912086262589,2019-03-26 08:00:00,2019-03-26 08:15:00
35,1,0,1,0.0035597433705770233,2019-03-26 08:00:00,2019-03-26 08:15:00
37,1,0,1,0.0035597433705770233,2019-03-26 08:00:00,2019-03-26 08:15:00
40,1,1,0,0.004967285549498415,2019-03-26 08:00:00,2019-03-26 08:15:00
41,1,0,1,0.0035597433705770233,2019-03-26 08:00:00,2019-03-26 08:15:00
46,6,6,0,0.01805518140559359,2019-03-26 08:00:00,2019-03-26 08:15:00
57,4,1,3,0.005072778149387781,2019-03-26 08:00:00,2019-03-26 08:15:00
58,4,0,4,0.0035597433705770233,2019-03-26 08:00:00,2019-03-26 08:15:00
61,2,2,0,0.009933691548825676,2019-03-26 08:00:00,2019-03-26 08:15:00
62,1,0,1,0.0035597433705770233,2019-03-26 08:00:00,2019-03-26 08:15:00
64,1,0,1,0.0035597433705770233,2019-03-26 08:00:00,2019-03-26 08:15:00
66,1,1,0,0.004967285549498415,2019-03-26 08:00:00,2019-03-26 08:15:00
68,2,0,2,0.0035597433705770233,2019-03-26 08:00:00,2019-03-26 08:15:00
79,1,0,1,0.0035597433705770233,2019-03-26 08:00:00,2019-03-26 08:15:00
85,1,1,0,0.006585812928198539,2019-03-26 08:00:00,2019-03-26 08:15:00
87,3,2,1,0.04353815566192354,2019-03-26 08:00:00,2019-03-26 08:15:00
88,2,2,0,0.01191202207235237,2019-03-26 08:00:00,2019-03-26 08:15:00
89,1,0,1,0.0035597433705770233,2019-03-26 08:00:00,2019-03-26 08:15:00
90,3,1,2,0.005813792132540189,2019-03-26 08:00:00,2019-03-26 08:15:00
104,3,1,2,0.008869021274999033,2019-03-26 08:00:00,2019-03-26 08:15:00
109,1,1,0,0.006838903816557627,2019-03-26 08:00:00,2019-03-26 08:15:00
110,2,1,1,0.023548949516250285,2019-03-26 08:00:00,2019-03-26 08:15:00
112,2,2,0,0.007930055455467608,2019-03-26 08:00:00,2019-03-26 08:15:00
113,2,1,1,0.006163842528641075,2019-03-26 08:00:00,2019-03-26 08:15:00
114,3,2,1,0.010004572220924587,2019-03-26 08:00:00,2019-03-26 08:15:00
115,1,1,0,0.008799591004300984,2019-03-26 08:00:00,2019-03-26 08:15:00
116,2,0,2,0.0035597433705770233,2019-03-26 08:00:00,2019-03-26 08:15:00
118,1,1,0,0.006585812928198539,2019-03-26 08:00:00,2019-03-26 08:15:00
119,1,1,0,0.0069785026633030715,2019-03-26 08:00:00,2019-03-26 08:15:00
120,9,3,6,0.00619136369251007,2019-03-26 08:00:00,2019-03-26 08:15:00
122,4,1,3,0.004967285549498415,2019-03-26 08:00:00,2019-03-26 08:15:00
126,3,3,0,0.010569992889553282,2019-03-26 08:00:00,2019-03-26 08:15:00
127,3,2,1,0.007855709437280754,2019-03-26 08:00:00,2019-03-26 08:15:00
133,1,1,0,0.006585812928198539,2019-03-26 08:00:00,2019-03-26 08:15:00
137,7,3,4,0.01060598735733155,2019-03-26 08:00:00,2019-03-26 08:15:00
138,4,4,0,0.015796536515556025,2019-03-26 08:00:00,2019-03-26 08:15:00
140,2,1,1,0.005813792132540189,2019-03-26 08:00:00,2019-03-26 08:15:00
141,1,1,0,0.00499717486319556,2019-03-26 08:00:00,2019-03-26 08:15:00
147,4,2,2,0.012490689979634068,2019-03-26 08:00:00,2019-03-26 08:15:00
151,1,1,0,0.006585812928198539,2019-03-26 08:00:00,2019-03-26 08:15:00
153,2,2,0,0.009611882485820053,2019-03-26 08:00:00,2019-03-26 08:15:00
158,2,1,1,0.00717353806606223,2019-03-26 08:00:00,2019-03-26 08:15:00
162,1,0,1,0.0035597433705770233,2019-03-26 08:00:00,2019-03-26 08:15:00
164,4,1,3,0.006585812928198539,2019-03-26 08:00:00,2019-03-26 08:15:00
168,1,0,1,0.0035597433705770233,2019-03-26 08:00:00,2019-03-26 08:15:00
170,5,3,2,0.011731146506875713,2019-03-26 08:00:00,2019-03-26 08:15:00
171,1,0,1,0.0035597433705770233,2019-03-26 08:00:00,2019-03-26 08:15:00
173,4,1,3,0.012064653573591598,2019-03-26 08:00:00,2019-03-26 08:15:00
189,1,1,0,0.010237927428538263,2019-03-26 08:00:00,2019-03-26 08:15:00
195,2,2,0,0.008451986060895108,2019-03-26 08:00:00,2019-03-26 08:15:00
196,3,3,0,0.006585812928198539,2019-03-26 08:00:00,2019-03-26 08:15:00
197,1,0,1,0.0035597433705770233,2019-03-26 08:00:00,2019-03-26 08:15:00
201,1,0,1,0.0035597433705770233,2019-03-26 08:00:00,2019-03-26 08:15:00
203,1,0,1,0.0035597433705770233,2019-03-26 08:00:00,2019-03-26 08:15:00
1,1,0,1,0.0035006369708668883,2019-03-26 08:15:00,2019-03-26 08:30:00
2,1,0,1,0.0035006369708668883,2019-03-26 08:15:00,2019-03-26 08:30:00
5,1,0,1,0.0035006369708668883,2019-03-26 08:15:00,2019-03-26 08:30:00
15,11,5,6,0.011580861177105953,2019-03-26 08:15:00,2019-03-26 08:30:00
16,4,2,2,0.023426696220184687,2019-03-26 08:15:00,2019-03-26 08:30:00
18,4,3,1,0.01642791281063163,2019-03-26 08:15:00,2019-03-26 08:30:00
21,1,1,0,0.0064764797259393,2019-03-26 08:15:00,2019-03-26 08:30:00
23,1,1,0,0.004492584555891025,2019-03-26 08:15:00,2019-03-26 08:30:00
26,3,1,2,0.005621001118150368,2019-03-26 08:15:00,2019-03-26 08:30:00
28,2,0,2,0.0035006369708668883,2019-03-26 08:15:00,2019-03-26 08:30:00
30,1,1,0,0.004988558348403094,2019-03-26 08:15:00,2019-03-26 08:30:00
37,2,1,1,0.0064764797259393,2019-03-26 08:15:00,2019-03-26 08:30:00
40,2,2,0,0.007964401103475505,2019-03-26 08:15:00,2019-03-26 08:30:00
41,2,0,2,0.0035006369708668883,2019-03-26 08:15:00,2019-03-26 08:30:00
46,4,4,0,0.017699016724873517,2019-03-26 08:15:00,2019-03-26 08:30:00
50,1,0,1,0.0035006369708668883,2019-03-26 08:15:00,2019-03-26 08:30:00
57,3,1,2,0.004988558348403094,2019-03-26 08:15:00,2019-03-26 08:30:00
58,3,0,3,0.0035006369708668883,2019-03-26 08:15:00,2019-03-26 08:30:00
61,1,1,0,0.007405410665369552,2019-03-26 08:15:00,2019-03-26 08:30:00
62,1,0,1,0.0035006369708668883,2019-03-26 08:15:00,2019-03-26 08:30:00
66,3,1,2,0.006088594342637206,2019-03-26 08:15:00,2019-03-26 08:30:00
68,1,0,1,0.0035006369708668883,2019-03-26 08:15:00,2019-03-26 08:30:00
69,3,1,2,0.006088594342637206,2019-03-26 08:15:00,2019-03-26 08:30:00
74,1,1,0,0.0045933376042431185,2019-03-26 08:15:00,2019-03-26 08:30:00
85,2,1,1,0.0064764797259393,2019-03-26 08:15:00,2019-03-26 08:30:00
87,2,1,1,0.023159924914244272,2019-03-26 08:15:00,2019-03-26 08:30:00
88,1,0,1,0.0035006369708668883,2019-03-26 08:15:00,2019-03-26 08:30:00
90,4,1,3,0.008783214966886742,2019-03-26 08:15:00,2019-03-26 08:30:00
104,2,1,1,0.0045933376042431185,2019-03-26 08:15:00,2019-03-26 08:30:00
108,1,0,1,0.0035006369708668883,2019-03-26 08:15:00,2019-03-26 08:30:00
109,4,3,1,0.010867593614740389,2019-03-26 08:15:00,2019-03-26 08:30:00
111,1,1,0,0.009006250804928399,2019-03-26 08:15:00,2019-03-26 08:30:00
112,3,3,0,0.017139026729940224,2019-03-26 08:15:00,2019-03-26 08:30:00
113,1,1,0,0.004988558348403094,2019-03-26 08:15:00,2019-03-26 08:30:00
114,2,1,1,0.0064764797259393,2019-03-26 08:15:00,2019-03-26 08:30:00
116,2,0,2,0.0035006369708668883,2019-03-26 08:15:00,2019-03-26 08:30:00
118,1,0,1,0.0035006369708668883,2019-03-26 08:15:00,2019-03-26 08:30:00
119,3,1,2,0.0051414905706842675,2019-03-26 08:15:00,2019-03-26 08:30:00
120,10,3,7,0.005506978496377984,2019-03-26 08:15:00,2019-03-26 08:30:00
122,2,0,2,0.0035006369708668883,2019-03-26 08:15:00,2019-03-26 08:30:00
126,4,3,1,0.009605254703292885,2019-03-26 08:15:00,2019-03-26 08:30:00
127,2,2,0,0.0071452602344429985,2019-03-26 08:15:00,2019-03-26 08:30:00
137,5,3,2,0.012428165236084124,2019-03-26 08:15:00,2019-03-26 08:30:00
138,7,6,1,0.01722546618256401,2019-03-26 08:15:00,2019-03-26 08:30:00
147,5,1,4,0.0051414905706842675,2019-03-26 08:15:00,2019-03-26 08:30:00
153,2,2,0,0.009452322481011712,2019-03-26 08:15:00,2019-03-26 08:30:00
154,1,1,0,0.0064764797259393,2019-03-26 08:15:00,2019-03-26 08:30:00
156,1,1,0,0.0045933376042431185,2019-03-26 08:15:00,2019-03-26 08:30:00
158,2,2,0,0.014127149233297375,2019-03-26 08:15:00,2019-03-26 08:30:00
164,1,1,0,0.009006250804928399,2019-03-26 08:15:00,2019-03-26 08:30:00
168,1,0,1,0.0035006369708668883,2019-03-26 08:15:00,2019-03-26 08:30:00
170,4,4,0,0.031583308596010426,2019-03-26 08:15:00,2019-03-26 08:30:00
171,1,0,1,0.0035006369708668883,2019-03-26 08:15:00,2019-03-26 08:30:00
173,1,0,1,0.0035006369708668883,2019-03-26 08:15:00,2019-03-26 08:30:00
177,1,0,1,0.0035006369708668883,2019-03-26 08:15:00,2019-03-26 08:30:00
189,1,0,1,0.0035006369708668883,2019-03-26 08:15:00,2019-03-26 08:30:00
191,4,3,1,0.046990074154697886,2019-03-26 08:15:00,2019-03-26 08:30:00
196,4,3,1,0.00866188099269176,2019-03-26 08:15:00,2019-03-26 08:30:00
197,1,0,1,0.0035006369708668883,2019-03-26 08:15:00,2019-03-26 08:30:00
199,2,0,2,0.0035006369708668883,2019-03-26 08:15:00,2019-03-26 08:30:00
201,1,0,1,0.0035006369708668883,2019-03-26 08:15:00,2019-03-26 08:30:00
203,1,0,1,0.0035006369708668883,2019-03-26 08:15:00,2019-03-26 08:30:00
1,1,1,0,0.003966979345750689,2019-03-26 08:30:00,2019-03-26 08:45:00
2,3,1,2,0.004404919804815666,2019-03-26 08:30:00,2019-03-26 08:45:00
5,1,0,1,0.003091098427620736,2019-03-26 08:30:00,2019-03-26 08:45:00
15,3,1,2,0.005376207620983894,2019-03-26 08:30:00,2019-03-26 08:45:00
16,3,2,1,0.012618425088373374,2019-03-26 08:30:00,2019-03-26 08:45:00
18,4,3,1,0.0392349907161435,2019-03-26 08:30:00,2019-03-26 08:45:00
19,2,1,1,0.005718741182010594,2019-03-26 08:30:00,2019-03-26 08:45:00
20,1,0,1,0.003091098427620736,2019-03-26 08:30:00,2019-03-26 08:45:00
23,2,2,0,0.01367792711067825,2019-03-26 08:30:00,2019-03-26 08:45:00
26,2,1,1,0.006463313403041515,2019-03-26 08:30:00,2019-03-26 08:45:00
30,1,1,0,0.004404919804815666,2019-03-26 08:30:00,2019-03-26 08:45:00
41,2,0,2,0.003091098427620736,2019-03-26 08:30:00,2019-03-26 08:45:00
46,2,2,0,0.006244269732888566,2019-03-26 08:30:00,2019-03-26 08:45:00
57,2,1,1,0.003966979345750689,2019-03-26 08:30:00,2019-03-26 08:45:00
58,3,0,3,0.003091098427620736,2019-03-26 08:30:00,2019-03-26 08:45:00
62,3,1,2,0.01595003632107321,2019-03-26 08:30:00,2019-03-26 08:45:00
66,2,1,1,0.038777060817150176,2019-03-26 08:30:00,2019-03-26 08:45:00
67,1,0,1,0.003091098427620736,2019-03-26 08:30:00,2019-03-26 08:45:00
68,1,0,1,0.003091098427620736,2019-03-26 08:30:00,2019-03-26 08:45:00
69,2,0,2,0.003091098427620736,2019-03-26 08:30:00,2019-03-26 08:45:00
79,1,0,1,0.003091098427620736,2019-03-26 08:30:00,2019-03-26 08:45:00
85,2,1,1,0.004404919804815666,2019-03-26 08:30:00,2019-03-26 08:45:00
87,3,2,1,0.03807159280870849,2019-03-26 08:30:00,2019-03-26 08:45:00
88,3,1,2,0.005376207620983894,2019-03-26 08:30:00,2019-03-26 08:45:00
90,5,0,5,0.003091098427620736,2019-03-26 08:30:00,2019-03-26 08:45:00
104,1,0,1,0.003091098427620736,2019-03-26 08:30:00,2019-03-26 08:45:00
108,1,0,1,0.003091098427620736,2019-03-26 08:30:00,2019-03-26 08:45:00
109,7,6,1,0.041999388701881454,2019-03-26 08:30:00,2019-03-26 08:45:00
110,1,1,0,0.005376207620983894,2019-03-26 08:30:00,2019-03-26 08:45:00
111,1,1,0,0.006835599513556975,2019-03-26 08:30:00,2019-03-26 08:45:00
112,4,3,1,0.041787243917746984,2019-03-26 08:30:00,2019-03-26 08:45:00
113,1,1,0,0.004404919804815666,2019-03-26 08:30:00,2019-03-26 08:45:00
114,2,1,1,0.005718741182010594,2019-03-26 08:30:00,2019-03-26 08:45:00
116,3,0,3,0.003091098427620736,2019-03-26 08:30:00,2019-03-26 08:45:00
118,1,0,1,0.003091098427620736,2019-03-26 08:30:00,2019-03-26 08:45:00
119,2,0,2,0.003091098427620736,2019-03-26 08:30:00,2019-03-26 08:45:00
120,4,1,3,0.004313310498384651,2019-03-26 08:30:00,2019-03-26 08:45:00
122,2,0,2,0.003091098427620736,2019-03-26 08:30:00,2019-03-26 08:45:00
126,5,3,2,0.013469799109447792,2019-03-26 08:30:00,2019-03-26 08:45:00
137,4,3,1,0.008116520275856685,2019-03-26 08:30:00,2019-03-26 08:45:00
138,4,4,0,0.007816834170904462,2019-03-26 08:30:00,2019-03-26 08:45:00
141,2,1,1,0.036406552132624954,2019-03-26 08:30:00,2019-03-26 08:45:00
147,3,1,2,0.004404919804815666,2019-03-26 08:30:00,2019-03-26 08:45:00
153,4,3,1,0.015126154047669422,2019-03-26 08:30:00,2019-03-26 08:45:00
154,2,2,0,0.009266279222298284,2019-03-26 08:30:00,2019-03-26 08:45:00
156,1,1,0,0.004963348970588855,2019-03-26 08:30:00,2019-03-26 08:45:00
158,2,2,0,0.005189191416514604,2019-03-26 08:30:00,2019-03-26 08:45:00
164,1,1,0,0.013817865270926034,2019-03-26 08:30:00,2019-03-26 08:45:00
170,3,3,0,0.014071853201975348,2019-03-26 08:30:00,2019-03-26 08:45:00
171,1,0,1,0.003091098427620736,2019-03-26 08:30:00,2019-03-26 08:45:00
177,1,0,1,0.003091098427620736,2019-03-26 08:30:00,2019-03-26 08:45:00
191,2,1,1,0.020581345618164618,2019-03-26 08:30:00,2019-03-26 08:45:00
195,1,1,0,0.003966979345750689,2019-03-26 08:30:00,2019-03-26 08:45:00
196,1,1,0,0.004404919804815666,2019-03-26 08:30:00,2019-03-26 08:45:00
199,2,0,2,0.003091098427620736,2019-03-26 08:30:00,2019-03-26 08:45:00
203,2,0,2,0.003091098427620736,2019-03-26 08:30:00,2019-03-26 08:45:00
1,1,1,0,0.004156508120795115,2019-03-26 08:45:00,2019-03-26 09:00:00
2,4,2,2,0.008027547672507674,2019-03-26 08:45:00,2019-03-26 09:00:00
15,5,2,3,0.0074755153169730896,2019-03-26 08:45:00,2019-03-26 09:00:00
16,3,1,2,0.005992000540484248,2019-03-26 08:45:00,2019-03-26 09:00:00
18,3,0,3,0.0032387619109505482,2019-03-26 08:45:00,2019-03-26 09:00:00
23,1,1,0,0.005184381857521152,2019-03-26 08:45:00,2019-03-26 09:00:00
26,1,0,1,0.0032387619109505482,2019-03-26 08:45:00,2019-03-26 09:00:00
30,1,0,1,0.0032387619109505482,2019-03-26 08:45:00,2019-03-26 09:00:00
35,1,0,1,0.0032387619109505482,2019-03-26 08:45:00,2019-03-26 09:00:00
37,4,4,0,0.014016391199608198,2019-03-26 08:45:00,2019-03-26 09:00:00
41,1,0,1,0.0032387619109505482,2019-03-26 08:45:00,2019-03-26 09:00:00
46,2,1,1,0.0039022112482601356,2019-03-26 08:45:00,2019-03-26 09:00:00
57,3,1,2,0.004156508120795115,2019-03-26 08:45:00,2019-03-26 09:00:00
58,4,2,2,0.009339686012304152,2019-03-26 08:45:00,2019-03-26 09:00:00
62,3,2,1,0.0761151051911773,2019-03-26 08:45:00,2019-03-26 09:00:00
66,2,2,0,0.01849608010701271,2019-03-26 08:45:00,2019-03-26 09:00:00
67,1,0,1,0.0032387619109505482,2019-03-26 08:45:00,2019-03-26 09:00:00
68,2,0,2,0.0032387619109505482,2019-03-26 08:45:00,2019-03-26 09:00:00
69,2,0,2,0.0032387619109505482,2019-03-26 08:45:00,2019-03-26 09:00:00
70,1,1,0,0.007162277801560545,2019-03-26 08:45:00,2019-03-26 09:00:00
79,1,0,1,0.0032387619109505482,2019-03-26 08:45:00,2019-03-26 09:00:00
85,2,2,0,0.007932627912265334,2019-03-26 08:45:00,2019-03-26 09:00:00
87,4,3,1,0.0489890888816075,2019-03-26 08:45:00,2019-03-26 09:00:00
88,3,1,2,0.0039022112482601356,2019-03-26 08:45:00,2019-03-26 09:00:00
89,1,0,1,0.0032387619109505482,2019-03-26 08:45:00,2019-03-26 09:00:00
90,6,1,5,0.0039022112482601356,2019-03-26 08:45:00,2019-03-26 09:00:00
108,1,0,1,0.0032387619109505482,2019-03-26 08:45:00,2019-03-26 09:00:00
109,6,5,1,0.014708823712704384,2019-03-26 08:45:00,2019-03-26 09:00:00
110,1,1,0,0.004897385254224516,2019-03-26 08:45:00,2019-03-26 09:00:00
111,2,2,0,0.006231214943351624,2019-03-26 08:45:00,2019-03-26 09:00:00
112,4,2,2,0.014493034817333088,2019-03-26 08:45:00,2019-03-26 09:00:00
113,1,1,0,0.004156508120795115,2019-03-26 08:45:00,2019-03-26 09:00:00
114,4,2,2,0.008361352224157887,2019-03-26 08:45:00,2019-03-26 09:00:00
116,3,0,3,0.0032387619109505482,2019-03-26 08:45:00,2019-03-26 09:00:00
118,1,0,1,0.0032387619109505482,2019-03-26 08:45:00,2019-03-26 09:00:00
119,3,2,1,0.0055331274355619655,2019-03-26 08:45:00,2019-03-26 09:00:00
120,5,2,3,0.008361352224157887,2019-03-26 08:45:00,2019-03-26 09:00:00
122,5,1,4,0.004112838240340353,2019-03-26 08:45:00,2019-03-26 09:00:00
126,5,2,3,0.0068660768698740535,2019-03-26 08:45:00,2019-03-26 09:00:00
127,1,1,0,0.009399241665646796,2019-03-26 08:45:00,2019-03-26 09:00:00
135,1,0,1,0.0032387619109505482,2019-03-26 08:45:00,2019-03-26 09:00:00
137,4,4,0,0.01172623966785808,2019-03-26 08:45:00,2019-03-26 09:00:00
138,5,5,0,0.014436830115029043,2019-03-26 08:45:00,2019-03-26 09:00:00
140,2,0,2,0.0032387619109505482,2019-03-26 08:45:00,2019-03-26 09:00:00
141,2,1,1,0.004156508120795115,2019-03-26 08:45:00,2019-03-26 09:00:00
147,2,1,1,0.005992000540484248,2019-03-26 08:45:00,2019-03-26 09:00:00
151,1,0,1,0.0032387619109505482,2019-03-26 08:45:00,2019-03-26 09:00:00
153,5,4,1,0.009662985379862517,2019-03-26 08:45:00,2019-03-26 09:00:00
154,4,3,1,0.05095583096632634,2019-03-26 08:45:00,2019-03-26 09:00:00
157,1,1,0,0.005992000540484248,2019-03-26 08:45:00,2019-03-26 09:00:00
159,1,1,0,0.005992000540484248,2019-03-26 08:45:00,2019-03-26 09:00:00
164,5,2,3,0.00807343701476284,2019-03-26 08:45:00,2019-03-26 09:00:00
168,2,1,1,0.004615381225717399,2019-03-26 08:45:00,2019-03-26 09:00:00
170,3,3,0,0.010225399015023997,2019-03-26 08:45:00,2019-03-26 09:00:00
171,1,0,1,0.0032387619109505482,2019-03-26 08:45:00,2019-03-26 09:00:00
173,1,0,1,0.0032387619109505482,2019-03-26 08:45:00,2019-03-26 09:00:00
177,1,0,1,0.0032387619109505482,2019-03-26 08:45:00,2019-03-26 09:00:00
189,2,2,0,0.009319081957044926,2019-03-26 08:45:00,2019-03-26 09:00:00
191,1,0,1,0.0032387619109505482,2019-03-26 08:45:00,2019-03-26 09:00:00
195,2,2,0,0.008585281621746588,2019-03-26 08:45:00,2019-03-26 09:00:00
196,2,0,2,0.0032387619109505482,2019-03-26 08:45:00,2019-03-26 09:00:00
201,1,0,1,0.0032387619109505482,2019-03-26 08:45:00,2019-03-26 09:00:00
202,1,0,1,0.0032387619109505482,2019-03-26 08:45:00,2019-03-26 09:00:00
203,2,0,2,0.0032387619109505482,2019-03-26 08:45:00,2019-03-26 09:00:00
2,7,4,3,0.00781857189676791,2019-03-26 09:00:00,2019-03-26 09:15:00
15,5,2,3,0.007569705990095308,2019-03-26 09:00:00,2019-03-26 09:15:00
16,2,1,1,0.0037444287298538997,2019-03-26 09:00:00,2019-03-26 09:15:00
18,2,0,2,0.0032797593474860314,2019-03-26 09:00:00,2019-03-26 09:15:00
19,1,1,0,0.017936752623818726,2019-03-26 09:00:00,2019-03-26 09:15:00
20,1,1,0,0.019708454556772566,2019-03-26 09:00:00,2019-03-26 09:15:00
21,1,0,1,0.0032797593474860314,2019-03-26 09:00:00,2019-03-26 09:15:00
23,3,3,0,0.008099150415978222,2019-03-26 09:00:00,2019-03-26 09:15:00
28,6,3,3,0.02161788383454679,2019-03-26 09:00:00,2019-03-26 09:15:00
30,1,0,1,0.0032797593474860314,2019-03-26 09:00:00,2019-03-26 09:15:00
35,3,1,2,0.005727373580948134,2019-03-26 09:00:00,2019-03-26 09:15:00
37,10,7,3,0.01769661751682959,2019-03-26 09:00:00,2019-03-26 09:15:00
40,1,1,0,0.012422529324334738,2019-03-26 09:00:00,2019-03-26 09:15:00
41,3,2,1,0.008855791935900451,2019-03-26 09:00:00,2019-03-26 09:15:00
46,1,0,1,0.0032797593474860314,2019-03-26 09:00:00,2019-03-26 09:15:00
50,1,0,1,0.0032797593474860314,2019-03-26 09:00:00,2019-03-26 09:15:00
57,7,2,5,0.0058867029868618906,2019-03-26 09:00:00,2019-03-26 09:15:00
58,3,1,2,0.008016251345161164,2019-03-26 09:00:00,2019-03-26 09:15:00
62,3,1,2,0.005704315689722144,2019-03-26 09:00:00,2019-03-26 09:15:00
66,1,1,0,0.004673767494589636,2019-03-26 09:00:00,2019-03-26 09:15:00
68,4,2,2,0.02161788383454679,2019-03-26 09:00:00,2019-03-26 09:15:00
69,3,1,2,0.006067775641693241,2019-03-26 09:00:00,2019-03-26 09:15:00
70,1,1,0,0.004273017922866034,2019-03-26 09:00:00,2019-03-26 09:15:00
85,4,4,0,0.008915952377454616,2019-03-26 09:00:00,2019-03-26 09:15:00
86,1,0,1,0.0032797593474860314,2019-03-26 09:00:00,2019-03-26 09:15:00
87,9,7,2,0.03165370068241272,2019-03-26 09:00:00,2019-03-26 09:15:00
88,3,2,1,0.010755021376686803,2019-03-26 09:00:00,2019-03-26 09:15:00
89,2,0,2,0.0032797593474860314,2019-03-26 09:00:00,2019-03-26 09:15:00
90,6,3,3,0.008683920269902393,2019-03-26 09:00:00,2019-03-26 09:15:00
104,3,1,2,0.005704315689722144,2019-03-26 09:00:00,2019-03-26 09:15:00
108,1,0,1,0.0032797593474860314,2019-03-26 09:00:00,2019-03-26 09:15:00
109,3,2,1,0.007068602220845715,2019-03-26 09:00:00,2019-03-26 09:15:00
110,2,2,0,0.017187552271687195,2019-03-26 09:00:00,2019-03-26 09:15:00
111,5,5,0,0.01017303906836697,2019-03-26 09:00:00,2019-03-26 09:15:00
113,1,1,0,0.004673767494589636,2019-03-26 09:00:00,2019-03-26 09:15:00
114,2,1,1,0.005571804345224066,2019-03-26 09:00:00,2019-03-26 09:15:00
115,1,1,0,0.005495224984928568,2019-03-26 09:00:00,2019-03-26 09:15:00
116,2,0,2,0.0032797593474860314,2019-03-26 09:00:00,2019-03-26 09:15:00
119,3,2,1,0.007252793649006042,2019-03-26 09:00:00,2019-03-26 09:15:00
120,9,4,5,0.013481229131439407,2019-03-26 09:00:00,2019-03-26 09:15:00
122,3,1,2,0.0057585623198869685,2019-03-26 09:00:00,2019-03-26 09:15:00
126,2,0,2,0.0032797593474860314,2019-03-26 09:00:00,2019-03-26 09:15:00
135,1,0,1,0.0032797593474860314,2019-03-26 09:00:00,2019-03-26 09:15:00
137,6,3,3,0.008747910661503645,2019-03-26 09:00:00,2019-03-26 09:15:00
138,6,5,1,0.01661137895106084,2019-03-26 09:00:00,2019-03-26 09:15:00
140,2,0,2,0.0032797593474860314,2019-03-26 09:00:00,2019-03-26 09:15:00
141,8,1,7,0.003733101356991328,2019-03-26 09:00:00,2019-03-26 09:15:00
147,2,2,0,0.00850213313352574,2019-03-26 09:00:00,2019-03-26 09:15:00
151,1,0,1,0.0032797593474860314,2019-03-26 09:00:00,2019-03-26 09:15:00
153,1,1,0,0.004673767494589636,2019-03-26 09:00:00,2019-03-26 09:15:00
157,1,1,0,0.0037444287298538997,2019-03-26 09:00:00,2019-03-26 09:15:00
158,2,2,0,0.0126958496057068,2019-03-26 09:00:00,2019-03-26 09:15:00
159,1,1,0,0.006067775641693241,2019-03-26 09:00:00,2019-03-26 09:15:00
164,4,1,3,0.0042805859266385055,2019-03-26 09:00:00,2019-03-26 09:15:00
168,5,1,4,0.004673767494589636,2019-03-26 09:00:00,2019-03-26 09:15:00
170,7,4,3,0.015099033217188387,2019-03-26 09:00:00,2019-03-26 09:15:00
171,1,0,1,0.0032797593474860314,2019-03-26 09:00:00,2019-03-26 09:15:00
173,5,3,2,0.034482462827958936,2019-03-26 09:00:00,2019-03-26 09:15:00
177,1,0,1,0.0032797593474860314,2019-03-26 09:00:00,2019-03-26 09:15:00
189,6,5,1,0.019325831863287284,2019-03-26 09:00:00,2019-03-26 09:15:00
195,1,1,0,0.006067775641693241,2019-03-26 09:00:00,2019-03-26 09:15:00
196,1,0,1,0.0032797593474860314,2019-03-26 09:00:00,2019-03-26 09:15:00
201,6,0,6,0.0032797593474860314,2019-03-26 09:00:00,2019-03-26 09:15:00
202,2,0,2,0.0032797593474860314,2019-03-26 09:00:00,2019-03-26 09:15:00
203,2,0,2,0.0032797593474860314,2019-03-26 09:00:00,2019-03-26 09:15:00
2,1,0,1,0.0032961461694033336,2019-03-26 09:15:00,2019-03-26 09:30:00
10,1,0,1,0.0032961461694033336,2019-03-26 09:15:00,2019-03-26 09:30:00
15,3,1,2,0.005732959488646872,2019-03-26 09:15:00,2019-03-26 09:30:00
16,1,1,0,0.004230152187258685,2019-03-26 09:15:00,2019-03-26 09:30:00
18,1,1,0,0.005024158997908162,2019-03-26 09:15:00,2019-03-26 09:30:00
19,1,1,0,0.009832656067733911,2019-03-26 09:15:00,2019-03-26 09:30:00
20,2,2,0,0.01161579407197982,2019-03-26 09:15:00,2019-03-26 09:30:00
23,2,1,1,0.006098164222969389,2019-03-26 09:15:00,2019-03-26 09:30:00
28,2,1,1,0.021923274562880346,2019-03-26 09:15:00,2019-03-26 09:30:00
35,3,1,2,0.0068624221778951534,2019-03-26 09:15:00,2019-03-26 09:30:00
37,2,1,1,0.006555267482009654,2019-03-26 09:15:00,2019-03-26 09:30:00
40,1,1,0,0.010835909282938995,2019-03-26 09:15:00,2019-03-26 09:30:00
41,1,1,0,0.006098164222969389,2019-03-26 09:15:00,2019-03-26 09:30:00
46,1,0,1,0.0032961461694033336,2019-03-26 09:15:00,2019-03-26 09:30:00
50,1,0,1,0.0032961461694033336,2019-03-26 09:15:00,2019-03-26 09:30:00
57,4,2,2,0.008992080801253192,2019-03-26 09:15:00,2019-03-26 09:30:00
58,1,1,0,0.009403455169378619,2019-03-26 09:15:00,2019-03-26 09:30:00
62,1,0,1,0.0032961461694033336,2019-03-26 09:15:00,2019-03-26 09:30:00
66,1,0,1,0.0032961461694033336,2019-03-26 09:15:00,2019-03-26 09:30:00
67,1,0,1,0.0032961461694033336,2019-03-26 09:15:00,2019-03-26 09:30:00
68,2,1,1,0.021923274562880346,2019-03-26 09:15:00,2019-03-26 09:30:00
69,1,0,1,0.0032961461694033336,2019-03-26 09:15:00,2019-03-26 09:30:00
70,1,1,0,0.004697155196186361,2019-03-26 09:15:00,2019-03-26 09:30:00
85,3,3,0,0.009460585887248655,2019-03-26 09:15:00,2019-03-26 09:30:00
87,7,6,1,0.08053220265631993,2019-03-26 09:15:00,2019-03-26 09:30:00
88,2,1,1,0.008868951912689155,2019-03-26 09:15:00,2019-03-26 09:30:00
90,3,3,0,0.006028164619366451,2019-03-26 09:15:00,2019-03-26 09:30:00
104,3,1,2,0.005732959488646872,2019-03-26 09:15:00,2019-03-26 09:30:00
109,5,1,4,0.006098164222969389,2019-03-26 09:15:00,2019-03-26 09:30:00
110,1,1,0,0.0038565497801165446,2019-03-26 09:15:00,2019-03-26 09:30:00
111,4,4,0,0.011649706933406917,2019-03-26 09:15:00,2019-03-26 09:30:00
112,5,4,1,0.06290295702852976,2019-03-26 09:15:00,2019-03-26 09:30:00
113,1,1,0,0.005024158997908162,2019-03-26 09:15:00,2019-03-26 09:30:00
115,1,1,0,0.006098164222969389,2019-03-26 09:15:00,2019-03-26 09:30:00
116,3,1,2,0.005732959488646872,2019-03-26 09:15:00,2019-03-26 09:30:00
118,1,0,1,0.0032961461694033336,2019-03-26 09:15:00,2019-03-26 09:30:00
119,1,1,0,0.006098164222969389,2019-03-26 09:15:00,2019-03-26 09:30:00
120,4,1,3,0.004599482718927852,2019-03-26 09:15:00,2019-03-26 09:30:00
122,2,1,1,0.004195152385457217,2019-03-26 09:15:00,2019-03-26 09:30:00
126,1,1,0,0.005024158997908162,2019-03-26 09:15:00,2019-03-26 09:30:00
135,1,0,1,0.0032961461694033336,2019-03-26 09:15:00,2019-03-26 09:30:00
137,5,1,4,0.004230152187258685,2019-03-26 09:15:00,2019-03-26 09:30:00
138,4,3,1,0.0127004033840239,2019-03-26 09:15:00,2019-03-26 09:30:00
141,5,0,5,0.0032961461694033336,2019-03-26 09:15:00,2019-03-26 09:30:00
147,1,1,0,0.006213028348984896,2019-03-26 09:15:00,2019-03-26 09:30:00
157,1,1,0,0.006098164222969389,2019-03-26 09:15:00,2019-03-26 09:30:00
158,4,3,1,0.0071841750335391984,2019-03-26 09:15:00,2019-03-26 09:30:00
164,6,3,3,0.011500964108323389,2019-03-26 09:15:00,2019-03-26 09:30:00
168,2,0,2,0.0032961461694033336,2019-03-26 09:15:00,2019-03-26 09:30:00
170,5,2,3,0.006418202488743221,2019-03-26 09:15:00,2019-03-26 09:30:00
173,6,3,3,0.023066249776617854,2019-03-26 09:15:00,2019-03-26 09:30:00
189,3,1,2,0.004195152385457217,2019-03-26 09:15:00,2019-03-26 09:30:00
191,4,1,3,0.006098164222969389,2019-03-26 09:15:00,2019-03-26 09:30:00
201,3,0,3,0.0032961461694033336,2019-03-26 09:15:00,2019-03-26 09:30:00
202,1,0,1,0.0032961461694033336,2019-03-26 09:15:00,2019-03-26 09:30:00
203,1,0,1,0.0032961461694033336,2019-03-26 09:15:00,2019-03-26 09:30:00
10,1,0,1,0.0037271137414463273,2019-03-26 09:30:00,2019-03-26 09:45:00
16,1,1,0,0.006895478828132726,2019-03-26 09:30:00,2019-03-26 09:45:00
19,1,0,1,0.0037271137414463273,2019-03-26 09:30:00,2019-03-26 09:45:00
20,2,1,1,0.007572083457741734,2019-03-26 09:30:00,2019-03-26 09:45:00
23,4,2,2,0.008369213980326813,2019-03-26 09:30:00,2019-03-26 09:45:00
27,1,0,1,0.0037271137414463273,2019-03-26 09:30:00,2019-03-26 09:45:00
35,1,0,1,0.0037271137414463273,2019-03-26 09:30:00,2019-03-26 09:45:00
37,1,1,0,0.005200848893640415,2019-03-26 09:30:00,2019-03-26 09:45:00
46,1,1,0,0.006895478828132726,2019-03-26 09:30:00,2019-03-26 09:45:00
57,2,2,0,0.014679296392971847,2019-03-26 09:30:00,2019-03-26 09:45:00
58,2,1,1,0.005311296284789526,2019-03-26 09:30:00,2019-03-26 09:45:00
66,1,0,1,0.0037271137414463273,2019-03-26 09:30:00,2019-03-26 09:45:00
67,1,0,1,0.0037271137414463273,2019-03-26 09:30:00,2019-03-26 09:45:00
68,3,2,1,0.03528505110047337,2019-03-26 09:30:00,2019-03-26 09:45:00
70,2,0,2,0.0037271137414463273,2019-03-26 09:30:00,2019-03-26 09:45:00
74,1,1,0,0.005200848893640415,2019-03-26 09:30:00,2019-03-26 09:45:00
85,1,1,0,0.006895478828132726,2019-03-26 09:30:00,2019-03-26 09:45:00
87,3,2,1,0.04071374352580284,2019-03-26 09:30:00,2019-03-26 09:45:00
88,1,0,1,0.0037271137414463273,2019-03-26 09:30:00,2019-03-26 09:45:00
90,1,1,0,0.006129953939152635,2019-03-26 09:30:00,2019-03-26 09:45:00
104,4,1,3,0.005200848893640415,2019-03-26 09:30:00,2019-03-26 09:45:00
109,1,0,1,0.0037271137414463273,2019-03-26 09:30:00,2019-03-26 09:45:00
110,1,1,0,0.005311296284789526,2019-03-26 09:30:00,2019-03-26 09:45:00
111,2,2,0,0.012581771597912655,2019-03-26 09:30:00,2019-03-26 09:45:00
112,5,3,2,0.014748680638616556,2019-03-26 09:30:00,2019-03-26 09:45:00
113,1,1,0,0.006658014786933701,2019-03-26 09:30:00,2019-03-26 09:45:00
114,1,0,1,0.0037271137414463273,2019-03-26 09:30:00,2019-03-26 09:45:00
115,5,4,1,0.061752368431820866,2019-03-26 09:30:00,2019-03-26 09:45:00
119,3,2,1,0.006688992146935805,2019-03-26 09:30:00,2019-03-26 09:45:00
120,6,2,4,0.0064825054657388845,2019-03-26 09:30:00,2019-03-26 09:45:00
126,1,1,0,0.006658014786933701,2019-03-26 09:30:00,2019-03-26 09:45:00
127,1,1,0,0.006895478828132726,2019-03-26 09:30:00,2019-03-26 09:45:00
137,5,2,3,0.008479661371475924,2019-03-26 09:30:00,2019-03-26 09:45:00
138,3,3,0,0.011830495920714309,2019-03-26 09:30:00,2019-03-26 09:45:00
141,2,0,2,0.0037271137414463273,2019-03-26 09:30:00,2019-03-26 09:45:00
157,1,1,0,0.006895478828132726,2019-03-26 09:30:00,2019-03-26 09:45:00
158,2,0,2,0.0037271137414463273,2019-03-26 09:30:00,2019-03-26 09:45:00
164,4,1,3,0.005200848893640415,2019-03-26 09:30:00,2019-03-26 09:45:00
168,2,0,2,0.0037271137414463273,2019-03-26 09:30:00,2019-03-26 09:45:00
173,4,2,2,0.009045818609935821,2019-03-26 09:30:00,2019-03-26 09:45:00
191,3,1,2,0.006895478828132726,2019-03-26 09:30:00,2019-03-26 09:45:00
195,2,2,0,0.013553454239022265,2019-03-26 09:30:00,2019-03-26 09:45:00
201,1,0,1,0.0037271137414463273,2019-03-26 09:30:00,2019-03-26 09:45:00
203,1,0,1,0.0037271137414463273,2019-03-26 09:30:00,2019-03-26 09:45:00
10,1,0,1,0.0037913561336275835,2019-03-26 09:45:00,2019-03-26 10:00:00
18,1,0,1,0.0037913561336275835,2019-03-26 09:45:00,2019-03-26 10:00:00
20,3,1,2,0.006594246010101321,2019-03-26 09:45:00,2019-03-26 10:00:00
23,3,1,2,0.006594246010101321,2019-03-26 09:45:00,2019-03-26 10:00:00
27,1,0,1,0.0037913561336275835,2019-03-26 09:45:00,2019-03-26 10:00:00
28,3,1,2,0.009754207823544761,2019-03-26 09:45:00,2019-03-26 10:00:00
30,2,1,1,0.0070143380150770275,2019-03-26 09:45:00,2019-03-26 10:00:00
35,1,0,1,0.0037913561336275835,2019-03-26 09:45:00,2019-03-26 10:00:00
37,2,2,0,0.015241007500256563,2019-03-26 09:45:00,2019-03-26 10:00:00
57,3,2,1,0.008205736950826043,2019-03-26 09:45:00,2019-03-26 10:00:00
58,2,0,2,0.0037913561336275835,2019-03-26 09:45:00,2019-03-26 10:00:00
62,1,0,1,0.0037913561336275835,2019-03-26 09:45:00,2019-03-26 10:00:00
66,2,1,1,0.0251561414116795,2019-03-26 09:45:00,2019-03-26 10:00:00
70,1,0,1,0.0037913561336275835,2019-03-26 09:45:00,2019-03-26 10:00:00
74,1,1,0,0.006087814526469238,2019-03-26 09:45:00,2019-03-26 10:00:00
80,1,0,1,0.0037913561336275835,2019-03-26 09:45:00,2019-03-26 10:00:00
85,6,3,3,0.01428533625857054,2019-03-26 09:45:00,2019-03-26 10:00:00
87,2,1,1,0.0251561414116795,2019-03-26 09:45:00,2019-03-26 10:00:00
104,2,0,2,0.0037913561336275835,2019-03-26 09:45:00,2019-03-26 10:00:00
109,2,1,1,0.010767070790808925,2019-03-26 09:45:00,2019-03-26 10:00:00
110,1,1,0,0.0067727819785861725,2019-03-26 09:45:00,2019-03-26 10:00:00
111,2,2,0,0.010820798340630239,2019-03-26 09:45:00,2019-03-26 10:00:00
113,1,1,0,0.006594246010101321,2019-03-26 09:45:00,2019-03-26 10:00:00
115,3,3,0,0.015241944494246066,2019-03-26 09:45:00,2019-03-26 10:00:00
116,1,1,0,0.008384272919310895,2019-03-26 09:45:00,2019-03-26 10:00:00
119,3,1,2,0.0070143380150770275,2019-03-26 09:45:00,2019-03-26 10:00:00
120,3,1,2,0.006594246010101321,2019-03-26 09:45:00,2019-03-26 10:00:00
126,1,0,1,0.0037913561336275835,2019-03-26 09:45:00,2019-03-26 10:00:00
127,2,2,0,0.010237319896526471,2019-03-26 09:45:00,2019-03-26 10:00:00
137,3,2,1,0.011062354377121095,2019-03-26 09:45:00,2019-03-26 10:00:00
138,1,1,0,0.006594246010101321,2019-03-26 09:45:00,2019-03-26 10:00:00
153,3,2,1,0.052610402543074065,2019-03-26 09:45:00,2019-03-26 10:00:00
154,3,2,1,0.010237319896526471,2019-03-26 09:45:00,2019-03-26 10:00:00
158,1,0,1,0.0037913561336275835,2019-03-26 09:45:00,2019-03-26 10:00:00
164,3,1,2,0.005402847074352305,2019-03-26 09:45:00,2019-03-26 10:00:00
168,5,1,4,0.004814560675104591,2019-03-26 09:45:00,2019-03-26 10:00:00
173,1,1,0,0.005402847074352305,2019-03-26 09:45:00,2019-03-26 10:00:00
177,1,1,0,0.0070143380150770275,2019-03-26 09:45:00,2019-03-26 10:00:00
189,1,1,0,0.004814560675104591,2019-03-26 09:45:00,2019-03-26 10:00:00
190,2,1,1,0.005402847074352305,2019-03-26 09:45:00,2019-03-26 10:00:00
196,1,1,0,0.007937397327927993,2019-03-26 09:45:00,2019-03-26 10:00:00
199,1,1,0,0.012494077632012495,2019-03-26 09:45:00,2019-03-26 10:00:00
203,1,0,1,0.0037913561336275835,2019-03-26 09:45:00,2019-03-26 10:00:00
5,1,0,1,0.003782042197891934,2019-03-26 10:00:00,2019-03-26 10:15:00
10,5,2,3,0.014708316459364212,2019-03-26 10:00:00,2019-03-26 10:15:00
20,4,2,2,0.012169790746018577,2019-03-26 10:00:00,2019-03-26 10:15:00
27,1,1,0,0.006997058620913151,2019-03-26 10:00:00,2019-03-26 10:15:00
28,2,1,1,0.006997058620913151,2019-03-26 10:00:00,2019-03-26 10:15:00
30,1,0,1,0.003782042197891934,2019-03-26 10:00:00,2019-03-26 10:15:00
35,2,1,1,0.006997058620913151,2019-03-26 10:00:00,2019-03-26 10:15:00
37,2,2,0,0.016015096994968142,2019-03-26 10:00:00,2019-03-26 10:15:00
41,1,1,0,0.008954774322997357,2019-03-26 10:00:00,2019-03-26 10:15:00
50,1,1,0,0.007949975449916732,2019-03-26 10:00:00,2019-03-26 10:15:00
57,1,0,1,0.003782042197891934,2019-03-26 10:00:00,2019-03-26 10:15:00
58,2,1,1,0.006997058620913151,2019-03-26 10:00:00,2019-03-26 10:15:00
62,1,0,1,0.003782042197891934,2019-03-26 10:00:00,2019-03-26 10:15:00
66,2,1,1,0.025050357512842833,2019-03-26 10:00:00,2019-03-26 10:15:00
80,1,0,1,0.003782042197891934,2019-03-26 10:00:00,2019-03-26 10:15:00
85,4,3,1,0.016497065646140424,2019-03-26 10:00:00,2019-03-26 10:15:00
87,2,1,1,0.025050357512842833,2019-03-26 10:00:00,2019-03-26 10:15:00
90,1,0,1,0.003782042197891934,2019-03-26 10:00:00,2019-03-26 10:15:00
99,1,0,1,0.003782042197891934,2019-03-26 10:00:00,2019-03-26 10:15:00
109,2,2,0,0.015268500543085496,2019-03-26 10:00:00,2019-03-26 10:15:00
110,2,1,1,0.006997058620913151,2019-03-26 10:00:00,2019-03-26 10:15:00
115,2,1,1,0.009730106392762087,2019-03-26 10:00:00,2019-03-26 10:15:00
116,1,0,1,0.003782042197891934,2019-03-26 10:00:00,2019-03-26 10:15:00
119,1,0,1,0.003782042197891934,2019-03-26 10:00:00,2019-03-26 10:15:00
120,3,1,2,0.006577958380600814,2019-03-26 10:00:00,2019-03-26 10:15:00
127,1,1,0,0.006997058620913151,2019-03-26 10:00:00,2019-03-26 10:15:00
137,1,1,0,0.017806119087634627,2019-03-26 10:00:00,2019-03-26 10:15:00
138,1,1,0,0.006577958380600814,2019-03-26 10:00:00,2019-03-26 10:15:00
151,1,1,0,0.006997058620913151,2019-03-26 10:00:00,2019-03-26 10:15:00
153,3,2,1,0.012945122815783305,2019-03-26 10:00:00,2019-03-26 10:15:00
154,3,1,2,0.009730106392762087,2019-03-26 10:00:00,2019-03-26 10:15:00
156,1,0,1,0.003782042197891934,2019-03-26 10:00:00,2019-03-26 10:15:00
164,3,1,2,0.014786531891913215,2019-03-26 10:00:00,2019-03-26 10:15:00
168,1,0,1,0.003782042197891934,2019-03-26 10:00:00,2019-03-26 10:15:00
170,4,2,2,0.025050357512842833,2019-03-26 10:00:00,2019-03-26 10:15:00
173,1,1,0,0.007917763158978106,2019-03-26 10:00:00,2019-03-26 10:15:00
177,2,1,1,0.007949975449916732,2019-03-26 10:00:00,2019-03-26 10:15:00
189,2,1,1,0.006997058620913151,2019-03-26 10:00:00,2019-03-26 10:15:00
190,1,1,0,0.009730106392762087,2019-03-26 10:00:00,2019-03-26 10:15:00
191,1,0,1,0.003782042197891934,2019-03-26 10:00:00,2019-03-26 10:15:00
199,1,1,0,0.007917763158978106,2019-03-26 10:00:00,2019-03-26 10:15:00
203,1,0,1,0.003782042197891934,2019-03-26 10:00:00,2019-03-26 10:15:00
1,1,0,1,0.003872998585176787,2019-03-26 10:15:00,2019-03-26 10:30:00
5,1,0,1,0.003872998585176787,2019-03-26 10:15:00,2019-03-26 10:30:00
10,3,1,2,0.011219495653828567,2019-03-26 10:15:00,2019-03-26 10:30:00
16,1,1,0,0.0071653383278967855,2019-03-26 10:15:00,2019-03-26 10:30:00
20,6,3,3,0.016538162375380132,2019-03-26 10:15:00,2019-03-26 10:30:00
21,1,1,0,0.009964121463151017,2019-03-26 10:15:00,2019-03-26 10:30:00
23,1,1,0,0.006736161717519408,2019-03-26 10:15:00,2019-03-26 10:30:00
27,1,1,0,0.0071653383278967855,2019-03-26 10:15:00,2019-03-26 10:30:00
35,1,1,0,0.009964121463151017,2019-03-26 10:15:00,2019-03-26 10:30:00
37,1,1,0,0.008564729895523902,2019-03-26 10:15:00,2019-03-26 10:30:00
50,1,1,0,0.008641883413639955,2019-03-26 10:15:00,2019-03-26 10:30:00
57,1,0,1,0.003872998585176787,2019-03-26 10:15:00,2019-03-26 10:30:00
58,7,4,3,0.026797849309544153,2019-03-26 10:15:00,2019-03-26 10:30:00
61,2,1,1,0.025654385881262984,2019-03-26 10:15:00,2019-03-26 10:30:00
66,3,1,2,0.006736161717519408,2019-03-26 10:15:00,2019-03-26 10:30:00
70,4,2,2,0.025654385881262984,2019-03-26 10:15:00,2019-03-26 10:30:00
80,1,0,1,0.003872998585176787,2019-03-26 10:15:00,2019-03-26 10:30:00
85,2,2,0,0.010457678070616785,2019-03-26 10:15:00,2019-03-26 10:30:00
87,2,1,1,0.025654385881262984,2019-03-26 10:15:00,2019-03-26 10:30:00
90,2,1,1,0.0071653383278967855,2019-03-26 10:15:00,2019-03-26 10:30:00
99,1,0,1,0.003872998585176787,2019-03-26 10:15:00,2019-03-26 10:30:00
110,2,1,1,0.011466777572693355,2019-03-26 10:15:00,2019-03-26 10:30:00
113,1,1,0,0.005519168456536786,2019-03-26 10:15:00,2019-03-26 10:30:00
114,1,1,0,0.0071653383278967855,2019-03-26 10:15:00,2019-03-26 10:30:00
115,1,1,0,0.013621117847324955,2019-03-26 10:15:00,2019-03-26 10:30:00
119,1,0,1,0.003872998585176787,2019-03-26 10:15:00,2019-03-26 10:30:00
120,3,1,2,0.006736161717519408,2019-03-26 10:15:00,2019-03-26 10:30:00
137,1,0,1,0.003872998585176787,2019-03-26 10:15:00,2019-03-26 10:30:00
138,2,2,0,0.011422573741261082,2019-03-26 10:15:00,2019-03-26 10:30:00
141,1,1,0,0.0071653383278967855,2019-03-26 10:15:00,2019-03-26 10:30:00
151,2,1,1,0.0071653383278967855,2019-03-26 10:15:00,2019-03-26 10:30:00
153,2,0,2,0.003872998585176787,2019-03-26 10:15:00,2019-03-26 10:30:00
154,1,0,1,0.003872998585176787,2019-03-26 10:15:00,2019-03-26 10:30:00
156,1,0,1,0.003872998585176787,2019-03-26 10:15:00,2019-03-26 10:30:00
157,1,1,0,0.0071653383278967855,2019-03-26 10:15:00,2019-03-26 10:30:00
164,2,1,1,0.005519168456536786,2019-03-26 10:15:00,2019-03-26 10:30:00
173,1,0,1,0.003872998585176787,2019-03-26 10:15:00,2019-03-26 10:30:00
177,2,1,1,0.008641883413639955,2019-03-26 10:15:00,2019-03-26 10:30:00
190,2,1,1,0.0071653383278967855,2019-03-26 10:15:00,2019-03-26 10:30:00
191,2,0,2,0.003872998585176787,2019-03-26 10:15:00,2019-03-26 10:30:00
199,1,1,0,0.005519168456536786,2019-03-26 10:15:00,2019-03-26 10:30:00
203,1,0,1,0.003872998585176787,2019-03-26 10:15:00,2019-03-26 10:30:00
1,1,0,1,0.002853753277856866,2019-03-26 10:30:00,2019-03-26 10:45:00
10,9,4,5,0.00892252539676674,2019-03-26 10:30:00,2019-03-26 10:45:00
16,1,1,0,0.005279700805112447,2019-03-26 10:30:00,2019-03-26 10:45:00
18,1,1,0,0.006757139526494878,2019-03-26 10:30:00,2019-03-26 10:45:00
19,1,1,0,0.005279700805112447,2019-03-26 10:30:00,2019-03-26 10:45:00
20,3,1,2,0.00496353120315473,2019-03-26 10:30:00,2019-03-26 10:45:00
21,1,0,1,0.002853753277856866,2019-03-26 10:30:00,2019-03-26 10:45:00
23,9,5,4,0.017918022607654658,2019-03-26 10:30:00,2019-03-26 10:45:00
27,3,2,1,0.035145770685514124,2019-03-26 10:30:00,2019-03-26 10:45:00
28,2,1,1,0.018999761981685494,2019-03-26 10:30:00,2019-03-26 10:45:00
35,2,2,0,0.008958050143281035,2019-03-26 10:30:00,2019-03-26 10:45:00
37,3,2,1,0.02707276633359981,2019-03-26 10:30:00,2019-03-26 10:45:00
57,1,0,1,0.002853753277856866,2019-03-26 10:30:00,2019-03-26 10:45:00
58,11,6,5,0.025428525804878397,2019-03-26 10:30:00,2019-03-26 10:45:00
64,2,1,1,0.018999761981685494,2019-03-26 10:30:00,2019-03-26 10:45:00
66,1,0,1,0.002853753277856866,2019-03-26 10:30:00,2019-03-26 10:45:00
75,2,1,1,0.018999761981685494,2019-03-26 10:30:00,2019-03-26 10:45:00
85,1,1,0,0.005279700805112447,2019-03-26 10:30:00,2019-03-26 10:45:00
87,14,7,7,0.014996233422635058,2019-03-26 10:30:00,2019-03-26 10:45:00
90,1,1,0,0.005685785973173974,2019-03-26 10:30:00,2019-03-26 10:45:00
99,1,0,1,0.002853753277856866,2019-03-26 10:30:00,2019-03-26 10:45:00
104,2,1,1,0.018999761981685494,2019-03-26 10:30:00,2019-03-26 10:45:00
110,3,1,2,0.007178660931823072,2019-03-26 10:30:00,2019-03-26 10:45:00
111,2,1,1,0.018999761981685494,2019-03-26 10:30:00,2019-03-26 10:45:00
113,1,1,0,0.005279700805112447,2019-03-26 10:30:00,2019-03-26 10:45:00
114,4,2,2,0.009183087053750458,2019-03-26 10:30:00,2019-03-26 10:45:00
115,6,4,2,0.04589192222724862,2019-03-26 10:30:00,2019-03-26 10:45:00
119,3,1,2,0.006662202624161673,2019-03-26 10:30:00,2019-03-26 10:45:00
120,4,2,2,0.007073309128452595,2019-03-26 10:30:00,2019-03-26 10:45:00
137,14,6,8,0.007875176387789463,2019-03-26 10:30:00,2019-03-26 10:45:00
138,6,4,2,0.05303544996536347,2019-03-26 10:30:00,2019-03-26 10:45:00
141,1,1,0,0.005279700805112447,2019-03-26 10:30:00,2019-03-26 10:45:00
153,1,0,1,0.002853753277856866,2019-03-26 10:30:00,2019-03-26 10:45:00
154,1,0,1,0.002853753277856866,2019-03-26 10:30:00,2019-03-26 10:45:00
157,3,2,1,0.024562054778633508,2019-03-26 10:30:00,2019-03-26 10:45:00
158,2,0,2,0.002853753277856866,2019-03-26 10:30:00,2019-03-26 10:45:00
164,2,0,2,0.002853753277856866,2019-03-26 10:30:00,2019-03-26 10:45:00
168,1,1,0,0.004066727041484657,2019-03-26 10:30:00,2019-03-26 10:45:00
169,1,1,0,0.003690657129512299,2019-03-26 10:30:00,2019-03-26 10:45:00
173,1,0,1,0.002853753277856866,2019-03-26 10:30:00,2019-03-26 10:45:00
177,5,3,2,0.02907699856660425,2019-03-26 10:30:00,2019-03-26 10:45:00
189,2,0,2,0.002853753277856866,2019-03-26 10:30:00,2019-03-26 10:45:00
190,6,3,3,0.012186815833709065,2019-03-26 10:30:00,2019-03-26 10:45:00
191,1,0,1,0.002853753277856866,2019-03-26 10:30:00,2019-03-26 10:45:00
199,1,1,0,0.005279700805112447,2019-03-26 10:30:00,2019-03-26 10:45:00
201,2,1,1,0.018999761981685494,2019-03-26 10:30:00,2019-03-26 10:45:00
203,1,0,1,0.002853753277856866,2019-03-26 10:30:00,2019-03-26 10:45:00
1,7,3,4,0.005891354531129911,2019-03-26 10:45:00,2019-03-26 11:00:00
10,6,3,3,0.014221463039437762,2019-03-26 10:45:00,2019-03-26 11:00:00
16,1,1,0,0.0039482377548647335,2019-03-26 10:45:00,2019-03-26 11:00:00
18,1,1,0,0.00463892937309136,2019-03-26 10:45:00,2019-03-26 11:00:00
19,3,2,1,0.026308847021861266,2019-03-26 10:45:00,2019-03-26 11:00:00
20,3,1,2,0.0037118750937701834,2019-03-26 10:45:00,2019-03-26 11:00:00
21,1,0,1,0.0021340790570142597,2019-03-26 10:45:00,2019-03-26 11:00:00
23,7,4,3,0.010664406610399347,2019-03-26 10:45:00,2019-03-26 11:00:00
27,5,3,2,0.026308847021861266,2019-03-26 10:45:00,2019-03-26 11:00:00
28,2,1,1,0.014221463039437762,2019-03-26 10:45:00,2019-03-26 11:00:00
35,4,3,1,0.025464990437836548,2019-03-26 10:45:00,2019-03-26 11:00:00
37,5,3,2,0.020265155030649514,2019-03-26 10:45:00,2019-03-26 11:00:00
46,2,1,1,0.014221463039437762,2019-03-26 10:45:00,2019-03-26 11:00:00
57,3,1,2,0.0037118750937701834,2019-03-26 10:45:00,2019-03-26 11:00:00
58,12,7,5,0.037146062820870504,2019-03-26 10:45:00,2019-03-26 11:00:00
62,2,1,1,0.014221463039437762,2019-03-26 10:45:00,2019-03-26 11:00:00
64,2,1,1,0.014221463039437762,2019-03-26 10:45:00,2019-03-26 11:00:00
66,3,1,2,0.0037118750937701834,2019-03-26 10:45:00,2019-03-26 11:00:00
67,6,3,3,0.014221463039437762,2019-03-26 10:45:00,2019-03-26 11:00:00
68,4,2,2,0.014221463039437762,2019-03-26 10:45:00,2019-03-26 11:00:00
75,2,1,1,0.014221463039437762,2019-03-26 10:45:00,2019-03-26 11:00:00
85,5,3,2,0.02473105098510534,2019-03-26 10:45:00,2019-03-26 11:00:00
86,2,1,1,0.014221463039437762,2019-03-26 10:45:00,2019-03-26 11:00:00
87,20,10,10,0.012105289922009767,2019-03-26 10:45:00,2019-03-26 11:00:00
90,4,2,2,0.014221463039437762,2019-03-26 10:45:00,2019-03-26 11:00:00
99,1,0,1,0.0021340790570142597,2019-03-26 10:45:00,2019-03-26 11:00:00
104,4,2,2,0.014221463039437762,2019-03-26 10:45:00,2019-03-26 11:00:00
109,4,2,2,0.014221463039437762,2019-03-26 10:45:00,2019-03-26 11:00:00
110,4,1,3,0.0029779356410389764,2019-03-26 10:45:00,2019-03-26 11:00:00
111,10,5,5,0.014221463039437762,2019-03-26 10:45:00,2019-03-26 11:00:00
114,4,2,2,0.005891354531129911,2019-03-26 10:45:00,2019-03-26 11:00:00
115,6,4,2,0.049440149295138805,2019-03-26 10:45:00,2019-03-26 11:00:00
119,2,1,1,0.005156805140866222,2019-03-26 10:45:00,2019-03-26 11:00:00
120,2,1,1,0.0030411584059394964,2019-03-26 10:45:00,2019-03-26 11:00:00
137,18,8,10,0.006677318335011695,2019-03-26 10:45:00,2019-03-26 11:00:00
138,6,4,2,0.04195504760981536,2019-03-26 10:45:00,2019-03-26 11:00:00
141,1,1,0,0.0039482377548647335,2019-03-26 10:45:00,2019-03-26 11:00:00
154,1,0,1,0.0021340790570142597,2019-03-26 10:45:00,2019-03-26 11:00:00
157,3,2,1,0.017993535391650797,2019-03-26 10:45:00,2019-03-26 11:00:00
158,2,0,2,0.0021340790570142597,2019-03-26 10:45:00,2019-03-26 11:00:00
159,6,3,3,0.014221463039437762,2019-03-26 10:45:00,2019-03-26 11:00:00
162,8,4,4,0.014221463039437762,2019-03-26 10:45:00,2019-03-26 11:00:00
164,2,0,2,0.0021340790570142597,2019-03-26 10:45:00,2019-03-26 11:00:00
168,1,1,0,0.002832169355101252,2019-03-26 10:45:00,2019-03-26 11:00:00
169,1,1,0,0.002701983966763939,2019-03-26 10:45:00,2019-03-26 11:00:00
170,2,1,1,0.014221463039437762,2019-03-26 10:45:00,2019-03-26 11:00:00
173,1,0,1,0.0021340790570142597,2019-03-26 10:45:00,2019-03-26 11:00:00
177,6,3,3,0.014221463039437762,2019-03-26 10:45:00,2019-03-26 11:00:00
189,10,4,6,0.0049264402493622295,2019-03-26 10:45:00,2019-03-26 11:00:00
190,6,3,3,0.00857013571613837,2019-03-26 10:45:00,2019-03-26 11:00:00
191,1,0,1,0.0021340790570142597,2019-03-26 10:45:00,2019-03-26 11:00:00
195,2,1,1,0.014221463039437762,2019-03-26 10:45:00,2019-03-26 11:00:00
199,5,3,2,0.026308847021861266,2019-03-26 10:45:00,2019-03-26 11:00:00
201,2,1,1,0.014221463039437762,2019-03-26 10:45:00,2019-03-26 11:00:00
203,3,1,2,0.0037118750937701834,2019-03-26 10:45:00,2019-03-26 11:00:00
1,6,3,3,0.013063395978587152,2019-03-26 11:00:00,2019-03-26 11:15:00
5,2,1,1,0.013063395978587152,2019-03-26 11:00:00,2019-03-26 11:15:00
16,1,1,0,0.003626673504782659,2019-03-26 11:00:00,2019-03-26 11:15:00
18,3,2,1,0.02160032708941098,2019-03-26 11:00:00,2019-03-26 11:15:00
19,4,2,2,0.006308685252507076,2019-03-26 11:00:00,2019-03-26 11:15:00
20,1,0,1,0.001960237438424835,2019-03-26 11:00:00,2019-03-26 11:15:00
21,1,0,1,0.001960237438424835,2019-03-26 11:00:00,2019-03-26 11:15:00
23,2,1,1,0.003243351153094083,2019-03-26 11:00:00,2019-03-26 11:15:00
27,5,3,2,0.024166554518749474,2019-03-26 11:00:00,2019-03-26 11:15:00
35,4,3,1,0.022124893261855225,2019-03-26 11:00:00,2019-03-26 11:15:00
37,9,5,4,0.024166554518749474,2019-03-26 11:00:00,2019-03-26 11:15:00
41,4,2,2,0.013063395978587152,2019-03-26 11:00:00,2019-03-26 11:15:00
46,2,1,1,0.013063395978587152,2019-03-26 11:00:00,2019-03-26 11:15:00
57,5,2,3,0.004526464867763331,2019-03-26 11:00:00,2019-03-26 11:15:00
58,12,7,5,0.035915016825104416,2019-03-26 11:00:00,2019-03-26 11:15:00
62,4,2,2,0.013063395978587152,2019-03-26 11:00:00,2019-03-26 11:15:00
64,2,1,1,0.013063395978587152,2019-03-26 11:00:00,2019-03-26 11:15:00
66,5,2,3,0.004526464867763331,2019-03-26 11:00:00,2019-03-26 11:15:00
67,6,3,3,0.013063395978587152,2019-03-26 11:00:00,2019-03-26 11:15:00
68,4,2,2,0.013063395978587152,2019-03-26 11:00:00,2019-03-26 11:15:00
74,4,2,2,0.013063395978587152,2019-03-26 11:00:00,2019-03-26 11:15:00
85,7,4,3,0.020711162769235097,2019-03-26 11:00:00,2019-03-26 11:15:00
86,2,1,1,0.013063395978587152,2019-03-26 11:00:00,2019-03-26 11:15:00
87,17,8,9,0.00806964439831229,2019-03-26 11:00:00,2019-03-26 11:15:00
90,4,2,2,0.013063395978587152,2019-03-26 11:00:00,2019-03-26 11:15:00
99,1,0,1,0.001960237438424835,2019-03-26 11:00:00,2019-03-26 11:15:00
104,4,2,2,0.013063395978587152,2019-03-26 11:00:00,2019-03-26 11:15:00
109,8,4,4,0.013063395978587152,2019-03-26 11:00:00,2019-03-26 11:15:00
110,8,3,5,0.004001898695319091,2019-03-26 11:00:00,2019-03-26 11:15:00
111,8,4,4,0.013063395978587152,2019-03-26 11:00:00,2019-03-26 11:15:00
113,4,2,2,0.013063395978587152,2019-03-26 11:00:00,2019-03-26 11:15:00
114,5,2,3,0.004526464867763331,2019-03-26 11:00:00,2019-03-26 11:15:00
115,3,2,1,0.0397656418498836,2019-03-26 11:00:00,2019-03-26 11:15:00
119,2,1,1,0.00471812604360762,2019-03-26 11:00:00,2019-03-26 11:15:00
120,6,3,3,0.007876699341696582,2019-03-26 11:00:00,2019-03-26 11:15:00
126,2,1,1,0.013063395978587152,2019-03-26 11:00:00,2019-03-26 11:15:00
137,16,7,9,0.005796093017328526,2019-03-26 11:00:00,2019-03-26 11:15:00
138,6,4,2,0.039006927091108284,2019-03-26 11:00:00,2019-03-26 11:15:00
151,2,1,1,0.013063395978587152,2019-03-26 11:00:00,2019-03-26 11:15:00
153,4,2,2,0.013063395978587152,2019-03-26 11:00:00,2019-03-26 11:15:00
154,1,0,1,0.001960237438424835,2019-03-26 11:00:00,2019-03-26 11:15:00
157,5,3,2,0.01669704745921647,2019-03-26 11:00:00,2019-03-26 11:15:00
158,3,1,2,0.0034097200431189153,2019-03-26 11:00:00,2019-03-26 11:15:00
159,4,2,2,0.013063395978587152,2019-03-26 11:00:00,2019-03-26 11:15:00
162,8,4,4,0.013063395978587152,2019-03-26 11:00:00,2019-03-26 11:15:00
164,1,0,1,0.001960237438424835,2019-03-26 11:00:00,2019-03-26 11:15:00
169,1,1,0,0.0025082168068396482,2019-03-26 11:00:00,2019-03-26 11:15:00
170,6,3,3,0.013063395978587152,2019-03-26 11:00:00,2019-03-26 11:15:00
177,6,3,3,0.013063395978587152,2019-03-26 11:00:00,2019-03-26 11:15:00
189,12,6,6,0.013063395978587152,2019-03-26 11:00:00,2019-03-26 11:15:00
190,3,2,1,0.02160032708941098,2019-03-26 11:00:00,2019-03-26 11:15:00
191,2,1,1,0.013063395978587152,2019-03-26 11:00:00,2019-03-26 11:15:00
195,6,3,3,0.013063395978587152,2019-03-26 11:00:00,2019-03-26 11:15:00
199,4,2,2,0.013063395978587152,2019-03-26 11:00:00,2019-03-26 11:15:00
201,2,1,1,0.013063395978587152,2019-03-26 11:00:00,2019-03-26 11:15:00
202,4,2,2,0.013063395978587152,2019-03-26 11:00:00,2019-03-26 11:15:00
203,7,3,4,0.005415629187939218,2019-03-26 11:00:00,2019-03-26 11:15:00
1,2,1,1,0.013585644294705055,2019-03-26 11:15:00,2019-03-26 11:30:00
5,2,1,1,0.013585644294705055,2019-03-26 11:15:00,2019-03-26 11:30:00
16,1,1,0,0.0037714682603018817,2019-03-26 11:15:00,2019-03-26 11:30:00
18,5,3,2,0.020787950322517595,2019-03-26 11:15:00,2019-03-26 11:30:00
19,2,1,1,0.0037714682603018817,2019-03-26 11:15:00,2019-03-26 11:30:00
20,1,0,1,0.0020385181513084744,2019-03-26 11:15:00,2019-03-26 11:30:00
21,1,0,1,0.0020385181513084744,2019-03-26 11:15:00,2019-03-26 11:30:00
23,1,0,1,0.0020385181513084744,2019-03-26 11:15:00,2019-03-26 11:30:00
27,4,2,2,0.013585644294705055,2019-03-26 11:15:00,2019-03-26 11:30:00
35,2,2,0,0.0035457790027785094,2019-03-26 11:15:00,2019-03-26 11:30:00
37,5,3,2,0.021541274659010866,2019-03-26 11:15:00,2019-03-26 11:30:00
41,10,5,5,0.013585644294705055,2019-03-26 11:15:00,2019-03-26 11:30:00
46,2,1,1,0.013585644294705055,2019-03-26 11:15:00,2019-03-26 11:30:00
50,2,1,1,0.013585644294705055,2019-03-26 11:15:00,2019-03-26 11:30:00
57,5,2,3,0.004706605954167508,2019-03-26 11:15:00,2019-03-26 11:30:00
58,10,6,4,0.039809837365343034,2019-03-26 11:15:00,2019-03-26 11:30:00
62,2,1,1,0.013585644294705055,2019-03-26 11:15:00,2019-03-26 11:30:00
64,2,1,1,0.013585644294705055,2019-03-26 11:15:00,2019-03-26 11:30:00
66,2,1,1,0.013585644294705055,2019-03-26 11:15:00,2019-03-26 11:30:00
68,4,2,2,0.013585644294705055,2019-03-26 11:15:00,2019-03-26 11:30:00
74,4,2,2,0.013585644294705055,2019-03-26 11:15:00,2019-03-26 11:30:00
85,7,4,3,0.025132770438101637,2019-03-26 11:15:00,2019-03-26 11:30:00
87,19,9,10,0.008722753401866831,2019-03-26 11:15:00,2019-03-26 11:30:00
104,2,1,1,0.013585644294705055,2019-03-26 11:15:00,2019-03-26 11:30:00
109,4,2,2,0.013585644294705055,2019-03-26 11:15:00,2019-03-26 11:30:00
110,6,2,4,0.0035457790027785094,2019-03-26 11:15:00,2019-03-26 11:30:00
111,8,4,4,0.013585644294705055,2019-03-26 11:15:00,2019-03-26 11:30:00
112,4,2,2,0.013585644294705055,2019-03-26 11:15:00,2019-03-26 11:30:00
113,4,2,2,0.013585644294705055,2019-03-26 11:15:00,2019-03-26 11:30:00
114,9,4,5,0.006383338266892519,2019-03-26 11:15:00,2019-03-26 11:30:00
115,2,1,1,0.013585644294705055,2019-03-26 11:15:00,2019-03-26 11:30:00
118,4,2,2,0.013585644294705055,2019-03-26 11:15:00,2019-03-26 11:30:00
119,9,5,4,0.025132770438101637,2019-03-26 11:15:00,2019-03-26 11:30:00
120,6,3,3,0.008189086808334505,2019-03-26 11:15:00,2019-03-26 11:30:00
126,4,2,2,0.013585644294705055,2019-03-26 11:15:00,2019-03-26 11:30:00
137,17,8,9,0.008381893066020227,2019-03-26 11:15:00,2019-03-26 11:30:00
138,6,4,2,0.040569193216398715,2019-03-26 11:15:00,2019-03-26 11:30:00
141,2,1,1,0.013585644294705055,2019-03-26 11:15:00,2019-03-26 11:30:00
151,2,1,1,0.013585644294705055,2019-03-26 11:15:00,2019-03-26 11:30:00
153,4,2,2,0.013585644294705055,2019-03-26 11:15:00,2019-03-26 11:30:00
154,1,0,1,0.0020385181513084744,2019-03-26 11:15:00,2019-03-26 11:30:00
157,3,2,1,0.018789395523389877,2019-03-26 11:15:00,2019-03-26 11:30:00
158,3,1,2,0.0035457790027785094,2019-03-26 11:15:00,2019-03-26 11:30:00
162,8,4,4,0.013585644294705055,2019-03-26 11:15:00,2019-03-26 11:30:00
164,7,3,4,0.005630013930399247,2019-03-26 11:15:00,2019-03-26 11:30:00
169,2,1,1,0.013585644294705055,2019-03-26 11:15:00,2019-03-26 11:30:00
170,10,5,5,0.013585644294705055,2019-03-26 11:15:00,2019-03-26 11:30:00
189,12,6,6,0.013585644294705055,2019-03-26 11:15:00,2019-03-26 11:30:00
190,3,2,1,0.0224646826352426,2019-03-26 11:15:00,2019-03-26 11:30:00
191,6,3,3,0.013585644294705055,2019-03-26 11:15:00,2019-03-26 11:30:00
195,6,3,3,0.013585644294705055,2019-03-26 11:15:00,2019-03-26 11:30:00
201,2,1,1,0.013585644294705055,2019-03-26 11:15:00,2019-03-26 11:30:00
202,2,1,1,0.013585644294705055,2019-03-26 11:15:00,2019-03-26 11:30:00
203,1,0,1,0.0020385181513084744,2019-03-26 11:15:00,2019-03-26 11:30:00
5,2,1,1,0.015273350604690171,2019-03-26 11:30:00,2019-03-26 11:45:00
10,2,1,1,0.015273350604690171,2019-03-26 11:30:00,2019-03-26 11:45:00
16,1,1,0,0.004240725402638609,2019-03-26 11:30:00,2019-03-26 11:45:00
18,5,3,2,0.026559831802917058,2019-03-26 11:30:00,2019-03-26 11:45:00
19,1,1,0,0.004240725402638609,2019-03-26 11:30:00,2019-03-26 11:45:00
20,1,0,1,0.002292158171327637,2019-03-26 11:30:00,2019-03-26 11:45:00
21,1,0,1,0.002292158171327637,2019-03-26 11:30:00,2019-03-26 11:45:00
23,1,0,1,0.002292158171327637,2019-03-26 11:30:00,2019-03-26 11:45:00
35,2,2,0,0.0039868694064632846,2019-03-26 11:30:00,2019-03-26 11:45:00
37,3,2,1,0.024219204547800945,2019-03-26 11:30:00,2019-03-26 11:45:00
41,17,8,9,0.009403861040751544,2019-03-26 11:30:00,2019-03-26 11:45:00
46,2,1,1,0.015273350604690171,2019-03-26 11:30:00,2019-03-26 11:45:00
50,2,1,1,0.015273350604690171,2019-03-26 11:30:00,2019-03-26 11:45:00
57,5,2,3,0.005291386218454796,2019-03-26 11:30:00,2019-03-26 11:45:00
58,7,4,3,0.021579256537329967,2019-03-26 11:30:00,2019-03-26 11:45:00
64,2,1,1,0.015273350604690171,2019-03-26 11:30:00,2019-03-26 11:45:00
68,4,2,2,0.015273350604690171,2019-03-26 11:30:00,2019-03-26 11:45:00
69,2,1,1,0.015273350604690171,2019-03-26 11:30:00,2019-03-26 11:45:00
74,5,3,2,0.021142840168628795,2019-03-26 11:30:00,2019-03-26 11:45:00
85,5,3,2,0.025255314990925547,2019-03-26 11:30:00,2019-03-26 11:45:00
87,15,7,8,0.00896744467205037,2019-03-26 11:30:00,2019-03-26 11:45:00
104,2,1,1,0.015273350604690171,2019-03-26 11:30:00,2019-03-26 11:45:00
109,10,5,5,0.015273350604690171,2019-03-26 11:30:00,2019-03-26 11:45:00
110,6,2,4,0.0039868694064632846,2019-03-26 11:30:00,2019-03-26 11:45:00
111,8,4,4,0.015273350604690171,2019-03-26 11:30:00,2019-03-26 11:45:00
112,10,5,5,0.015273350604690171,2019-03-26 11:30:00,2019-03-26 11:45:00
113,4,2,2,0.015273350604690171,2019-03-26 11:30:00,2019-03-26 11:45:00
114,3,1,2,0.0039868694064632846,2019-03-26 11:30:00,2019-03-26 11:45:00
115,2,1,1,0.015273350604690171,2019-03-26 11:30:00,2019-03-26 11:45:00
116,2,1,1,0.015273350604690171,2019-03-26 11:30:00,2019-03-26 11:45:00
118,4,2,2,0.015273350604690171,2019-03-26 11:30:00,2019-03-26 11:45:00
119,9,5,4,0.028254543038052707,2019-03-26 11:30:00,2019-03-26 11:45:00
120,4,2,2,0.006595903030446309,2019-03-26 11:30:00,2019-03-26 11:45:00
137,13,6,7,0.008462440524300782,2019-03-26 11:30:00,2019-03-26 11:45:00
138,2,2,0,0.007044856238193701,2019-03-26 11:30:00,2019-03-26 11:45:00
141,2,1,1,0.015273350604690171,2019-03-26 11:30:00,2019-03-26 11:45:00
147,2,1,1,0.015273350604690171,2019-03-26 11:30:00,2019-03-26 11:45:00
153,2,1,1,0.015273350604690171,2019-03-26 11:30:00,2019-03-26 11:45:00
154,1,0,1,0.002292158171327637,2019-03-26 11:30:00,2019-03-26 11:45:00
157,3,2,1,0.022084260685079557,2019-03-26 11:30:00,2019-03-26 11:45:00
158,5,2,3,0.005291386218454796,2019-03-26 11:30:00,2019-03-26 11:45:00
162,8,4,4,0.015273350604690171,2019-03-26 11:30:00,2019-03-26 11:45:00
164,7,3,4,0.0063274966615794,2019-03-26 11:30:00,2019-03-26 11:45:00
169,2,1,1,0.015273350604690171,2019-03-26 11:30:00,2019-03-26 11:45:00
170,10,5,5,0.015273350604690171,2019-03-26 11:30:00,2019-03-26 11:45:00
189,12,6,6,0.015273350604690171,2019-03-26 11:30:00,2019-03-26 11:45:00
190,1,1,0,0.0037917721948912166,2019-03-26 11:30:00,2019-03-26 11:45:00
191,6,3,3,0.015273350604690171,2019-03-26 11:30:00,2019-03-26 11:45:00
195,6,3,3,0.015273350604690171,2019-03-26 11:30:00,2019-03-26 11:45:00
202,4,2,2,0.015273350604690171,2019-03-26 11:30:00,2019-03-26 11:45:00
203,5,2,3,0.005291386218454796,2019-03-26 11:30:00,2019-03-26 11:45:00
10,10,5,5,0.015971788472021242,2019-03-26 11:45:00,2019-03-26 12:00:00
16,1,1,0,0.004435779637583804,2019-03-26 11:45:00,2019-03-26 12:00:00
18,5,3,2,0.027773255953762652,2019-03-26 11:45:00,2019-03-26 12:00:00
19,1,1,0,0.004435779637583804,2019-03-26 11:45:00,2019-03-26 12:00:00
20,1,0,1,0.0023975469065498586,2019-03-26 11:45:00,2019-03-26 12:00:00
21,1,0,1,0.0023975469065498586,2019-03-26 11:45:00,2019-03-26 12:00:00
23,1,0,1,0.0023975469065498586,2019-03-26 11:45:00,2019-03-26 12:00:00
28,2,1,1,0.015971788472021242,2019-03-26 11:45:00,2019-03-26 12:00:00
35,2,2,0,0.003966315615186001,2019-03-26 11:45:00,2019-03-26 12:00:00
37,3,2,1,0.02954603003749263,2019-03-26 11:45:00,2019-03-26 12:00:00
41,9,4,5,0.007501876478168008,2019-03-26 11:45:00,2019-03-26 12:00:00
46,2,1,1,0.015971788472021242,2019-03-26 11:45:00,2019-03-26 12:00:00
57,5,2,3,0.005535084323822144,2019-03-26 11:45:00,2019-03-26 12:00:00
58,13,7,6,0.022562165781604235,2019-03-26 11:45:00,2019-03-26 12:00:00
64,2,1,1,0.015971788472021242,2019-03-26 11:45:00,2019-03-26 12:00:00
68,4,2,2,0.015971788472021242,2019-03-26 11:45:00,2019-03-26 12:00:00
69,2,1,1,0.015971788472021242,2019-03-26 11:45:00,2019-03-26 12:00:00
74,5,3,2,0.02444170046587448,2019-03-26 11:45:00,2019-03-26 12:00:00
85,13,7,6,0.026408492620220343,2019-03-26 11:45:00,2019-03-26 12:00:00
87,15,7,8,0.009381411162438251,2019-03-26 11:45:00,2019-03-26 12:00:00
104,2,1,1,0.015971788472021242,2019-03-26 11:45:00,2019-03-26 12:00:00
109,16,8,8,0.015971788472021242,2019-03-26 11:45:00,2019-03-26 12:00:00
110,10,4,6,0.005535084323822144,2019-03-26 11:45:00,2019-03-26 12:00:00
111,8,4,4,0.015971788472021242,2019-03-26 11:45:00,2019-03-26 12:00:00
112,8,4,4,0.015971788472021242,2019-03-26 11:45:00,2019-03-26 12:00:00
113,4,2,2,0.015971788472021242,2019-03-26 11:45:00,2019-03-26 12:00:00
114,3,1,2,0.004170320990279835,2019-03-26 11:45:00,2019-03-26 12:00:00
115,6,3,3,0.015971788472021242,2019-03-26 11:45:00,2019-03-26 12:00:00
116,2,1,1,0.015971788472021242,2019-03-26 11:45:00,2019-03-26 12:00:00
119,9,5,4,0.02954603003749263,2019-03-26 11:45:00,2019-03-26 12:00:00
120,2,1,1,0.003966315615186001,2019-03-26 11:45:00,2019-03-26 12:00:00
126,2,1,1,0.015971788472021242,2019-03-26 11:45:00,2019-03-26 12:00:00
127,2,1,1,0.015971788472021242,2019-03-26 11:45:00,2019-03-26 12:00:00
135,2,1,1,0.015971788472021242,2019-03-26 11:45:00,2019-03-26 12:00:00
137,16,7,9,0.007081982036821954,2019-03-26 11:45:00,2019-03-26 12:00:00
138,2,2,0,0.007808049066054989,2019-03-26 11:45:00,2019-03-26 12:00:00
141,1,1,0,0.0030667519251601576,2019-03-26 11:45:00,2019-03-26 12:00:00
154,1,0,1,0.0023975469065498586,2019-03-26 11:45:00,2019-03-26 12:00:00
157,3,2,1,0.02041669168962089,2019-03-26 11:45:00,2019-03-26 12:00:00
158,5,2,3,0.005535084323822144,2019-03-26 11:45:00,2019-03-26 12:00:00
162,8,4,4,0.015971788472021242,2019-03-26 11:45:00,2019-03-26 12:00:00
164,1,0,1,0.0023975469065498586,2019-03-26 11:45:00,2019-03-26 12:00:00
170,10,5,5,0.015971788472021242,2019-03-26 11:45:00,2019-03-26 12:00:00
189,8,4,4,0.015971788472021242,2019-03-26 11:45:00,2019-03-26 12:00:00
190,1,1,0,0.003966315615186001,2019-03-26 11:45:00,2019-03-26 12:00:00
195,6,3,3,0.015971788472021242,2019-03-26 11:45:00,2019-03-26 12:00:00
201,2,1,1,0.015971788472021242,2019-03-26 11:45:00,2019-03-26 12:00:00
202,6,3,3,0.015971788472021242,2019-03-26 11:45:00,2019-03-26 12:00:00
203,5,2,3,0.005535084323822144,2019-03-26 11:45:00,2019-03-26 12:00:00
5,4,2,2,0.015154369205866849,2019-03-26 12:00:00,2019-03-26 12:15:00
10,4,2,2,0.015154369205866849,2019-03-26 12:00:00,2019-03-26 12:15:00
18,7,4,3,0.026352394565920863,2019-03-26 12:00:00,2019-03-26 12:15:00
20,1,0,1,0.0022745280161564976,2019-03-26 12:00:00,2019-03-26 12:15:00
23,1,0,1,0.0022745280161564976,2019-03-26 12:00:00,2019-03-26 12:15:00
28,4,2,2,0.015154369205866849,2019-03-26 12:00:00,2019-03-26 12:15:00
35,2,2,0,0.003762875577718003,2019-03-26 12:00:00,2019-03-26 12:15:00
37,3,2,1,0.02319035607877313,2019-03-26 12:00:00,2019-03-26 12:15:00
41,5,2,3,0.005251223139279508,2019-03-26 12:00:00,2019-03-26 12:15:00
46,2,1,1,0.015154369205866849,2019-03-26 12:00:00,2019-03-26 12:15:00
57,5,2,3,0.005251223139279508,2019-03-26 12:00:00,2019-03-26 12:15:00
58,13,7,6,0.02190652089995219,2019-03-26 12:00:00,2019-03-26 12:15:00
64,2,1,1,0.015154369205866849,2019-03-26 12:00:00,2019-03-26 12:15:00
66,2,1,1,0.015154369205866849,2019-03-26 12:00:00,2019-03-26 12:15:00
67,2,1,1,0.015154369205866849,2019-03-26 12:00:00,2019-03-26 12:15:00
68,4,2,2,0.015154369205866849,2019-03-26 12:00:00,2019-03-26 12:15:00
69,2,1,1,0.015154369205866849,2019-03-26 12:00:00,2019-03-26 12:15:00
70,2,1,1,0.015154369205866849,2019-03-26 12:00:00,2019-03-26 12:15:00
74,5,3,2,0.025057515272454197,2019-03-26 12:00:00,2019-03-26 12:15:00
85,13,7,6,0.028034210395577203,2019-03-26 12:00:00,2019-03-26 12:15:00
87,13,6,7,0.008402217511781506,2019-03-26 12:00:00,2019-03-26 12:15:00
90,2,1,1,0.015154369205866849,2019-03-26 12:00:00,2019-03-26 12:15:00
109,4,2,2,0.015154369205866849,2019-03-26 12:00:00,2019-03-26 12:15:00
110,10,4,6,0.005251223139279508,2019-03-26 12:00:00,2019-03-26 12:15:00
111,8,4,4,0.015154369205866849,2019-03-26 12:00:00,2019-03-26 12:15:00
112,8,4,4,0.015154369205866849,2019-03-26 12:00:00,2019-03-26 12:15:00
113,4,2,2,0.015154369205866849,2019-03-26 12:00:00,2019-03-26 12:15:00
114,3,1,2,0.003956343845812836,2019-03-26 12:00:00,2019-03-26 12:15:00
115,2,1,1,0.015154369205866849,2019-03-26 12:00:00,2019-03-26 12:15:00
119,9,5,4,0.028034210395577203,2019-03-26 12:00:00,2019-03-26 12:15:00
120,2,1,1,0.003762875577718003,2019-03-26 12:00:00,2019-03-26 12:15:00
126,4,2,2,0.015154369205866849,2019-03-26 12:00:00,2019-03-26 12:15:00
127,2,1,1,0.015154369205866849,2019-03-26 12:00:00,2019-03-26 12:15:00
137,19,9,10,0.009716896789076642,2019-03-26 12:00:00,2019-03-26 12:15:00
138,2,2,0,0.007407509061608554,2019-03-26 12:00:00,2019-03-26 12:15:00
141,2,1,1,0.015154369205866849,2019-03-26 12:00:00,2019-03-26 12:15:00
153,2,1,1,0.015154369205866849,2019-03-26 12:00:00,2019-03-26 12:15:00
157,3,2,1,0.020591841622657064,2019-03-26 12:00:00,2019-03-26 12:15:00
158,5,2,3,0.005251223139279508,2019-03-26 12:00:00,2019-03-26 12:15:00
162,8,4,4,0.015154369205866849,2019-03-26 12:00:00,2019-03-26 12:15:00
164,9,4,5,0.0071183823329605735,2019-03-26 12:00:00,2019-03-26 12:15:00
170,10,5,5,0.015154369205866849,2019-03-26 12:00:00,2019-03-26 12:15:00
189,10,5,5,0.015154369205866849,2019-03-26 12:00:00,2019-03-26 12:15:00
190,1,1,0,0.003762875577718003,2019-03-26 12:00:00,2019-03-26 12:15:00
195,8,4,4,0.015154369205866849,2019-03-26 12:00:00,2019-03-26 12:15:00
201,2,1,1,0.015154369205866849,2019-03-26 12:00:00,2019-03-26 12:15:00
202,2,1,1,0.015154369205866849,2019-03-26 12:00:00,2019-03-26 12:15:00
203,1,0,1,0.0022745280161564976,2019-03-26 12:00:00,2019-03-26 12:15:00
5,8,4,4,0.014741197477650982,2019-03-26 12:15:00,2019-03-26 12:30:00
10,4,2,2,0.014741197477650982,2019-03-26 12:15:00,2019-03-26 12:30:00
16,2,1,1,0.014741197477650982,2019-03-26 12:15:00,2019-03-26 12:30:00
18,6,4,2,0.02981886770713607,2019-03-26 12:15:00,2019-03-26 12:30:00
19,1,0,1,0.002213255952619769,2019-03-26 12:15:00,2019-03-26 12:30:00
20,1,0,1,0.002213255952619769,2019-03-26 12:15:00,2019-03-26 12:30:00
23,2,1,1,0.004094783443808234,2019-03-26 12:15:00,2019-03-26 12:30:00
27,1,1,0,0.004094783443808234,2019-03-26 12:15:00,2019-03-26 12:30:00
28,5,2,3,0.005109288461037017,2019-03-26 12:15:00,2019-03-26 12:30:00
35,2,2,0,0.003661272206828393,2019-03-26 12:15:00,2019-03-26 12:30:00
37,5,3,2,0.008097153918101991,2019-03-26 12:15:00,2019-03-26 12:30:00
41,5,2,3,0.005109288461037017,2019-03-26 12:15:00,2019-03-26 12:30:00
46,2,1,1,0.014741197477650982,2019-03-26 12:15:00,2019-03-26 12:30:00
50,1,0,1,0.002213255952619769,2019-03-26 12:15:00,2019-03-26 12:30:00
57,5,2,3,0.005109288461037017,2019-03-26 12:15:00,2019-03-26 12:30:00
58,15,8,7,0.0190569826528915,2019-03-26 12:15:00,2019-03-26 12:30:00
64,2,1,1,0.014741197477650982,2019-03-26 12:15:00,2019-03-26 12:30:00
66,2,1,1,0.014741197477650982,2019-03-26 12:15:00,2019-03-26 12:30:00
67,2,1,1,0.014741197477650982,2019-03-26 12:15:00,2019-03-26 12:30:00
68,4,2,2,0.014741197477650982,2019-03-26 12:15:00,2019-03-26 12:30:00
69,2,1,1,0.014741197477650982,2019-03-26 12:15:00,2019-03-26 12:30:00
70,2,1,1,0.014741197477650982,2019-03-26 12:15:00,2019-03-26 12:30:00
74,5,3,2,0.02437310649426495,2019-03-26 12:15:00,2019-03-26 12:30:00
85,5,3,2,0.0272691390026822,2019-03-26 12:15:00,2019-03-26 12:30:00
87,14,6,8,0.006109627127169944,2019-03-26 12:15:00,2019-03-26 12:30:00
88,1,1,0,0.0056562961273715785,2019-03-26 12:15:00,2019-03-26 12:30:00
90,2,1,1,0.014741197477650982,2019-03-26 12:15:00,2019-03-26 12:30:00
104,2,1,1,0.014741197477650982,2019-03-26 12:15:00,2019-03-26 12:30:00
109,4,2,2,0.014741197477650982,2019-03-26 12:15:00,2019-03-26 12:30:00
110,10,4,6,0.005109288461037017,2019-03-26 12:15:00,2019-03-26 12:30:00
111,9,5,4,0.0190569826528915,2019-03-26 12:15:00,2019-03-26 12:30:00
112,10,5,5,0.014741197477650982,2019-03-26 12:15:00,2019-03-26 12:30:00
113,4,2,2,0.014741197477650982,2019-03-26 12:15:00,2019-03-26 12:30:00
114,6,2,4,0.003849675051908745,2019-03-26 12:15:00,2019-03-26 12:30:00
115,2,1,1,0.014741197477650982,2019-03-26 12:15:00,2019-03-26 12:30:00
119,9,5,4,0.03791555303652494,2019-03-26 12:15:00,2019-03-26 12:30:00
120,2,1,1,0.00482413535323223,2019-03-26 12:15:00,2019-03-26 12:30:00
126,4,2,2,0.014741197477650982,2019-03-26 12:15:00,2019-03-26 12:30:00
127,2,1,1,0.014741197477650982,2019-03-26 12:15:00,2019-03-26 12:30:00
137,19,9,10,0.009446120400053867,2019-03-26 12:15:00,2019-03-26 12:30:00
138,2,2,0,0.008197869160094943,2019-03-26 12:15:00,2019-03-26 12:30:00
153,2,1,1,0.014741197477650982,2019-03-26 12:15:00,2019-03-26 12:30:00
157,8,4,4,0.008333955975759226,2019-03-26 12:15:00,2019-03-26 12:30:00
158,6,3,3,0.009207364226467691,2019-03-26 12:15:00,2019-03-26 12:30:00
162,8,4,4,0.014741197477650982,2019-03-26 12:15:00,2019-03-26 12:30:00
164,13,6,7,0.008170305171750498,2019-03-26 12:15:00,2019-03-26 12:30:00
170,12,6,6,0.014741197477650982,2019-03-26 12:15:00,2019-03-26 12:30:00
173,3,2,1,0.0201869586905221,2019-03-26 12:15:00,2019-03-26 12:30:00
189,14,7,7,0.014741197477650982,2019-03-26 12:15:00,2019-03-26 12:30:00
190,1,1,0,0.003661272206828393,2019-03-26 12:15:00,2019-03-26 12:30:00
195,8,4,4,0.014741197477650982,2019-03-26 12:15:00,2019-03-26 12:30:00
196,2,1,1,0.014741197477650982,2019-03-26 12:15:00,2019-03-26 12:30:00
201,2,1,1,0.014741197477650982,2019-03-26 12:15:00,2019-03-26 12:30:00
202,5,2,3,0.005109288461037017,2019-03-26 12:15:00,2019-03-26 12:30:00
203,1,0,1,0.002213255952619769,2019-03-26 12:15:00,2019-03-26 12:30:00
1,1,1,0,0.005427502382588641,2019-03-26 12:30:00,2019-03-26 12:45:00
5,2,1,1,0.02183401262962451,2019-03-26 12:30:00,2019-03-26 12:45:00
18,6,4,2,0.022476313238071623,2019-03-26 12:30:00,2019-03-26 12:45:00
19,2,0,2,0.0032813228938629426,2019-03-26 12:30:00,2019-03-26 12:45:00
23,1,1,0,0.006070722993364082,2019-03-26 12:30:00,2019-03-26 12:45:00
27,1,1,0,0.004676022943613512,2019-03-26 12:30:00,2019-03-26 12:45:00
28,1,0,1,0.0032813228938629426,2019-03-26 12:30:00,2019-03-26 12:45:00
37,5,3,2,0.010922377941101713,2019-03-26 12:30:00,2019-03-26 12:45:00
41,2,1,1,0.005205735508552314,2019-03-26 12:30:00,2019-03-26 12:45:00
46,2,1,1,0.02183401262962451,2019-03-26 12:30:00,2019-03-26 12:45:00
50,1,0,1,0.0032813228938629426,2019-03-26 12:30:00,2019-03-26 12:45:00
58,7,4,3,0.040386702365386086,2019-03-26 12:30:00,2019-03-26 12:45:00
74,1,1,0,0.00770680644644953,2019-03-26 12:30:00,2019-03-26 12:45:00
75,1,1,0,0.007923916808760471,2019-03-26 12:30:00,2019-03-26 12:45:00
85,1,1,0,0.006070722993364082,2019-03-26 12:30:00,2019-03-26 12:45:00
87,9,4,5,0.009544281444052383,2019-03-26 12:30:00,2019-03-26 12:45:00
88,1,1,0,0.007923916808760471,2019-03-26 12:30:00,2019-03-26 12:45:00
90,1,1,0,0.004243529201207628,2019-03-26 12:30:00,2019-03-26 12:45:00
104,2,1,1,0.02183401262962451,2019-03-26 12:30:00,2019-03-26 12:45:00
109,2,2,0,0.01049620654595067,2019-03-26 12:30:00,2019-03-26 12:45:00
110,1,0,1,0.0032813228938629426,2019-03-26 12:30:00,2019-03-26 12:45:00
111,1,1,0,0.004904075727342567,2019-03-26 12:30:00,2019-03-26 12:45:00
113,1,0,1,0.0032813228938629426,2019-03-26 12:30:00,2019-03-26 12:45:00
114,3,1,2,0.012835798013662414,2019-03-26 12:30:00,2019-03-26 12:45:00
115,2,1,1,0.013605413965863688,2019-03-26 12:30:00,2019-03-26 12:45:00
120,1,0,1,0.0032813228938629426,2019-03-26 12:30:00,2019-03-26 12:45:00
126,5,2,3,0.00757368187131434,2019-03-26 12:30:00,2019-03-26 12:45:00
127,1,0,1,0.0032813228938629426,2019-03-26 12:30:00,2019-03-26 12:45:00
137,14,6,8,0.009054560737931056,2019-03-26 12:30:00,2019-03-26 12:45:00
138,1,1,0,0.006070722993364082,2019-03-26 12:30:00,2019-03-26 12:45:00
141,2,0,2,0.0032813228938629426,2019-03-26 12:30:00,2019-03-26 12:45:00
147,4,2,2,0.02183401262962451,2019-03-26 12:30:00,2019-03-26 12:45:00
157,7,3,4,0.009054560737931056,2019-03-26 12:30:00,2019-03-26 12:45:00
158,2,1,1,0.005205735508552314,2019-03-26 12:30:00,2019-03-26 12:45:00
162,4,2,2,0.02183401262962451,2019-03-26 12:30:00,2019-03-26 12:45:00
164,3,1,2,0.0057071503677317585,2019-03-26 12:30:00,2019-03-26 12:45:00
168,2,2,0,0.006298775777093136,2019-03-26 12:30:00,2019-03-26 12:45:00
170,7,4,3,0.03645233723923205,2019-03-26 12:30:00,2019-03-26 12:45:00
173,1,1,0,0.00873773796902044,2019-03-26 12:30:00,2019-03-26 12:45:00
189,7,3,4,0.009054560737931056,2019-03-26 12:30:00,2019-03-26 12:45:00
195,2,1,1,0.02183401262962451,2019-03-26 12:30:00,2019-03-26 12:45:00
196,2,1,1,0.02183401262962451,2019-03-26 12:30:00,2019-03-26 12:45:00
202,3,1,2,0.0057071503677317585,2019-03-26 12:30:00,2019-03-26 12:45:00
203,1,0,1,0.0032813228938629426,2019-03-26 12:30:00,2019-03-26 12:45:00
5,2,1,1,0.020432619997575417,2019-03-26 12:45:00,2019-03-26 13:00:00
16,2,1,1,0.004679470521127609,2019-03-26 12:45:00,2019-03-26 13:00:00
18,3,2,1,0.00943717123146128,2019-03-26 12:45:00,2019-03-26 13:00:00
19,5,2,3,0.011373884288456485,2019-03-26 12:45:00,2019-03-26 13:00:00
23,1,1,0,0.005679785884572559,2019-03-26 12:45:00,2019-03-26 13:00:00
27,1,1,0,0.006293296474957353,2019-03-26 12:45:00,2019-03-26 13:00:00
37,2,1,1,0.005679785884572559,2019-03-26 12:45:00,2019-03-26 13:00:00
41,3,2,1,0.006919179648428503,2019-03-26 12:45:00,2019-03-26 13:00:00
46,3,2,1,0.029113933111704467,2019-03-26 12:45:00,2019-03-26 13:00:00
50,1,0,1,0.0030699937693173256,2019-03-26 12:45:00,2019-03-26 13:00:00
57,1,1,0,0.004679470521127609,2019-03-26 12:45:00,2019-03-26 13:00:00
58,7,4,3,0.028506966994832475,2019-03-26 12:45:00,2019-03-26 13:00:00
62,1,0,1,0.0030699937693173256,2019-03-26 12:45:00,2019-03-26 13:00:00
66,1,1,0,0.006702212561437118,2019-03-26 12:45:00,2019-03-26 13:00:00
68,1,1,0,0.006213868525821253,2019-03-26 12:45:00,2019-03-26 13:00:00
74,1,1,0,0.008952256131479784,2019-03-26 12:45:00,2019-03-26 13:00:00
75,1,1,0,0.007898424024748175,2019-03-26 12:45:00,2019-03-26 13:00:00
85,4,1,3,0.005679785884572559,2019-03-26 12:45:00,2019-03-26 13:00:00
87,11,4,7,0.0099008485475325,2019-03-26 12:45:00,2019-03-26 13:00:00
88,1,0,1,0.0030699937693173256,2019-03-26 12:45:00,2019-03-26 13:00:00
90,1,1,0,0.004679470521127609,2019-03-26 12:45:00,2019-03-26 13:00:00
104,2,1,1,0.020432619997575417,2019-03-26 12:45:00,2019-03-26 13:00:00
109,3,2,1,0.00826198941198177,2019-03-26 12:45:00,2019-03-26 13:00:00
111,2,1,1,0.004272511126842375,2019-03-26 12:45:00,2019-03-26 13:00:00
112,2,1,1,0.008352862915234415,2019-03-26 12:45:00,2019-03-26 13:00:00
114,4,1,3,0.011093412272060848,2019-03-26 12:45:00,2019-03-26 13:00:00
115,2,0,2,0.0030699937693173256,2019-03-26 12:45:00,2019-03-26 13:00:00
116,2,0,2,0.0030699937693173256,2019-03-26 12:45:00,2019-03-26 13:00:00
120,1,0,1,0.0030699937693173256,2019-03-26 12:45:00,2019-03-26 13:00:00
126,4,2,2,0.009879019834986234,2019-03-26 12:45:00,2019-03-26 13:00:00
127,4,1,3,0.004283926003061305,2019-03-26 12:45:00,2019-03-26 13:00:00
137,15,9,6,0.10140259735449987,2019-03-26 12:45:00,2019-03-26 13:00:00
138,2,2,0,0.007949461239795529,2019-03-26 12:45:00,2019-03-26 13:00:00
140,1,1,0,0.008920850701612734,2019-03-26 12:45:00,2019-03-26 13:00:00
141,1,0,1,0.0030699937693173256,2019-03-26 12:45:00,2019-03-26 13:00:00
153,1,1,0,0.004374889826944942,2019-03-26 12:45:00,2019-03-26 13:00:00
154,1,0,1,0.0030699937693173256,2019-03-26 12:45:00,2019-03-26 13:00:00
157,6,3,3,0.020432619997575417,2019-03-26 12:45:00,2019-03-26 13:00:00
158,3,1,2,0.005339669124540295,2019-03-26 12:45:00,2019-03-26 13:00:00
162,4,2,2,0.020432619997575417,2019-03-26 12:45:00,2019-03-26 13:00:00
164,1,1,0,0.007269227719731002,2019-03-26 12:45:00,2019-03-26 13:00:00
168,3,2,1,0.006882303242097607,2019-03-26 12:45:00,2019-03-26 13:00:00
170,3,2,1,0.029113933111704463,2019-03-26 12:45:00,2019-03-26 13:00:00
171,1,1,0,0.005339669124540295,2019-03-26 12:45:00,2019-03-26 13:00:00
173,2,1,1,0.006213868525821253,2019-03-26 12:45:00,2019-03-26 13:00:00
189,8,4,4,0.011970882885064729,2019-03-26 12:45:00,2019-03-26 13:00:00
195,3,1,2,0.005339669124540295,2019-03-26 12:45:00,2019-03-26 13:00:00
202,1,0,1,0.0030699937693173256,2019-03-26 12:45:00,2019-03-26 13:00:00
203,1,0,1,0.0030699937693173256,2019-03-26 12:45:00,2019-03-26 13:00:00
1,1,0,1,0.003280048796716184,2019-03-26 13:00:00,2019-03-26 13:15:00
2,1,1,0,0.006068330768062851,2019-03-26 13:00:00,2019-03-26 13:15:00
5,2,1,1,0.02180234889602595,2019-03-26 13:00:00,2019-03-26 13:15:00
10,2,1,1,0.004674189782389517,2019-03-26 13:00:00,2019-03-26 13:15:00
16,2,1,1,0.004281731981840561,2019-03-26 13:00:00,2019-03-26 13:15:00
18,3,3,0,0.008953565713780977,2019-03-26 13:00:00,2019-03-26 13:15:00
19,4,2,2,0.013368220231523058,2019-03-26 13:00:00,2019-03-26 13:15:00
20,2,0,2,0.003280048796716184,2019-03-26 13:00:00,2019-03-26 13:15:00
27,1,1,0,0.008962300039647732,2019-03-26 13:00:00,2019-03-26 13:15:00
28,1,0,1,0.003280048796716184,2019-03-26 13:00:00,2019-03-26 13:15:00
37,5,2,3,0.008507038917817077,2019-03-26 13:00:00,2019-03-26 13:15:00
41,5,4,1,0.014435537446686832,2019-03-26 13:00:00,2019-03-26 13:15:00
46,3,2,1,0.04032464899533574,2019-03-26 13:00:00,2019-03-26 13:15:00
57,1,1,0,0.004281731981840561,2019-03-26 13:00:00,2019-03-26 13:15:00
58,8,4,4,0.015741960674567707,2019-03-26 13:00:00,2019-03-26 13:15:00
61,1,1,0,0.006068330768062851,2019-03-26 13:00:00,2019-03-26 13:15:00
66,1,1,0,0.01153809978281051,2019-03-26 13:00:00,2019-03-26 13:15:00
68,1,1,0,0.004674189782389517,2019-03-26 13:00:00,2019-03-26 13:15:00
74,1,1,0,0.015552109767494524,2019-03-26 13:00:00,2019-03-26 13:15:00
75,1,1,0,0.005690702394081295,2019-03-26 13:00:00,2019-03-26 13:15:00
79,1,1,0,0.006068330768062851,2019-03-26 13:00:00,2019-03-26 13:15:00
85,8,2,6,0.007070013953187227,2019-03-26 13:00:00,2019-03-26 13:15:00
86,1,0,1,0.003280048796716184,2019-03-26 13:00:00,2019-03-26 13:15:00
87,11,6,5,0.023984798983176233,2019-03-26 13:00:00,2019-03-26 13:15:00
90,1,1,0,0.004281731981840561,2019-03-26 13:00:00,2019-03-26 13:15:00
104,2,1,1,0.02180234889602595,2019-03-26 13:00:00,2019-03-26 13:15:00
109,5,2,3,0.008314002762386224,2019-03-26 13:00:00,2019-03-26 13:15:00
111,3,2,1,0.009713992891822933,2019-03-26 13:00:00,2019-03-26 13:15:00
112,3,2,1,0.007070013953187227,2019-03-26 13:00:00,2019-03-26 13:15:00
114,2,0,2,0.003280048796716184,2019-03-26 13:00:00,2019-03-26 13:15:00
115,1,0,1,0.003280048796716184,2019-03-26 13:00:00,2019-03-26 13:15:00
116,1,1,0,0.006068330768062851,2019-03-26 13:00:00,2019-03-26 13:15:00
120,2,0,2,0.003280048796716184,2019-03-26 13:00:00,2019-03-26 13:15:00
126,1,1,0,0.006068330768062851,2019-03-26 13:00:00,2019-03-26 13:15:00
127,3,1,2,0.005704861579344386,2019-03-26 13:00:00,2019-03-26 13:15:00
135,1,1,0,0.006068330768062851,2019-03-26 13:00:00,2019-03-26 13:15:00
137,19,10,9,0.026087276219693558,2019-03-26 13:00:00,2019-03-26 13:15:00
138,5,3,2,0.031063498945680834,2019-03-26 13:00:00,2019-03-26 13:15:00
140,2,2,0,0.007138428596437655,2019-03-26 13:00:00,2019-03-26 13:15:00
151,1,0,1,0.003280048796716184,2019-03-26 13:00:00,2019-03-26 13:15:00
153,1,0,1,0.003280048796716184,2019-03-26 13:00:00,2019-03-26 13:15:00
154,3,1,2,0.006625748495123958,2019-03-26 13:00:00,2019-03-26 13:15:00
157,7,3,4,0.00905056127775216,2019-03-26 13:00:00,2019-03-26 13:15:00
158,2,2,0,0.006068330768062851,2019-03-26 13:00:00,2019-03-26 13:15:00
162,4,2,2,0.02180234889602595,2019-03-26 13:00:00,2019-03-26 13:15:00
164,3,1,2,0.005704861579344386,2019-03-26 13:00:00,2019-03-26 13:15:00
168,2,0,2,0.003280048796716184,2019-03-26 13:00:00,2019-03-26 13:15:00
171,1,1,0,0.005704861579344386,2019-03-26 13:00:00,2019-03-26 13:15:00
173,1,0,1,0.003280048796716184,2019-03-26 13:00:00,2019-03-26 13:15:00
189,7,3,4,0.010603557290757824,2019-03-26 13:00:00,2019-03-26 13:15:00
191,2,0,2,0.003280048796716184,2019-03-26 13:00:00,2019-03-26 13:15:00
195,2,1,1,0.02180234889602595,2019-03-26 13:00:00,2019-03-26 13:15:00
202,1,0,1,0.003280048796716184,2019-03-26 13:00:00,2019-03-26 13:15:00
203,1,0,1,0.003280048796716184,2019-03-26 13:00:00,2019-03-26 13:15:00
2,1,1,0,0.006091384801198311,2019-03-26 13:15:00,2019-03-26 13:30:00
5,3,2,1,0.02997746419041355,2019-03-26 13:15:00,2019-03-26 13:30:00
10,4,3,1,0.005391661794096178,2019-03-26 13:15:00,2019-03-26 13:30:00
18,4,3,1,0.01323082252465704,2019-03-26 13:15:00,2019-03-26 13:30:00
19,3,1,2,0.005544155847454059,2019-03-26 13:15:00,2019-03-26 13:30:00
20,4,0,4,0.003292492772789784,2019-03-26 13:15:00,2019-03-26 13:30:00
27,1,1,0,0.005649043781108613,2019-03-26 13:15:00,2019-03-26 13:30:00
35,3,1,2,0.005726565498702142,2019-03-26 13:15:00,2019-03-26 13:30:00
37,2,1,1,0.006091384801198311,2019-03-26 13:15:00,2019-03-26 13:30:00
40,1,0,1,0.003292492772789784,2019-03-26 13:15:00,2019-03-26 13:30:00
41,5,4,1,0.012262786941192786,2019-03-26 13:15:00,2019-03-26 13:30:00
46,2,1,1,0.021893831293176413,2019-03-26 13:15:00,2019-03-26 13:30:00
58,7,3,4,0.009085242600635753,2019-03-26 13:15:00,2019-03-26 13:30:00
70,2,1,1,0.021893831293176413,2019-03-26 13:15:00,2019-03-26 13:30:00
74,1,1,0,0.013717329781501414,2019-03-26 13:15:00,2019-03-26 13:30:00
79,1,1,0,0.006091384801198311,2019-03-26 13:15:00,2019-03-26 13:30:00
85,7,3,4,0.01059471095052686,2019-03-26 13:15:00,2019-03-26 13:30:00
86,1,0,1,0.003292492772789784,2019-03-26 13:15:00,2019-03-26 13:30:00
87,4,2,2,0.008160638224614502,2019-03-26 13:15:00,2019-03-26 13:30:00
104,2,1,1,0.021893831293176413,2019-03-26 13:15:00,2019-03-26 13:30:00
109,3,1,2,0.005726565498702142,2019-03-26 13:15:00,2019-03-26 13:30:00
111,2,2,0,0.018009223355496432,2019-03-26 13:15:00,2019-03-26 13:30:00
112,2,2,0,0.007900706855772889,2019-03-26 13:15:00,2019-03-26 13:30:00
114,1,0,1,0.003292492772789784,2019-03-26 13:15:00,2019-03-26 13:30:00
118,1,0,1,0.003292492772789784,2019-03-26 13:15:00,2019-03-26 13:30:00
119,1,1,0,0.005726565498702142,2019-03-26 13:15:00,2019-03-26 13:30:00
120,2,0,2,0.003292492772789784,2019-03-26 13:15:00,2019-03-26 13:30:00
122,1,1,0,0.006091384801198311,2019-03-26 13:15:00,2019-03-26 13:30:00
126,3,1,2,0.005726565498702142,2019-03-26 13:15:00,2019-03-26 13:30:00
127,1,1,0,0.004509529135745963,2019-03-26 13:15:00,2019-03-26 13:30:00
135,2,2,0,0.008890276829606837,2019-03-26 13:15:00,2019-03-26 13:30:00
137,18,8,10,0.021685705209090397,2019-03-26 13:15:00,2019-03-26 13:30:00
138,7,4,3,0.031194500553369718,2019-03-26 13:15:00,2019-03-26 13:30:00
140,1,1,0,0.005136079729064592,2019-03-26 13:15:00,2019-03-26 13:30:00
147,2,1,1,0.021893831293176413,2019-03-26 13:15:00,2019-03-26 13:30:00
151,1,0,1,0.003292492772789784,2019-03-26 13:15:00,2019-03-26 13:30:00
154,1,0,1,0.003292492772789784,2019-03-26 13:15:00,2019-03-26 13:30:00
157,9,5,4,0.022138396403119417,2019-03-26 13:15:00,2019-03-26 13:30:00
158,2,2,0,0.005726565498702142,2019-03-26 13:15:00,2019-03-26 13:30:00
162,4,2,2,0.021893831293176413,2019-03-26 13:15:00,2019-03-26 13:30:00
164,1,0,1,0.003292492772789784,2019-03-26 13:15:00,2019-03-26 13:30:00
168,1,1,0,0.005136079729064592,2019-03-26 13:15:00,2019-03-26 13:30:00
170,2,1,1,0.021893831293176413,2019-03-26 13:15:00,2019-03-26 13:30:00
171,1,1,0,0.006091384801198311,2019-03-26 13:15:00,2019-03-26 13:30:00
189,5,2,3,0.007599409525695653,2019-03-26 13:15:00,2019-03-26 13:30:00
191,5,1,4,0.005726565498702142,2019-03-26 13:15:00,2019-03-26 13:30:00
195,3,1,2,0.005726565498702142,2019-03-26 13:15:00,2019-03-26 13:30:00
196,1,1,0,0.005726565498702142,2019-03-26 13:15:00,2019-03-26 13:30:00
197,1,0,1,0.003292492772789784,2019-03-26 13:15:00,2019-03-26 13:30:00
202,1,0,1,0.003292492772789784,2019-03-26 13:15:00,2019-03-26 13:30:00
203,1,0,1,0.003292492772789784,2019-03-26 13:15:00,2019-03-26 13:30:00
2,2,1,1,0.005013138059200317,2019-03-26 13:30:00,2019-03-26 13:45:00
5,2,1,1,0.021978882821152308,2019-03-26 13:30:00,2019-03-26 13:45:00
10,5,2,3,0.007623972257937574,2019-03-26 13:30:00,2019-03-26 13:45:00
16,2,1,1,0.004609140542648177,2019-03-26 13:30:00,2019-03-26 13:45:00
18,2,1,1,0.00611096773177625,2019-03-26 13:30:00,2019-03-26 13:45:00
19,4,3,1,0.011254931273824414,2019-03-26 13:30:00,2019-03-26 13:45:00
21,1,0,1,0.0033030653935665804,2019-03-26 13:30:00,2019-03-26 13:45:00
27,1,1,0,0.00611096773177625,2019-03-26 13:30:00,2019-03-26 13:45:00
35,4,1,3,0.004609140542648177,2019-03-26 13:30:00,2019-03-26 13:45:00
37,2,1,1,0.00611096773177625,2019-03-26 13:30:00,2019-03-26 13:45:00
40,1,0,1,0.0033030653935665804,2019-03-26 13:30:00,2019-03-26 13:45:00
41,1,0,1,0.0033030653935665804,2019-03-26 13:30:00,2019-03-26 13:45:00
46,2,1,1,0.021978882821152308,2019-03-26 13:30:00,2019-03-26 13:45:00
58,8,3,5,0.006741928087006686,2019-03-26 13:30:00,2019-03-26 13:45:00
61,2,1,1,0.021978882821152308,2019-03-26 13:30:00,2019-03-26 13:45:00
64,1,1,0,0.007564744922536307,2019-03-26 13:30:00,2019-03-26 13:45:00
66,1,1,0,0.005745003449663147,2019-03-26 13:30:00,2019-03-26 13:45:00
74,1,1,0,0.00611096773177625,2019-03-26 13:30:00,2019-03-26 13:45:00
85,5,3,2,0.010928219411791909,2019-03-26 13:30:00,2019-03-26 13:45:00
87,3,1,2,0.005745003449663147,2019-03-26 13:30:00,2019-03-26 13:45:00
90,2,2,0,0.008625242009916205,2019-03-26 13:30:00,2019-03-26 13:45:00
104,2,1,1,0.021978882821152308,2019-03-26 13:30:00,2019-03-26 13:45:00
109,3,1,2,0.005745003449663147,2019-03-26 13:30:00,2019-03-26 13:45:00
110,2,1,1,0.021978882821152308,2019-03-26 13:30:00,2019-03-26 13:45:00
111,2,2,0,0.010939933658192905,2019-03-26 13:30:00,2019-03-26 13:45:00
112,2,2,0,0.01751635127617515,2019-03-26 13:30:00,2019-03-26 13:45:00
114,1,0,1,0.0033030653935665804,2019-03-26 13:30:00,2019-03-26 13:45:00
115,2,1,1,0.021978882821152308,2019-03-26 13:30:00,2019-03-26 13:45:00
116,1,0,1,0.0033030653935665804,2019-03-26 13:30:00,2019-03-26 13:45:00
119,1,1,0,0.004609140542648177,2019-03-26 13:30:00,2019-03-26 13:45:00
120,2,0,2,0.0033030653935665804,2019-03-26 13:30:00,2019-03-26 13:45:00
122,2,1,1,0.00611096773177625,2019-03-26 13:30:00,2019-03-26 13:45:00
126,1,0,1,0.0033030653935665804,2019-03-26 13:30:00,2019-03-26 13:45:00
127,1,1,0,0.00849799560209634,2019-03-26 13:30:00,2019-03-26 13:45:00
135,1,1,0,0.00611096773177625,2019-03-26 13:30:00,2019-03-26 13:45:00
137,15,6,9,0.007623972257937574,2019-03-26 13:30:00,2019-03-26 13:45:00
138,1,1,0,0.004707016562671415,2019-03-26 13:30:00,2019-03-26 13:45:00
140,1,0,1,0.0033030653935665804,2019-03-26 13:30:00,2019-03-26 13:45:00
157,8,5,3,0.04827317761581084,2019-03-26 13:30:00,2019-03-26 13:45:00
162,4,2,2,0.021978882821152308,2019-03-26 13:30:00,2019-03-26 13:45:00
168,2,2,0,0.009218146746158172,2019-03-26 13:30:00,2019-03-26 13:45:00
189,4,2,2,0.021978882821152308,2019-03-26 13:30:00,2019-03-26 13:45:00
191,2,1,1,0.00611096773177625,2019-03-26 13:30:00,2019-03-26 13:45:00
195,3,1,2,0.005745003449663147,2019-03-26 13:30:00,2019-03-26 13:45:00
196,1,1,0,0.005745003449663147,2019-03-26 13:30:00,2019-03-26 13:45:00
197,1,0,1,0.0033030653935665804,2019-03-26 13:30:00,2019-03-26 13:45:00
199,2,1,1,0.021978882821152308,2019-03-26 13:30:00,2019-03-26 13:45:00
203,3,1,2,0.004023216537628413,2019-03-26 13:30:00,2019-03-26 13:45:00
1,4,2,2,0.012542831177429822,2019-03-26 13:45:00,2019-03-26 14:00:00
2,1,0,1,0.003469691785868751,2019-03-26 13:45:00,2019-03-26 14:00:00
5,2,1,1,0.023077153816014443,2019-03-26 13:45:00,2019-03-26 14:00:00
10,3,1,2,0.006034806374744233,2019-03-26 13:45:00,2019-03-26 14:00:00
16,1,0,1,0.003469691785868751,2019-03-26 13:45:00,2019-03-26 14:00:00
19,3,3,0,0.009603985742925963,2019-03-26 13:45:00,2019-03-26 14:00:00
23,1,1,0,0.0049444655498478455,2019-03-26 13:45:00,2019-03-26 14:00:00
26,1,1,0,0.008508769963236355,2019-03-26 13:45:00,2019-03-26 14:00:00
35,1,1,0,0.004452874295188147,2019-03-26 13:45:00,2019-03-26 14:00:00
37,1,1,0,0.0049444655498478455,2019-03-26 13:45:00,2019-03-26 14:00:00
41,1,0,1,0.003469691785868751,2019-03-26 13:45:00,2019-03-26 14:00:00
46,3,1,2,0.006034806374744233,2019-03-26 13:45:00,2019-03-26 14:00:00
58,9,4,5,0.012318023187352136,2019-03-26 13:45:00,2019-03-26 14:00:00
61,1,1,0,0.007211039595210754,2019-03-26 13:45:00,2019-03-26 14:00:00
62,1,1,0,0.00641923931382694,2019-03-26 13:45:00,2019-03-26 14:00:00
64,1,1,0,0.00641923931382694,2019-03-26 13:45:00,2019-03-26 14:00:00
74,1,1,0,0.00641923931382694,2019-03-26 13:45:00,2019-03-26 14:00:00
85,4,3,1,0.01048266998311512,2019-03-26 13:45:00,2019-03-26 14:00:00
87,3,1,2,0.006034806374744233,2019-03-26 13:45:00,2019-03-26 14:00:00
88,2,2,0,0.016777829516218947,2019-03-26 13:45:00,2019-03-26 14:00:00
89,1,1,0,0.004071744684364885,2019-03-26 13:45:00,2019-03-26 14:00:00
90,4,3,1,0.04922043652287536,2019-03-26 13:45:00,2019-03-26 14:00:00
104,2,1,1,0.023077153816014443,2019-03-26 13:45:00,2019-03-26 14:00:00
110,2,0,2,0.003469691785868751,2019-03-26 13:45:00,2019-03-26 14:00:00
111,3,2,1,0.014946201978960088,2019-03-26 13:45:00,2019-03-26 14:00:00
112,1,1,0,0.00641923931382694,2019-03-26 13:45:00,2019-03-26 14:00:00
114,1,0,1,0.003469691785868751,2019-03-26 13:45:00,2019-03-26 14:00:00
115,2,1,1,0.023077153816014443,2019-03-26 13:45:00,2019-03-26 14:00:00
116,2,0,2,0.003469691785868751,2019-03-26 13:45:00,2019-03-26 14:00:00
118,1,0,1,0.003469691785868751,2019-03-26 13:45:00,2019-03-26 14:00:00
120,3,0,3,0.003469691785868751,2019-03-26 13:45:00,2019-03-26 14:00:00
122,1,0,1,0.003469691785868751,2019-03-26 13:45:00,2019-03-26 14:00:00
137,16,6,10,0.007082009176845551,2019-03-26 13:45:00,2019-03-26 14:00:00
138,3,2,1,0.005927648059167241,2019-03-26 13:45:00,2019-03-26 14:00:00
140,2,0,2,0.003469691785868751,2019-03-26 13:45:00,2019-03-26 14:00:00
157,6,3,3,0.023077153816014443,2019-03-26 13:45:00,2019-03-26 14:00:00
158,1,1,0,0.005564097390071385,2019-03-26 13:45:00,2019-03-26 14:00:00
162,4,2,2,0.023077153816014443,2019-03-26 13:45:00,2019-03-26 14:00:00
189,4,2,2,0.023077153816014443,2019-03-26 13:45:00,2019-03-26 14:00:00
195,2,1,1,0.023077153816014443,2019-03-26 13:45:00,2019-03-26 14:00:00
196,2,2,0,0.00641923931382694,2019-03-26 13:45:00,2019-03-26 14:00:00
199,3,1,2,0.00880148336808782,2019-03-26 13:45:00,2019-03-26 14:00:00
203,2,1,1,0.004071744684364885,2019-03-26 13:45:00,2019-03-26 14:00:00
1,1,0,1,0.00314675273738297,2019-03-26 14:00:00,2019-03-26 14:15:00
2,1,0,1,0.00314675273738297,2019-03-26 14:00:00,2019-03-26 14:15:00
5,3,2,1,0.038294373587289224,2019-03-26 14:00:00,2019-03-26 14:15:00
10,8,4,4,0.012290498362938478,2019-03-26 14:00:00,2019-03-26 14:15:00
19,2,2,0,0.008434009748560949,2019-03-26 14:00:00,2019-03-26 14:15:00
21,2,0,2,0.00314675273738297,2019-03-26 14:00:00,2019-03-26 14:15:00
22,2,1,1,0.020938116878935018,2019-03-26 14:00:00,2019-03-26 14:15:00
23,1,1,0,0.004484288247399416,2019-03-26 14:00:00,2019-03-26 14:15:00
26,2,2,0,0.010043427051036675,2019-03-26 14:00:00,2019-03-26 14:15:00
30,3,1,2,0.0054732229117870485,2019-03-26 14:00:00,2019-03-26 14:15:00
37,1,0,1,0.00314675273738297,2019-03-26 14:00:00,2019-03-26 14:15:00
41,1,0,1,0.00314675273738297,2019-03-26 14:00:00,2019-03-26 14:15:00
46,3,1,2,0.0054732229117870485,2019-03-26 14:00:00,2019-03-26 14:15:00
57,2,2,0,0.0071658989201115065,2019-03-26 14:00:00,2019-03-26 14:15:00
58,9,6,3,0.06754406350240547,2019-03-26 14:00:00,2019-03-26 14:15:00
62,2,1,1,0.005821823757415862,2019-03-26 14:00:00,2019-03-26 14:15:00
66,4,2,2,0.020938116878935018,2019-03-26 14:00:00,2019-03-26 14:15:00
68,2,1,1,0.005821823757415862,2019-03-26 14:00:00,2019-03-26 14:15:00
70,1,1,0,0.004484288247399416,2019-03-26 14:00:00,2019-03-26 14:15:00
74,1,1,0,0.005821823757415862,2019-03-26 14:00:00,2019-03-26 14:15:00
85,4,2,2,0.013469201924402983,2019-03-26 14:00:00,2019-03-26 14:15:00
87,3,1,2,0.0054732229117870485,2019-03-26 14:00:00,2019-03-26 14:15:00
88,3,3,0,0.010416723804484863,2019-03-26 14:00:00,2019-03-26 14:15:00
89,1,1,0,0.004069621472290982,2019-03-26 14:00:00,2019-03-26 14:15:00
90,3,2,1,0.0268685715927857,2019-03-26 14:00:00,2019-03-26 14:15:00
104,2,1,1,0.020938116878935018,2019-03-26 14:00:00,2019-03-26 14:15:00
109,9,4,5,0.011818839268919664,2019-03-26 14:00:00,2019-03-26 14:15:00
110,2,0,2,0.00314675273738297,2019-03-26 14:00:00,2019-03-26 14:15:00
111,5,2,3,0.011198664715900055,2019-03-26 14:00:00,2019-03-26 14:15:00
112,1,0,1,0.00314675273738297,2019-03-26 14:00:00,2019-03-26 14:15:00
114,1,0,1,0.00314675273738297,2019-03-26 14:00:00,2019-03-26 14:15:00
116,2,0,2,0.00314675273738297,2019-03-26 14:00:00,2019-03-26 14:15:00
120,3,0,3,0.00314675273738297,2019-03-26 14:00:00,2019-03-26 14:15:00
126,2,2,0,0.01382142530458895,2019-03-26 14:00:00,2019-03-26 14:15:00
137,14,6,8,0.008683965146831046,2019-03-26 14:00:00,2019-03-26 14:15:00
138,3,2,1,0.00537597858741038,2019-03-26 14:00:00,2019-03-26 14:15:00
140,1,0,1,0.00314675273738297,2019-03-26 14:00:00,2019-03-26 14:15:00
151,1,1,0,0.004484288247399416,2019-03-26 14:00:00,2019-03-26 14:15:00
153,1,0,1,0.00314675273738297,2019-03-26 14:00:00,2019-03-26 14:15:00
154,1,1,0,0.004038443077393934,2019-03-26 14:00:00,2019-03-26 14:15:00
157,4,1,3,0.004391055360615411,2019-03-26 14:00:00,2019-03-26 14:15:00
158,1,0,1,0.00314675273738297,2019-03-26 14:00:00,2019-03-26 14:15:00
162,4,2,2,0.020938116878935018,2019-03-26 14:00:00,2019-03-26 14:15:00
164,1,1,0,0.008095983500475943,2019-03-26 14:00:00,2019-03-26 14:15:00
168,1,0,1,0.00314675273738297,2019-03-26 14:00:00,2019-03-26 14:15:00
170,3,1,2,0.0054732229117870485,2019-03-26 14:00:00,2019-03-26 14:15:00
171,2,1,1,0.020938116878935018,2019-03-26 14:00:00,2019-03-26 14:15:00
173,1,1,0,0.005821823757415862,2019-03-26 14:00:00,2019-03-26 14:15:00
189,4,2,2,0.020938116878935018,2019-03-26 14:00:00,2019-03-26 14:15:00
195,3,1,2,0.0054732229117870485,2019-03-26 14:00:00,2019-03-26 14:15:00
196,2,2,0,0.005821823757415862,2019-03-26 14:00:00,2019-03-26 14:15:00
197,1,1,0,0.004391055360615411,2019-03-26 14:00:00,2019-03-26 14:15:00
199,1,1,0,0.005821823757415862,2019-03-26 14:00:00,2019-03-26 14:15:00
203,3,2,1,0.008995374923512801,2019-03-26 14:00:00,2019-03-26 14:15:00
1,1,0,1,0.00326187363134406,2019-03-26 14:15:00,2019-03-26 14:30:00
2,1,0,1,0.00326187363134406,2019-03-26 14:15:00,2019-03-26 14:30:00
5,3,2,1,0.05265762715222131,2019-03-26 14:15:00,2019-03-26 14:30:00
10,3,2,1,0.005476016597719887,2019-03-26 14:15:00,2019-03-26 14:30:00
16,2,1,1,0.004551702558345184,2019-03-26 14:15:00,2019-03-26 14:30:00
19,5,2,3,0.005560435829890049,2019-03-26 14:15:00,2019-03-26 14:30:00
21,4,0,4,0.00326187363134406,2019-03-26 14:15:00,2019-03-26 14:30:00
22,2,1,1,0.021704748084551223,2019-03-26 14:15:00,2019-03-26 14:30:00
26,1,1,0,0.005673468157912109,2019-03-26 14:15:00,2019-03-26 14:30:00
28,3,3,0,0.007988998568885422,2019-03-26 14:15:00,2019-03-26 14:30:00
30,3,1,2,0.005673468157912109,2019-03-26 14:15:00,2019-03-26 14:30:00
37,3,0,3,0.00326187363134406,2019-03-26 14:15:00,2019-03-26 14:30:00
41,2,0,2,0.00326187363134406,2019-03-26 14:15:00,2019-03-26 14:30:00
46,2,1,1,0.021704748084551223,2019-03-26 14:15:00,2019-03-26 14:30:00
57,2,2,0,0.008048913109493384,2019-03-26 14:15:00,2019-03-26 14:30:00
58,7,4,3,0.037615578814004985,2019-03-26 14:15:00,2019-03-26 14:30:00
62,3,2,1,0.030926185311154812,2019-03-26 14:15:00,2019-03-26 14:30:00
64,2,1,1,0.021704748084551223,2019-03-26 14:15:00,2019-03-26 14:30:00
67,1,1,0,0.003955109160875088,2019-03-26 14:15:00,2019-03-26 14:30:00
70,1,1,0,0.003955109160875088,2019-03-26 14:15:00,2019-03-26 14:30:00
74,2,1,1,0.004648344690406115,2019-03-26 14:15:00,2019-03-26 14:30:00
85,4,2,2,0.013215374966692155,2019-03-26 14:15:00,2019-03-26 14:30:00
87,3,1,2,0.005673468157912109,2019-03-26 14:15:00,2019-03-26 14:30:00
88,2,2,0,0.006682201429456974,2019-03-26 14:15:00,2019-03-26 14:30:00
104,4,3,1,0.03707381012889053,2019-03-26 14:15:00,2019-03-26 14:30:00
109,5,2,3,0.008446410276036218,2019-03-26 14:15:00,2019-03-26 14:30:00
110,1,0,1,0.00326187363134406,2019-03-26 14:15:00,2019-03-26 14:30:00
111,3,1,2,0.005673468157912109,2019-03-26 14:15:00,2019-03-26 14:30:00
114,2,0,2,0.00326187363134406,2019-03-26 14:15:00,2019-03-26 14:30:00
119,4,1,3,0.004551702558345184,2019-03-26 14:15:00,2019-03-26 14:30:00
120,2,0,2,0.00326187363134406,2019-03-26 14:15:00,2019-03-26 14:30:00
122,1,1,0,0.004186187670718763,2019-03-26 14:15:00,2019-03-26 14:30:00
126,2,2,0,0.010265825247577447,2019-03-26 14:15:00,2019-03-26 14:30:00
137,12,5,7,0.008305539989068385,2019-03-26 14:15:00,2019-03-26 14:30:00
138,1,1,0,0.004648344690406115,2019-03-26 14:15:00,2019-03-26 14:30:00
141,1,1,0,0.007131360412347432,2019-03-26 14:15:00,2019-03-26 14:30:00
147,1,1,0,0.0072135008315121155,2019-03-26 14:15:00,2019-03-26 14:30:00
151,2,2,0,0.004648344690406115,2019-03-26 14:15:00,2019-03-26 14:30:00
154,2,2,0,0.010265825247577447,2019-03-26 14:15:00,2019-03-26 14:30:00
157,4,1,3,0.004551702558345184,2019-03-26 14:15:00,2019-03-26 14:30:00
164,1,1,0,0.004648344690406115,2019-03-26 14:15:00,2019-03-26 14:30:00
168,1,0,1,0.00326187363134406,2019-03-26 14:15:00,2019-03-26 14:30:00
170,2,1,1,0.021704748084551223,2019-03-26 14:15:00,2019-03-26 14:30:00
189,6,3,3,0.021704748084551223,2019-03-26 14:15:00,2019-03-26 14:30:00
195,3,1,2,0.005673468157912109,2019-03-26 14:15:00,2019-03-26 14:30:00
196,2,0,2,0.00326187363134406,2019-03-26 14:15:00,2019-03-26 14:30:00
197,1,1,0,0.004551702558345184,2019-03-26 14:15:00,2019-03-26 14:30:00
199,2,2,0,0.007421286808530223,2019-03-26 14:15:00,2019-03-26 14:30:00
203,3,2,1,0.008446410276036218,2019-03-26 14:15:00,2019-03-26 14:30:00
1,1,0,1,0.0033543624301633434,2019-03-26 14:30:00,2019-03-26 14:45:00
2,3,1,2,0.005834116929151029,2019-03-26 14:30:00,2019-03-26 14:45:00
5,2,1,1,0.022291115087308203,2019-03-26 14:30:00,2019-03-26 14:45:00
10,8,3,5,0.007879604356317457,2019-03-26 14:30:00,2019-03-26 14:45:00
16,2,1,1,0.004593443967858157,2019-03-26 14:30:00,2019-03-26 14:45:00
18,2,2,0,0.012160475830351436,2019-03-26 14:30:00,2019-03-26 14:45:00
19,6,3,3,0.0064423529834848805,2019-03-26 14:30:00,2019-03-26 14:45:00
20,1,1,0,0.004593443967858157,2019-03-26 14:30:00,2019-03-26 14:45:00
21,2,0,2,0.0033543624301633434,2019-03-26 14:30:00,2019-03-26 14:45:00
23,1,0,1,0.0033543624301633434,2019-03-26 14:30:00,2019-03-26 14:45:00
28,4,3,1,0.008830937499688803,2019-03-26 14:30:00,2019-03-26 14:45:00
30,2,1,1,0.022291115087308203,2019-03-26 14:30:00,2019-03-26 14:45:00
37,6,2,4,0.008685573866863335,2019-03-26 14:30:00,2019-03-26 14:45:00
40,1,0,1,0.0033543624301633434,2019-03-26 14:30:00,2019-03-26 14:45:00
41,2,0,2,0.0033543624301633434,2019-03-26 14:30:00,2019-03-26 14:45:00
46,3,2,1,0.031096331934800155,2019-03-26 14:30:00,2019-03-26 14:45:00
50,2,2,0,0.014681854633309517,2019-03-26 14:30:00,2019-03-26 14:45:00
57,1,0,1,0.0033543624301633434,2019-03-26 14:30:00,2019-03-26 14:45:00
58,5,2,3,0.007742041333759921,2019-03-26 14:30:00,2019-03-26 14:45:00
61,1,1,0,0.010861496598493845,2019-03-26 14:30:00,2019-03-26 14:45:00
62,1,0,1,0.0033543624301633434,2019-03-26 14:30:00,2019-03-26 14:45:00
64,6,3,3,0.022291115087308203,2019-03-26 14:30:00,2019-03-26 14:45:00
67,1,1,0,0.004780090899019496,2019-03-26 14:30:00,2019-03-26 14:45:00
68,1,0,1,0.0033543624301633434,2019-03-26 14:30:00,2019-03-26 14:45:00
69,1,1,0,0.005386089164083337,2019-03-26 14:30:00,2019-03-26 14:45:00
74,3,1,2,0.004780090899019496,2019-03-26 14:30:00,2019-03-26 14:45:00
85,2,1,1,0.012211252224600082,2019-03-26 14:30:00,2019-03-26 14:45:00
87,4,1,3,0.004680681392324294,2019-03-26 14:30:00,2019-03-26 14:45:00
88,2,2,0,0.005709463754549536,2019-03-26 14:30:00,2019-03-26 14:45:00
90,8,4,4,0.01434943162921538,2019-03-26 14:30:00,2019-03-26 14:45:00
104,4,3,1,0.04400931442481735,2019-03-26 14:30:00,2019-03-26 14:45:00
109,2,1,1,0.008798578791913064,2019-03-26 14:30:00,2019-03-26 14:45:00
110,2,1,1,0.006404093658328128,2019-03-26 14:30:00,2019-03-26 14:45:00
111,3,2,1,0.008309601411001089,2019-03-26 14:30:00,2019-03-26 14:45:00
114,3,2,1,0.009057276305587954,2019-03-26 14:30:00,2019-03-26 14:45:00
116,1,1,0,0.011830397695597213,2019-03-26 14:30:00,2019-03-26 14:45:00
119,5,2,3,0.0043728140498203606,2019-03-26 14:30:00,2019-03-26 14:45:00
120,1,0,1,0.0033543624301633434,2019-03-26 14:30:00,2019-03-26 14:45:00
126,6,3,3,0.029910884803022196,2019-03-26 14:30:00,2019-03-26 14:45:00
127,1,1,0,0.004680681392324294,2019-03-26 14:30:00,2019-03-26 14:45:00
133,1,1,0,0.005834116929151029,2019-03-26 14:30:00,2019-03-26 14:45:00
137,13,4,9,0.005391265669477377,2019-03-26 14:30:00,2019-03-26 14:45:00
138,1,1,0,0.006205819367875649,2019-03-26 14:30:00,2019-03-26 14:45:00
147,1,1,0,0.005386089164083337,2019-03-26 14:30:00,2019-03-26 14:45:00
151,1,1,0,0.004780090899019496,2019-03-26 14:30:00,2019-03-26 14:45:00
153,2,2,0,0.006033728841759772,2019-03-26 14:30:00,2019-03-26 14:45:00
157,3,1,2,0.005834116929151029,2019-03-26 14:30:00,2019-03-26 14:45:00
158,4,1,3,0.004680681392324294,2019-03-26 14:30:00,2019-03-26 14:45:00
164,1,1,0,0.004780090899019496,2019-03-26 14:30:00,2019-03-26 14:45:00
172,1,1,0,0.006205819367875649,2019-03-26 14:30:00,2019-03-26 14:45:00
189,6,3,3,0.012806041919315224,2019-03-26 14:30:00,2019-03-26 14:45:00
191,1,1,0,0.003863588239991852,2019-03-26 14:30:00,2019-03-26 14:45:00
196,2,0,2,0.0033543624301633434,2019-03-26 14:30:00,2019-03-26 14:45:00
199,2,2,0,0.007631547836731801,2019-03-26 14:30:00,2019-03-26 14:45:00
201,1,1,0,0.0072591589677806455,2019-03-26 14:30:00,2019-03-26 14:45:00
203,2,1,1,0.010418455521384594,2019-03-26 14:30:00,2019-03-26 14:45:00
1,1,0,1,0.0031827137870564077,2019-03-26 14:45:00,2019-03-26 15:00:00
2,2,0,2,0.0031827137870564077,2019-03-26 14:45:00,2019-03-26 15:00:00
5,2,1,1,0.021166219238475066,2019-03-26 14:45:00,2019-03-26 15:00:00
10,5,1,4,0.004041655716878006,2019-03-26 14:45:00,2019-03-26 15:00:00
19,2,2,0,0.010818248852157222,2019-03-26 14:45:00,2019-03-26 15:00:00
20,1,1,0,0.00884671884697458,2019-03-26 14:45:00,2019-03-26 15:00:00
21,1,0,1,0.0031827137870564077,2019-03-26 14:45:00,2019-03-26 15:00:00
23,1,0,1,0.0031827137870564077,2019-03-26 14:45:00,2019-03-26 15:00:00
27,3,1,2,0.0055356355938313145,2019-03-26 14:45:00,2019-03-26 15:00:00
30,3,2,1,0.03914972468989373,2019-03-26 14:45:00,2019-03-26 15:00:00
35,1,1,0,0.005888287682048615,2019-03-26 14:45:00,2019-03-26 15:00:00
37,7,2,5,0.009044031597538454,2019-03-26 14:45:00,2019-03-26 15:00:00
40,5,3,2,0.010606805266297028,2019-03-26 14:45:00,2019-03-26 15:00:00
41,3,1,2,0.00511050427507319,2019-03-26 14:45:00,2019-03-26 15:00:00
46,4,2,2,0.010241479207381127,2019-03-26 14:45:00,2019-03-26 15:00:00
57,1,0,1,0.0031827137870564077,2019-03-26 14:45:00,2019-03-26 15:00:00
58,3,1,2,0.0055356355938313145,2019-03-26 14:45:00,2019-03-26 15:00:00
62,1,0,1,0.0031827137870564077,2019-03-26 14:45:00,2019-03-26 15:00:00
64,4,2,2,0.021166219238475066,2019-03-26 14:45:00,2019-03-26 15:00:00
68,2,1,1,0.00472041233757055,2019-03-26 14:45:00,2019-03-26 15:00:00
69,1,1,0,0.007734906590503462,2019-03-26 14:45:00,2019-03-26 15:00:00
70,3,2,1,0.05007446472098767,2019-03-26 14:45:00,2019-03-26 15:00:00
74,2,1,1,0.005354916510102762,2019-03-26 14:45:00,2019-03-26 15:00:00
85,2,1,1,0.007038294763089974,2019-03-26 14:45:00,2019-03-26 15:00:00
87,5,1,4,0.004041655716878006,2019-03-26 14:45:00,2019-03-26 15:00:00
88,1,1,0,0.005888287682048615,2019-03-26 14:45:00,2019-03-26 15:00:00
89,1,0,1,0.0031827137870564077,2019-03-26 14:45:00,2019-03-26 15:00:00
90,2,1,1,0.00472041233757055,2019-03-26 14:45:00,2019-03-26 15:00:00
104,3,2,1,0.03137473125705223,2019-03-26 14:45:00,2019-03-26 15:00:00
109,1,1,0,0.00472041233757055,2019-03-26 14:45:00,2019-03-26 15:00:00
110,2,1,1,0.00789949163238797,2019-03-26 14:45:00,2019-03-26 15:00:00
111,3,3,0,0.016421235069593615,2019-03-26 14:45:00,2019-03-26 15:00:00
112,1,0,1,0.0031827137870564077,2019-03-26 14:45:00,2019-03-26 15:00:00
114,2,2,0,0.009901125841203808,2019-03-26 14:45:00,2019-03-26 15:00:00
115,1,0,1,0.0031827137870564077,2019-03-26 14:45:00,2019-03-26 15:00:00
119,6,4,2,0.013325053131987837,2019-03-26 14:45:00,2019-03-26 15:00:00
120,1,0,1,0.0031827137870564077,2019-03-26 14:45:00,2019-03-26 15:00:00
122,1,0,1,0.0031827137870564077,2019-03-26 14:45:00,2019-03-26 15:00:00
126,1,1,0,0.005888287682048615,2019-03-26 14:45:00,2019-03-26 15:00:00
127,1,1,0,0.004041655716878006,2019-03-26 14:45:00,2019-03-26 15:00:00
137,19,9,10,0.027825447962055366,2019-03-26 14:45:00,2019-03-26 15:00:00
138,1,1,0,0.005888287682048615,2019-03-26 14:45:00,2019-03-26 15:00:00
140,1,1,0,0.004041655716878006,2019-03-26 14:45:00,2019-03-26 15:00:00
141,3,1,2,0.004535500734552511,2019-03-26 14:45:00,2019-03-26 15:00:00
147,1,1,0,0.005888287682048615,2019-03-26 14:45:00,2019-03-26 15:00:00
153,2,2,0,0.004900597646699603,2019-03-26 14:45:00,2019-03-26 15:00:00
154,2,1,1,0.021166219238475066,2019-03-26 14:45:00,2019-03-26 15:00:00
156,1,1,0,0.005888287682048615,2019-03-26 14:45:00,2019-03-26 15:00:00
157,4,2,2,0.01594254391952883,2019-03-26 14:45:00,2019-03-26 15:00:00
158,1,0,1,0.0031827137870564077,2019-03-26 14:45:00,2019-03-26 15:00:00
160,1,1,0,0.0055356355938313145,2019-03-26 14:45:00,2019-03-26 15:00:00
164,3,1,2,0.0055356355938313145,2019-03-26 14:45:00,2019-03-26 15:00:00
168,3,3,0,0.00969402462325927,2019-03-26 14:45:00,2019-03-26 15:00:00
170,2,0,2,0.0031827137870564077,2019-03-26 14:45:00,2019-03-26 15:00:00
172,2,2,0,0.00806049040509497,2019-03-26 14:45:00,2019-03-26 15:00:00
189,6,3,3,0.012777286270216544,2019-03-26 14:45:00,2019-03-26 15:00:00
190,1,0,1,0.0031827137870564077,2019-03-26 14:45:00,2019-03-26 15:00:00
191,2,1,1,0.005548309564529915,2019-03-26 14:45:00,2019-03-26 15:00:00
195,1,0,1,0.0031827137870564077,2019-03-26 14:45:00,2019-03-26 15:00:00
196,1,0,1,0.0031827137870564077,2019-03-26 14:45:00,2019-03-26 15:00:00
199,1,1,0,0.005888287682048615,2019-03-26 14:45:00,2019-03-26 15:00:00
203,2,1,1,0.004535500734552511,2019-03-26 14:45:00,2019-03-26 15:00:00
1,3,2,1,0.006828342129261379,2019-03-26 15:00:00,2019-03-26 15:15:00
2,1,0,1,0.0033105443093889484,2019-03-26 15:00:00,2019-03-26 15:15:00
5,2,1,1,0.022017384658970327,2019-03-26 15:00:00,2019-03-26 15:15:00
10,4,0,4,0.0033105443093889484,2019-03-26 15:00:00,2019-03-26 15:15:00
19,2,1,1,0.004445111981886294,2019-03-26 15:00:00,2019-03-26 15:15:00
21,1,0,1,0.0033105443093889484,2019-03-26 15:00:00,2019-03-26 15:15:00
23,1,0,1,0.0033105443093889484,2019-03-26 15:00:00,2019-03-26 15:15:00
27,1,0,1,0.0033105443093889484,2019-03-26 15:00:00,2019-03-26 15:15:00
30,2,0,2,0.0033105443093889484,2019-03-26 15:00:00,2019-03-26 15:15:00
37,3,1,2,0.006124782565286893,2019-03-26 15:00:00,2019-03-26 15:15:00
40,3,3,0,0.012536509230602993,2019-03-26 15:00:00,2019-03-26 15:15:00
41,4,2,2,0.011244753891330521,2019-03-26 15:00:00,2019-03-26 15:15:00
46,3,2,1,0.039317105880602735,2019-03-26 15:00:00,2019-03-26 15:15:00
58,3,2,1,0.047128535136002854,2019-03-26 15:00:00,2019-03-26 15:15:00
62,1,0,1,0.0033105443093889484,2019-03-26 15:00:00,2019-03-26 15:15:00
64,4,2,2,0.022017384658970327,2019-03-26 15:00:00,2019-03-26 15:15:00
68,1,1,0,0.005913857423404058,2019-03-26 15:00:00,2019-03-26 15:15:00
69,1,0,1,0.0033105443093889484,2019-03-26 15:00:00,2019-03-26 15:15:00
71,1,1,0,0.010188164164551025,2019-03-26 15:00:00,2019-03-26 15:15:00
74,2,1,1,0.00809020926038368,2019-03-26 15:00:00,2019-03-26 15:15:00
85,1,1,0,0.008517170537419167,2019-03-26 15:00:00,2019-03-26 15:15:00
87,5,1,4,0.004203983854713208,2019-03-26 15:00:00,2019-03-26 15:15:00
89,1,1,0,0.006124782565286893,2019-03-26 15:00:00,2019-03-26 15:15:00
90,1,0,1,0.0033105443093889484,2019-03-26 15:00:00,2019-03-26 15:15:00
104,2,1,1,0.022017384658970327,2019-03-26 15:00:00,2019-03-26 15:15:00
109,6,2,4,0.005338551527210553,2019-03-26 15:00:00,2019-03-26 15:15:00
110,6,4,2,0.016551212039232314,2019-03-26 15:00:00,2019-03-26 15:15:00
111,2,2,0,0.010606804068809563,2019-03-26 15:00:00,2019-03-26 15:15:00
113,1,0,1,0.0033105443093889484,2019-03-26 15:00:00,2019-03-26 15:15:00
114,1,1,0,0.006124782565286893,2019-03-26 15:00:00,2019-03-26 15:15:00
116,1,0,1,0.0033105443093889484,2019-03-26 15:00:00,2019-03-26 15:15:00
119,3,2,1,0.007531901693235865,2019-03-26 15:00:00,2019-03-26 15:15:00
120,2,1,1,0.004203983854713208,2019-03-26 15:00:00,2019-03-26 15:15:00
122,1,0,1,0.0033105443093889484,2019-03-26 15:00:00,2019-03-26 15:15:00
126,1,1,0,0.006124782565286893,2019-03-26 15:00:00,2019-03-26 15:15:00
137,16,7,9,0.02388374535066112,2019-03-26 15:00:00,2019-03-26 15:15:00
138,1,1,0,0.006884302490685985,2019-03-26 15:00:00,2019-03-26 15:15:00
140,1,0,1,0.0033105443093889484,2019-03-26 15:00:00,2019-03-26 15:15:00
141,3,2,1,0.006022666280888375,2019-03-26 15:00:00,2019-03-26 15:15:00
153,2,2,0,0.004717663437337921,2019-03-26 15:00:00,2019-03-26 15:15:00
154,1,0,1,0.0033105443093889484,2019-03-26 15:00:00,2019-03-26 15:15:00
156,3,3,0,0.00800094140255219,2019-03-26 15:00:00,2019-03-26 15:15:00
157,2,1,1,0.022017384658970327,2019-03-26 15:00:00,2019-03-26 15:15:00
160,2,2,0,0.008939020821184838,2019-03-26 15:00:00,2019-03-26 15:15:00
164,2,1,1,0.004888098608391029,2019-03-26 15:00:00,2019-03-26 15:15:00
168,1,1,0,0.004888098608391029,2019-03-26 15:00:00,2019-03-26 15:15:00
170,4,1,3,0.005566812157353768,2019-03-26 15:00:00,2019-03-26 15:15:00
172,3,3,0,0.013109029301608021,2019-03-26 15:00:00,2019-03-26 15:15:00
173,2,1,1,0.004248623728021597,2019-03-26 15:00:00,2019-03-26 15:15:00
189,4,2,2,0.022017384658970327,2019-03-26 15:00:00,2019-03-26 15:15:00
190,1,1,0,0.004014103873363434,2019-03-26 15:00:00,2019-03-26 15:15:00
191,1,0,1,0.0033105443093889484,2019-03-26 15:00:00,2019-03-26 15:15:00
195,3,0,3,0.0033105443093889484,2019-03-26 15:00:00,2019-03-26 15:15:00
199,1,1,0,0.009115267530452236,2019-03-26 15:00:00,2019-03-26 15:15:00
201,1,1,0,0.006124782565286893,2019-03-26 15:00:00,2019-03-26 15:15:00
202,1,0,1,0.0033105443093889484,2019-03-26 15:00:00,2019-03-26 15:15:00
203,2,1,1,0.006124782565286893,2019-03-26 15:00:00,2019-03-26 15:15:00
1,2,1,1,0.004429721712400116,2019-03-26 15:15:00,2019-03-26 15:30:00
5,2,1,1,0.021099199247727907,2019-03-26 15:15:00,2019-03-26 15:30:00
10,4,1,3,0.004429721712400116,2019-03-26 15:15:00,2019-03-26 15:30:00
15,1,1,0,0.011967947636171029,2019-03-26 15:15:00,2019-03-26 15:30:00
16,1,1,0,0.004523801282455322,2019-03-26 15:15:00,2019-03-26 15:30:00
18,2,2,0,0.011748205757419165,2019-03-26 15:15:00,2019-03-26 15:30:00
19,6,3,3,0.012088984898363794,2019-03-26 15:15:00,2019-03-26 15:30:00
20,2,1,1,0.010343706768071538,2019-03-26 15:15:00,2019-03-26 15:30:00
21,1,0,1,0.0031745149187905417,2019-03-26 15:15:00,2019-03-26 15:30:00
26,1,0,1,0.0031745149187905417,2019-03-26 15:15:00,2019-03-26 15:30:00
27,2,1,1,0.005250729538445102,2019-03-26 15:15:00,2019-03-26 15:30:00
28,2,2,0,0.01148370973979721,2019-03-26 15:15:00,2019-03-26 15:30:00
30,1,0,1,0.0031745149187905417,2019-03-26 15:15:00,2019-03-26 15:30:00
35,2,1,1,0.021099199247727907,2019-03-26 15:15:00,2019-03-26 15:30:00
37,1,0,1,0.0031745149187905417,2019-03-26 15:15:00,2019-03-26 15:30:00
40,3,1,2,0.005521314514223087,2019-03-26 15:15:00,2019-03-26 15:30:00
41,5,3,2,0.01686628202797677,2019-03-26 15:15:00,2019-03-26 15:30:00
46,3,2,1,0.03902388357666527,2019-03-26 15:15:00,2019-03-26 15:30:00
58,4,2,2,0.011479799053277258,2019-03-26 15:15:00,2019-03-26 15:30:00
61,1,1,0,0.004523801282455322,2019-03-26 15:15:00,2019-03-26 15:30:00
62,2,0,2,0.0031745149187905417,2019-03-26 15:15:00,2019-03-26 15:30:00
64,2,1,1,0.021099199247727907,2019-03-26 15:15:00,2019-03-26 15:30:00
67,1,1,0,0.00610565915791737,2019-03-26 15:15:00,2019-03-26 15:30:00
68,2,1,1,0.006600174386303735,2019-03-26 15:15:00,2019-03-26 15:30:00
69,1,0,1,0.0031745149187905417,2019-03-26 15:15:00,2019-03-26 15:30:00
70,2,1,1,0.008899551570962658,2019-03-26 15:15:00,2019-03-26 15:30:00
71,1,1,0,0.00610565915791737,2019-03-26 15:15:00,2019-03-26 15:30:00
74,4,1,3,0.010343706768071538,2019-03-26 15:15:00,2019-03-26 15:30:00
80,1,1,0,0.006957365439847679,2019-03-26 15:15:00,2019-03-26 15:30:00
85,2,1,1,0.0058730876461201035,2019-03-26 15:15:00,2019-03-26 15:30:00
87,6,1,5,0.003824788001347793,2019-03-26 15:15:00,2019-03-26 15:30:00
90,1,1,0,0.004212622228617822,2019-03-26 15:15:00,2019-03-26 15:30:00
104,5,2,3,0.007326944158099662,2019-03-26 15:15:00,2019-03-26 15:30:00
109,8,3,5,0.007859633313947526,2019-03-26 15:15:00,2019-03-26 15:30:00
110,1,1,0,0.004510787504060711,2019-03-26 15:15:00,2019-03-26 15:30:00
111,2,2,0,0.008817388329738324,2019-03-26 15:15:00,2019-03-26 15:30:00
112,2,0,2,0.0031745149187905417,2019-03-26 15:15:00,2019-03-26 15:30:00
113,1,1,0,0.006600174386303735,2019-03-26 15:15:00,2019-03-26 15:30:00
114,2,1,1,0.004523801282455322,2019-03-26 15:15:00,2019-03-26 15:30:00
119,2,1,1,0.0058730876461201035,2019-03-26 15:15:00,2019-03-26 15:30:00
120,3,2,1,0.007956975818528724,2019-03-26 15:15:00,2019-03-26 15:30:00
122,1,0,1,0.0031745149187905417,2019-03-26 15:15:00,2019-03-26 15:30:00
126,4,3,1,0.01341912271223274,2019-03-26 15:15:00,2019-03-26 15:30:00
127,1,1,0,0.008785356091092156,2019-03-26 15:15:00,2019-03-26 15:30:00
137,10,4,6,0.007326944158099662,2019-03-26 15:15:00,2019-03-26 15:30:00
138,6,3,3,0.02020309314156314,2019-03-26 15:15:00,2019-03-26 15:30:00
141,2,1,1,0.004510787504060711,2019-03-26 15:15:00,2019-03-26 15:30:00
147,1,1,0,0.00610565915791737,2019-03-26 15:15:00,2019-03-26 15:30:00
153,4,1,3,0.014582196110695625,2019-03-26 15:15:00,2019-03-26 15:30:00
154,3,1,2,0.005521314514223087,2019-03-26 15:15:00,2019-03-26 15:30:00
156,2,2,0,0.007222374009784885,2019-03-26 15:15:00,2019-03-26 15:30:00
157,3,2,1,0.029969912516306103,2019-03-26 15:15:00,2019-03-26 15:30:00
158,2,2,0,0.009304165035280225,2019-03-26 15:15:00,2019-03-26 15:30:00
160,1,1,0,0.0058730876461201035,2019-03-26 15:15:00,2019-03-26 15:30:00
162,1,1,0,0.004523801282455322,2019-03-26 15:15:00,2019-03-26 15:30:00
164,3,1,2,0.008899551570962658,2019-03-26 15:15:00,2019-03-26 15:30:00
170,2,1,1,0.004212622228617822,2019-03-26 15:15:00,2019-03-26 15:30:00
173,1,1,0,0.004523801282455322,2019-03-26 15:15:00,2019-03-26 15:30:00
177,1,1,0,0.003824788001347793,2019-03-26 15:15:00,2019-03-26 15:30:00
189,4,2,2,0.021099199247727907,2019-03-26 15:15:00,2019-03-26 15:30:00
190,2,1,1,0.004429721712400116,2019-03-26 15:15:00,2019-03-26 15:30:00
195,2,0,2,0.0031745149187905417,2019-03-26 15:15:00,2019-03-26 15:30:00
196,1,0,1,0.0031745149187905417,2019-03-26 15:15:00,2019-03-26 15:30:00
199,1,1,0,0.006940135299619264,2019-03-26 15:15:00,2019-03-26 15:30:00
203,1,0,1,0.0031745149187905417,2019-03-26 15:15:00,2019-03-26 15:30:00
1,1,0,1,0.0027756364112129367,2019-03-26 15:30:00,2019-03-26 15:45:00
2,8,4,4,0.008961193393237045,2019-03-26 15:30:00,2019-03-26 15:45:00
5,3,1,2,0.004827585963647254,2019-03-26 15:30:00,2019-03-26 15:45:00
10,4,2,2,0.01846969030643687,2019-03-26 15:30:00,2019-03-26 15:45:00
15,5,5,0,0.010984978093341724,2019-03-26 15:30:00,2019-03-26 15:45:00
16,1,0,1,0.0027756364112129367,2019-03-26 15:30:00,2019-03-26 15:45:00
18,5,3,2,0.008223632954136004,2019-03-26 15:30:00,2019-03-26 15:45:00
19,6,4,2,0.018311786814213884,2019-03-26 15:30:00,2019-03-26 15:45:00
20,1,0,1,0.0027756364112129367,2019-03-26 15:30:00,2019-03-26 15:45:00
21,1,0,1,0.0027756364112129367,2019-03-26 15:30:00,2019-03-26 15:45:00
23,1,1,0,0.006645851666921369,2019-03-26 15:30:00,2019-03-26 15:45:00
26,5,0,5,0.0027756364112129367,2019-03-26 15:30:00,2019-03-26 15:45:00
27,2,1,1,0.009521110290808902,2019-03-26 15:30:00,2019-03-26 15:45:00
28,1,1,0,0.010870191026398338,2019-03-26 15:30:00,2019-03-26 15:45:00
30,1,0,1,0.0027756364112129367,2019-03-26 15:30:00,2019-03-26 15:45:00
40,2,0,2,0.0027756364112129367,2019-03-26 15:30:00,2019-03-26 15:45:00
41,5,3,2,0.005521483689523754,2019-03-26 15:30:00,2019-03-26 15:45:00
46,4,3,1,0.04209013051202242,2019-03-26 15:30:00,2019-03-26 15:45:00
50,2,1,1,0.005536304681110042,2019-03-26 15:30:00,2019-03-26 15:45:00
58,6,2,4,0.011788197390504837,2019-03-26 15:30:00,2019-03-26 15:45:00
61,1,1,0,0.0037939354270905734,2019-03-26 15:30:00,2019-03-26 15:45:00
62,2,1,1,0.003247537820799526,2019-03-26 15:30:00,2019-03-26 15:45:00
64,2,1,1,0.01846969030643687,2019-03-26 15:30:00,2019-03-26 15:45:00
66,4,1,3,0.006271107104109822,2019-03-26 15:30:00,2019-03-26 15:45:00
67,2,2,0,0.004861816017588657,2019-03-26 15:30:00,2019-03-26 15:45:00
68,5,3,2,0.014932748425272958,2019-03-26 15:30:00,2019-03-26 15:45:00
69,2,2,0,0.00603700694182462,2019-03-26 15:30:00,2019-03-26 15:45:00
70,4,2,2,0.006562629666942375,2019-03-26 15:30:00,2019-03-26 15:45:00
71,2,2,0,0.004882590898761949,2019-03-26 15:30:00,2019-03-26 15:45:00
74,5,1,4,0.005122520106436981,2019-03-26 15:30:00,2019-03-26 15:45:00
79,1,1,0,0.005135143459145883,2019-03-26 15:30:00,2019-03-26 15:45:00
80,1,1,0,0.0035621387605239184,2019-03-26 15:30:00,2019-03-26 15:45:00
85,4,2,2,0.008931485068515887,2019-03-26 15:30:00,2019-03-26 15:45:00
87,4,1,3,0.003873135019793081,2019-03-26 15:30:00,2019-03-26 15:45:00
88,3,1,2,0.005506231573301294,2019-03-26 15:30:00,2019-03-26 15:45:00
89,2,1,1,0.00455267029521496,2019-03-26 15:30:00,2019-03-26 15:45:00
90,1,1,0,0.005506231573301294,2019-03-26 15:30:00,2019-03-26 15:45:00
104,4,2,2,0.015868552759013256,2019-03-26 15:30:00,2019-03-26 15:45:00
109,8,3,5,0.011844425389173715,2019-03-26 15:30:00,2019-03-26 15:45:00
110,3,1,2,0.004827585963647254,2019-03-26 15:30:00,2019-03-26 15:45:00
111,4,3,1,0.01173391887044371,2019-03-26 15:30:00,2019-03-26 15:45:00
112,6,2,4,0.0047914595617949175,2019-03-26 15:30:00,2019-03-26 15:45:00
113,1,1,0,0.010559382779593816,2019-03-26 15:30:00,2019-03-26 15:45:00
114,2,0,2,0.0027756364112129367,2019-03-26 15:30:00,2019-03-26 15:45:00
115,3,1,2,0.004827585963647254,2019-03-26 15:30:00,2019-03-26 15:45:00
116,1,1,0,0.00395538993517941,2019-03-26 15:30:00,2019-03-26 15:45:00
119,2,1,1,0.005135143459145883,2019-03-26 15:30:00,2019-03-26 15:45:00
120,4,2,2,0.0038161074404395256,2019-03-26 15:30:00,2019-03-26 15:45:00
122,2,1,1,0.004680188268692109,2019-03-26 15:30:00,2019-03-26 15:45:00
126,3,3,0,0.004288008850026115,2019-03-26 15:30:00,2019-03-26 15:45:00
127,2,1,1,0.009123078879417292,2019-03-26 15:30:00,2019-03-26 15:45:00
133,1,1,0,0.005280969902329813,2019-03-26 15:30:00,2019-03-26 15:45:00
137,15,8,7,0.02248297065763957,2019-03-26 15:30:00,2019-03-26 15:45:00
138,11,4,7,0.008213950310809993,2019-03-26 15:30:00,2019-03-26 15:45:00
147,2,2,0,0.004882590898761949,2019-03-26 15:30:00,2019-03-26 15:45:00
151,1,1,0,0.005135143459145883,2019-03-26 15:30:00,2019-03-26 15:45:00
153,6,1,5,0.0033442060308529363,2019-03-26 15:30:00,2019-03-26 15:45:00
154,3,2,1,0.031844354721683364,2019-03-26 15:30:00,2019-03-26 15:45:00
157,3,2,1,0.031844354721683364,2019-03-26 15:30:00,2019-03-26 15:45:00
158,4,3,1,0.005739416419194736,2019-03-26 15:30:00,2019-03-26 15:45:00
159,1,1,0,0.0038642918828843127,2019-03-26 15:30:00,2019-03-26 15:45:00
162,2,2,0,0.01551137093349866,2019-03-26 15:30:00,2019-03-26 15:45:00
164,3,0,3,0.0027756364112129367,2019-03-26 15:30:00,2019-03-26 15:45:00
168,2,1,1,0.007654664788000908,2019-03-26 15:30:00,2019-03-26 15:45:00
170,5,0,5,0.0027756364112129367,2019-03-26 15:30:00,2019-03-26 15:45:00
173,2,1,1,0.003247537820799526,2019-03-26 15:30:00,2019-03-26 15:45:00
177,2,2,0,0.004345036429379671,2019-03-26 15:30:00,2019-03-26 15:45:00
189,5,3,2,0.03511503415918333,2019-03-26 15:30:00,2019-03-26 15:45:00
190,1,0,1,0.0027756364112129367,2019-03-26 15:30:00,2019-03-26 15:45:00
195,1,0,1,0.0027756364112129367,2019-03-26 15:30:00,2019-03-26 15:45:00
196,1,1,0,0.004397641071295015,2019-03-26 15:30:00,2019-03-26 15:45:00
199,3,2,1,0.034163744201660795,2019-03-26 15:30:00,2019-03-26 15:45:00
202,1,1,0,0.004789495008959134,2019-03-26 15:30:00,2019-03-26 15:45:00
203,1,0,1,0.0027756364112129367,2019-03-26 15:30:00,2019-03-26 15:45:00
1,1,1,0,0.005861650514928242,2019-03-26 15:45:00,2019-03-26 16:00:00
2,7,3,4,0.006328516617972405,2019-03-26 15:45:00,2019-03-26 16:00:00
5,3,1,2,0.005219309392050026,2019-03-26 15:45:00,2019-03-26 16:00:00
15,3,3,0,0.008655436447587164,2019-03-26 15:45:00,2019-03-26 16:00:00
16,2,2,0,0.006857806414685145,2019-03-26 15:45:00,2019-03-26 16:00:00
18,3,2,1,0.011213294853908956,2019-03-26 15:45:00,2019-03-26 16:00:00
19,4,4,0,0.014952919832214289,2019-03-26 15:45:00,2019-03-26 16:00:00
20,1,0,1,0.003000894940205268,2019-03-26 15:45:00,2019-03-26 16:00:00
21,2,0,2,0.003000894940205268,2019-03-26 15:45:00,2019-03-26 16:00:00
23,2,2,0,0.006827343572825166,2019-03-26 15:45:00,2019-03-26 16:00:00
26,7,0,7,0.003000894940205268,2019-03-26 15:45:00,2019-03-26 16:00:00
27,1,1,0,0.007358399153851326,2019-03-26 15:45:00,2019-03-26 16:00:00
28,2,2,0,0.0051829336814176894,2019-03-26 15:45:00,2019-03-26 16:00:00
30,1,0,1,0.003000894940205268,2019-03-26 15:45:00,2019-03-26 16:00:00
37,1,0,1,0.003000894940205268,2019-03-26 15:45:00,2019-03-26 16:00:00
40,2,1,1,0.006659617842021622,2019-03-26 15:45:00,2019-03-26 16:00:00
41,6,3,3,0.008205558168510731,2019-03-26 15:45:00,2019-03-26 16:00:00
46,7,4,3,0.019055555376535357,2019-03-26 15:45:00,2019-03-26 16:00:00
50,2,1,1,0.008339969072072573,2019-03-26 15:45:00,2019-03-26 16:00:00
58,5,2,3,0.013193524749084293,2019-03-26 15:45:00,2019-03-26 16:00:00
61,1,0,1,0.003000894940205268,2019-03-26 15:45:00,2019-03-26 16:00:00
62,2,1,1,0.003365318619502401,2019-03-26 15:45:00,2019-03-26 16:00:00
64,2,1,1,0.019900959698587073,2019-03-26 15:45:00,2019-03-26 16:00:00
66,4,1,3,0.012533376439948118,2019-03-26 15:45:00,2019-03-26 16:00:00
67,2,1,1,0.005386879256532426,2019-03-26 15:45:00,2019-03-26 16:00:00
68,2,1,1,0.0043068406596052135,2019-03-26 15:45:00,2019-03-26 16:00:00
69,2,2,0,0.010507016759529078,2019-03-26 15:45:00,2019-03-26 16:00:00
70,2,1,1,0.008400785048538507,2019-03-26 15:45:00,2019-03-26 16:00:00
71,1,1,0,0.004187439317481393,2019-03-26 15:45:00,2019-03-26 16:00:00
74,2,1,1,0.005326023358928646,2019-03-26 15:45:00,2019-03-26 16:00:00
79,1,1,0,0.0055518606952852,2019-03-26 15:45:00,2019-03-26 16:00:00
80,1,1,0,0.00863868215139011,2019-03-26 15:45:00,2019-03-26 16:00:00
85,6,3,3,0.012813952298479227,2019-03-26 15:45:00,2019-03-26 16:00:00
87,6,2,4,0.007050157417056032,2019-03-26 15:45:00,2019-03-26 16:00:00
88,5,2,3,0.012911207113248786,2019-03-26 15:45:00,2019-03-26 16:00:00
89,1,0,1,0.003000894940205268,2019-03-26 15:45:00,2019-03-26 16:00:00
104,6,3,3,0.015377142153739767,2019-03-26 15:45:00,2019-03-26 16:00:00
106,1,1,0,0.0055518606952852,2019-03-26 15:45:00,2019-03-26 16:00:00
108,1,0,1,0.003000894940205268,2019-03-26 15:45:00,2019-03-26 16:00:00
109,7,1,6,0.009216910088899327,2019-03-26 15:45:00,2019-03-26 16:00:00
110,1,0,1,0.003000894940205268,2019-03-26 15:45:00,2019-03-26 16:00:00
111,4,2,2,0.009218686154557322,2019-03-26 15:45:00,2019-03-26 16:00:00
112,4,1,3,0.004187439317481393,2019-03-26 15:45:00,2019-03-26 16:00:00
113,1,0,1,0.003000894940205268,2019-03-26 15:45:00,2019-03-26 16:00:00
114,2,0,2,0.003000894940205268,2019-03-26 15:45:00,2019-03-26 16:00:00
115,5,2,3,0.006926117883514852,2019-03-26 15:45:00,2019-03-26 16:00:00
116,1,1,0,0.004276377817745234,2019-03-26 15:45:00,2019-03-26 16:00:00
118,1,0,1,0.003000894940205268,2019-03-26 15:45:00,2019-03-26 16:00:00
119,2,1,1,0.0055518606952852,2019-03-26 15:45:00,2019-03-26 16:00:00
120,3,1,2,0.008400785048538507,2019-03-26 15:45:00,2019-03-26 16:00:00
122,2,1,1,0.004345835059703845,2019-03-26 15:45:00,2019-03-26 16:00:00
126,4,2,2,0.004276377817745234,2019-03-26 15:45:00,2019-03-26 16:00:00
133,1,1,0,0.006739472825520346,2019-03-26 15:45:00,2019-03-26 16:00:00
137,15,9,6,0.04387010506204181,2019-03-26 15:45:00,2019-03-26 16:00:00
138,10,5,5,0.014033264740893434,2019-03-26 15:45:00,2019-03-26 16:00:00
141,1,0,1,0.003000894940205268,2019-03-26 15:45:00,2019-03-26 16:00:00
147,2,2,0,0.008766825187072742,2019-03-26 15:45:00,2019-03-26 16:00:00
151,1,1,0,0.004276377817745234,2019-03-26 15:45:00,2019-03-26 16:00:00
153,6,2,4,0.006485047699190033,2019-03-26 15:45:00,2019-03-26 16:00:00
154,1,1,0,0.0043068406596052135,2019-03-26 15:45:00,2019-03-26 16:00:00
157,2,1,1,0.019900959698587073,2019-03-26 15:45:00,2019-03-26 16:00:00
158,2,1,1,0.003638636378975251,2019-03-26 15:45:00,2019-03-26 16:00:00
159,1,1,0,0.007528443197278805,2019-03-26 15:45:00,2019-03-26 16:00:00
162,2,2,0,0.01250592748768448,2019-03-26 15:45:00,2019-03-26 16:00:00
164,2,1,1,0.006631940741802282,2019-03-26 15:45:00,2019-03-26 16:00:00
168,3,2,1,0.007592289601431355,2019-03-26 15:45:00,2019-03-26 16:00:00
170,4,0,4,0.003000894940205268,2019-03-26 15:45:00,2019-03-26 16:00:00
172,5,2,3,0.007431961522227847,2019-03-26 15:45:00,2019-03-26 16:00:00
173,4,3,1,0.006280708053879466,2019-03-26 15:45:00,2019-03-26 16:00:00
175,1,1,0,0.004345835059703845,2019-03-26 15:45:00,2019-03-26 16:00:00
177,2,2,0,0.004863615341273233,2019-03-26 15:45:00,2019-03-26 16:00:00
189,5,3,2,0.04461115981650544,2019-03-26 15:45:00,2019-03-26 16:00:00
190,1,0,1,0.003000894940205268,2019-03-26 15:45:00,2019-03-26 16:00:00
191,2,2,0,0.007204494318447715,2019-03-26 15:45:00,2019-03-26 16:00:00
195,1,1,0,0.0043068406596052135,2019-03-26 15:45:00,2019-03-26 16:00:00
196,2,1,1,0.006571744010218606,2019-03-26 15:45:00,2019-03-26 16:00:00
199,1,1,0,0.0055518606952852,2019-03-26 15:45:00,2019-03-26 16:00:00
202,1,1,0,0.0043068406596052135,2019-03-26 15:45:00,2019-03-26 16:00:00
203,1,0,1,0.003000894940205268,2019-03-26 15:45:00,2019-03-26 16:00:00
1,2,2,0,0.007453691055798113,2019-03-26 16:00:00,2019-03-26 16:15:00
2,2,1,1,0.0037065527877644337,2019-03-26 16:00:00,2019-03-26 16:15:00
5,2,1,1,0.018499002709826746,2019-03-26 16:00:00,2019-03-26 16:15:00
10,1,1,0,0.00901150136346799,2019-03-26 16:00:00,2019-03-26 16:15:00
15,1,0,1,0.0027809907355561617,2019-03-26 16:00:00,2019-03-26 16:15:00
16,2,2,0,0.007446529702978893,2019-03-26 16:00:00,2019-03-26 16:15:00
18,6,4,2,0.016368552498859587,2019-03-26 16:00:00,2019-03-26 16:15:00
19,4,3,1,0.008024350447094026,2019-03-26 16:00:00,2019-03-26 16:15:00
21,1,0,1,0.0027809907355561617,2019-03-26 16:00:00,2019-03-26 16:15:00
22,1,0,1,0.0027809907355561617,2019-03-26 16:00:00,2019-03-26 16:15:00
23,3,2,1,0.009513230559751451,2019-03-26 16:00:00,2019-03-26 16:15:00
26,3,0,3,0.0027809907355561617,2019-03-26 16:00:00,2019-03-26 16:15:00
28,5,3,2,0.012431123669605589,2019-03-26 16:00:00,2019-03-26 16:15:00
35,5,2,3,0.006418687061175768,2019-03-26 16:00:00,2019-03-26 16:15:00
37,2,1,1,0.00382826938466241,2019-03-26 16:00:00,2019-03-26 16:15:00
40,1,1,0,0.008008897737051164,2019-03-26 16:00:00,2019-03-26 16:15:00
41,4,2,2,0.008333660287771941,2019-03-26 16:00:00,2019-03-26 16:15:00
46,7,2,5,0.004774809396575006,2019-03-26 16:00:00,2019-03-26 16:15:00
57,4,3,1,0.011291302110544032,2019-03-26 16:00:00,2019-03-26 16:15:00
58,4,3,1,0.04094843022858607,2019-03-26 16:00:00,2019-03-26 16:15:00
62,5,2,3,0.008244764400079242,2019-03-26 16:00:00,2019-03-26 16:15:00
64,2,1,1,0.018499002709826746,2019-03-26 16:00:00,2019-03-26 16:15:00
66,2,0,2,0.0027809907355561617,2019-03-26 16:00:00,2019-03-26 16:15:00
67,4,3,1,0.007155561613163553,2019-03-26 16:00:00,2019-03-26 16:15:00
68,3,1,2,0.00337200223499348,2019-03-26 16:00:00,2019-03-26 16:15:00
69,1,1,0,0.005567670036988414,2019-03-26 16:00:00,2019-03-26 16:15:00
70,3,3,0,0.009846836503432226,2019-03-26 16:00:00,2019-03-26 16:15:00
71,1,1,0,0.00498799140267389,2019-03-26 16:00:00,2019-03-26 16:15:00
74,1,1,0,0.006323163882585096,2019-03-26 16:00:00,2019-03-26 16:15:00
79,1,1,0,0.003963013734430799,2019-03-26 16:00:00,2019-03-26 16:15:00
85,4,2,2,0.012444078230188702,2019-03-26 16:00:00,2019-03-26 16:15:00
86,1,1,0,0.0038788146999691065,2019-03-26 16:00:00,2019-03-26 16:15:00
87,4,1,3,0.0038805970297246073,2019-03-26 16:00:00,2019-03-26 16:15:00
88,2,1,1,0.006149861860007764,2019-03-26 16:00:00,2019-03-26 16:15:00
89,2,1,1,0.005138119934252259,2019-03-26 16:00:00,2019-03-26 16:15:00
90,3,2,1,0.011794523647350083,2019-03-26 16:00:00,2019-03-26 16:15:00
104,3,2,1,0.0224285057033944,2019-03-26 16:00:00,2019-03-26 16:15:00
109,5,2,3,0.004980203323893054,2019-03-26 16:00:00,2019-03-26 16:15:00
111,6,2,4,0.004927875678830856,2019-03-26 16:00:00,2019-03-26 16:15:00
112,9,4,5,0.012980027927240245,2019-03-26 16:00:00,2019-03-26 16:15:00
113,1,0,1,0.0027809907355561617,2019-03-26 16:00:00,2019-03-26 16:15:00
114,1,0,1,0.0027809907355561617,2019-03-26 16:00:00,2019-03-26 16:15:00
115,8,3,5,0.005443910502116913,2019-03-26 16:00:00,2019-03-26 16:15:00
116,2,1,1,0.0037509584301525806,2019-03-26 16:00:00,2019-03-26 16:15:00
118,2,1,1,0.018499002709826746,2019-03-26 16:00:00,2019-03-26 16:15:00
119,4,1,3,0.005145036733305436,2019-03-26 16:00:00,2019-03-26 16:15:00
120,2,1,1,0.003592786397700369,2019-03-26 16:00:00,2019-03-26 16:15:00
122,2,1,1,0.003963013734430799,2019-03-26 16:00:00,2019-03-26 16:15:00
126,6,3,3,0.01262644179060973,2019-03-26 16:00:00,2019-03-26 16:15:00
137,18,10,8,0.022179297879951633,2019-03-26 16:00:00,2019-03-26 16:15:00
138,10,3,7,0.007987134613045926,2019-03-26 16:00:00,2019-03-26 16:15:00
140,1,1,0,0.012807809350489223,2019-03-26 16:00:00,2019-03-26 16:15:00
141,1,0,1,0.0027809907355561617,2019-03-26 16:00:00,2019-03-26 16:15:00
147,1,1,0,0.008863921478432138,2019-03-26 16:00:00,2019-03-26 16:15:00
153,9,3,6,0.00774847469558402,2019-03-26 16:00:00,2019-03-26 16:15:00
154,1,0,1,0.0027809907355561617,2019-03-26 16:00:00,2019-03-26 16:15:00
157,3,2,1,0.05362590514025669,2019-03-26 16:00:00,2019-03-26 16:15:00
158,2,2,0,0.004538973762735672,2019-03-26 16:00:00,2019-03-26 16:15:00
162,2,2,0,0.005010292383537047,2019-03-26 16:00:00,2019-03-26 16:15:00
164,4,0,4,0.0027809907355561617,2019-03-26 16:00:00,2019-03-26 16:15:00
168,1,1,0,0.0038805970297246073,2019-03-26 16:00:00,2019-03-26 16:15:00
170,3,0,3,0.0027809907355561617,2019-03-26 16:00:00,2019-03-26 16:15:00
171,1,1,0,0.004214220016106381,2019-03-26 16:00:00,2019-03-26 16:15:00
172,3,1,2,0.006323163882585096,2019-03-26 16:00:00,2019-03-26 16:15:00
173,4,4,0,0.009754996814022445,2019-03-26 16:00:00,2019-03-26 16:15:00
175,1,1,0,0.0059318652718167615,2019-03-26 16:00:00,2019-03-26 16:15:00
177,5,3,2,0.010271305928370365,2019-03-26 16:00:00,2019-03-26 16:15:00
189,4,2,2,0.018499002709826746,2019-03-26 16:00:00,2019-03-26 16:15:00
190,2,0,2,0.0027809907355561617,2019-03-26 16:00:00,2019-03-26 16:15:00
191,3,2,1,0.007328993620483477,2019-03-26 16:00:00,2019-03-26 16:15:00
195,4,2,2,0.006556233989059236,2019-03-26 16:00:00,2019-03-26 16:15:00
196,2,0,2,0.0027809907355561617,2019-03-26 16:00:00,2019-03-26 16:15:00
197,1,1,0,0.009738640863045642,2019-03-26 16:00:00,2019-03-26 16:15:00
201,3,1,2,0.004836873519860603,2019-03-26 16:00:00,2019-03-26 16:15:00
202,1,1,0,0.004214220016106381,2019-03-26 16:00:00,2019-03-26 16:15:00
203,2,1,1,0.005145036733305436,2019-03-26 16:00:00,2019-03-26 16:15:00
1,2,2,0,0.014619795916942327,2019-03-26 16:15:00,2019-03-26 16:30:00
2,3,2,1,0.026322443878494663,2019-03-26 16:15:00,2019-03-26 16:30:00
10,3,3,0,0.009476749423560766,2019-03-26 16:15:00,2019-03-26 16:30:00
15,2,0,2,0.002891213139309992,2019-03-26 16:15:00,2019-03-26 16:30:00
16,2,1,1,0.004818840446915145,2019-03-26 16:15:00,2019-03-26 16:30:00
18,5,2,3,0.006249662321452129,2019-03-26 16:15:00,2019-03-26 16:30:00
19,4,3,1,0.0068601563102180735,2019-03-26 16:15:00,2019-03-26 16:30:00
21,1,0,1,0.002891213139309992,2019-03-26 16:15:00,2019-03-26 16:30:00
22,1,0,1,0.002891213139309992,2019-03-26 16:15:00,2019-03-26 16:30:00
23,4,1,3,0.0044422095427389076,2019-03-26 16:15:00,2019-03-26 16:30:00
26,4,3,1,0.005671084385406908,2019-03-26 16:15:00,2019-03-26 16:30:00
28,4,0,4,0.002891213139309992,2019-03-26 16:15:00,2019-03-26 16:30:00
35,6,3,3,0.009509516733047462,2019-03-26 16:15:00,2019-03-26 16:30:00
41,5,3,2,0.011194153112562165,2019-03-26 16:15:00,2019-03-26 16:30:00
46,3,1,2,0.005028588140895756,2019-03-26 16:15:00,2019-03-26 16:30:00
50,1,1,0,0.003281344150047114,2019-03-26 16:15:00,2019-03-26 16:30:00
57,3,3,0,0.0055483477795229275,2019-03-26 16:15:00,2019-03-26 16:30:00
58,5,4,1,0.03964088505961773,2019-03-26 16:15:00,2019-03-26 16:30:00
61,1,1,0,0.0036490567676633356,2019-03-26 16:15:00,2019-03-26 16:30:00
62,7,4,3,0.033812108010806335,2019-03-26 16:15:00,2019-03-26 16:30:00
64,2,1,1,0.019224491965961692,2019-03-26 16:15:00,2019-03-26 16:30:00
66,2,1,1,0.0036490567676633356,2019-03-26 16:15:00,2019-03-26 16:30:00
67,10,4,6,0.008637189158909563,2019-03-26 16:15:00,2019-03-26 16:30:00
68,5,3,2,0.005728859172743336,2019-03-26 16:15:00,2019-03-26 16:30:00
69,2,2,0,0.006963941663716091,2019-03-26 16:15:00,2019-03-26 16:30:00
70,2,2,0,0.004406350057450128,2019-03-26 16:15:00,2019-03-26 16:30:00
71,1,1,0,0.004581143472875429,2019-03-26 16:15:00,2019-03-26 16:30:00
74,1,1,0,0.0076492452908440405,2019-03-26 16:15:00,2019-03-26 16:30:00
85,1,1,0,0.008522326730553129,2019-03-26 16:15:00,2019-03-26 16:30:00
86,2,1,1,0.003899467376914716,2019-03-26 16:15:00,2019-03-26 16:30:00
87,4,2,2,0.011521286097219714,2019-03-26 16:15:00,2019-03-26 16:30:00
89,1,1,0,0.007985959805200527,2019-03-26 16:15:00,2019-03-26 16:30:00
90,2,1,1,0.004662130741590944,2019-03-26 16:15:00,2019-03-26 16:30:00
104,4,3,1,0.049011735250669715,2019-03-26 16:15:00,2019-03-26 16:30:00
108,1,0,1,0.002891213139309992,2019-03-26 16:15:00,2019-03-26 16:30:00
109,2,2,0,0.006577837667313994,2019-03-26 16:15:00,2019-03-26 16:30:00
110,1,0,1,0.002891213139309992,2019-03-26 16:15:00,2019-03-26 16:30:00
111,2,1,1,0.0077884621349641765,2019-03-26 16:15:00,2019-03-26 16:30:00
112,7,3,4,0.007951653302517854,2019-03-26 16:15:00,2019-03-26 16:30:00
113,1,1,0,0.012473043598648014,2019-03-26 16:15:00,2019-03-26 16:30:00
114,1,1,0,0.00957136297524117,2019-03-26 16:15:00,2019-03-26 16:30:00
115,5,1,4,0.005028588140895756,2019-03-26 16:15:00,2019-03-26 16:30:00
116,4,3,1,0.005430412426340129,2019-03-26 16:15:00,2019-03-26 16:30:00
119,3,0,3,0.002891213139309992,2019-03-26 16:15:00,2019-03-26 16:30:00
120,1,0,1,0.002891213139309992,2019-03-26 16:15:00,2019-03-26 16:30:00
122,2,1,1,0.005993205946167823,2019-03-26 16:15:00,2019-03-26 16:30:00
126,4,2,2,0.005050662027987218,2019-03-26 16:15:00,2019-03-26 16:30:00
127,1,1,0,0.0036490567676633356,2019-03-26 16:15:00,2019-03-26 16:30:00
137,14,7,7,0.0158724404923081,2019-03-26 16:15:00,2019-03-26 16:30:00
138,8,2,6,0.006357217062250718,2019-03-26 16:15:00,2019-03-26 16:30:00
141,4,2,2,0.008782055256252806,2019-03-26 16:15:00,2019-03-26 16:30:00
147,3,2,1,0.004513904798248716,2019-03-26 16:15:00,2019-03-26 16:30:00
151,1,1,0,0.0053489628246459935,2019-03-26 16:15:00,2019-03-26 16:30:00
153,15,6,9,0.010674407486826002,2019-03-26 16:15:00,2019-03-26 16:30:00
154,1,0,1,0.002891213139309992,2019-03-26 16:15:00,2019-03-26 16:30:00
156,3,1,2,0.0036490567676633356,2019-03-26 16:15:00,2019-03-26 16:30:00
157,3,2,1,0.026322443878494667,2019-03-26 16:15:00,2019-03-26 16:30:00
158,1,1,0,0.003791912636116128,2019-03-26 16:15:00,2019-03-26 16:30:00
162,1,1,0,0.004662130741590944,2019-03-26 16:15:00,2019-03-26 16:30:00
164,10,2,8,0.0036714751607842358,2019-03-26 16:15:00,2019-03-26 16:30:00
170,1,0,1,0.002891213139309992,2019-03-26 16:15:00,2019-03-26 16:30:00
171,1,1,0,0.005326266693121379,2019-03-26 16:15:00,2019-03-26 16:30:00
172,2,0,2,0.002891213139309992,2019-03-26 16:15:00,2019-03-26 16:30:00
173,4,3,1,0.00785814305332343,2019-03-26 16:15:00,2019-03-26 16:30:00
177,4,3,1,0.02688609513127472,2019-03-26 16:15:00,2019-03-26 16:30:00
189,5,2,3,0.006673100907159975,2019-03-26 16:15:00,2019-03-26 16:30:00
190,1,0,1,0.002891213139309992,2019-03-26 16:15:00,2019-03-26 16:30:00
191,3,0,3,0.002891213139309992,2019-03-26 16:15:00,2019-03-26 16:30:00
195,7,1,6,0.0053489628246459935,2019-03-26 16:15:00,2019-03-26 16:30:00
197,3,2,1,0.011283264826992179,2019-03-26 16:15:00,2019-03-26 16:30:00
199,1,1,0,0.003791912636116128,2019-03-26 16:15:00,2019-03-26 16:30:00
201,1,1,0,0.004818840446915145,2019-03-26 16:15:00,2019-03-26 16:30:00
202,1,1,0,0.005326266693121379,2019-03-26 16:15:00,2019-03-26 16:30:00
203,2,1,1,0.006624037101565529,2019-03-26 16:15:00,2019-03-26 16:30:00
1,1,1,0,0.0036694024717705345,2019-03-26 16:30:00,2019-03-26 16:45:00
2,2,1,1,0.0036556804433874298,2019-03-26 16:30:00,2019-03-26 16:45:00
10,3,3,0,0.009091893621812517,2019-03-26 16:30:00,2019-03-26 16:45:00
15,3,1,2,0.004854766514222798,2019-03-26 16:30:00,2019-03-26 16:45:00
16,5,2,3,0.007044507734891032,2019-03-26 16:30:00,2019-03-26 16:45:00
18,8,4,4,0.013371686254633464,2019-03-26 16:30:00,2019-03-26 16:45:00
19,6,2,4,0.010199186785531195,2019-03-26 16:30:00,2019-03-26 16:45:00
21,1,0,1,0.0028592150167020473,2019-03-26 16:30:00,2019-03-26 16:45:00
23,8,5,3,0.0136926657233947,2019-03-26 16:30:00,2019-03-26 16:45:00
26,3,1,2,0.010451706862055198,2019-03-26 16:30:00,2019-03-26 16:45:00
28,3,0,3,0.0028592150167020473,2019-03-26 16:30:00,2019-03-26 16:45:00
30,1,1,0,0.004219138180978481,2019-03-26 16:30:00,2019-03-26 16:45:00
35,2,1,1,0.004922764817543194,2019-03-26 16:30:00,2019-03-26 16:45:00
37,1,1,0,0.005289777381907509,2019-03-26 16:30:00,2019-03-26 16:45:00
41,4,2,2,0.006649700546183943,2019-03-26 16:30:00,2019-03-26 16:45:00
46,6,2,4,0.0063835615007709,2019-03-26 16:30:00,2019-03-26 16:45:00
50,2,1,1,0.003661194983311063,2019-03-26 16:30:00,2019-03-26 16:45:00
57,4,3,1,0.012581808998944772,2019-03-26 16:30:00,2019-03-26 16:45:00
58,4,3,1,0.05405983084463134,2019-03-26 16:30:00,2019-03-26 16:45:00
62,4,2,2,0.006042026315558477,2019-03-26 16:30:00,2019-03-26 16:45:00
64,2,1,1,0.01902229585713565,2019-03-26 16:30:00,2019-03-26 16:45:00
66,2,2,0,0.004630320947584312,2019-03-26 16:30:00,2019-03-26 16:45:00
67,9,3,6,0.007164912768878536,2019-03-26 16:30:00,2019-03-26 16:45:00
68,5,3,2,0.005691519321936785,2019-03-26 16:30:00,2019-03-26 16:45:00
69,1,1,0,0.0032544349174219085,2019-03-26 16:30:00,2019-03-26 16:45:00
70,1,1,0,0.0036694024717705345,2019-03-26 16:30:00,2019-03-26 16:45:00
71,1,1,0,0.0036556804433874298,2019-03-26 16:30:00,2019-03-26 16:45:00
74,2,1,1,0.0056856698957990425,2019-03-26 16:30:00,2019-03-26 16:45:00
85,1,1,0,0.005289777381907509,2019-03-26 16:30:00,2019-03-26 16:45:00
86,3,2,1,0.008931183769588022,2019-03-26 16:30:00,2019-03-26 16:45:00
87,6,2,4,0.009389388403629344,2019-03-26 16:30:00,2019-03-26 16:45:00
88,1,1,0,0.004024054082094856,2019-03-26 16:30:00,2019-03-26 16:45:00
89,2,1,1,0.009165739388743918,2019-03-26 16:30:00,2019-03-26 16:45:00
90,3,1,2,0.004972963417298372,2019-03-26 16:30:00,2019-03-26 16:45:00
101,1,1,0,0.0032544349174219085,2019-03-26 16:30:00,2019-03-26 16:45:00
104,3,2,1,0.03227955778895401,2019-03-26 16:30:00,2019-03-26 16:45:00
108,1,0,1,0.0028592150167020473,2019-03-26 16:30:00,2019-03-26 16:45:00
110,1,0,1,0.0028592150167020473,2019-03-26 16:30:00,2019-03-26 16:45:00
111,7,2,5,0.0068509980388607675,2019-03-26 16:30:00,2019-03-26 16:45:00
112,7,2,5,0.004684564641083395,2019-03-26 16:30:00,2019-03-26 16:45:00
113,1,1,0,0.005427427303930959,2019-03-26 16:30:00,2019-03-26 16:45:00
114,2,2,0,0.01491200517806266,2019-03-26 16:30:00,2019-03-26 16:45:00
115,3,3,0,0.009649527768481185,2019-03-26 16:30:00,2019-03-26 16:45:00
119,3,1,2,0.004024054082094856,2019-03-26 16:30:00,2019-03-26 16:45:00
120,4,1,3,0.004855446541340017,2019-03-26 16:30:00,2019-03-26 16:45:00
122,4,2,2,0.014836318416347218,2019-03-26 16:30:00,2019-03-26 16:45:00
126,3,0,3,0.0028592150167020473,2019-03-26 16:30:00,2019-03-26 16:45:00
127,2,2,0,0.00956095928946378,2019-03-26 16:30:00,2019-03-26 16:45:00
133,1,0,1,0.0028592150167020473,2019-03-26 16:30:00,2019-03-26 16:45:00
137,12,6,6,0.01746677788051682,2019-03-26 16:30:00,2019-03-26 16:45:00
138,9,4,5,0.007998437873003599,2019-03-26 16:30:00,2019-03-26 16:45:00
140,1,1,0,0.004922764817543194,2019-03-26 16:30:00,2019-03-26 16:45:00
141,2,1,1,0.005334081933709734,2019-03-26 16:30:00,2019-03-26 16:45:00
147,3,2,1,0.00490797706824044,2019-03-26 16:30:00,2019-03-26 16:45:00
151,1,1,0,0.005289777381907509,2019-03-26 16:30:00,2019-03-26 16:45:00
153,10,4,6,0.008741800703821247,2019-03-26 16:30:00,2019-03-26 16:45:00
156,2,1,1,0.0032544349174219085,2019-03-26 16:30:00,2019-03-26 16:45:00
157,2,1,1,0.01902229585713565,2019-03-26 16:30:00,2019-03-26 16:45:00
158,1,0,1,0.0028592150167020473,2019-03-26 16:30:00,2019-03-26 16:45:00
162,1,1,0,0.005701101800654136,2019-03-26 16:30:00,2019-03-26 16:45:00
164,10,4,6,0.005660374817248956,2019-03-26 16:30:00,2019-03-26 16:45:00
168,1,0,1,0.0028592150167020473,2019-03-26 16:30:00,2019-03-26 16:45:00
171,3,2,1,0.035096883497152405,2019-03-26 16:30:00,2019-03-26 16:45:00
172,2,1,1,0.0036694024717705345,2019-03-26 16:30:00,2019-03-26 16:45:00
173,2,2,0,0.006497567227339518,2019-03-26 16:30:00,2019-03-26 16:45:00
175,1,1,0,0.004215912371227332,2019-03-26 16:30:00,2019-03-26 16:45:00
177,2,2,0,0.009012243140505352,2019-03-26 16:30:00,2019-03-26 16:45:00
189,6,3,3,0.012209523070570945,2019-03-26 16:30:00,2019-03-26 16:45:00
190,1,1,0,0.0036694024717705345,2019-03-26 16:30:00,2019-03-26 16:45:00
191,1,1,0,0.004569640817883346,2019-03-26 16:30:00,2019-03-26 16:45:00
195,8,1,7,0.0032544349174219085,2019-03-26 16:30:00,2019-03-26 16:45:00
197,3,1,2,0.004024054082094856,2019-03-26 16:30:00,2019-03-26 16:45:00
199,2,2,0,0.005457712777448387,2019-03-26 16:30:00,2019-03-26 16:45:00
201,5,3,2,0.03544937659724822,2019-03-26 16:30:00,2019-03-26 16:45:00
202,1,1,0,0.0052784121867355425,2019-03-26 16:30:00,2019-03-26 16:45:00
203,1,0,1,0.0028592150167020473,2019-03-26 16:30:00,2019-03-26 16:45:00
2,2,1,1,0.0041231612463113795,2019-03-26 16:45:00,2019-03-26 17:00:00
10,2,1,1,0.004636536153552525,2019-03-26 16:45:00,2019-03-26 17:00:00
15,2,1,1,0.004788225450494734,2019-03-26 16:45:00,2019-03-26 17:00:00
16,3,0,3,0.002601237747003575,2019-03-26 16:45:00,2019-03-26 17:00:00
18,5,2,3,0.022944611577339628,2019-03-26 16:45:00,2019-03-26 17:00:00
19,3,1,2,0.004788225450494734,2019-03-26 16:45:00,2019-03-26 17:00:00
23,4,3,1,0.007526779407569223,2019-03-26 16:45:00,2019-03-26 17:00:00
26,3,1,2,0.00481241738726496,2019-03-26 16:45:00,2019-03-26 17:00:00
28,2,0,2,0.002601237747003575,2019-03-26 16:45:00,2019-03-26 17:00:00
30,1,1,0,0.004586068269603215,2019-03-26 16:45:00,2019-03-26 17:00:00
35,1,0,1,0.002601237747003575,2019-03-26 16:45:00,2019-03-26 17:00:00
37,4,3,1,0.028605587135162234,2019-03-26 16:45:00,2019-03-26 17:00:00
40,4,1,3,0.0036297237575129092,2019-03-26 16:45:00,2019-03-26 17:00:00
41,4,3,1,0.009008427550125986,2019-03-26 16:45:00,2019-03-26 17:00:00
46,11,3,8,0.005887847604601667,2019-03-26 16:45:00,2019-03-26 17:00:00
50,1,0,1,0.002601237747003575,2019-03-26 16:45:00,2019-03-26 17:00:00
57,4,3,1,0.01709888186202424,2019-03-26 16:45:00,2019-03-26 17:00:00
58,9,6,3,0.03840377933297466,2019-03-26 16:45:00,2019-03-26 17:00:00
61,2,2,0,0.006632108784761085,2019-03-26 16:45:00,2019-03-26 17:00:00
62,4,1,3,0.0031338784141347973,2019-03-26 16:45:00,2019-03-26 17:00:00
64,2,1,1,0.017262020643387957,2019-03-26 16:45:00,2019-03-26 17:00:00
67,8,2,6,0.003759534139659368,2019-03-26 16:45:00,2019-03-26 17:00:00
68,4,3,1,0.021855331178053824,2019-03-26 16:45:00,2019-03-26 17:00:00
74,1,1,0,0.010258961645604227,2019-03-26 16:45:00,2019-03-26 17:00:00
85,3,2,1,0.006999405090756118,2019-03-26 16:45:00,2019-03-26 17:00:00
86,1,0,1,0.002601237747003575,2019-03-26 16:45:00,2019-03-26 17:00:00
87,8,2,6,0.015434208490230047,2019-03-26 16:45:00,2019-03-26 17:00:00
88,2,1,1,0.004166951358937333,2019-03-26 16:45:00,2019-03-26 17:00:00
89,2,1,1,0.0064444922224008334,2019-03-26 16:45:00,2019-03-26 17:00:00
90,3,1,2,0.0032268934725281457,2019-03-26 16:45:00,2019-03-26 17:00:00
101,1,1,0,0.0036297237575129092,2019-03-26 16:45:00,2019-03-26 17:00:00
104,4,3,1,0.04814987307333755,2019-03-26 16:45:00,2019-03-26 17:00:00
108,1,0,1,0.002601237747003575,2019-03-26 16:45:00,2019-03-26 17:00:00
109,2,2,0,0.00550824911884483,2019-03-26 16:45:00,2019-03-26 17:00:00
111,5,2,3,0.005525285330581862,2019-03-26 16:45:00,2019-03-26 17:00:00
112,3,1,2,0.0035807690944741318,2019-03-26 16:45:00,2019-03-26 17:00:00
114,2,1,1,0.017137330119909387,2019-03-26 16:45:00,2019-03-26 17:00:00
115,6,3,3,0.006866220321431724,2019-03-26 16:45:00,2019-03-26 17:00:00
118,1,1,0,0.0032268934725281457,2019-03-26 16:45:00,2019-03-26 17:00:00
120,2,1,1,0.003338297627090703,2019-03-26 16:45:00,2019-03-26 17:00:00
122,4,3,1,0.011319415349708475,2019-03-26 16:45:00,2019-03-26 17:00:00
126,3,1,2,0.0034892259363130326,2019-03-26 16:45:00,2019-03-26 17:00:00
127,6,3,3,0.0322439233057971,2019-03-26 16:45:00,2019-03-26 17:00:00
133,1,0,1,0.002601237747003575,2019-03-26 16:45:00,2019-03-26 17:00:00
135,1,0,1,0.002601237747003575,2019-03-26 16:45:00,2019-03-26 17:00:00
137,12,7,5,0.022604062436305986,2019-03-26 16:45:00,2019-03-26 17:00:00
138,5,2,3,0.007004675021902091,2019-03-26 16:45:00,2019-03-26 17:00:00
140,1,1,0,0.006671834560101475,2019-03-26 16:45:00,2019-03-26 17:00:00
141,1,1,0,0.0036297237575129092,2019-03-26 16:45:00,2019-03-26 17:00:00
151,2,2,0,0.006757988854464422,2019-03-26 16:45:00,2019-03-26 17:00:00
153,5,3,2,0.006882399864776047,2019-03-26 16:45:00,2019-03-26 17:00:00
157,2,1,1,0.017262020643387957,2019-03-26 16:45:00,2019-03-26 17:00:00
162,2,2,0,0.009991235315939926,2019-03-26 16:45:00,2019-03-26 17:00:00
164,6,2,4,0.004609255104983466,2019-03-26 16:45:00,2019-03-26 17:00:00
168,2,1,1,0.0064444922224008334,2019-03-26 16:45:00,2019-03-26 17:00:00
169,1,1,0,0.013247220786738888,2019-03-26 16:45:00,2019-03-26 17:00:00
170,6,2,4,0.004524117556287158,2019-03-26 16:45:00,2019-03-26 17:00:00
172,2,2,0,0.005045690811215831,2019-03-26 16:45:00,2019-03-26 17:00:00
173,1,1,0,0.004586068269603215,2019-03-26 16:45:00,2019-03-26 17:00:00
175,1,1,0,0.0032268934725281457,2019-03-26 16:45:00,2019-03-26 17:00:00
177,1,1,0,0.004646643601189328,2019-03-26 16:45:00,2019-03-26 17:00:00
189,5,2,3,0.03756621465582574,2019-03-26 16:45:00,2019-03-26 17:00:00
190,1,1,0,0.0037068275671342677,2019-03-26 16:45:00,2019-03-26 17:00:00
191,1,1,0,0.004337154905371732,2019-03-26 16:45:00,2019-03-26 17:00:00
195,4,1,3,0.0036297237575129092,2019-03-26 16:45:00,2019-03-26 17:00:00
196,7,5,2,0.032806249515078656,2019-03-26 16:45:00,2019-03-26 17:00:00
197,3,1,2,0.004084250906574039,2019-03-26 16:45:00,2019-03-26 17:00:00
199,2,1,1,0.005526518964630392,2019-03-26 16:45:00,2019-03-26 17:00:00
201,1,0,1,0.002601237747003575,2019-03-26 16:45:00,2019-03-26 17:00:00
203,1,0,1,0.002601237747003575,2019-03-26 16:45:00,2019-03-26 17:00:00
1,1,1,0,0.004374997317318641,2019-03-26 17:00:00,2019-03-26 17:15:00
2,2,1,1,0.009287664055904369,2019-03-26 17:00:00,2019-03-26 17:15:00
5,2,1,1,0.007768595615457532,2019-03-26 17:00:00,2019-03-26 17:15:00
10,1,0,1,0.003062165874026431,2019-03-26 17:00:00,2019-03-26 17:15:00
15,1,0,1,0.003062165874026431,2019-03-26 17:00:00,2019-03-26 17:15:00
16,4,1,3,0.008779497525586913,2019-03-26 17:00:00,2019-03-26 17:15:00
18,4,3,1,0.011481039849400075,2019-03-26 17:00:00,2019-03-26 17:15:00
19,10,3,7,0.021667127127967676,2019-03-26 17:00:00,2019-03-26 17:15:00
20,2,1,1,0.009666373278877713,2019-03-26 17:00:00,2019-03-26 17:15:00
21,1,0,1,0.003062165874026431,2019-03-26 17:00:00,2019-03-26 17:15:00
22,2,0,2,0.003062165874026431,2019-03-26 17:00:00,2019-03-26 17:15:00
23,5,3,2,0.013992462977778343,2019-03-26 17:00:00,2019-03-26 17:15:00
26,1,0,1,0.003062165874026431,2019-03-26 17:00:00,2019-03-26 17:15:00
27,2,2,0,0.008551892431438076,2019-03-26 17:00:00,2019-03-26 17:15:00
28,4,1,3,0.004633052200034779,2019-03-26 17:00:00,2019-03-26 17:15:00
30,1,1,0,0.005649296210772932,2019-03-26 17:00:00,2019-03-26 17:15:00
37,1,1,0,0.005665242846685145,2019-03-26 17:00:00,2019-03-26 17:15:00
40,3,1,2,0.005325920888606765,2019-03-26 17:00:00,2019-03-26 17:15:00
41,7,4,3,0.01660860671065403,2019-03-26 17:00:00,2019-03-26 17:15:00
46,11,2,9,0.0037753563844478387,2019-03-26 17:00:00,2019-03-26 17:15:00
50,3,1,2,0.005649296210772932,2019-03-26 17:00:00,2019-03-26 17:15:00
57,2,2,0,0.009781301656295835,2019-03-26 17:00:00,2019-03-26 17:15:00
58,8,4,4,0.010473656719431004,2019-03-26 17:00:00,2019-03-26 17:15:00
61,2,2,0,0.013249719507356282,2019-03-26 17:00:00,2019-03-26 17:15:00
62,4,2,2,0.0049994287155927675,2019-03-26 17:00:00,2019-03-26 17:15:00
64,2,1,1,0.020272967836153847,2019-03-26 17:00:00,2019-03-26 17:15:00
66,1,1,0,0.004122480479681524,2019-03-26 17:00:00,2019-03-26 17:15:00
67,5,0,5,0.003062165874026431,2019-03-26 17:00:00,2019-03-26 17:15:00
68,1,0,1,0.003062165874026431,2019-03-26 17:00:00,2019-03-26 17:15:00
70,5,2,3,0.0049994287155927675,2019-03-26 17:00:00,2019-03-26 17:15:00
74,2,2,0,0.010729774625337096,2019-03-26 17:00:00,2019-03-26 17:15:00
85,4,2,2,0.007904017033979721,2019-03-26 17:00:00,2019-03-26 17:15:00
87,6,1,5,0.003689427751221498,2019-03-26 17:00:00,2019-03-26 17:15:00
89,3,2,1,0.006725557452340237,2019-03-26 17:00:00,2019-03-26 17:15:00
90,4,3,1,0.007323376588225205,2019-03-26 17:00:00,2019-03-26 17:15:00
104,4,2,2,0.009853430917767433,2019-03-26 17:00:00,2019-03-26 17:15:00
108,2,1,1,0.004478813321061025,2019-03-26 17:00:00,2019-03-26 17:15:00
109,3,2,1,0.006930064166251177,2019-03-26 17:00:00,2019-03-26 17:15:00
110,1,1,0,0.003689427751221498,2019-03-26 17:00:00,2019-03-26 17:15:00
111,4,2,2,0.005915337059989076,2019-03-26 17:00:00,2019-03-26 17:15:00
112,1,0,1,0.003062165874026431,2019-03-26 17:00:00,2019-03-26 17:15:00
114,2,1,1,0.005693562836798227,2019-03-26 17:00:00,2019-03-26 17:15:00
115,4,1,3,0.004363704360355788,2019-03-26 17:00:00,2019-03-26 17:15:00
118,1,1,0,0.003418761129237135,2019-03-26 17:00:00,2019-03-26 17:15:00
120,3,2,1,0.005906568948905888,2019-03-26 17:00:00,2019-03-26 17:15:00
122,1,1,0,0.005325920888606765,2019-03-26 17:00:00,2019-03-26 17:15:00
126,5,2,3,0.005543732299789026,2019-03-26 17:00:00,2019-03-26 17:15:00
127,5,3,2,0.009260204106403332,2019-03-26 17:00:00,2019-03-26 17:15:00
135,2,0,2,0.003062165874026431,2019-03-26 17:00:00,2019-03-26 17:15:00
137,11,4,7,0.008730917510660463,2019-03-26 17:00:00,2019-03-26 17:15:00
138,11,5,6,0.01825967103659897,2019-03-26 17:00:00,2019-03-26 17:15:00
140,1,0,1,0.003062165874026431,2019-03-26 17:00:00,2019-03-26 17:15:00
147,4,2,2,0.006966781333014501,2019-03-26 17:00:00,2019-03-26 17:15:00
151,3,3,0,0.008203282662467452,2019-03-26 17:00:00,2019-03-26 17:15:00
153,3,1,2,0.02087822104433572,2019-03-26 17:00:00,2019-03-26 17:15:00
154,1,1,0,0.004374997317318641,2019-03-26 17:00:00,2019-03-26 17:15:00
157,2,1,1,0.020272967836153847,2019-03-26 17:00:00,2019-03-26 17:15:00
158,1,1,0,0.005693562836798227,2019-03-26 17:00:00,2019-03-26 17:15:00
162,1,1,0,0.005187137044578322,2019-03-26 17:00:00,2019-03-26 17:15:00
164,2,1,1,0.020272967836153847,2019-03-26 17:00:00,2019-03-26 17:15:00
168,1,1,0,0.004122480479681524,2019-03-26 17:00:00,2019-03-26 17:15:00
170,2,0,2,0.003062165874026431,2019-03-26 17:00:00,2019-03-26 17:15:00
172,2,2,0,0.005600205689808738,2019-03-26 17:00:00,2019-03-26 17:15:00
173,3,3,0,0.01754433525100025,2019-03-26 17:00:00,2019-03-26 17:15:00
175,1,1,0,0.003418761129237135,2019-03-26 17:00:00,2019-03-26 17:15:00
189,2,1,1,0.020272967836153847,2019-03-26 17:00:00,2019-03-26 17:15:00
190,1,1,0,0.005693562836798227,2019-03-26 17:00:00,2019-03-26 17:15:00
191,4,3,1,0.012261024064528349,2019-03-26 17:00:00,2019-03-26 17:15:00
195,2,2,0,0.014898067073943637,2019-03-26 17:00:00,2019-03-26 17:15:00
196,5,3,2,0.00445999191830062,2019-03-26 17:00:00,2019-03-26 17:15:00
197,5,4,1,0.020956899430481207,2019-03-26 17:00:00,2019-03-26 17:15:00
199,1,0,1,0.003062165874026431,2019-03-26 17:00:00,2019-03-26 17:15:00
202,2,2,0,0.01155654609921438,2019-03-26 17:00:00,2019-03-26 17:15:00
203,2,1,1,0.004957845247695249,2019-03-26 17:00:00,2019-03-26 17:15:00
1,1,1,0,0.004690932889866597,2019-03-26 17:15:00,2019-03-26 17:30:00
5,3,3,0,0.011366717730261695,2019-03-26 17:15:00,2019-03-26 17:30:00
15,2,1,1,0.0037468113650647897,2019-03-26 17:15:00,2019-03-26 17:30:00
16,4,2,2,0.019788493743148363,2019-03-26 17:15:00,2019-03-26 17:30:00
18,2,1,1,0.004417546771091062,2019-03-26 17:15:00,2019-03-26 17:30:00
19,8,1,7,0.0060900618558269995,2019-03-26 17:15:00,2019-03-26 17:30:00
20,1,1,0,0.005297111090601185,2019-03-26 17:15:00,2019-03-26 17:30:00
21,2,1,1,0.005584821603084287,2019-03-26 17:15:00,2019-03-26 17:30:00
22,1,0,1,0.003291803923906195,2019-03-26 17:15:00,2019-03-26 17:30:00
23,5,1,4,0.005297111090601185,2019-03-26 17:15:00,2019-03-26 17:30:00
26,1,0,1,0.003291803923906195,2019-03-26 17:15:00,2019-03-26 17:30:00
27,2,2,0,0.00859695210669744,2019-03-26 17:15:00,2019-03-26 17:30:00
28,2,0,2,0.003291803923906195,2019-03-26 17:15:00,2019-03-26 17:30:00
37,1,0,1,0.003291803923906195,2019-03-26 17:15:00,2019-03-26 17:30:00
41,3,1,2,0.004031375897786779,2019-03-26 17:15:00,2019-03-26 17:30:00
46,8,1,7,0.0037468113650647897,2019-03-26 17:15:00,2019-03-26 17:30:00
50,3,3,0,0.023125159715947006,2019-03-26 17:15:00,2019-03-26 17:30:00
57,1,1,0,0.006891387186497355,2019-03-26 17:15:00,2019-03-26 17:30:00
58,7,3,4,0.011685712537808134,2019-03-26 17:15:00,2019-03-26 17:30:00
62,5,2,3,0.006306214275749955,2019-03-26 17:15:00,2019-03-26 17:30:00
64,5,3,2,0.011700164977761609,2019-03-26 17:15:00,2019-03-26 17:30:00
66,1,1,0,0.0055276773457630084,2019-03-26 17:15:00,2019-03-26 17:30:00
67,3,1,2,0.005394816911863692,2019-03-26 17:15:00,2019-03-26 17:30:00
68,1,0,1,0.003291803923906195,2019-03-26 17:15:00,2019-03-26 17:30:00
69,1,1,0,0.004690932889866597,2019-03-26 17:15:00,2019-03-26 17:30:00
70,6,2,4,0.007092026779006167,2019-03-26 17:15:00,2019-03-26 17:30:00
74,2,2,0,0.006999098940942215,2019-03-26 17:15:00,2019-03-26 17:30:00
85,3,1,2,0.008468807741070285,2019-03-26 17:15:00,2019-03-26 17:30:00
87,4,1,3,0.004593372189422688,2019-03-26 17:15:00,2019-03-26 17:30:00
88,1,1,0,0.008264936557823635,2019-03-26 17:15:00,2019-03-26 17:30:00
89,2,1,1,0.015171408790907365,2019-03-26 17:15:00,2019-03-26 17:30:00
90,3,2,1,0.009275113943937163,2019-03-26 17:15:00,2019-03-26 17:30:00
104,2,1,1,0.021781086925394075,2019-03-26 17:15:00,2019-03-26 17:30:00
106,2,1,1,0.021781086925394075,2019-03-26 17:15:00,2019-03-26 17:30:00
108,1,1,0,0.004799009099828075,2019-03-26 17:15:00,2019-03-26 17:30:00
109,4,2,2,0.007011596876566158,2019-03-26 17:15:00,2019-03-26 17:30:00
110,1,1,0,0.004593372189422688,2019-03-26 17:15:00,2019-03-26 17:30:00
111,5,2,3,0.00707684691660886,2019-03-26 17:15:00,2019-03-26 17:30:00
112,2,0,2,0.003291803923906195,2019-03-26 17:15:00,2019-03-26 17:30:00
113,3,2,1,0.0042018188062233845,2019-03-26 17:15:00,2019-03-26 17:30:00
114,1,0,1,0.003291803923906195,2019-03-26 17:15:00,2019-03-26 17:30:00
115,3,0,3,0.003291803923906195,2019-03-26 17:15:00,2019-03-26 17:30:00
120,3,2,1,0.008133864508091523,2019-03-26 17:15:00,2019-03-26 17:30:00
122,1,1,0,0.0055276773457630084,2019-03-26 17:15:00,2019-03-26 17:30:00
126,3,2,1,0.005849824353022287,2019-03-26 17:15:00,2019-03-26 17:30:00
127,5,2,3,0.00919738608242534,2019-03-26 17:15:00,2019-03-26 17:30:00
135,1,0,1,0.003291803923906195,2019-03-26 17:15:00,2019-03-26 17:30:00
137,11,4,7,0.018410528797369596,2019-03-26 17:15:00,2019-03-26 17:30:00
138,6,4,2,0.035869668717788954,2019-03-26 17:15:00,2019-03-26 17:30:00
140,3,2,1,0.0139746247663166,2019-03-26 17:15:00,2019-03-26 17:30:00
141,1,0,1,0.003291803923906195,2019-03-26 17:15:00,2019-03-26 17:30:00
147,3,1,2,0.004690932889866597,2019-03-26 17:15:00,2019-03-26 17:30:00
151,2,2,0,0.007022814499800601,2019-03-26 17:15:00,2019-03-26 17:30:00
153,3,1,2,0.0058979910862347095,2019-03-26 17:15:00,2019-03-26 17:30:00
154,1,1,0,0.004690932889866597,2019-03-26 17:15:00,2019-03-26 17:30:00
157,2,1,1,0.021781086925394075,2019-03-26 17:15:00,2019-03-26 17:30:00
158,2,1,1,0.004031375897786779,2019-03-26 17:15:00,2019-03-26 17:30:00
162,1,1,0,0.005078740065090468,2019-03-26 17:15:00,2019-03-26 17:30:00
168,1,1,0,0.0060900618558269995,2019-03-26 17:15:00,2019-03-26 17:30:00
172,2,2,0,0.006011492709064069,2019-03-26 17:15:00,2019-03-26 17:30:00
173,2,2,0,0.0055432896182759294,2019-03-26 17:15:00,2019-03-26 17:30:00
175,1,1,0,0.0037468113650647897,2019-03-26 17:15:00,2019-03-26 17:30:00
177,1,1,0,0.005078740065090468,2019-03-26 17:15:00,2019-03-26 17:30:00
190,1,1,0,0.004031375897786779,2019-03-26 17:15:00,2019-03-26 17:30:00
191,4,3,1,0.008342794115966886,2019-03-26 17:15:00,2019-03-26 17:30:00
195,7,3,4,0.009895522600005355,2019-03-26 17:15:00,2019-03-26 17:30:00
196,1,0,1,0.003291803923906195,2019-03-26 17:15:00,2019-03-26 17:30:00
197,4,4,0,0.01615753994011051,2019-03-26 17:15:00,2019-03-26 17:30:00
199,1,1,0,0.004417546771091062,2019-03-26 17:15:00,2019-03-26 17:30:00
202,1,1,0,0.008039349381777708,2019-03-26 17:15:00,2019-03-26 17:30:00
203,2,1,1,0.0060900618558269995,2019-03-26 17:15:00,2019-03-26 17:30:00
2,1,0,1,0.0030592294316243835,2019-03-26 17:30:00,2019-03-26 17:45:00
5,3,3,0,0.008554454423164496,2019-03-26 17:30:00,2019-03-26 17:45:00
15,2,2,0,0.009453395739193796,2019-03-26 17:30:00,2019-03-26 17:45:00
16,2,2,0,0.017401000935630483,2019-03-26 17:30:00,2019-03-26 17:45:00
18,8,3,5,0.006126977501077352,2019-03-26 17:30:00,2019-03-26 17:45:00
19,4,1,3,0.0056598006401844345,2019-03-26 17:30:00,2019-03-26 17:45:00
20,4,2,2,0.006639403753406685,2019-03-26 17:30:00,2019-03-26 17:45:00
21,1,1,0,0.006396705812218824,2019-03-26 17:30:00,2019-03-26 17:45:00
23,6,1,5,0.004268851374122215,2019-03-26 17:30:00,2019-03-26 17:45:00
27,2,1,1,0.007248931041039519,2019-03-26 17:30:00,2019-03-26 17:45:00
37,1,1,0,0.005060034890596194,2019-03-26 17:30:00,2019-03-26 17:45:00
40,1,0,1,0.0030592294316243835,2019-03-26 17:30:00,2019-03-26 17:45:00
41,4,3,1,0.009088805327153098,2019-03-26 17:30:00,2019-03-26 17:45:00
46,6,3,3,0.006572967214050486,2019-03-26 17:30:00,2019-03-26 17:45:00
50,2,2,0,0.00475168913698752,2019-03-26 17:30:00,2019-03-26 17:45:00
57,3,2,1,0.006748137913564301,2019-03-26 17:30:00,2019-03-26 17:45:00
58,5,1,4,0.003884832067467503,2019-03-26 17:30:00,2019-03-26 17:45:00
61,2,1,1,0.009221496502530478,2019-03-26 17:30:00,2019-03-26 17:45:00
62,5,2,3,0.0056598006401844345,2019-03-26 17:30:00,2019-03-26 17:45:00
64,5,3,2,0.011811688892475379,2019-03-26 17:30:00,2019-03-26 17:45:00
66,2,1,1,0.003926086501144401,2019-03-26 17:30:00,2019-03-26 17:45:00
67,2,1,1,0.003926086501144401,2019-03-26 17:30:00,2019-03-26 17:45:00
68,1,0,1,0.0030592294316243835,2019-03-26 17:30:00,2019-03-26 17:45:00
69,2,1,1,0.004268851374122215,2019-03-26 17:30:00,2019-03-26 17:45:00
70,2,0,2,0.0030592294316243835,2019-03-26 17:30:00,2019-03-26 17:45:00
74,1,1,0,0.010785559311450855,2019-03-26 17:30:00,2019-03-26 17:45:00
79,1,1,0,0.0056598006401844345,2019-03-26 17:30:00,2019-03-26 17:45:00
85,3,1,2,0.015746776424909726,2019-03-26 17:30:00,2019-03-26 17:45:00
86,1,1,0,0.006688095259117876,2019-03-26 17:30:00,2019-03-26 17:45:00
87,3,1,2,0.005320799104914795,2019-03-26 17:30:00,2019-03-26 17:45:00
88,1,1,0,0.008079845182244983,2019-03-26 17:30:00,2019-03-26 17:45:00
89,1,0,1,0.0030592294316243835,2019-03-26 17:30:00,2019-03-26 17:45:00
90,3,2,1,0.006138162573612747,2019-03-26 17:30:00,2019-03-26 17:45:00
104,4,3,1,0.03755084080080013,2019-03-26 17:30:00,2019-03-26 17:45:00
106,2,1,1,0.020305035116212254,2019-03-26 17:30:00,2019-03-26 17:45:00
109,5,1,4,0.008795759447135374,2019-03-26 17:30:00,2019-03-26 17:45:00
110,1,1,0,0.004453942035394778,2019-03-26 17:30:00,2019-03-26 17:45:00
111,4,2,2,0.006715511708685189,2019-03-26 17:30:00,2019-03-26 17:45:00
112,4,1,3,0.004268851374122215,2019-03-26 17:30:00,2019-03-26 17:45:00
113,2,1,1,0.006396705812218824,2019-03-26 17:30:00,2019-03-26 17:45:00
114,2,0,2,0.0030592294316243835,2019-03-26 17:30:00,2019-03-26 17:45:00
115,2,0,2,0.0030592294316243835,2019-03-26 17:30:00,2019-03-26 17:45:00
116,1,1,0,0.004100918731298628,2019-03-26 17:30:00,2019-03-26 17:45:00
119,3,2,1,0.008997277020778875,2019-03-26 17:30:00,2019-03-26 17:45:00
120,5,3,2,0.010969518137245544,2019-03-26 17:30:00,2019-03-26 17:45:00
122,1,1,0,0.009752551348723543,2019-03-26 17:30:00,2019-03-26 17:45:00
126,2,1,1,0.003926086501144401,2019-03-26 17:30:00,2019-03-26 17:45:00
127,3,1,2,0.004359515035904409,2019-03-26 17:30:00,2019-03-26 17:45:00
135,4,1,3,0.004268851374122215,2019-03-26 17:30:00,2019-03-26 17:45:00
137,10,4,6,0.009843938451495617,2019-03-26 17:30:00,2019-03-26 17:45:00
138,7,4,3,0.01596795438405183,2019-03-26 17:30:00,2019-03-26 17:45:00
140,1,1,0,0.008277225659972963,2019-03-26 17:30:00,2019-03-26 17:45:00
153,2,1,1,0.004928540631114916,2019-03-26 17:30:00,2019-03-26 17:45:00
157,2,1,1,0.020305035116212254,2019-03-26 17:30:00,2019-03-26 17:45:00
158,3,0,3,0.0030592294316243835,2019-03-26 17:30:00,2019-03-26 17:45:00
159,2,0,2,0.0030592294316243835,2019-03-26 17:30:00,2019-03-26 17:45:00
162,1,1,0,0.0046629916731787905,2019-03-26 17:30:00,2019-03-26 17:45:00
164,2,2,0,0.00696008624446446,2019-03-26 17:30:00,2019-03-26 17:45:00
168,1,0,1,0.0030592294316243835,2019-03-26 17:30:00,2019-03-26 17:45:00
171,1,0,1,0.0030592294316243835,2019-03-26 17:30:00,2019-03-26 17:45:00
172,2,1,1,0.0046629916731787905,2019-03-26 17:30:00,2019-03-26 17:45:00
173,1,1,0,0.007584084539703264,2019-03-26 17:30:00,2019-03-26 17:45:00
175,2,2,0,0.006131383884862078,2019-03-26 17:30:00,2019-03-26 17:45:00
177,3,2,1,0.03093538183641749,2019-03-26 17:30:00,2019-03-26 17:45:00
189,5,2,3,0.007060840349568005,2019-03-26 17:30:00,2019-03-26 17:45:00
190,5,3,2,0.02709741084749725,2019-03-26 17:30:00,2019-03-26 17:45:00
191,4,3,1,0.01350257652883738,2019-03-26 17:30:00,2019-03-26 17:45:00
195,3,0,3,0.0030592294316243835,2019-03-26 17:30:00,2019-03-26 17:45:00
196,2,1,1,0.010898414679751545,2019-03-26 17:30:00,2019-03-26 17:45:00
197,4,4,0,0.018207091168010878,2019-03-26 17:30:00,2019-03-26 17:45:00
199,1,1,0,0.0037850025971230823,2019-03-26 17:30:00,2019-03-26 17:45:00
200,1,0,1,0.0030592294316243835,2019-03-26 17:30:00,2019-03-26 17:45:00
201,1,1,0,0.0037850025971230823,2019-03-26 17:30:00,2019-03-26 17:45:00
203,3,2,1,0.014924607861845933,2019-03-26 17:30:00,2019-03-26 17:45:00
1,1,1,0,0.005459502556947351,2019-03-26 17:45:00,2019-03-26 18:00:00
2,3,1,2,0.005315582503773613,2019-03-26 17:45:00,2019-03-26 18:00:00
5,1,1,0,0.005654224359920775,2019-03-26 17:45:00,2019-03-26 18:00:00
10,1,1,0,0.004257756336229599,2019-03-26 17:45:00,2019-03-26 18:00:00
15,1,1,0,0.00887414609917973,2019-03-26 17:45:00,2019-03-26 18:00:00
16,1,1,0,0.003981778523352496,2019-03-26 17:45:00,2019-03-26 18:00:00
18,5,1,4,0.0043552120512608365,2019-03-26 17:45:00,2019-03-26 18:00:00
19,2,1,1,0.005654224359920775,2019-03-26 17:45:00,2019-03-26 18:00:00
20,3,1,2,0.0037057058969308674,2019-03-26 17:45:00,2019-03-26 18:00:00
23,4,0,4,0.003056199742600898,2019-03-26 17:45:00,2019-03-26 18:00:00
26,3,1,2,0.00887414609917973,2019-03-26 17:45:00,2019-03-26 18:00:00
27,1,1,0,0.009905813654719682,2019-03-26 17:45:00,2019-03-26 18:00:00
30,1,0,1,0.003056199742600898,2019-03-26 17:45:00,2019-03-26 18:00:00
35,1,0,1,0.003056199742600898,2019-03-26 17:45:00,2019-03-26 18:00:00
40,1,0,1,0.003056199742600898,2019-03-26 17:45:00,2019-03-26 18:00:00
41,4,3,1,0.013054592699099615,2019-03-26 17:45:00,2019-03-26 18:00:00
46,5,2,3,0.006077311386925467,2019-03-26 17:45:00,2019-03-26 18:00:00
50,1,0,1,0.003056199742600898,2019-03-26 17:45:00,2019-03-26 18:00:00
57,3,2,1,0.00943789030637537,2019-03-26 17:45:00,2019-03-26 18:00:00
58,2,1,1,0.003682245519850208,2019-03-26 17:45:00,2019-03-26 18:00:00
61,2,1,1,0.006828302280790404,2019-03-26 17:45:00,2019-03-26 18:00:00
62,5,3,2,0.009834348026119044,2019-03-26 17:45:00,2019-03-26 18:00:00
64,5,3,2,0.010400875376400727,2019-03-26 17:45:00,2019-03-26 18:00:00
66,2,1,1,0.007101323470590728,2019-03-26 17:45:00,2019-03-26 18:00:00
67,2,0,2,0.003056199742600898,2019-03-26 17:45:00,2019-03-26 18:00:00
70,2,0,2,0.003056199742600898,2019-03-26 17:45:00,2019-03-26 18:00:00
74,2,2,0,0.017926138062545845,2019-03-26 17:45:00,2019-03-26 18:00:00
75,1,1,0,0.005874087339904362,2019-03-26 17:45:00,2019-03-26 18:00:00
79,2,2,0,0.008252248977240651,2019-03-26 17:45:00,2019-03-26 18:00:00
80,2,1,1,0.020292201256662333,2019-03-26 17:45:00,2019-03-26 18:00:00
85,2,1,1,0.007574965264946328,2019-03-26 17:45:00,2019-03-26 18:00:00
87,6,1,5,0.003682245519850208,2019-03-26 17:45:00,2019-03-26 18:00:00
88,2,2,0,0.010075244064427273,2019-03-26 17:45:00,2019-03-26 18:00:00
89,1,0,1,0.003056199742600898,2019-03-26 17:45:00,2019-03-26 18:00:00
90,2,2,0,0.005556768644889538,2019-03-26 17:45:00,2019-03-26 18:00:00
104,5,4,1,0.04894464808410756,2019-03-26 17:45:00,2019-03-26 18:00:00
106,2,1,1,0.020292201256662333,2019-03-26 17:45:00,2019-03-26 18:00:00
109,6,1,5,0.007066936434510885,2019-03-26 17:45:00,2019-03-26 18:00:00
110,1,0,1,0.003056199742600898,2019-03-26 17:45:00,2019-03-26 18:00:00
111,6,3,3,0.014153355336002546,2019-03-26 17:45:00,2019-03-26 18:00:00
112,5,3,2,0.008252248977240651,2019-03-26 17:45:00,2019-03-26 18:00:00
113,1,1,0,0.005459502556947351,2019-03-26 17:45:00,2019-03-26 18:00:00
114,2,0,2,0.003056199742600898,2019-03-26 17:45:00,2019-03-26 18:00:00
115,2,1,1,0.005315582503773613,2019-03-26 17:45:00,2019-03-26 18:00:00
116,2,1,1,0.003981778523352496,2019-03-26 17:45:00,2019-03-26 18:00:00
119,5,3,2,0.015198789808283066,2019-03-26 17:45:00,2019-03-26 18:00:00
120,2,1,1,0.011079350093816089,2019-03-26 17:45:00,2019-03-26 18:00:00
122,1,1,0,0.009495706169971882,2019-03-26 17:45:00,2019-03-26 18:00:00
126,3,1,2,0.005654224359920775,2019-03-26 17:45:00,2019-03-26 18:00:00
135,2,0,2,0.003056199742600898,2019-03-26 17:45:00,2019-03-26 18:00:00
137,7,4,3,0.009944066491706444,2019-03-26 17:45:00,2019-03-26 18:00:00
138,6,3,3,0.020530725609380195,2019-03-26 17:45:00,2019-03-26 18:00:00
141,3,1,2,0.005315582503773613,2019-03-26 17:45:00,2019-03-26 18:00:00
151,1,1,0,0.007236323408799167,2019-03-26 17:45:00,2019-03-26 18:00:00
153,4,3,1,0.008057337547178177,2019-03-26 17:45:00,2019-03-26 18:00:00
157,2,1,1,0.020292201256662333,2019-03-26 17:45:00,2019-03-26 18:00:00
158,3,1,2,0.009516572866843251,2019-03-26 17:45:00,2019-03-26 18:00:00
159,2,0,2,0.003056199742600898,2019-03-26 17:45:00,2019-03-26 18:00:00
160,1,0,1,0.003056199742600898,2019-03-26 17:45:00,2019-03-26 18:00:00
164,3,3,0,0.010822496036596175,2019-03-26 17:45:00,2019-03-26 18:00:00
171,1,0,1,0.003056199742600898,2019-03-26 17:45:00,2019-03-26 18:00:00
172,1,0,1,0.003056199742600898,2019-03-26 17:45:00,2019-03-26 18:00:00
173,1,1,0,0.00887414609917973,2019-03-26 17:45:00,2019-03-26 18:00:00
175,1,1,0,0.006563793062633865,2019-03-26 17:45:00,2019-03-26 18:00:00
177,2,1,1,0.020292201256662333,2019-03-26 17:45:00,2019-03-26 18:00:00
190,4,2,2,0.012452719695474228,2019-03-26 17:45:00,2019-03-26 18:00:00
191,4,3,1,0.009964667923817259,2019-03-26 17:45:00,2019-03-26 18:00:00
195,1,0,1,0.003056199742600898,2019-03-26 17:45:00,2019-03-26 18:00:00
196,2,2,0,0.010160126418331496,2019-03-26 17:45:00,2019-03-26 18:00:00
197,2,2,0,0.008998785032101471,2019-03-26 17:45:00,2019-03-26 18:00:00
200,1,0,1,0.003056199742600898,2019-03-26 17:45:00,2019-03-26 18:00:00
201,1,1,0,0.0037057058969308674,2019-03-26 17:45:00,2019-03-26 18:00:00
203,2,1,1,0.005315582503773613,2019-03-26 17:45:00,2019-03-26 18:00:00
1,3,2,1,0.006910999359563195,2019-03-26 18:00:00,2019-03-26 18:15:00
2,5,2,3,0.007011229553801878,2019-03-26 18:00:00,2019-03-26 18:15:00
5,1,1,0,0.005619875534487393,2019-03-26 18:00:00,2019-03-26 18:15:00
10,4,2,2,0.0075848883677648495,2019-03-26 18:00:00,2019-03-26 18:15:00
15,2,1,1,0.0043608516089524325,2019-03-26 18:00:00,2019-03-26 18:15:00
16,2,1,1,0.005619875534487393,2019-03-26 18:00:00,2019-03-26 18:15:00
18,1,0,1,0.0030376278843357875,2019-03-26 18:00:00,2019-03-26 18:15:00
19,1,1,0,0.005619875534487393,2019-03-26 18:00:00,2019-03-26 18:15:00
20,2,1,1,0.0043608516089524325,2019-03-26 18:00:00,2019-03-26 18:15:00
23,2,0,2,0.0030376278843357875,2019-03-26 18:00:00,2019-03-26 18:15:00
26,2,1,1,0.010116502408150152,2019-03-26 18:00:00,2019-03-26 18:15:00
30,1,0,1,0.0030376278843357875,2019-03-26 18:00:00,2019-03-26 18:15:00
40,1,0,1,0.0030376278843357875,2019-03-26 18:00:00,2019-03-26 18:15:00
41,5,4,1,0.014977687423319742,2019-03-26 18:00:00,2019-03-26 18:15:00
46,6,4,2,0.014982731603577522,2019-03-26 18:00:00,2019-03-26 18:15:00
50,1,0,1,0.0030376278843357875,2019-03-26 18:00:00,2019-03-26 18:15:00
57,2,1,1,0.00432875170941159,2019-03-26 18:00:00,2019-03-26 18:15:00
58,4,1,3,0.005283308404927826,2019-03-26 18:00:00,2019-03-26 18:15:00
62,4,2,2,0.009774669446111904,2019-03-26 18:00:00,2019-03-26 18:15:00
64,4,2,2,0.0075848883677648495,2019-03-26 18:00:00,2019-03-26 18:15:00
66,4,4,0,0.009466519265990143,2019-03-26 18:00:00,2019-03-26 18:15:00
67,2,0,2,0.0030376278843357875,2019-03-26 18:00:00,2019-03-26 18:15:00
68,1,0,1,0.0030376278843357875,2019-03-26 18:00:00,2019-03-26 18:15:00
70,1,1,0,0.005619875534487393,2019-03-26 18:00:00,2019-03-26 18:15:00
74,2,2,0,0.024370675865145686,2019-03-26 18:00:00,2019-03-26 18:15:00
75,1,1,0,0.005283308404927826,2019-03-26 18:00:00,2019-03-26 18:15:00
79,1,1,0,0.005619875534487393,2019-03-26 18:00:00,2019-03-26 18:15:00
80,2,1,1,0.020204857181174388,2019-03-26 18:00:00,2019-03-26 18:15:00
85,1,1,0,0.007308952961511158,2019-03-26 18:00:00,2019-03-26 18:15:00
87,3,1,2,0.005283308404927826,2019-03-26 18:00:00,2019-03-26 18:15:00
88,4,4,0,0.01048349335934195,2019-03-26 18:00:00,2019-03-26 18:15:00
90,1,1,0,0.005619875534487393,2019-03-26 18:00:00,2019-03-26 18:15:00
104,3,2,1,0.062489610423938614,2019-03-26 18:00:00,2019-03-26 18:15:00
106,2,1,1,0.020204857181174388,2019-03-26 18:00:00,2019-03-26 18:15:00
109,11,3,8,0.01245225964153817,2019-03-26 18:00:00,2019-03-26 18:15:00
110,1,0,1,0.0030376278843357875,2019-03-26 18:00:00,2019-03-26 18:15:00
111,2,1,1,0.005619875534487393,2019-03-26 18:00:00,2019-03-26 18:15:00
112,3,2,1,0.011407626233225953,2019-03-26 18:00:00,2019-03-26 18:15:00
113,1,0,1,0.0030376278843357875,2019-03-26 18:00:00,2019-03-26 18:15:00
114,1,0,1,0.0030376278843357875,2019-03-26 18:00:00,2019-03-26 18:15:00
119,1,0,1,0.0030376278843357875,2019-03-26 18:00:00,2019-03-26 18:15:00
120,3,2,1,0.010397307733850893,2019-03-26 18:00:00,2019-03-26 18:15:00
122,5,1,4,0.003857418417356858,2019-03-26 18:00:00,2019-03-26 18:15:00
126,1,0,1,0.0030376278843357875,2019-03-26 18:00:00,2019-03-26 18:15:00
127,2,0,2,0.0030376278843357875,2019-03-26 18:00:00,2019-03-26 18:15:00
135,1,0,1,0.0030376278843357875,2019-03-26 18:00:00,2019-03-26 18:15:00
137,3,1,2,0.005283308404927826,2019-03-26 18:00:00,2019-03-26 18:15:00
138,4,2,2,0.01665386823022975,2019-03-26 18:00:00,2019-03-26 18:15:00
141,2,1,1,0.020204857181174388,2019-03-26 18:00:00,2019-03-26 18:15:00
147,1,0,1,0.0030376278843357875,2019-03-26 18:00:00,2019-03-26 18:15:00
151,1,1,0,0.007192421795960299,2019-03-26 18:00:00,2019-03-26 18:15:00
153,3,3,0,0.009188779779696076,2019-03-26 18:00:00,2019-03-26 18:15:00
157,2,1,1,0.020204857181174388,2019-03-26 18:00:00,2019-03-26 18:15:00
158,1,0,1,0.0030376278843357875,2019-03-26 18:00:00,2019-03-26 18:15:00
162,1,0,1,0.0030376278843357875,2019-03-26 18:00:00,2019-03-26 18:15:00
164,9,4,5,0.008901131406674954,2019-03-26 18:00:00,2019-03-26 18:15:00
170,1,1,0,0.006744793385571734,2019-03-26 18:00:00,2019-03-26 18:15:00
171,1,1,0,0.005619875534487393,2019-03-26 18:00:00,2019-03-26 18:15:00
172,2,2,0,0.006943099259104038,2019-03-26 18:00:00,2019-03-26 18:15:00
175,1,1,0,0.012735529193849491,2019-03-26 18:00:00,2019-03-26 18:15:00
177,3,2,1,0.041615354327283374,2019-03-26 18:00:00,2019-03-26 18:15:00
190,3,0,3,0.0030376278843357875,2019-03-26 18:00:00,2019-03-26 18:15:00
191,2,1,1,0.003898377101052989,2019-03-26 18:00:00,2019-03-26 18:15:00
195,3,1,2,0.005283308404927826,2019-03-26 18:00:00,2019-03-26 18:15:00
196,2,1,1,0.00432875170941159,2019-03-26 18:00:00,2019-03-26 18:15:00
197,2,2,0,0.005189500926128791,2019-03-26 18:00:00,2019-03-26 18:15:00
200,1,0,1,0.0030376278843357875,2019-03-26 18:00:00,2019-03-26 18:15:00
201,1,1,0,0.00432875170941159,2019-03-26 18:00:00,2019-03-26 18:15:00
203,2,1,1,0.005024428719068833,2019-03-26 18:00:00,2019-03-26 18:15:00
1,2,1,1,0.004405469762208503,2019-03-26 18:15:00,2019-03-26 18:30:00
2,3,1,2,0.005376903745040646,2019-03-26 18:15:00,2019-03-26 18:30:00
10,1,0,1,0.003091473792990921,2019-03-26 18:15:00,2019-03-26 18:30:00
15,4,2,2,0.005719465731426086,2019-03-26 18:15:00,2019-03-26 18:30:00
18,2,0,2,0.003091473792990921,2019-03-26 18:15:00,2019-03-26 18:30:00
19,2,1,1,0.007115898486217879,2019-03-26 18:15:00,2019-03-26 18:30:00
20,3,2,1,0.004255684873139962,2019-03-26 18:15:00,2019-03-26 18:30:00
23,1,0,1,0.003091473792990921,2019-03-26 18:15:00,2019-03-26 18:30:00
28,1,1,0,0.005201377633303705,2019-03-26 18:15:00,2019-03-26 18:30:00
41,5,3,2,0.011330179469019996,2019-03-26 18:15:00,2019-03-26 18:30:00
46,5,4,1,0.06694114420526032,2019-03-26 18:15:00,2019-03-26 18:30:00
57,2,2,0,0.01045486815288899,2019-03-26 18:15:00,2019-03-26 18:30:00
58,3,0,3,0.003091473792990921,2019-03-26 18:15:00,2019-03-26 18:30:00
62,2,1,1,0.005719465731426086,2019-03-26 18:15:00,2019-03-26 18:30:00
64,1,1,0,0.0036735793330654417,2019-03-26 18:15:00,2019-03-26 18:30:00
66,3,3,0,0.009925470990237733,2019-03-26 18:15:00,2019-03-26 18:30:00
67,1,0,1,0.003091473792990921,2019-03-26 18:15:00,2019-03-26 18:30:00
68,3,2,1,0.005719465731426086,2019-03-26 18:15:00,2019-03-26 18:30:00
69,1,1,0,0.005719465731426086,2019-03-26 18:15:00,2019-03-26 18:30:00
70,1,1,0,0.0079535045580971,2019-03-26 18:15:00,2019-03-26 18:30:00
74,4,2,2,0.013753292659490518,2019-03-26 18:15:00,2019-03-26 18:30:00
85,1,1,0,0.007662333697090371,2019-03-26 18:15:00,2019-03-26 18:30:00
87,5,2,3,0.00713533746879873,2019-03-26 18:15:00,2019-03-26 18:30:00
88,5,2,3,0.010513779237602695,2019-03-26 18:15:00,2019-03-26 18:30:00
90,4,2,2,0.013413186810954731,2019-03-26 18:15:00,2019-03-26 18:30:00
99,1,0,1,0.003091473792990921,2019-03-26 18:15:00,2019-03-26 18:30:00
104,2,1,1,0.02055083750553458,2019-03-26 18:15:00,2019-03-26 18:30:00
106,1,1,0,0.008937432548003044,2019-03-26 18:15:00,2019-03-26 18:30:00
109,11,3,8,0.005478064622334845,2019-03-26 18:15:00,2019-03-26 18:30:00
110,9,4,5,0.007498064394081432,2019-03-26 18:15:00,2019-03-26 18:30:00
111,3,2,1,0.006388233984566822,2019-03-26 18:15:00,2019-03-26 18:30:00
112,3,1,2,0.004963979468876257,2019-03-26 18:15:00,2019-03-26 18:30:00
113,1,0,1,0.003091473792990921,2019-03-26 18:15:00,2019-03-26 18:30:00
114,2,1,1,0.006163310208046398,2019-03-26 18:15:00,2019-03-26 18:30:00
115,1,1,0,0.006163310208046398,2019-03-26 18:15:00,2019-03-26 18:30:00
116,1,1,0,0.0043138535421858035,2019-03-26 18:15:00,2019-03-26 18:30:00
119,3,1,2,0.004405469762208503,2019-03-26 18:15:00,2019-03-26 18:30:00
120,2,1,1,0.0079535045580971,2019-03-26 18:15:00,2019-03-26 18:30:00
122,6,3,3,0.013096412185107213,2019-03-26 18:15:00,2019-03-26 18:30:00
126,2,2,0,0.00834745766986125,2019-03-26 18:15:00,2019-03-26 18:30:00
127,2,0,2,0.003091473792990921,2019-03-26 18:15:00,2019-03-26 18:30:00
135,1,0,1,0.003091473792990921,2019-03-26 18:15:00,2019-03-26 18:30:00
137,8,4,4,0.014453551864613844,2019-03-26 18:15:00,2019-03-26 18:30:00
138,5,3,2,0.026582731745095935,2019-03-26 18:15:00,2019-03-26 18:30:00
140,3,2,1,0.009050129972169127,2019-03-26 18:15:00,2019-03-26 18:30:00
141,2,2,0,0.017462692589079194,2019-03-26 18:15:00,2019-03-26 18:30:00
147,2,0,2,0.003091473792990921,2019-03-26 18:15:00,2019-03-26 18:30:00
151,1,1,0,0.0079535045580971,2019-03-26 18:15:00,2019-03-26 18:30:00
153,5,3,2,0.03801020121807822,2019-03-26 18:15:00,2019-03-26 18:30:00
154,1,0,1,0.003091473792990921,2019-03-26 18:15:00,2019-03-26 18:30:00
157,2,1,1,0.02055083750553458,2019-03-26 18:15:00,2019-03-26 18:30:00
162,1,0,1,0.003091473792990921,2019-03-26 18:15:00,2019-03-26 18:30:00
164,3,1,2,0.0036735793330654417,2019-03-26 18:15:00,2019-03-26 18:30:00
168,1,1,0,0.007115898486217879,2019-03-26 18:15:00,2019-03-26 18:30:00
170,1,1,0,0.00552248917554401,2019-03-26 18:15:00,2019-03-26 18:30:00
172,2,2,0,0.0063015712715006065,2019-03-26 18:15:00,2019-03-26 18:30:00
175,1,1,0,0.005201377633303705,2019-03-26 18:15:00,2019-03-26 18:30:00
177,1,1,0,0.005719465731426086,2019-03-26 18:15:00,2019-03-26 18:30:00
189,8,4,4,0.01893551138052141,2019-03-26 18:15:00,2019-03-26 18:30:00
190,1,0,1,0.003091473792990921,2019-03-26 18:15:00,2019-03-26 18:30:00
191,4,1,3,0.0043138535421858035,2019-03-26 18:15:00,2019-03-26 18:30:00
195,1,0,1,0.003091473792990921,2019-03-26 18:15:00,2019-03-26 18:30:00
196,2,1,1,0.005719465731426086,2019-03-26 18:15:00,2019-03-26 18:30:00
197,1,1,0,0.005719465731426086,2019-03-26 18:15:00,2019-03-26 18:30:00
202,2,0,2,0.003091473792990921,2019-03-26 18:15:00,2019-03-26 18:30:00
203,2,1,1,0.005376903745040646,2019-03-26 18:15:00,2019-03-26 18:30:00
1,1,1,0,0.004432556687481801,2019-03-26 18:30:00,2019-03-26 18:45:00
2,2,1,1,0.021111549073860536,2019-03-26 18:30:00,2019-03-26 18:45:00
10,1,1,0,0.004526694677564825,2019-03-26 18:30:00,2019-03-26 18:45:00
15,3,3,0,0.013248348248863798,2019-03-26 18:30:00,2019-03-26 18:45:00
16,4,3,1,0.011236037170386912,2019-03-26 18:30:00,2019-03-26 18:45:00
18,7,3,4,0.019770494844944527,2019-03-26 18:30:00,2019-03-26 18:45:00
19,2,1,1,0.006248325530408682,2019-03-26 18:30:00,2019-03-26 18:45:00
20,3,2,1,0.004477924204041717,2019-03-26 18:30:00,2019-03-26 18:45:00
23,3,1,2,0.00552485538508544,2019-03-26 18:30:00,2019-03-26 18:45:00
28,1,1,0,0.006783463242063616,2019-03-26 18:30:00,2019-03-26 18:45:00
35,1,0,1,0.003176542533862901,2019-03-26 18:30:00,2019-03-26 18:45:00
41,2,0,2,0.003176542533862901,2019-03-26 18:30:00,2019-03-26 18:45:00
46,4,1,3,0.004432556687481801,2019-03-26 18:30:00,2019-03-26 18:45:00
57,1,1,0,0.008488178448844738,2019-03-26 18:30:00,2019-03-26 18:45:00
58,6,2,4,0.00552485538508544,2019-03-26 18:30:00,2019-03-26 18:45:00
61,6,2,4,0.00552485538508544,2019-03-26 18:30:00,2019-03-26 18:45:00
62,2,2,0,0.00552485538508544,2019-03-26 18:30:00,2019-03-26 18:45:00
64,1,1,0,0.005876846821266749,2019-03-26 18:30:00,2019-03-26 18:45:00
68,3,3,0,0.009683450884756981,2019-03-26 18:30:00,2019-03-26 18:45:00
69,1,1,0,0.005876846821266749,2019-03-26 18:30:00,2019-03-26 18:45:00
74,2,1,1,0.004526694677564825,2019-03-26 18:30:00,2019-03-26 18:45:00
85,4,2,2,0.007544969305854879,2019-03-26 18:30:00,2019-03-26 18:45:00
87,4,3,1,0.06360075257263208,2019-03-26 18:30:00,2019-03-26 18:45:00
88,1,0,1,0.003176542533862901,2019-03-26 18:30:00,2019-03-26 18:45:00
89,1,1,0,0.005876846821266749,2019-03-26 18:30:00,2019-03-26 18:45:00
90,4,2,2,0.009644889282123452,2019-03-26 18:30:00,2019-03-26 18:45:00
99,1,0,1,0.003176542533862901,2019-03-26 18:30:00,2019-03-26 18:45:00
104,2,1,1,0.021111549073860536,2019-03-26 18:30:00,2019-03-26 18:45:00
106,1,1,0,0.007024600723162653,2019-03-26 18:30:00,2019-03-26 18:45:00
108,1,1,0,0.008567083642042946,2019-03-26 18:30:00,2019-03-26 18:45:00
109,6,1,5,0.003827233368952309,2019-03-26 18:30:00,2019-03-26 18:45:00
110,4,2,2,0.00665660339584086,2019-03-26 18:30:00,2019-03-26 18:45:00
111,2,1,1,0.00552485538508544,2019-03-26 18:30:00,2019-03-26 18:45:00
112,4,1,3,0.012728465465752624,2019-03-26 18:30:00,2019-03-26 18:45:00
113,1,1,0,0.007378384149069284,2019-03-26 18:30:00,2019-03-26 18:45:00
114,1,1,0,0.004844665018451031,2019-03-26 18:30:00,2019-03-26 18:45:00
115,1,1,0,0.004844665018451031,2019-03-26 18:30:00,2019-03-26 18:45:00
116,2,1,1,0.004526694677564825,2019-03-26 18:30:00,2019-03-26 18:45:00
118,1,1,0,0.006783463242063616,2019-03-26 18:30:00,2019-03-26 18:45:00
119,2,1,1,0.010459537112048813,2019-03-26 18:30:00,2019-03-26 18:45:00
120,1,0,1,0.003176542533862901,2019-03-26 18:30:00,2019-03-26 18:45:00
122,1,1,0,0.00727605583964001,2019-03-26 18:30:00,2019-03-26 18:45:00
126,3,2,1,0.008225159672489287,2019-03-26 18:30:00,2019-03-26 18:45:00
127,1,1,0,0.00435069895947417,2019-03-26 18:30:00,2019-03-26 18:45:00
135,2,1,1,0.004432556687481801,2019-03-26 18:30:00,2019-03-26 18:45:00
137,9,3,6,0.011773548351116691,2019-03-26 18:30:00,2019-03-26 18:45:00
138,6,3,3,0.01634019451854903,2019-03-26 18:30:00,2019-03-26 18:45:00
140,1,0,1,0.003176542533862901,2019-03-26 18:30:00,2019-03-26 18:45:00
141,5,3,2,0.012681949244929243,2019-03-26 18:30:00,2019-03-26 18:45:00
147,2,0,2,0.003176542533862901,2019-03-26 18:30:00,2019-03-26 18:45:00
153,4,2,2,0.021111549073860536,2019-03-26 18:30:00,2019-03-26 18:45:00
154,1,0,1,0.003176542533862901,2019-03-26 18:30:00,2019-03-26 18:45:00
157,2,1,1,0.021111549073860536,2019-03-26 18:30:00,2019-03-26 18:45:00
158,2,1,1,0.00435069895947417,2019-03-26 18:30:00,2019-03-26 18:45:00
164,2,1,1,0.006783463242063616,2019-03-26 18:30:00,2019-03-26 18:45:00
168,1,0,1,0.003176542533862901,2019-03-26 18:30:00,2019-03-26 18:45:00
170,1,1,0,0.0078068645741128945,2019-03-26 18:30:00,2019-03-26 18:45:00
175,1,0,1,0.003176542533862901,2019-03-26 18:30:00,2019-03-26 18:45:00
189,4,2,2,0.007226998964968673,2019-03-26 18:30:00,2019-03-26 18:45:00
190,2,1,1,0.010168676040099786,2019-03-26 18:30:00,2019-03-26 18:45:00
191,2,0,2,0.003176542533862901,2019-03-26 18:30:00,2019-03-26 18:45:00
196,1,1,0,0.007024600723162653,2019-03-26 18:30:00,2019-03-26 18:45:00
197,1,1,0,0.01182092661892532,2019-03-26 18:30:00,2019-03-26 18:45:00
199,3,1,2,0.00552485538508544,2019-03-26 18:30:00,2019-03-26 18:45:00
202,2,1,1,0.008567083642042946,2019-03-26 18:30:00,2019-03-26 18:45:00
203,1,0,1,0.003176542533862901,2019-03-26 18:30:00,2019-03-26 18:45:00
1,2,1,1,0.004549866866601248,2019-03-26 18:45:00,2019-03-26 19:00:00
5,2,1,1,0.021692528588431126,2019-03-26 18:45:00,2019-03-26 19:00:00
10,1,1,0,0.006032381044988591,2019-03-26 18:45:00,2019-03-26 19:00:00
15,2,2,0,0.008302367691613481,2019-03-26 18:45:00,2019-03-26 19:00:00
16,3,2,1,0.011740696582799106,2019-03-26 18:45:00,2019-03-26 19:00:00
18,4,2,2,0.015069107158842653,2019-03-26 18:45:00,2019-03-26 19:00:00
20,1,0,1,0.003260588684606124,2019-03-26 18:45:00,2019-03-26 19:00:00
23,3,1,2,0.005671119908616625,2019-03-26 18:45:00,2019-03-26 19:00:00
30,1,1,0,0.006032381044988591,2019-03-26 18:45:00,2019-03-26 19:00:00
35,1,0,1,0.003260588684606124,2019-03-26 18:45:00,2019-03-26 19:00:00
37,1,0,1,0.003260588684606124,2019-03-26 18:45:00,2019-03-26 19:00:00
40,1,0,1,0.003260588684606124,2019-03-26 18:45:00,2019-03-26 19:00:00
41,3,0,3,0.003260588684606124,2019-03-26 18:45:00,2019-03-26 19:00:00
46,4,1,3,0.004549866866601248,2019-03-26 18:45:00,2019-03-26 19:00:00
50,1,1,0,0.004184519471400279,2019-03-26 18:45:00,2019-03-26 19:00:00
58,1,0,1,0.003260588684606124,2019-03-26 18:45:00,2019-03-26 19:00:00
61,2,0,2,0.003260588684606124,2019-03-26 18:45:00,2019-03-26 19:00:00
62,2,2,0,0.006032381044988591,2019-03-26 18:45:00,2019-03-26 19:00:00
68,2,1,1,0.006032381044988591,2019-03-26 18:45:00,2019-03-26 19:00:00
69,1,1,0,0.0073176509139930325,2019-03-26 18:45:00,2019-03-26 19:00:00
70,1,0,1,0.003260588684606124,2019-03-26 18:45:00,2019-03-26 19:00:00
74,1,1,0,0.004184519471400279,2019-03-26 18:45:00,2019-03-26 19:00:00
85,5,2,3,0.007321659226983714,2019-03-26 18:45:00,2019-03-26 19:00:00
87,2,1,1,0.021692528588431126,2019-03-26 18:45:00,2019-03-26 19:00:00
89,1,1,0,0.006032381044988591,2019-03-26 18:45:00,2019-03-26 19:00:00
90,2,1,1,0.007128423230591496,2019-03-26 18:45:00,2019-03-26 19:00:00
99,2,1,1,0.004772444300642338,2019-03-26 18:45:00,2019-03-26 19:00:00
104,2,1,1,0.021692528588431126,2019-03-26 18:45:00,2019-03-26 19:00:00
108,1,1,0,0.004772444300642338,2019-03-26 18:45:00,2019-03-26 19:00:00
109,2,1,1,0.021692528588431126,2019-03-26 18:45:00,2019-03-26 19:00:00
111,2,1,1,0.006032381044988591,2019-03-26 18:45:00,2019-03-26 19:00:00
112,4,1,3,0.01324179514743878,2019-03-26 18:45:00,2019-03-26 19:00:00
113,3,2,1,0.06423261932550559,2019-03-26 18:45:00,2019-03-26 19:00:00
114,3,1,2,0.005671119908616625,2019-03-26 18:45:00,2019-03-26 19:00:00
116,1,0,1,0.003260588684606124,2019-03-26 18:45:00,2019-03-26 19:00:00
118,2,2,0,0.009784881870000824,2019-03-26 18:45:00,2019-03-26 19:00:00
119,1,1,0,0.006032381044988591,2019-03-26 18:45:00,2019-03-26 19:00:00
120,1,0,1,0.003260588684606124,2019-03-26 18:45:00,2019-03-26 19:00:00
122,1,1,0,0.009320507601797307,2019-03-26 18:45:00,2019-03-26 19:00:00
126,1,1,0,0.007128423230591496,2019-03-26 18:45:00,2019-03-26 19:00:00
127,1,1,0,0.006032381044988591,2019-03-26 18:45:00,2019-03-26 19:00:00
135,2,1,1,0.004549866866601248,2019-03-26 18:45:00,2019-03-26 19:00:00
137,4,1,3,0.004549866866601248,2019-03-26 18:45:00,2019-03-26 19:00:00
138,5,3,2,0.019411784979935696,2019-03-26 18:45:00,2019-03-26 19:00:00
141,4,1,3,0.005335309596956538,2019-03-26 18:45:00,2019-03-26 19:00:00
147,1,0,1,0.003260588684606124,2019-03-26 18:45:00,2019-03-26 19:00:00
153,2,1,1,0.021692528588431126,2019-03-26 18:45:00,2019-03-26 19:00:00
157,3,2,1,0.03548390863049356,2019-03-26 18:45:00,2019-03-26 19:00:00
164,1,1,0,0.007013089509618358,2019-03-26 18:45:00,2019-03-26 19:00:00
171,2,2,0,0.011160501596436924,2019-03-26 18:45:00,2019-03-26 19:00:00
172,1,0,1,0.003260588684606124,2019-03-26 18:45:00,2019-03-26 19:00:00
173,2,2,0,0.008081651132627125,2019-03-26 18:45:00,2019-03-26 19:00:00
189,2,1,1,0.004184519471400279,2019-03-26 18:45:00,2019-03-26 19:00:00
190,1,0,1,0.003260588684606124,2019-03-26 18:45:00,2019-03-26 19:00:00
191,1,0,1,0.003260588684606124,2019-03-26 18:45:00,2019-03-26 19:00:00
196,1,1,0,0.006032381044988591,2019-03-26 18:45:00,2019-03-26 19:00:00
197,1,1,0,0.006032381044988591,2019-03-26 18:45:00,2019-03-26 19:00:00
199,1,0,1,0.003260588684606124,2019-03-26 18:45:00,2019-03-26 19:00:00
202,2,2,0,0.007544236661024804,2019-03-26 18:45:00,2019-03-26 19:00:00
203,1,0,1,0.003260588684606124,2019-03-26 18:45:00,2019-03-26 19:00:00
1,4,2,2,0.009845282176722418,2019-03-26 19:00:00,2019-03-26 19:15:00
5,4,3,1,0.06350400173269764,2019-03-26 19:00:00,2019-03-26 19:15:00
11,1,1,0,0.008378130103676605,2019-03-26 19:00:00,2019-03-26 19:15:00
15,3,1,2,0.006945804016491414,2019-03-26 19:00:00,2019-03-26 19:15:00
18,1,1,0,0.006945804016491414,2019-03-26 19:00:00,2019-03-26 19:15:00
19,4,2,2,0.005881979353543837,2019-03-26 19:00:00,2019-03-26 19:15:00
20,1,1,0,0.006945804016491414,2019-03-26 19:00:00,2019-03-26 19:15:00
23,2,0,2,0.0037543300276486826,2019-03-26 19:00:00,2019-03-26 19:15:00
28,1,1,0,0.007939112673758707,2019-03-26 19:00:00,2019-03-26 19:15:00
30,1,1,0,0.006945804016491414,2019-03-26 19:00:00,2019-03-26 19:15:00
37,1,0,1,0.0037543300276486826,2019-03-26 19:00:00,2019-03-26 19:15:00
40,1,0,1,0.0037543300276486826,2019-03-26 19:00:00,2019-03-26 19:15:00
41,2,0,2,0.0037543300276486826,2019-03-26 19:00:00,2019-03-26 19:15:00
46,7,2,5,0.011211421902764845,2019-03-26 19:00:00,2019-03-26 19:15:00
58,3,0,3,0.0037543300276486826,2019-03-26 19:00:00,2019-03-26 19:15:00
61,1,1,0,0.005350067022070049,2019-03-26 19:00:00,2019-03-26 19:15:00
66,1,1,0,0.006945804016491414,2019-03-26 19:00:00,2019-03-26 19:15:00
74,1,1,0,0.005350067022070049,2019-03-26 19:00:00,2019-03-26 19:15:00
85,1,1,0,0.006945804016491414,2019-03-26 19:00:00,2019-03-26 19:15:00
87,2,1,1,0.024937961201133063,2019-03-26 19:00:00,2019-03-26 19:15:00
90,3,2,1,0.010137278005334146,2019-03-26 19:00:00,2019-03-26 19:15:00
99,1,1,0,0.006466304961918799,2019-03-26 19:00:00,2019-03-26 19:15:00
104,2,1,1,0.024937961201133063,2019-03-26 19:00:00,2019-03-26 19:15:00
108,1,1,0,0.006466304961918799,2019-03-26 19:00:00,2019-03-26 19:15:00
109,10,5,5,0.015444582121564911,2019-03-26 19:00:00,2019-03-26 19:15:00
110,1,1,0,0.005660499530612394,2019-03-26 19:00:00,2019-03-26 19:15:00
111,1,0,1,0.0037543300276486826,2019-03-26 19:00:00,2019-03-26 19:15:00
112,1,0,1,0.0037543300276486826,2019-03-26 19:00:00,2019-03-26 19:15:00
113,1,0,1,0.0037543300276486826,2019-03-26 19:00:00,2019-03-26 19:15:00
115,1,0,1,0.0037543300276486826,2019-03-26 19:00:00,2019-03-26 19:15:00
119,1,1,0,0.009071130687023317,2019-03-26 19:00:00,2019-03-26 19:15:00
120,1,0,1,0.0037543300276486826,2019-03-26 19:00:00,2019-03-26 19:15:00
122,1,1,0,0.012371909359949262,2019-03-26 19:00:00,2019-03-26 19:15:00
126,2,1,1,0.005350067022070049,2019-03-26 19:00:00,2019-03-26 19:15:00
127,1,0,1,0.0037543300276486826,2019-03-26 19:00:00,2019-03-26 19:15:00
135,1,0,1,0.0037543300276486826,2019-03-26 19:00:00,2019-03-26 19:15:00
137,3,1,2,0.006529791213724908,2019-03-26 19:00:00,2019-03-26 19:15:00
138,4,4,0,0.016041804665905803,2019-03-26 19:00:00,2019-03-26 19:15:00
141,3,1,2,0.006380301056978285,2019-03-26 19:00:00,2019-03-26 19:15:00
157,4,2,2,0.010878217988674279,2019-03-26 19:00:00,2019-03-26 19:15:00
158,1,1,0,0.00481815469059626,2019-03-26 19:00:00,2019-03-26 19:15:00
172,2,1,1,0.006254417912646356,2019-03-26 19:00:00,2019-03-26 19:15:00
173,2,2,0,0.009898067346777242,2019-03-26 19:00:00,2019-03-26 19:15:00
190,1,0,1,0.0037543300276486826,2019-03-26 19:00:00,2019-03-26 19:15:00
196,1,0,1,0.0037543300276486826,2019-03-26 19:00:00,2019-03-26 19:15:00
197,1,1,0,0.006945804016491414,2019-03-26 19:00:00,2019-03-26 19:15:00
202,2,1,1,0.006529791213724908,2019-03-26 19:00:00,2019-03-26 19:15:00
203,1,0,1,0.0037543300276486826,2019-03-26 19:00:00,2019-03-26 19:15:00
1,1,0,1,0.003548409364523118,2019-03-26 19:15:00,2019-03-26 19:30:00
5,5,4,1,0.11423308064784649,2019-03-26 19:15:00,2019-03-26 19:30:00
11,1,1,0,0.0061717552681335025,2019-03-26 19:15:00,2019-03-26 19:30:00
15,2,2,0,0.005002178464749191,2019-03-26 19:15:00,2019-03-26 19:30:00
19,6,4,2,0.015162216653826862,2019-03-26 19:15:00,2019-03-26 19:30:00
23,3,0,3,0.003548409364523118,2019-03-26 19:15:00,2019-03-26 19:30:00
28,1,1,0,0.006564891972499325,2019-03-26 19:15:00,2019-03-26 19:30:00
30,1,1,0,0.006564891972499325,2019-03-26 19:15:00,2019-03-26 19:30:00
37,1,0,1,0.003548409364523118,2019-03-26 19:15:00,2019-03-26 19:30:00
40,1,0,1,0.003548409364523118,2019-03-26 19:15:00,2019-03-26 19:30:00
41,1,0,1,0.003548409364523118,2019-03-26 19:15:00,2019-03-26 19:30:00
46,6,1,5,0.0042752939146361545,2019-03-26 19:15:00,2019-03-26 19:30:00
58,2,0,2,0.003548409364523118,2019-03-26 19:15:00,2019-03-26 19:30:00
61,1,1,0,0.004553903567181853,2019-03-26 19:15:00,2019-03-26 19:30:00
66,1,1,0,0.006564891972499325,2019-03-26 19:15:00,2019-03-26 19:30:00
74,1,1,0,0.006564891972499325,2019-03-26 19:15:00,2019-03-26 19:30:00
85,1,1,0,0.006564891972499325,2019-03-26 19:15:00,2019-03-26 19:30:00
87,2,1,1,0.023604927354518877,2019-03-26 19:15:00,2019-03-26 19:30:00
90,3,2,1,0.009581374580475532,2019-03-26 19:15:00,2019-03-26 19:30:00
99,1,1,0,0.007847071705186887,2019-03-26 19:15:00,2019-03-26 19:30:00
104,2,1,1,0.023604927354518877,2019-03-26 19:15:00,2019-03-26 19:30:00
109,2,0,2,0.003548409364523118,2019-03-26 19:15:00,2019-03-26 19:30:00
110,2,1,1,0.0042752939146361545,2019-03-26 19:15:00,2019-03-26 19:30:00
111,2,0,2,0.003548409364523118,2019-03-26 19:15:00,2019-03-26 19:30:00
115,1,0,1,0.003548409364523118,2019-03-26 19:15:00,2019-03-26 19:30:00
116,2,1,1,0.006564891972499325,2019-03-26 19:15:00,2019-03-26 19:30:00
120,1,0,1,0.003548409364523118,2019-03-26 19:15:00,2019-03-26 19:30:00
122,1,1,0,0.011693610903249572,2019-03-26 19:15:00,2019-03-26 19:30:00
126,2,0,2,0.003548409364523118,2019-03-26 19:15:00,2019-03-26 19:30:00
127,1,0,1,0.003548409364523118,2019-03-26 19:15:00,2019-03-26 19:30:00
133,1,1,0,0.007182832115088299,2019-03-26 19:15:00,2019-03-26 19:30:00
135,1,0,1,0.003548409364523118,2019-03-26 19:15:00,2019-03-26 19:30:00
137,1,0,1,0.003548409364523118,2019-03-26 19:15:00,2019-03-26 19:30:00
138,2,2,0,0.008073133276487428,2019-03-26 19:15:00,2019-03-26 19:30:00
141,2,1,1,0.005056650668511221,2019-03-26 19:15:00,2019-03-26 19:30:00
153,3,2,1,0.033633186349516765,2019-03-26 19:15:00,2019-03-26 19:30:00
154,1,1,0,0.004553903567181853,2019-03-26 19:15:00,2019-03-26 19:30:00
157,3,1,2,0.0061717552681335025,2019-03-26 19:15:00,2019-03-26 19:30:00
158,3,2,1,0.010720109432505023,2019-03-26 19:15:00,2019-03-26 19:30:00
164,1,1,0,0.005056650668511221,2019-03-26 19:15:00,2019-03-26 19:30:00
172,1,1,0,0.009993224882391988,2019-03-26 19:15:00,2019-03-26 19:30:00
173,2,2,0,0.006062144871169957,2019-03-26 19:15:00,2019-03-26 19:30:00
190,1,0,1,0.003548409364523118,2019-03-26 19:15:00,2019-03-26 19:30:00
191,1,0,1,0.003548409364523118,2019-03-26 19:15:00,2019-03-26 19:30:00
196,1,0,1,0.003548409364523118,2019-03-26 19:15:00,2019-03-26 19:30:00
197,1,1,0,0.006564891972499325,2019-03-26 19:15:00,2019-03-26 19:30:00
202,1,1,0,0.006564891972499325,2019-03-26 19:15:00,2019-03-26 19:30:00
203,1,0,1,0.003548409364523118,2019-03-26 19:15:00,2019-03-26 19:30:00
5,1,1,0,0.013358539653991553,2019-03-26 19:30:00,2019-03-26 19:45:00
11,1,1,0,0.006869708006972084,2019-03-26 19:30:00,2019-03-26 19:45:00
15,3,2,1,0.006081633489568736,2019-03-26 19:30:00,2019-03-26 19:45:00
19,1,0,1,0.00394974211044302,2019-03-26 19:30:00,2019-03-26 19:45:00
23,2,1,1,0.005628549597781505,2019-03-26 19:30:00,2019-03-26 19:45:00
28,1,0,1,0.00394974211044302,2019-03-26 19:30:00,2019-03-26 19:45:00
41,3,1,2,0.007307357085119989,2019-03-26 19:30:00,2019-03-26 19:45:00
46,5,1,4,0.005015687800005878,2019-03-26 19:30:00,2019-03-26 19:45:00
58,1,0,1,0.00394974211044302,2019-03-26 19:30:00,2019-03-26 19:45:00
61,1,1,0,0.008734513396461046,2019-03-26 19:30:00,2019-03-26 19:45:00
70,1,0,1,0.00394974211044302,2019-03-26 19:30:00,2019-03-26 19:45:00
74,1,1,0,0.007055705909122561,2019-03-26 19:30:00,2019-03-26 19:45:00
80,4,2,2,0.026201304399966492,2019-03-26 19:30:00,2019-03-26 19:45:00
85,1,1,0,0.007307357085119989,2019-03-26 19:30:00,2019-03-26 19:45:00
87,2,1,1,0.026201304399966492,2019-03-26 19:30:00,2019-03-26 19:45:00
90,2,1,1,0.010161669707802102,2019-03-26 19:30:00,2019-03-26 19:45:00
99,1,1,0,0.007307357085119989,2019-03-26 19:30:00,2019-03-26 19:45:00
104,2,1,1,0.026201304399966492,2019-03-26 19:30:00,2019-03-26 19:45:00
109,2,1,1,0.011067837491376565,2019-03-26 19:30:00,2019-03-26 19:45:00
110,1,0,1,0.00394974211044302,2019-03-26 19:30:00,2019-03-26 19:45:00
111,1,0,1,0.00394974211044302,2019-03-26 19:30:00,2019-03-26 19:45:00
116,3,3,0,0.0137709358584765,2019-03-26 19:30:00,2019-03-26 19:45:00
120,1,0,1,0.00394974211044302,2019-03-26 19:30:00,2019-03-26 19:45:00
122,1,1,0,0.012588181142375815,2019-03-26 19:30:00,2019-03-26 19:45:00
133,1,1,0,0.007307357085119989,2019-03-26 19:30:00,2019-03-26 19:45:00
135,2,1,1,0.007307357085119989,2019-03-26 19:30:00,2019-03-26 19:45:00
137,2,0,2,0.00394974211044302,2019-03-26 19:30:00,2019-03-26 19:45:00
138,2,2,0,0.010664972059796957,2019-03-26 19:30:00,2019-03-26 19:45:00
141,1,0,1,0.00394974211044302,2019-03-26 19:30:00,2019-03-26 19:45:00
157,3,1,2,0.006869708006972084,2019-03-26 19:30:00,2019-03-26 19:45:00
158,3,2,1,0.008373302774682847,2019-03-26 19:30:00,2019-03-26 19:45:00
168,1,0,1,0.00394974211044302,2019-03-26 19:30:00,2019-03-26 19:45:00
175,2,1,1,0.026201304399966492,2019-03-26 19:30:00,2019-03-26 19:45:00
190,1,0,1,0.00394974211044302,2019-03-26 19:30:00,2019-03-26 19:45:00
191,1,0,1,0.00394974211044302,2019-03-26 19:30:00,2019-03-26 19:45:00
196,1,1,0,0.007307357085119989,2019-03-26 19:30:00,2019-03-26 19:45:00
197,1,1,0,0.007307357085119989,2019-03-26 19:30:00,2019-03-26 19:45:00
202,2,2,0,0.010798500139607398,2019-03-26 19:30:00,2019-03-26 19:45:00
203,1,0,1,0.00394974211044302,2019-03-26 19:30:00,2019-03-26 19:45:00
5,1,1,0,0.007275515029094891,2019-03-26 19:45:00,2019-03-26 20:00:00
19,1,1,0,0.005604026191851871,2019-03-26 19:45:00,2019-03-26 20:00:00
23,2,1,1,0.007275515029094891,2019-03-26 19:45:00,2019-03-26 20:00:00
28,1,0,1,0.003932537354608852,2019-03-26 19:45:00,2019-03-26 20:00:00
30,1,0,1,0.003932537354608852,2019-03-26 19:45:00,2019-03-26 20:00:00
35,1,1,0,0.007275515029094891,2019-03-26 19:45:00,2019-03-26 20:00:00
41,2,1,1,0.007275515029094891,2019-03-26 19:45:00,2019-03-26 20:00:00
46,2,1,1,0.026120137601164967,2019-03-26 19:45:00,2019-03-26 20:00:00
50,1,0,1,0.003932537354608852,2019-03-26 19:45:00,2019-03-26 20:00:00
58,1,0,1,0.003932537354608852,2019-03-26 19:45:00,2019-03-26 20:00:00
61,1,1,0,0.010117374070168392,2019-03-26 19:45:00,2019-03-26 20:00:00
68,1,1,0,0.007275515029094891,2019-03-26 19:45:00,2019-03-26 20:00:00
70,1,0,1,0.003932537354608852,2019-03-26 19:45:00,2019-03-26 20:00:00
74,1,1,0,0.010117374070168392,2019-03-26 19:45:00,2019-03-26 20:00:00
85,1,1,0,0.007275515029094891,2019-03-26 19:45:00,2019-03-26 20:00:00
87,2,1,1,0.026120137601164967,2019-03-26 19:45:00,2019-03-26 20:00:00
88,1,0,1,0.003932537354608852,2019-03-26 19:45:00,2019-03-26 20:00:00
90,1,1,0,0.010117374070168392,2019-03-26 19:45:00,2019-03-26 20:00:00
99,1,1,0,0.010117374070168392,2019-03-26 19:45:00,2019-03-26 20:00:00
104,2,1,1,0.026120137601164967,2019-03-26 19:45:00,2019-03-26 20:00:00
109,1,1,0,0.005604026191851871,2019-03-26 19:45:00,2019-03-26 20:00:00
111,4,1,3,0.005487487827405525,2019-03-26 19:45:00,2019-03-26 20:00:00
112,1,0,1,0.003932537354608852,2019-03-26 19:45:00,2019-03-26 20:00:00
116,1,1,0,0.007275515029094891,2019-03-26 19:45:00,2019-03-26 20:00:00
120,1,0,1,0.003932537354608852,2019-03-26 19:45:00,2019-03-26 20:00:00
126,1,0,1,0.003932537354608852,2019-03-26 19:45:00,2019-03-26 20:00:00
127,1,1,0,0.007275515029094891,2019-03-26 19:45:00,2019-03-26 20:00:00
135,2,1,1,0.007275515029094891,2019-03-26 19:45:00,2019-03-26 20:00:00
137,1,0,1,0.003932537354608852,2019-03-26 19:45:00,2019-03-26 20:00:00
138,2,2,0,0.008830465501891564,2019-03-26 19:45:00,2019-03-26 20:00:00
141,2,1,1,0.007275515029094891,2019-03-26 19:45:00,2019-03-26 20:00:00
153,1,1,0,0.007275515029094891,2019-03-26 19:45:00,2019-03-26 20:00:00
157,2,1,1,0.026120137601164967,2019-03-26 19:45:00,2019-03-26 20:00:00
158,2,0,2,0.003932537354608852,2019-03-26 19:45:00,2019-03-26 20:00:00
164,1,0,1,0.003932537354608852,2019-03-26 19:45:00,2019-03-26 20:00:00
168,1,0,1,0.003932537354608852,2019-03-26 19:45:00,2019-03-26 20:00:00
171,1,0,1,0.003932537354608852,2019-03-26 19:45:00,2019-03-26 20:00:00
175,2,1,1,0.026120137601164967,2019-03-26 19:45:00,2019-03-26 20:00:00
190,1,0,1,0.003932537354608852,2019-03-26 19:45:00,2019-03-26 20:00:00
191,1,1,0,0.007275515029094891,2019-03-26 19:45:00,2019-03-26 20:00:00
196,1,1,0,0.007275515029094891,2019-03-26 19:45:00,2019-03-26 20:00:00
197,1,1,0,0.007275515029094891,2019-03-26 19:45:00,2019-03-26 20:00:00
199,1,1,0,0.005487487827405525,2019-03-26 19:45:00,2019-03-26 20:00:00
203,1,0,1,0.003932537354608852,2019-03-26 19:45:00,2019-03-26 20:00:00
5,1,1,0,0.008198651159554107,2019-03-26 20:00:00,2019-03-26 20:15:00
10,1,1,0,0.010075238975585092,2019-03-26 20:00:00,2019-03-26 20:15:00
18,1,1,0,0.008198651159554107,2019-03-26 20:00:00,2019-03-26 20:15:00
19,1,1,0,0.007245151782810565,2019-03-26 20:00:00,2019-03-26 20:15:00
23,2,1,1,0.007245151782810565,2019-03-26 20:00:00,2019-03-26 20:15:00
30,1,0,1,0.003916093291608584,2019-03-26 20:00:00,2019-03-26 20:15:00
35,1,1,0,0.007245151782810565,2019-03-26 20:00:00,2019-03-26 20:15:00
41,1,0,1,0.003916093291608584,2019-03-26 20:00:00,2019-03-26 20:15:00
46,2,1,1,0.025991544411263848,2019-03-26 20:00:00,2019-03-26 20:15:00
58,3,1,2,0.00681127122047356,2019-03-26 20:00:00,2019-03-26 20:15:00
61,1,1,0,0.010075238975585092,2019-03-26 20:00:00,2019-03-26 20:15:00
62,1,1,0,0.007245151782810565,2019-03-26 20:00:00,2019-03-26 20:15:00
74,1,1,0,0.007245151782810565,2019-03-26 20:00:00,2019-03-26 20:15:00
85,1,1,0,0.007245151782810565,2019-03-26 20:00:00,2019-03-26 20:15:00
87,2,1,1,0.025991544411263848,2019-03-26 20:00:00,2019-03-26 20:15:00
88,1,0,1,0.003916093291608584,2019-03-26 20:00:00,2019-03-26 20:15:00
89,1,0,1,0.003916093291608584,2019-03-26 20:00:00,2019-03-26 20:15:00
90,2,1,1,0.007245151782810565,2019-03-26 20:00:00,2019-03-26 20:15:00
104,2,1,1,0.025991544411263848,2019-03-26 20:00:00,2019-03-26 20:15:00
109,1,1,0,0.00681127122047356,2019-03-26 20:00:00,2019-03-26 20:15:00
111,2,0,2,0.003916093291608584,2019-03-26 20:00:00,2019-03-26 20:15:00
112,1,0,1,0.003916093291608584,2019-03-26 20:00:00,2019-03-26 20:15:00
116,1,1,0,0.007245151782810565,2019-03-26 20:00:00,2019-03-26 20:15:00
120,4,2,2,0.01260162707820351,2019-03-26 20:00:00,2019-03-26 20:15:00
126,1,0,1,0.003916093291608584,2019-03-26 20:00:00,2019-03-26 20:15:00
127,2,1,1,0.007245151782810565,2019-03-26 20:00:00,2019-03-26 20:15:00
135,1,0,1,0.003916093291608584,2019-03-26 20:00:00,2019-03-26 20:15:00
138,2,2,0,0.010937097832602521,2019-03-26 20:00:00,2019-03-26 20:15:00
141,1,1,0,0.007245151782810565,2019-03-26 20:00:00,2019-03-26 20:15:00
153,1,0,1,0.003916093291608584,2019-03-26 20:00:00,2019-03-26 20:15:00
157,2,1,1,0.025991544411263848,2019-03-26 20:00:00,2019-03-26 20:15:00
158,1,0,1,0.003916093291608584,2019-03-26 20:00:00,2019-03-26 20:15:00
161,2,1,1,0.025991544411263848,2019-03-26 20:00:00,2019-03-26 20:15:00
164,3,1,2,0.010075238975585092,2019-03-26 20:00:00,2019-03-26 20:15:00
168,1,0,1,0.003916093291608584,2019-03-26 20:00:00,2019-03-26 20:15:00
190,1,0,1,0.003916093291608584,2019-03-26 20:00:00,2019-03-26 20:15:00
197,1,1,0,0.007245151782810565,2019-03-26 20:00:00,2019-03-26 20:15:00
199,1,1,0,0.005580622537209574,2019-03-26 20:00:00,2019-03-26 20:15:00
203,1,0,1,0.003916093291608584,2019-03-26 20:00:00,2019-03-26 20:15:00
5,2,2,0,0.01809267659682216,2019-03-26 20:15:00,2019-03-26 20:30:00
10,1,1,0,0.007283033195698976,2019-03-26 20:15:00,2019-03-26 20:30:00
18,3,2,1,0.011587984237405653,2019-03-26 20:15:00,2019-03-26 20:30:00
23,2,1,1,0.010127918728985264,2019-03-26 20:15:00,2019-03-26 20:30:00
41,1,0,1,0.003936568246579925,2019-03-26 20:15:00,2019-03-26 20:30:00
46,2,1,1,0.026127832943001715,2019-03-26 20:15:00,2019-03-26 20:30:00
61,1,1,0,0.01254647032999328,2019-03-26 20:15:00,2019-03-26 20:30:00
62,1,1,0,0.007283033195698976,2019-03-26 20:15:00,2019-03-26 20:30:00
74,1,1,0,0.007283033195698976,2019-03-26 20:15:00,2019-03-26 20:30:00
85,1,1,0,0.007283033195698976,2019-03-26 20:15:00,2019-03-26 20:30:00
87,2,1,1,0.026127832943001715,2019-03-26 20:15:00,2019-03-26 20:30:00
88,1,1,0,0.006846884802434102,2019-03-26 20:15:00,2019-03-26 20:30:00
89,2,0,2,0.003936568246579925,2019-03-26 20:15:00,2019-03-26 20:30:00
90,2,1,1,0.007283033195698976,2019-03-26 20:15:00,2019-03-26 20:30:00
104,2,1,1,0.026127832943001715,2019-03-26 20:15:00,2019-03-26 20:30:00
109,1,1,0,0.0061548035382641576,2019-03-26 20:15:00,2019-03-26 20:30:00
111,2,0,2,0.003936568246579925,2019-03-26 20:15:00,2019-03-26 20:30:00
120,5,2,3,0.007828036012823683,2019-03-26 20:15:00,2019-03-26 20:30:00
126,3,2,1,0.007283033195698976,2019-03-26 20:15:00,2019-03-26 20:30:00
127,1,0,1,0.003936568246579925,2019-03-26 20:15:00,2019-03-26 20:30:00
135,1,0,1,0.003936568246579925,2019-03-26 20:15:00,2019-03-26 20:30:00
138,2,2,0,0.007828036012823683,2019-03-26 20:15:00,2019-03-26 20:30:00
151,1,1,0,0.005609800721139451,2019-03-26 20:15:00,2019-03-26 20:30:00
153,1,0,1,0.003936568246579925,2019-03-26 20:15:00,2019-03-26 20:30:00
157,2,1,1,0.026127832943001715,2019-03-26 20:15:00,2019-03-26 20:30:00
161,2,1,1,0.026127832943001715,2019-03-26 20:15:00,2019-03-26 20:30:00
164,3,1,2,0.010127918728985264,2019-03-26 20:15:00,2019-03-26 20:30:00
189,3,1,2,0.006846884802434102,2019-03-26 20:15:00,2019-03-26 20:30:00
196,2,0,2,0.003936568246579925,2019-03-26 20:15:00,2019-03-26 20:30:00
199,1,1,0,0.005609800721139451,2019-03-26 20:15:00,2019-03-26 20:30:00
201,1,0,1,0.003936568246579925,2019-03-26 20:15:00,2019-03-26 20:30:00
203,1,0,1,0.003936568246579925,2019-03-26 20:15:00,2019-03-26 20:30:00
5,1,1,0,0.010332529060611243,2019-03-26 20:30:00,2019-03-26 20:45:00
18,2,1,1,0.007430220294267849,2019-03-26 20:30:00,2019-03-26 20:45:00
20,1,0,1,0.00401614990600423,2019-03-26 20:30:00,2019-03-26 20:45:00
23,6,2,4,0.006985215561764926,2019-03-26 20:30:00,2019-03-26 20:45:00
28,1,1,0,0.005500682733884578,2019-03-26 20:30:00,2019-03-26 20:45:00
35,1,1,0,0.007430220294267849,2019-03-26 20:30:00,2019-03-26 20:45:00
37,1,0,1,0.00401614990600423,2019-03-26 20:30:00,2019-03-26 20:45:00
41,2,1,1,0.007430220294267849,2019-03-26 20:30:00,2019-03-26 20:45:00
46,4,2,2,0.01797146871980186,2019-03-26 20:30:00,2019-03-26 20:45:00
61,1,1,0,0.005500682733884578,2019-03-26 20:30:00,2019-03-26 20:45:00
74,1,1,0,0.010332529060611243,2019-03-26 20:30:00,2019-03-26 20:45:00
85,1,1,0,0.007430220294267849,2019-03-26 20:30:00,2019-03-26 20:45:00
87,2,1,1,0.026642938573436255,2019-03-26 20:30:00,2019-03-26 20:45:00
88,1,1,0,0.006985215561764926,2019-03-26 20:30:00,2019-03-26 20:45:00
89,1,0,1,0.00401614990600423,2019-03-26 20:30:00,2019-03-26 20:45:00
90,2,2,0,0.008914753122148197,2019-03-26 20:30:00,2019-03-26 20:45:00
104,2,1,1,0.026642938573436255,2019-03-26 20:30:00,2019-03-26 20:45:00
109,1,1,0,0.00572318510013604,2019-03-26 20:30:00,2019-03-26 20:45:00
110,1,1,0,0.007430220294267849,2019-03-26 20:30:00,2019-03-26 20:45:00
111,1,1,0,0.007430220294267849,2019-03-26 20:30:00,2019-03-26 20:45:00
112,1,0,1,0.00401614990600423,2019-03-26 20:30:00,2019-03-26 20:45:00
120,2,0,2,0.00401614990600423,2019-03-26 20:30:00,2019-03-26 20:45:00
126,3,2,1,0.007430220294267849,2019-03-26 20:30:00,2019-03-26 20:45:00
133,1,0,1,0.00401614990600423,2019-03-26 20:30:00,2019-03-26 20:45:00
135,1,0,1,0.00401614990600423,2019-03-26 20:30:00,2019-03-26 20:45:00
138,1,1,0,0.00572318510013604,2019-03-26 20:30:00,2019-03-26 20:45:00
151,1,1,0,0.007430220294267849,2019-03-26 20:30:00,2019-03-26 20:45:00
153,6,2,4,0.006985215561764926,2019-03-26 20:30:00,2019-03-26 20:45:00
157,2,1,1,0.026642938573436255,2019-03-26 20:30:00,2019-03-26 20:45:00
161,2,1,1,0.026642938573436255,2019-03-26 20:30:00,2019-03-26 20:45:00
171,1,1,0,0.011655089565194846,2019-03-26 20:30:00,2019-03-26 20:45:00
189,3,1,2,0.006985215561764926,2019-03-26 20:30:00,2019-03-26 20:45:00
196,2,0,2,0.00401614990600423,2019-03-26 20:30:00,2019-03-26 20:45:00
199,1,1,0,0.005500682733884578,2019-03-26 20:30:00,2019-03-26 20:45:00
201,1,0,1,0.00401614990600423,2019-03-26 20:30:00,2019-03-26 20:45:00
203,1,0,1,0.00401614990600423,2019-03-26 20:30:00,2019-03-26 20:45:00
15,3,1,2,0.00503758346809264,2019-03-26 20:45:00,2019-03-26 21:00:00
16,8,2,6,0.007178788999042573,2019-03-26 20:45:00,2019-03-26 21:00:00
23,4,1,3,0.007438218205924073,2019-03-26 20:45:00,2019-03-26 21:00:00
28,1,1,0,0.006128199320705154,2019-03-26 20:45:00,2019-03-26 21:00:00
37,1,0,1,0.004020471403049384,2019-03-26 20:45:00,2019-03-26 21:00:00
41,1,0,1,0.004020471403049384,2019-03-26 20:45:00,2019-03-26 21:00:00
46,4,2,2,0.01293726769087263,2019-03-26 20:45:00,2019-03-26 21:00:00
57,2,0,2,0.004020471403049384,2019-03-26 20:45:00,2019-03-26 21:00:00
58,2,1,1,0.00564395982902305,2019-03-26 20:45:00,2019-03-26 21:00:00
61,1,1,0,0.006128199320705154,2019-03-26 20:45:00,2019-03-26 21:00:00
74,1,1,0,0.007438218205924073,2019-03-26 20:45:00,2019-03-26 21:00:00
85,1,1,0,0.007438218205924073,2019-03-26 20:45:00,2019-03-26 21:00:00
87,2,1,1,0.026671300636181706,2019-03-26 20:45:00,2019-03-26 21:00:00
88,1,0,1,0.004020471403049384,2019-03-26 20:45:00,2019-03-26 21:00:00
89,1,0,1,0.004020471403049384,2019-03-26 20:45:00,2019-03-26 21:00:00
90,2,2,0,0.00910046474997957,2019-03-26 20:45:00,2019-03-26 21:00:00
104,2,1,1,0.026671300636181706,2019-03-26 20:45:00,2019-03-26 21:00:00
109,4,1,3,0.005729344804486728,2019-03-26 20:45:00,2019-03-26 21:00:00
110,2,2,0,0.01085596500879876,2019-03-26 20:45:00,2019-03-26 21:00:00
111,3,2,1,0.009061706631897738,2019-03-26 20:45:00,2019-03-26 21:00:00
112,1,1,0,0.00564395982902305,2019-03-26 20:45:00,2019-03-26 21:00:00
120,2,0,2,0.004020471403049384,2019-03-26 20:45:00,2019-03-26 21:00:00
126,1,0,1,0.004020471403049384,2019-03-26 20:45:00,2019-03-26 21:00:00
127,2,2,0,0.006054695533135895,2019-03-26 20:45:00,2019-03-26 21:00:00
133,1,0,1,0.004020471403049384,2019-03-26 20:45:00,2019-03-26 21:00:00
135,3,1,2,0.0069927368323237996,2019-03-26 20:45:00,2019-03-26 21:00:00
138,3,3,0,0.009147091607361418,2019-03-26 20:45:00,2019-03-26 21:00:00
151,1,1,0,0.007438218205924073,2019-03-26 20:45:00,2019-03-26 21:00:00
153,1,0,1,0.004020471403049384,2019-03-26 20:45:00,2019-03-26 21:00:00
157,2,1,1,0.026671300636181706,2019-03-26 20:45:00,2019-03-26 21:00:00
158,2,2,0,0.016521686505155328,2019-03-26 20:45:00,2019-03-26 21:00:00
161,2,1,1,0.026671300636181706,2019-03-26 20:45:00,2019-03-26 21:00:00
164,2,2,0,0.006054695533135895,2019-03-26 20:45:00,2019-03-26 21:00:00
171,1,1,0,0.009519520887997943,2019-03-26 20:45:00,2019-03-26 21:00:00
196,1,1,0,0.006161676933999317,2019-03-26 20:45:00,2019-03-26 21:00:00
203,1,0,1,0.004020471403049384,2019-03-26 20:45:00,2019-03-26 21:00:00
15,3,2,1,0.012452051497888823,2019-03-26 21:00:00,2019-03-26 21:15:00
16,2,0,2,0.003778586849457856,2019-03-26 21:00:00,2019-03-26 21:15:00
23,2,0,2,0.003778586849457856,2019-03-26 21:00:00,2019-03-26 21:15:00
35,1,0,1,0.003778586849457856,2019-03-26 21:00:00,2019-03-26 21:15:00
41,2,1,1,0.006250016907999947,2019-03-26 21:00:00,2019-03-26 21:15:00
46,2,1,1,0.025078769433567707,2019-03-26 21:00:00,2019-03-26 21:15:00
57,2,0,2,0.003778586849457856,2019-03-26 21:00:00,2019-03-26 21:15:00
58,2,1,1,0.02010282742085181,2019-03-26 21:00:00,2019-03-26 21:15:00
61,1,1,0,0.005384655846618846,2019-03-26 21:00:00,2019-03-26 21:15:00
74,1,1,0,0.009091800934431984,2019-03-26 21:00:00,2019-03-26 21:15:00
85,1,1,0,0.006990724843779836,2019-03-26 21:00:00,2019-03-26 21:15:00
86,1,1,0,0.005384655846618846,2019-03-26 21:00:00,2019-03-26 21:15:00
87,2,1,1,0.025078769433567707,2019-03-26 21:00:00,2019-03-26 21:15:00
89,2,2,0,0.010202862838101815,2019-03-26 21:00:00,2019-03-26 21:15:00
90,1,1,0,0.005384655846618846,2019-03-26 21:00:00,2019-03-26 21:15:00
104,2,1,1,0.025078769433567707,2019-03-26 21:00:00,2019-03-26 21:15:00
109,1,0,1,0.003778586849457856,2019-03-26 21:00:00,2019-03-26 21:15:00
111,2,1,1,0.006990724843779836,2019-03-26 21:00:00,2019-03-26 21:15:00
119,1,1,0,0.006990724843779836,2019-03-26 21:00:00,2019-03-26 21:15:00
120,1,0,1,0.003778586849457856,2019-03-26 21:00:00,2019-03-26 21:15:00
126,5,2,3,0.008721446966542038,2019-03-26 21:00:00,2019-03-26 21:15:00
127,4,3,1,0.019202072024631187,2019-03-26 21:00:00,2019-03-26 21:15:00
135,2,0,2,0.003778586849457856,2019-03-26 21:00:00,2019-03-26 21:15:00
138,5,3,2,0.010202862838101815,2019-03-26 21:00:00,2019-03-26 21:15:00
140,1,0,1,0.003778586849457856,2019-03-26 21:00:00,2019-03-26 21:15:00
141,1,0,1,0.003778586849457856,2019-03-26 21:00:00,2019-03-26 21:15:00
153,1,1,0,0.005384655846618846,2019-03-26 21:00:00,2019-03-26 21:15:00
157,2,1,1,0.025078769433567707,2019-03-26 21:00:00,2019-03-26 21:15:00
158,2,2,0,0.026811660153021506,2019-03-26 21:00:00,2019-03-26 21:15:00
161,2,1,1,0.025078769433567707,2019-03-26 21:00:00,2019-03-26 21:15:00
164,1,0,1,0.003778586849457856,2019-03-26 21:00:00,2019-03-26 21:15:00
196,2,1,1,0.014364221887669875,2019-03-26 21:00:00,2019-03-26 21:15:00
201,1,1,0,0.006990724843779836,2019-03-26 21:00:00,2019-03-26 21:15:00
203,1,0,1,0.003778586849457856,2019-03-26 21:00:00,2019-03-26 21:15:00
19,2,0,2,0.003610355766937766,2019-03-26 21:15:00,2019-03-26 21:30:00
23,2,0,2,0.003610355766937766,2019-03-26 21:15:00,2019-03-26 21:30:00
41,3,1,2,0.006679495983525184,2019-03-26 21:15:00,2019-03-26 21:30:00
46,2,1,1,0.02402378035756273,2019-03-26 21:15:00,2019-03-26 21:30:00
57,1,1,0,0.006449487779662696,2019-03-26 21:15:00,2019-03-26 21:30:00
58,2,1,1,0.009288619792387626,2019-03-26 21:15:00,2019-03-26 21:30:00
61,2,2,0,0.006679495983525184,2019-03-26 21:15:00,2019-03-26 21:30:00
70,1,0,1,0.003610355766937766,2019-03-26 21:15:00,2019-03-26 21:30:00
74,1,1,0,0.006449487779662696,2019-03-26 21:15:00,2019-03-26 21:30:00
85,1,1,0,0.006679495983525184,2019-03-26 21:15:00,2019-03-26 21:30:00
87,2,1,1,0.02402378035756273,2019-03-26 21:15:00,2019-03-26 21:30:00
88,1,1,0,0.010397683546817053,2019-03-26 21:15:00,2019-03-26 21:30:00
89,2,1,1,0.006679495983525184,2019-03-26 21:15:00,2019-03-26 21:30:00
90,1,0,1,0.003610355766937766,2019-03-26 21:15:00,2019-03-26 21:30:00
104,2,1,1,0.02402378035756273,2019-03-26 21:15:00,2019-03-26 21:30:00
111,2,0,2,0.003610355766937766,2019-03-26 21:15:00,2019-03-26 21:30:00
120,2,1,1,0.005144925875231475,2019-03-26 21:15:00,2019-03-26 21:30:00
126,1,0,1,0.003610355766937766,2019-03-26 21:15:00,2019-03-26 21:30:00
127,3,2,1,0.006679495983525184,2019-03-26 21:15:00,2019-03-26 21:30:00
135,1,1,0,0.006679495983525184,2019-03-26 21:15:00,2019-03-26 21:30:00
138,2,1,1,0.007984057887956406,2019-03-26 21:15:00,2019-03-26 21:30:00
140,2,0,2,0.003610355766937766,2019-03-26 21:15:00,2019-03-26 21:30:00
153,1,1,0,0.005144925875231475,2019-03-26 21:15:00,2019-03-26 21:30:00
157,3,2,1,0.09770582513073536,2019-03-26 21:15:00,2019-03-26 21:30:00
158,3,2,1,0.013041317409540188,2019-03-26 21:15:00,2019-03-26 21:30:00
161,2,1,1,0.02402378035756273,2019-03-26 21:15:00,2019-03-26 21:30:00
164,1,0,1,0.003610355766937766,2019-03-26 21:15:00,2019-03-26 21:30:00
196,2,1,1,0.02402378035756273,2019-03-26 21:15:00,2019-03-26 21:30:00
201,3,3,0,0.013892330117268752,2019-03-26 21:15:00,2019-03-26 21:30:00
203,1,0,1,0.003610355766937766,2019-03-26 21:15:00,2019-03-26 21:30:00
18,3,2,1,0.005508069722543458,2019-03-26 21:30:00,2019-03-26 21:45:00
19,1,0,1,0.0038651843744289213,2019-03-26 21:30:00,2019-03-26 21:45:00
22,1,1,0,0.007150955070657996,2019-03-26 21:30:00,2019-03-26 21:45:00
23,2,0,2,0.0038651843744289213,2019-03-26 21:30:00,2019-03-26 21:45:00
41,2,0,2,0.0038651843744289213,2019-03-26 21:30:00,2019-03-26 21:45:00
46,2,1,1,0.025696201640888164,2019-03-26 21:30:00,2019-03-26 21:45:00
57,2,2,0,0.01019048111314527,2019-03-26 21:30:00,2019-03-26 21:45:00
61,2,2,0,0.008793840418772533,2019-03-26 21:30:00,2019-03-26 21:45:00
70,1,0,1,0.0038651843744289213,2019-03-26 21:30:00,2019-03-26 21:45:00
74,1,1,0,0.005508069722543458,2019-03-26 21:30:00,2019-03-26 21:45:00
85,1,1,0,0.007150955070657996,2019-03-26 21:30:00,2019-03-26 21:45:00
87,2,1,1,0.025696201640888164,2019-03-26 21:30:00,2019-03-26 21:45:00
88,1,1,0,0.012318914672715356,2019-03-26 21:30:00,2019-03-26 21:45:00
104,2,1,1,0.025696201640888164,2019-03-26 21:30:00,2019-03-26 21:45:00
111,4,0,4,0.0038651843744289213,2019-03-26 21:30:00,2019-03-26 21:45:00
120,2,1,1,0.007150955070657996,2019-03-26 21:30:00,2019-03-26 21:45:00
127,1,1,0,0.0046866270484861895,2019-03-26 21:30:00,2019-03-26 21:45:00
135,1,1,0,0.007150955070657996,2019-03-26 21:30:00,2019-03-26 21:45:00
138,2,1,1,0.009944236459403469,2019-03-26 21:30:00,2019-03-26 21:45:00
140,1,0,1,0.0038651843744289213,2019-03-26 21:30:00,2019-03-26 21:45:00
153,2,1,1,0.005508069722543458,2019-03-26 21:30:00,2019-03-26 21:45:00
156,1,0,1,0.0038651843744289213,2019-03-26 21:30:00,2019-03-26 21:45:00
157,5,3,2,0.05216353054990495,2019-03-26 21:30:00,2019-03-26 21:45:00
158,2,1,1,0.0046866270484861895,2019-03-26 21:30:00,2019-03-26 21:45:00
161,2,1,1,0.025696201640888164,2019-03-26 21:30:00,2019-03-26 21:45:00
172,1,1,0,0.008547595765030733,2019-03-26 21:30:00,2019-03-26 21:45:00
196,2,1,1,0.025696201640888164,2019-03-26 21:30:00,2019-03-26 21:45:00
203,1,0,1,0.0038651843744289213,2019-03-26 21:30:00,2019-03-26 21:45:00
15,2,0,2,0.004069857017186562,2019-03-26 21:45:00,2019-03-26 22:00:00
18,3,2,1,0.0075295780402134214,2019-03-26 21:45:00,2019-03-26 22:00:00
23,1,0,1,0.004069857017186562,2019-03-26 21:45:00,2019-03-26 22:00:00
28,1,1,0,0.0075295780402134214,2019-03-26 21:45:00,2019-03-26 22:00:00
41,1,0,1,0.004069857017186562,2019-03-26 21:45:00,2019-03-26 22:00:00
46,2,1,1,0.02703399930073549,2019-03-26 21:45:00,2019-03-26 22:00:00
57,2,2,0,0.016871525822902012,2019-03-26 21:45:00,2019-03-26 22:00:00
61,1,1,0,0.0075295780402134214,2019-03-26 21:45:00,2019-03-26 22:00:00
74,1,1,0,0.0075295780402134214,2019-03-26 21:45:00,2019-03-26 22:00:00
85,1,1,0,0.0075295780402134214,2019-03-26 21:45:00,2019-03-26 22:00:00
86,1,1,0,0.0075295780402134214,2019-03-26 21:45:00,2019-03-26 22:00:00
87,2,1,1,0.02703399930073549,2019-03-26 21:45:00,2019-03-26 22:00:00
104,2,1,1,0.02703399930073549,2019-03-26 21:45:00,2019-03-26 22:00:00
109,1,0,1,0.004069857017186562,2019-03-26 21:45:00,2019-03-26 22:00:00
111,2,0,2,0.004069857017186562,2019-03-26 21:45:00,2019-03-26 22:00:00
120,1,0,1,0.004069857017186562,2019-03-26 21:45:00,2019-03-26 22:00:00
122,2,2,0,0.0075295780402134214,2019-03-26 21:45:00,2019-03-26 22:00:00
138,1,1,0,0.0075295780402134214,2019-03-26 21:45:00,2019-03-26 22:00:00
147,1,0,1,0.004069857017186562,2019-03-26 21:45:00,2019-03-26 22:00:00
153,1,0,1,0.004069857017186562,2019-03-26 21:45:00,2019-03-26 22:00:00
157,4,2,2,0.02703399930073549,2019-03-26 21:45:00,2019-03-26 22:00:00
158,2,1,1,0.0075295780402134214,2019-03-26 21:45:00,2019-03-26 22:00:00
161,2,1,1,0.02703399930073549,2019-03-26 21:45:00,2019-03-26 22:00:00
164,2,0,2,0.004069857017186562,2019-03-26 21:45:00,2019-03-26 22:00:00
172,1,1,0,0.0075295780402134214,2019-03-26 21:45:00,2019-03-26 22:00:00
173,2,2,0,0.0075295780402134214,2019-03-26 21:45:00,2019-03-26 22:00:00
196,1,0,1,0.004069857017186562,2019-03-26 21:45:00,2019-03-26 22:00:00
203,1,0,1,0.004069857017186562,2019-03-26 21:45:00,2019-03-26 22:00:00
1,2,0,2,0.004040114864249477,2019-03-26 22:00:00,2019-03-26 22:15:00
15,2,0,2,0.004040114864249477,2019-03-26 22:00:00,2019-03-26 22:15:00
18,2,2,0,0.007474567958361846,2019-03-26 22:00:00,2019-03-26 22:15:00
20,1,1,0,0.005757341411305661,2019-03-26 22:00:00,2019-03-26 22:15:00
21,1,0,1,0.004040114864249477,2019-03-26 22:00:00,2019-03-26 22:15:00
23,1,0,1,0.004040114864249477,2019-03-26 22:00:00,2019-03-26 22:15:00
28,1,1,0,0.007474567958361846,2019-03-26 22:00:00,2019-03-26 22:15:00
41,2,0,2,0.004040114864249477,2019-03-26 22:00:00,2019-03-26 22:15:00
46,2,1,1,0.026842175965765484,2019-03-26 22:00:00,2019-03-26 22:15:00
50,1,0,1,0.004040114864249477,2019-03-26 22:00:00,2019-03-26 22:15:00
61,1,1,0,0.007474567958361846,2019-03-26 22:00:00,2019-03-26 22:15:00
66,1,1,0,0.007474567958361846,2019-03-26 22:00:00,2019-03-26 22:15:00
74,1,1,0,0.005757341411305661,2019-03-26 22:00:00,2019-03-26 22:15:00
85,1,1,0,0.007474567958361846,2019-03-26 22:00:00,2019-03-26 22:15:00
86,1,1,0,0.007474567958361846,2019-03-26 22:00:00,2019-03-26 22:15:00
87,2,1,1,0.026842175965765484,2019-03-26 22:00:00,2019-03-26 22:15:00
104,3,2,1,0.03824320651652348,2019-03-26 22:00:00,2019-03-26 22:15:00
111,2,0,2,0.004040114864249477,2019-03-26 22:00:00,2019-03-26 22:15:00
120,1,0,1,0.004040114864249477,2019-03-26 22:00:00,2019-03-26 22:15:00
122,3,3,0,0.010909021052474216,2019-03-26 22:00:00,2019-03-26 22:15:00
127,1,0,1,0.004040114864249477,2019-03-26 22:00:00,2019-03-26 22:15:00
138,1,1,0,0.007474567958361846,2019-03-26 22:00:00,2019-03-26 22:15:00
147,1,0,1,0.004040114864249477,2019-03-26 22:00:00,2019-03-26 22:15:00
157,2,1,1,0.026842175965765484,2019-03-26 22:00:00,2019-03-26 22:15:00
161,2,1,1,0.026842175965765484,2019-03-26 22:00:00,2019-03-26 22:15:00
164,2,0,2,0.004040114864249477,2019-03-26 22:00:00,2019-03-26 22:15:00
168,1,0,1,0.004040114864249477,2019-03-26 22:00:00,2019-03-26 22:15:00
171,1,1,0,0.007474567958361846,2019-03-26 22:00:00,2019-03-26 22:15:00
172,1,1,0,0.005757341411305661,2019-03-26 22:00:00,2019-03-26 22:15:00
173,2,2,0,0.007474567958361846,2019-03-26 22:00:00,2019-03-26 22:15:00
196,1,0,1,0.004040114864249477,2019-03-26 22:00:00,2019-03-26 22:15:00
197,1,1,0,0.007474567958361846,2019-03-26 22:00:00,2019-03-26 22:15:00
203,1,0,1,0.004040114864249477,2019-03-26 22:00:00,2019-03-26 22:15:00
1,1,0,1,0.003942152718263549,2019-03-26 22:15:00,2019-03-26 22:30:00
16,2,2,0,0.0067348036471862145,2019-03-26 22:15:00,2019-03-26 22:30:00
20,1,1,0,0.005617743275617149,2019-03-26 22:15:00,2019-03-26 22:30:00
23,2,1,1,0.02619583456948258,2019-03-26 22:15:00,2019-03-26 22:30:00
41,2,0,2,0.003942152718263549,2019-03-26 22:15:00,2019-03-26 22:30:00
46,2,1,1,0.02619583456948258,2019-03-26 22:15:00,2019-03-26 22:30:00
50,1,0,1,0.003942152718263549,2019-03-26 22:15:00,2019-03-26 22:30:00
57,2,2,0,0.006176273461401681,2019-03-26 22:15:00,2019-03-26 22:30:00
61,2,2,0,0.007059700729251035,2019-03-26 22:15:00,2019-03-26 22:30:00
66,2,1,1,0.007293333832970747,2019-03-26 22:15:00,2019-03-26 22:30:00
70,1,0,1,0.003942152718263549,2019-03-26 22:15:00,2019-03-26 22:30:00
74,1,1,0,0.005617743275617149,2019-03-26 22:15:00,2019-03-26 22:30:00
85,1,1,0,0.012564104804403693,2019-03-26 22:15:00,2019-03-26 22:30:00
87,2,1,1,0.02619583456948258,2019-03-26 22:15:00,2019-03-26 22:30:00
90,1,1,0,0.010142198743376536,2019-03-26 22:15:00,2019-03-26 22:30:00
104,2,1,1,0.02619583456948258,2019-03-26 22:15:00,2019-03-26 22:30:00
120,1,0,1,0.003942152718263549,2019-03-26 22:15:00,2019-03-26 22:30:00
122,1,1,0,0.005617743275617149,2019-03-26 22:15:00,2019-03-26 22:30:00
126,4,1,3,0.005500926723757292,2019-03-26 22:15:00,2019-03-26 22:30:00
127,2,0,2,0.003942152718263549,2019-03-26 22:15:00,2019-03-26 22:30:00
138,2,1,1,0.007293333832970747,2019-03-26 22:15:00,2019-03-26 22:30:00
153,3,1,2,0.006856546007342042,2019-03-26 22:15:00,2019-03-26 22:30:00
157,2,1,1,0.02619583456948258,2019-03-26 22:15:00,2019-03-26 22:30:00
161,2,1,1,0.02619583456948258,2019-03-26 22:15:00,2019-03-26 22:30:00
168,1,0,1,0.003942152718263549,2019-03-26 22:15:00,2019-03-26 22:30:00
191,1,1,0,0.006856546007342042,2019-03-26 22:15:00,2019-03-26 22:30:00
195,1,1,0,0.007293333832970747,2019-03-26 22:15:00,2019-03-26 22:30:00
196,3,0,3,0.003942152718263549,2019-03-26 22:15:00,2019-03-26 22:30:00
197,1,1,0,0.007293333832970747,2019-03-26 22:15:00,2019-03-26 22:30:00
199,1,1,0,0.007293333832970747,2019-03-26 22:15:00,2019-03-26 22:30:00
203,2,1,1,0.010142198743376536,2019-03-26 22:15:00,2019-03-26 22:30:00
1,1,0,1,0.004015267674671436,2019-03-26 22:30:00,2019-03-26 22:45:00
16,2,2,0,0.009828088137571118,2019-03-26 22:30:00,2019-03-26 22:45:00
18,1,1,0,0.007428576640003777,2019-03-26 22:30:00,2019-03-26 22:45:00
19,2,1,1,0.005499465837232802,2019-03-26 22:30:00,2019-03-26 22:45:00
23,6,2,4,0.006983663999794167,2019-03-26 22:30:00,2019-03-26 22:45:00
41,1,0,1,0.004015267674671436,2019-03-26 22:30:00,2019-03-26 22:45:00
46,2,1,1,0.02667092408637419,2019-03-26 22:30:00,2019-03-26 22:45:00
57,1,1,0,0.005153037329782216,2019-03-26 22:30:00,2019-03-26 22:45:00
62,1,1,0,0.007428576640003777,2019-03-26 22:30:00,2019-03-26 22:45:00
66,1,0,1,0.004015267674671436,2019-03-26 22:30:00,2019-03-26 22:45:00
70,1,0,1,0.004015267674671436,2019-03-26 22:30:00,2019-03-26 22:45:00
74,1,1,0,0.007428576640003777,2019-03-26 22:30:00,2019-03-26 22:45:00
85,1,1,0,0.013496009471640114,2019-03-26 22:30:00,2019-03-26 22:45:00
87,2,1,1,0.02667092408637419,2019-03-26 22:30:00,2019-03-26 22:45:00
90,1,1,0,0.007428576640003777,2019-03-26 22:30:00,2019-03-26 22:45:00
104,2,1,1,0.02667092408637419,2019-03-26 22:30:00,2019-03-26 22:45:00
110,1,1,0,0.005153037329782216,2019-03-26 22:30:00,2019-03-26 22:45:00
111,1,0,1,0.004015267674671436,2019-03-26 22:30:00,2019-03-26 22:45:00
120,2,1,1,0.005153037329782216,2019-03-26 22:30:00,2019-03-26 22:45:00
126,1,0,1,0.004015267674671436,2019-03-26 22:30:00,2019-03-26 22:45:00
127,2,1,1,0.005499465837232802,2019-03-26 22:30:00,2019-03-26 22:45:00
137,3,0,3,0.004015267674671436,2019-03-26 22:30:00,2019-03-26 22:45:00
138,2,1,1,0.008395793830561597,2019-03-26 22:30:00,2019-03-26 22:45:00
157,2,1,1,0.02667092408637419,2019-03-26 22:30:00,2019-03-26 22:45:00
161,2,1,1,0.02667092408637419,2019-03-26 22:30:00,2019-03-26 22:45:00
168,2,2,0,0.0062908069848929965,2019-03-26 22:30:00,2019-03-26 22:45:00
172,1,1,0,0.008690318482460338,2019-03-26 22:30:00,2019-03-26 22:45:00
195,1,1,0,0.007428576640003777,2019-03-26 22:30:00,2019-03-26 22:45:00
196,3,0,3,0.004015267674671436,2019-03-26 22:30:00,2019-03-26 22:45:00
199,1,1,0,0.007428576640003777,2019-03-26 22:30:00,2019-03-26 22:45:00
203,2,1,1,0.011152478367169327,2019-03-26 22:30:00,2019-03-26 22:45:00
18,1,1,0,0.007379337182709769,2019-03-26 22:45:00,2019-03-26 23:00:00
19,2,1,1,0.005683988649991992,2019-03-26 22:45:00,2019-03-26 23:00:00
28,2,2,0,0.011096456097012118,2019-03-26 22:45:00,2019-03-26 23:00:00
41,1,0,1,0.0039886401172742145,2019-03-26 22:45:00,2019-03-26 23:00:00
46,6,3,3,0.012541469137135032,2019-03-26 22:45:00,2019-03-26 23:00:00
57,3,2,1,0.04309037475242385,2019-03-26 22:45:00,2019-03-26 23:00:00
74,1,1,0,0.007379337182709769,2019-03-26 22:45:00,2019-03-26 23:00:00
85,1,1,0,0.007379337182709769,2019-03-26 22:45:00,2019-03-26 23:00:00
87,2,1,1,0.026503635934792262,2019-03-26 22:45:00,2019-03-26 23:00:00
104,2,1,1,0.026503635934792262,2019-03-26 22:45:00,2019-03-26 23:00:00
110,1,1,0,0.005683988649991992,2019-03-26 22:45:00,2019-03-26 23:00:00
111,1,0,1,0.0039886401172742145,2019-03-26 22:45:00,2019-03-26 23:00:00
120,2,1,1,0.005683988649991992,2019-03-26 22:45:00,2019-03-26 23:00:00
127,2,0,2,0.0039886401172742145,2019-03-26 22:45:00,2019-03-26 23:00:00
137,2,0,2,0.0039886401172742145,2019-03-26 22:45:00,2019-03-26 23:00:00
138,4,1,3,0.008820564675456798,2019-03-26 22:45:00,2019-03-26 23:00:00
151,2,2,0,0.011487021662262013,2019-03-26 22:45:00,2019-03-26 23:00:00
157,2,1,1,0.026503635934792262,2019-03-26 22:45:00,2019-03-26 23:00:00
161,2,1,1,0.026503635934792262,2019-03-26 22:45:00,2019-03-26 23:00:00
168,1,1,0,0.007379337182709769,2019-03-26 22:45:00,2019-03-26 23:00:00
172,3,1,2,0.008820564675456798,2019-03-26 22:45:00,2019-03-26 23:00:00
191,1,1,0,0.005683988649991992,2019-03-26 22:45:00,2019-03-26 23:00:00
196,1,0,1,0.0039886401172742145,2019-03-26 22:45:00,2019-03-26 23:00:00
203,1,0,1,0.0039886401172742145,2019-03-26 22:45:00,2019-03-26 23:00:00
10,1,0,1,0.003928656485089019,2019-03-26 23:00:00,2019-03-26 23:15:00
15,1,1,0,0.008820798243026503,2019-03-26 23:00:00,2019-03-26 23:15:00
18,1,1,0,0.0077704719656612594,2019-03-26 23:00:00,2019-03-26 23:15:00
19,1,1,0,0.0047635870288036345,2019-03-26 23:00:00,2019-03-26 23:15:00
20,3,2,1,0.00559851757251825,2019-03-26 23:00:00,2019-03-26 23:15:00
28,2,2,0,0.004988925902043768,2019-03-26 23:00:00,2019-03-26 23:15:00
41,5,3,2,0.009038432919195824,2019-03-26 23:00:00,2019-03-26 23:15:00
46,10,2,8,0.004988925902043768,2019-03-26 23:00:00,2019-03-26 23:15:00
57,3,2,1,0.058590204428052614,2019-03-26 23:00:00,2019-03-26 23:15:00
58,1,1,0,0.008687948344534673,2019-03-26 23:00:00,2019-03-26 23:15:00
67,1,1,0,0.0054821043500108135,2019-03-26 23:00:00,2019-03-26 23:15:00
74,1,1,0,0.0077704719656612594,2019-03-26 23:00:00,2019-03-26 23:15:00
85,1,1,0,0.00726837865994748,2019-03-26 23:00:00,2019-03-26 23:15:00
87,2,1,1,0.026113204288441078,2019-03-26 23:00:00,2019-03-26 23:15:00
88,1,1,0,0.0054821043500108135,2019-03-26 23:00:00,2019-03-26 23:15:00
104,2,1,1,0.026113204288441078,2019-03-26 23:00:00,2019-03-26 23:15:00
110,1,1,0,0.00726837865994748,2019-03-26 23:00:00,2019-03-26 23:15:00
115,4,1,3,0.0054821043500108135,2019-03-26 23:00:00,2019-03-26 23:15:00
120,3,2,1,0.004988925902043768,2019-03-26 23:00:00,2019-03-26 23:15:00
127,4,0,4,0.003928656485089019,2019-03-26 23:00:00,2019-03-26 23:15:00
137,1,0,1,0.003928656485089019,2019-03-26 23:00:00,2019-03-26 23:15:00
138,4,2,2,0.011509456327766471,2019-03-26 23:00:00,2019-03-26 23:15:00
151,2,2,0,0.00726837865994748,2019-03-26 23:00:00,2019-03-26 23:15:00
157,2,1,1,0.026113204288441078,2019-03-26 23:00:00,2019-03-26 23:15:00
161,2,1,1,0.026113204288441078,2019-03-26 23:00:00,2019-03-26 23:15:00
172,2,0,2,0.003928656485089019,2019-03-26 23:00:00,2019-03-26 23:15:00
191,2,1,1,0.0047635870288036345,2019-03-26 23:00:00,2019-03-26 23:15:00
203,1,0,1,0.003928656485089019,2019-03-26 23:00:00,2019-03-26 23:15:00
10,1,0,1,0.003895650645599996,2019-03-26 23:15:00,2019-03-26 23:30:00
15,2,1,1,0.02589672166807023,2019-03-26 23:15:00,2019-03-26 23:30:00
18,4,3,1,0.008745091412603946,2019-03-26 23:15:00,2019-03-26 23:30:00
20,2,2,0,0.007207319036171793,2019-03-26 23:15:00,2019-03-26 23:30:00
28,3,3,0,0.005718714494920722,2019-03-26 23:15:00,2019-03-26 23:30:00
41,5,3,2,0.006214916008671079,2019-03-26 23:15:00,2019-03-26 23:30:00
46,11,3,8,0.005718714494920722,2019-03-26 23:15:00,2019-03-26 23:30:00
57,3,2,1,0.04789779269054047,2019-03-26 23:15:00,2019-03-26 23:30:00
58,1,1,0,0.011329928347059596,2019-03-26 23:15:00,2019-03-26 23:30:00
67,1,1,0,0.007207319036171793,2019-03-26 23:15:00,2019-03-26 23:30:00
74,1,1,0,0.006537312485556081,2019-03-26 23:15:00,2019-03-26 23:30:00
85,1,1,0,0.007207319036171793,2019-03-26 23:15:00,2019-03-26 23:30:00
87,2,1,1,0.02589672166807023,2019-03-26 23:15:00,2019-03-26 23:30:00
88,2,2,0,0.01051898742674359,2019-03-26 23:15:00,2019-03-26 23:30:00
104,2,1,1,0.02589672166807023,2019-03-26 23:15:00,2019-03-26 23:30:00
110,1,0,1,0.003895650645599996,2019-03-26 23:15:00,2019-03-26 23:30:00
115,1,0,1,0.003895650645599996,2019-03-26 23:15:00,2019-03-26 23:30:00
120,1,0,1,0.003895650645599996,2019-03-26 23:15:00,2019-03-26 23:30:00
127,2,0,2,0.003895650645599996,2019-03-26 23:15:00,2019-03-26 23:30:00
137,1,0,1,0.003895650645599996,2019-03-26 23:15:00,2019-03-26 23:30:00
138,2,2,0,0.01051898742674359,2019-03-26 23:15:00,2019-03-26 23:30:00
151,2,2,0,0.007207319036171793,2019-03-26 23:15:00,2019-03-26 23:30:00
157,2,1,1,0.02589672166807023,2019-03-26 23:15:00,2019-03-26 23:30:00
161,2,1,1,0.02589672166807023,2019-03-26 23:15:00,2019-03-26 23:30:00
172,2,0,2,0.003895650645599996,2019-03-26 23:15:00,2019-03-26 23:30:00
190,1,0,1,0.003895650645599996,2019-03-26 23:15:00,2019-03-26 23:30:00
191,3,0,3,0.003895650645599996,2019-03-26 23:15:00,2019-03-26 23:30:00
203,1,0,1,0.003895650645599996,2019-03-26 23:15:00,2019-03-26 23:30:00
10,1,0,1,0.0035355754225447214,2019-03-26 23:30:00,2019-03-26 23:45:00
15,4,3,1,0.06350530382886849,2019-03-26 23:30:00,2019-03-26 23:45:00
16,1,0,1,0.0035355754225447214,2019-03-26 23:30:00,2019-03-26 23:45:00
18,4,3,1,0.008044022472372571,2019-03-26 23:30:00,2019-03-26 23:45:00
20,3,2,1,0.009096408493920752,2019-03-26 23:30:00,2019-03-26 23:45:00
23,6,2,4,0.006149551080029836,2019-03-26 23:30:00,2019-03-26 23:45:00
28,1,1,0,0.0048425632512872786,2019-03-26 23:30:00,2019-03-26 23:45:00
41,2,0,2,0.0035355754225447214,2019-03-26 23:30:00,2019-03-26 23:45:00
46,6,2,4,0.006149551080029836,2019-03-26 23:30:00,2019-03-26 23:45:00
57,3,2,1,0.08718546465528153,2019-03-26 23:30:00,2019-03-26 23:45:00
58,1,0,1,0.0035355754225447214,2019-03-26 23:30:00,2019-03-26 23:45:00
74,1,1,0,0.005038391105820671,2019-03-26 23:30:00,2019-03-26 23:45:00
85,1,1,0,0.006541206789096621,2019-03-26 23:30:00,2019-03-26 23:45:00
87,2,1,1,0.023525484891319306,2019-03-26 23:30:00,2019-03-26 23:45:00
104,2,1,1,0.023525484891319306,2019-03-26 23:30:00,2019-03-26 23:45:00
113,1,0,1,0.0035355754225447214,2019-03-26 23:30:00,2019-03-26 23:45:00
118,1,1,0,0.0048425632512872786,2019-03-26 23:30:00,2019-03-26 23:45:00
120,1,0,1,0.0035355754225447214,2019-03-26 23:30:00,2019-03-26 23:45:00
127,3,1,2,0.006541206789096621,2019-03-26 23:30:00,2019-03-26 23:45:00
137,3,3,0,0.012987985003817929,2019-03-26 23:30:00,2019-03-26 23:45:00
138,2,2,0,0.00954683815564852,2019-03-26 23:30:00,2019-03-26 23:45:00
151,2,2,0,0.006541206789096621,2019-03-26 23:30:00,2019-03-26 23:45:00
157,2,1,1,0.023525484891319306,2019-03-26 23:30:00,2019-03-26 23:45:00
161,2,1,1,0.023525484891319306,2019-03-26 23:30:00,2019-03-26 23:45:00
172,2,0,2,0.0035355754225447214,2019-03-26 23:30:00,2019-03-26 23:45:00
190,2,1,1,0.0112687690957529,2019-03-26 23:30:00,2019-03-26 23:45:00
191,2,0,2,0.0035355754225447214,2019-03-26 23:30:00,2019-03-26 23:45:00
203,1,0,1,0.0035355754225447214,2019-03-26 23:30:00,2019-03-26 23:45:00
15,2,1,1,0.027290887779083707,2019-03-26 23:45:00,2019-03-27 00:00:00
18,2,0,2,0.0041084412599294426,2019-03-26 23:45:00,2019-03-27 00:00:00
20,3,2,1,0.007600964126300954,2019-03-26 23:45:00,2019-03-27 00:00:00
23,4,1,3,0.005732954266139656,2019-03-26 23:45:00,2019-03-27 00:00:00
41,1,0,1,0.0041084412599294426,2019-03-26 23:45:00,2019-03-27 00:00:00
46,3,1,2,0.007145734644240614,2019-03-26 23:45:00,2019-03-27 00:00:00
69,1,1,0,0.007600964126300954,2019-03-26 23:45:00,2019-03-27 00:00:00
74,1,1,0,0.007600964126300954,2019-03-26 23:45:00,2019-03-27 00:00:00
85,1,1,0,0.007600964126300954,2019-03-26 23:45:00,2019-03-27 00:00:00
87,2,1,1,0.027290887779083707,2019-03-26 23:45:00,2019-03-27 00:00:00
104,2,1,1,0.027290887779083707,2019-03-26 23:45:00,2019-03-27 00:00:00
109,1,1,0,0.005854702693115199,2019-03-26 23:45:00,2019-03-27 00:00:00
112,1,0,1,0.0041084412599294426,2019-03-26 23:45:00,2019-03-27 00:00:00
118,1,1,0,0.007145734644240614,2019-03-26 23:45:00,2019-03-27 00:00:00
120,1,0,1,0.0041084412599294426,2019-03-26 23:45:00,2019-03-27 00:00:00
127,2,0,2,0.0041084412599294426,2019-03-26 23:45:00,2019-03-27 00:00:00
137,3,3,0,0.009103728705535625,2019-03-26 23:45:00,2019-03-27 00:00:00
138,1,1,0,0.007600964126300954,2019-03-26 23:45:00,2019-03-27 00:00:00
151,2,2,0,0.007600964126300954,2019-03-26 23:45:00,2019-03-27 00:00:00
157,2,1,1,0.027290887779083707,2019-03-26 23:45:00,2019-03-27 00:00:00
161,2,1,1,0.027290887779083707,2019-03-26 23:45:00,2019-03-27 00:00:00
172,2,0,2,0.0041084412599294426,2019-03-26 23:45:00,2019-03-27 00:00:00
190,1,1,0,0.01056996452676684,2019-03-26 23:45:00,2019-03-27 00:00:00
203,1,0,1,0.0041084412599294426,2019-03-26 23:45:00,2019-03-27 00:00:00
1,1,0,1,0.004030700565601763,2019-03-27 00:00:00,2019-03-27 00:15:00
5,1,0,1,0.004030700565601763,2019-03-27 00:00:00,2019-03-27 00:15:00
10,1,1,0,0.007457163255714711,2019-03-27 00:00:00,2019-03-27 00:15:00
16,1,0,1,0.004030700565601763,2019-03-27 00:00:00,2019-03-27 00:15:00
18,2,1,1,0.007457163255714711,2019-03-27 00:00:00,2019-03-27 00:15:00
20,2,2,0,0.007457163255714711,2019-03-27 00:00:00,2019-03-27 00:15:00
41,1,0,1,0.004030700565601763,2019-03-27 00:00:00,2019-03-27 00:15:00
46,2,1,1,0.026785514928931928,2019-03-27 00:00:00,2019-03-27 00:15:00
67,1,1,0,0.007457163255714711,2019-03-27 00:00:00,2019-03-27 00:15:00
69,1,1,0,0.007457163255714711,2019-03-27 00:00:00,2019-03-27 00:15:00
74,1,1,0,0.007457163255714711,2019-03-27 00:00:00,2019-03-27 00:15:00
85,1,1,0,0.007457163255714711,2019-03-27 00:00:00,2019-03-27 00:15:00
87,2,1,1,0.026785514928931928,2019-03-27 00:00:00,2019-03-27 00:15:00
104,2,1,1,0.026785514928931928,2019-03-27 00:00:00,2019-03-27 00:15:00
109,3,3,0,0.013796496916356836,2019-03-27 00:00:00,2019-03-27 00:15:00
111,2,0,2,0.004030700565601763,2019-03-27 00:00:00,2019-03-27 00:15:00
112,1,0,1,0.004030700565601763,2019-03-27 00:00:00,2019-03-27 00:15:00
118,1,0,1,0.004030700565601763,2019-03-27 00:00:00,2019-03-27 00:15:00
127,2,0,2,0.004030700565601763,2019-03-27 00:00:00,2019-03-27 00:15:00
138,3,0,3,0.004030700565601763,2019-03-27 00:00:00,2019-03-27 00:15:00
157,2,1,1,0.026785514928931928,2019-03-27 00:00:00,2019-03-27 00:15:00
161,3,2,1,0.04954032929226209,2019-03-27 00:00:00,2019-03-27 00:15:00
173,3,3,0,0.007457163255714711,2019-03-27 00:00:00,2019-03-27 00:15:00
203,1,0,1,0.004030700565601763,2019-03-27 00:00:00,2019-03-27 00:15:00
1,1,0,1,0.003938941584045363,2019-03-27 00:15:00,2019-03-27 00:30:00
5,2,0,2,0.003938941584045363,2019-03-27 00:15:00,2019-03-27 00:30:00
10,1,1,0,0.005613173434752178,2019-03-27 00:15:00,2019-03-27 00:30:00
16,2,1,1,0.005613173434752178,2019-03-27 00:15:00,2019-03-27 00:30:00
18,3,1,2,0.007287405285458992,2019-03-27 00:15:00,2019-03-27 00:30:00
20,2,2,0,0.006171250718321116,2019-03-27 00:15:00,2019-03-27 00:30:00
41,1,0,1,0.003938941584045363,2019-03-27 00:15:00,2019-03-27 00:30:00
46,2,1,1,0.02617989901187476,2019-03-27 00:15:00,2019-03-27 00:30:00
57,2,2,0,0.01323148995100611,2019-03-27 00:15:00,2019-03-27 00:30:00
61,1,1,0,0.005055096151183239,2019-03-27 00:15:00,2019-03-27 00:30:00
67,2,1,1,0.007287405285458992,2019-03-27 00:15:00,2019-03-27 00:30:00
69,1,1,0,0.005001985957866832,2019-03-27 00:15:00,2019-03-27 00:30:00
74,1,1,0,0.007287405285458992,2019-03-27 00:15:00,2019-03-27 00:30:00
85,1,1,0,0.007287405285458992,2019-03-27 00:15:00,2019-03-27 00:30:00
87,2,1,1,0.02617989901187476,2019-03-27 00:15:00,2019-03-27 00:30:00
104,2,1,1,0.02617989901187476,2019-03-27 00:15:00,2019-03-27 00:30:00
109,1,1,0,0.007036457706365612,2019-03-27 00:15:00,2019-03-27 00:30:00
112,5,1,4,0.005001985957866832,2019-03-27 00:15:00,2019-03-27 00:30:00
118,1,0,1,0.003938941584045363,2019-03-27 00:15:00,2019-03-27 00:30:00
119,2,2,0,0.007287405285458992,2019-03-27 00:15:00,2019-03-27 00:30:00
127,3,0,3,0.003938941584045363,2019-03-27 00:15:00,2019-03-27 00:30:00
137,2,0,2,0.003938941584045363,2019-03-27 00:15:00,2019-03-27 00:30:00
138,3,0,3,0.003938941584045363,2019-03-27 00:15:00,2019-03-27 00:30:00
147,3,3,0,0.0122600625763288,2019-03-27 00:15:00,2019-03-27 00:30:00
157,2,1,1,0.02617989901187476,2019-03-27 00:15:00,2019-03-27 00:30:00
161,3,2,1,0.05786710330291203,2019-03-27 00:15:00,2019-03-27 00:30:00
173,4,3,1,0.007287405285458992,2019-03-27 00:15:00,2019-03-27 00:30:00
203,1,0,1,0.003938941584045363,2019-03-27 00:15:00,2019-03-27 00:30:00
5,1,0,1,0.0039787292528594195,2019-03-27 00:30:00,2019-03-27 00:45:00
16,2,1,1,0.007361027851172328,2019-03-27 00:30:00,2019-03-27 00:45:00
18,1,0,1,0.0039787292528594195,2019-03-27 00:30:00,2019-03-27 00:45:00
20,2,2,0,0.006233594985068025,2019-03-27 00:30:00,2019-03-27 00:45:00
41,1,0,1,0.0039787292528594195,2019-03-27 00:30:00,2019-03-27 00:45:00
46,2,1,1,0.026450459878190925,2019-03-27 00:30:00,2019-03-27 00:45:00
57,2,2,0,0.010743326449485236,2019-03-27 00:30:00,2019-03-27 00:45:00
61,1,1,0,0.005106162118963722,2019-03-27 00:30:00,2019-03-27 00:45:00
69,1,1,0,0.005106162118963722,2019-03-27 00:30:00,2019-03-27 00:45:00
74,1,1,0,0.007361027851172328,2019-03-27 00:30:00,2019-03-27 00:45:00
85,1,1,0,0.007361027851172328,2019-03-27 00:30:00,2019-03-27 00:45:00
87,2,1,1,0.026450459878190925,2019-03-27 00:30:00,2019-03-27 00:45:00
104,2,1,1,0.026450459878190925,2019-03-27 00:30:00,2019-03-27 00:45:00
112,3,0,3,0.0039787292528594195,2019-03-27 00:30:00,2019-03-27 00:45:00
119,2,2,0,0.007361027851172328,2019-03-27 00:30:00,2019-03-27 00:45:00
122,1,1,0,0.007361027851172328,2019-03-27 00:30:00,2019-03-27 00:45:00
127,3,0,3,0.0039787292528594195,2019-03-27 00:30:00,2019-03-27 00:45:00
137,2,0,2,0.0039787292528594195,2019-03-27 00:30:00,2019-03-27 00:45:00
147,2,2,0,0.006233594985068025,2019-03-27 00:30:00,2019-03-27 00:45:00
157,2,1,1,0.026450459878190925,2019-03-27 00:30:00,2019-03-27 00:45:00
161,3,2,1,0.06801162253054102,2019-03-27 00:30:00,2019-03-27 00:45:00
164,1,0,1,0.0039787292528594195,2019-03-27 00:30:00,2019-03-27 00:45:00
173,1,0,1,0.0039787292528594195,2019-03-27 00:30:00,2019-03-27 00:45:00
203,1,0,1,0.0039787292528594195,2019-03-27 00:30:00,2019-03-27 00:45:00
16,1,0,1,0.004226268095442559,2019-03-27 00:45:00,2019-03-27 01:00:00
18,1,0,1,0.004226268095442559,2019-03-27 00:45:00,2019-03-27 01:00:00
41,1,0,1,0.004226268095442559,2019-03-27 00:45:00,2019-03-27 01:00:00
57,1,1,0,0.007818963449821796,2019-03-27 00:45:00,2019-03-27 01:00:00
74,1,1,0,0.007818963449821796,2019-03-27 00:45:00,2019-03-27 01:00:00
85,1,1,0,0.007818963449821796,2019-03-27 00:45:00,2019-03-27 01:00:00
87,2,1,1,0.028075119898793726,2019-03-27 00:45:00,2019-03-27 01:00:00
104,2,1,1,0.028075119898793726,2019-03-27 00:45:00,2019-03-27 01:00:00
157,2,1,1,0.028075119898793726,2019-03-27 00:45:00,2019-03-27 01:00:00
158,1,1,0,0.007818963449821796,2019-03-27 00:45:00,2019-03-27 01:00:00
161,3,2,1,0.0519239717021449,2019-03-27 00:45:00,2019-03-27 01:00:00
164,1,0,1,0.004226268095442559,2019-03-27 00:45:00,2019-03-27 01:00:00
203,1,0,1,0.004226268095442559,2019-03-27 00:45:00,2019-03-27 01:00:00
18,1,0,1,0.004314275409061863,2019-03-27 01:00:00,2019-03-27 01:15:00
41,1,0,1,0.004314275409061863,2019-03-27 01:00:00,2019-03-27 01:15:00
57,1,1,0,0.007981812998297949,2019-03-27 01:00:00,2019-03-27 01:15:00
58,1,1,0,0.007981812998297949,2019-03-27 01:00:00,2019-03-27 01:15:00
74,1,1,0,0.007981812998297949,2019-03-27 01:00:00,2019-03-27 01:15:00
85,1,1,0,0.007981812998297949,2019-03-27 01:00:00,2019-03-27 01:15:00
87,2,1,1,0.028623238708095335,2019-03-27 01:00:00,2019-03-27 01:15:00
104,2,1,1,0.028623238708095335,2019-03-27 01:00:00,2019-03-27 01:15:00
114,1,0,1,0.004314275409061863,2019-03-27 01:00:00,2019-03-27 01:15:00
157,2,1,1,0.028623238708095335,2019-03-27 01:00:00,2019-03-27 01:15:00
158,1,1,0,0.007981812998297949,2019-03-27 01:00:00,2019-03-27 01:15:00
161,2,1,1,0.028623238708095335,2019-03-27 01:00:00,2019-03-27 01:15:00
164,1,0,1,0.004314275409061863,2019-03-27 01:00:00,2019-03-27 01:15:00
203,1,0,1,0.004314275409061863,2019-03-27 01:00:00,2019-03-27 01:15:00
41,1,0,1,0.004256845831190339,2019-03-27 01:15:00,2019-03-27 01:30:00
74,1,1,0,0.007875537030415434,2019-03-27 01:15:00,2019-03-27 01:30:00
85,1,1,0,0.007875537030415434,2019-03-27 01:15:00,2019-03-27 01:30:00
87,2,1,1,0.028278690272695563,2019-03-27 01:15:00,2019-03-27 01:30:00
104,2,1,1,0.028278690272695563,2019-03-27 01:15:00,2019-03-27 01:30:00
111,2,1,1,0.028278690272695563,2019-03-27 01:15:00,2019-03-27 01:30:00
157,2,1,1,0.028278690272695563,2019-03-27 01:15:00,2019-03-27 01:30:00
161,2,1,1,0.028278690272695563,2019-03-27 01:15:00,2019-03-27 01:30:00
203,1,0,1,0.004256845831190339,2019-03-27 01:15:00,2019-03-27 01:30:00
41,1,0,1,0.004156699937784361,2019-03-27 01:30:00,2019-03-27 01:45:00
61,2,1,1,0.0276249248187501,2019-03-27 01:30:00,2019-03-27 01:45:00
74,1,1,0,0.007690281671990205,2019-03-27 01:30:00,2019-03-27 01:45:00
85,1,1,0,0.007690281671990205,2019-03-27 01:30:00,2019-03-27 01:45:00
87,2,1,1,0.0276249248187501,2019-03-27 01:30:00,2019-03-27 01:45:00
104,3,2,1,0.04802011290296472,2019-03-27 01:30:00,2019-03-27 01:45:00
111,3,1,2,0.007229736734535481,2019-03-27 01:30:00,2019-03-27 01:45:00
157,2,1,1,0.0276249248187501,2019-03-27 01:30:00,2019-03-27 01:45:00
161,2,1,1,0.0276249248187501,2019-03-27 01:30:00,2019-03-27 01:45:00
203,1,0,1,0.004156699937784361,2019-03-27 01:30:00,2019-03-27 01:45:00
16,1,1,0,0.00605583325168371,2019-03-27 01:45:00,2019-03-27 02:00:00
41,1,0,1,0.004339807926556627,2019-03-27 01:45:00,2019-03-27 02:00:00
74,1,1,0,0.008029052445949026,2019-03-27 01:45:00,2019-03-27 02:00:00
85,1,1,0,0.008029052445949026,2019-03-27 01:45:00,2019-03-27 02:00:00
104,3,2,1,0.05324621294741921,2019-03-27 01:45:00,2019-03-27 02:00:00
110,4,1,3,0.00605583325168371,2019-03-27 01:45:00,2019-03-27 02:00:00
111,1,0,1,0.004339807926556627,2019-03-27 01:45:00,2019-03-27 02:00:00
140,1,1,0,0.00605583325168371,2019-03-27 01:45:00,2019-03-27 02:00:00
157,2,1,1,0.02879301043698792,2019-03-27 01:45:00,2019-03-27 02:00:00
161,2,1,1,0.02879301043698792,2019-03-27 01:45:00,2019-03-27 02:00:00
203,1,0,1,0.004339807926556627,2019-03-27 01:45:00,2019-03-27 02:00:00
16,1,1,0,0.006185143374441444,2019-03-27 02:00:00,2019-03-27 02:15:00
41,1,0,1,0.004432476917756821,2019-03-27 02:00:00,2019-03-27 02:15:00
74,1,1,0,0.008200497594744727,2019-03-27 02:00:00,2019-03-27 02:15:00
85,1,1,0,0.008200497594744727,2019-03-27 02:00:00,2019-03-27 02:15:00
104,2,1,1,0.029359200404035404,2019-03-27 02:00:00,2019-03-27 02:15:00
110,4,1,3,0.006185143374441444,2019-03-27 02:00:00,2019-03-27 02:15:00
126,1,0,1,0.004432476917756821,2019-03-27 02:00:00,2019-03-27 02:15:00
140,1,1,0,0.006185143374441444,2019-03-27 02:00:00,2019-03-27 02:15:00
157,2,1,1,0.029359200404035404,2019-03-27 02:00:00,2019-03-27 02:15:00
161,2,1,1,0.029359200404035404,2019-03-27 02:00:00,2019-03-27 02:15:00
162,1,1,0,0.008200497594744727,2019-03-27 02:00:00,2019-03-27 02:15:00
203,1,0,1,0.004432476917756821,2019-03-27 02:00:00,2019-03-27 02:15:00
41,1,0,1,0.00433015287020663,2019-03-27 02:15:00,2019-03-27 02:30:00
74,1,1,0,0.00801118920310601,2019-03-27 02:15:00,2019-03-27 02:30:00
85,1,1,0,0.00801118920310601,2019-03-27 02:15:00,2019-03-27 02:30:00
104,2,1,1,0.028728781939215957,2019-03-27 02:15:00,2019-03-27 02:30:00
110,2,1,1,0.028728781939215957,2019-03-27 02:15:00,2019-03-27 02:30:00
126,1,0,1,0.00433015287020663,2019-03-27 02:15:00,2019-03-27 02:30:00
157,2,1,1,0.028728781939215957,2019-03-27 02:15:00,2019-03-27 02:30:00
160,1,1,0,0.00801118920310601,2019-03-27 02:15:00,2019-03-27 02:30:00
161,2,1,1,0.028728781939215957,2019-03-27 02:15:00,2019-03-27 02:30:00
162,1,1,0,0.00801118920310601,2019-03-27 02:15:00,2019-03-27 02:30:00
173,1,0,1,0.00433015287020663,2019-03-27 02:15:00,2019-03-27 02:30:00
203,1,0,1,0.00433015287020663,2019-03-27 02:15:00,2019-03-27 02:30:00
41,1,0,1,0.00433015287020663,2019-03-27 02:30:00,2019-03-27 02:45:00
74,1,1,0,0.00801118920310601,2019-03-27 02:30:00,2019-03-27 02:45:00
85,1,1,0,0.00801118920310601,2019-03-27 02:30:00,2019-03-27 02:45:00
104,2,1,1,0.028728781939215957,2019-03-27 02:30:00,2019-03-27 02:45:00
110,2,1,1,0.028728781939215957,2019-03-27 02:30:00,2019-03-27 02:45:00
126,1,0,1,0.00433015287020663,2019-03-27 02:30:00,2019-03-27 02:45:00
157,2,1,1,0.028728781939215957,2019-03-27 02:30:00,2019-03-27 02:45:00
160,1,1,0,0.00801118920310601,2019-03-27 02:30:00,2019-03-27 02:45:00
161,2,1,1,0.028728781939215957,2019-03-27 02:30:00,2019-03-27 02:45:00
162,1,1,0,0.00801118920310601,2019-03-27 02:30:00,2019-03-27 02:45:00
173,1,0,1,0.00433015287020663,2019-03-27 02:30:00,2019-03-27 02:45:00
203,1,0,1,0.00433015287020663,2019-03-27 02:30:00,2019-03-27 02:45:00
41,1,0,1,0.004346147609863273,2019-03-27 02:45:00,2019-03-27 03:00:00
74,1,1,0,0.008040782404046858,2019-03-27 02:45:00,2019-03-27 03:00:00
85,1,1,0,0.008040782404046858,2019-03-27 02:45:00,2019-03-27 03:00:00
104,2,1,1,0.02883510650873368,2019-03-27 02:45:00,2019-03-27 03:00:00
110,2,1,1,0.02883510650873368,2019-03-27 02:45:00,2019-03-27 03:00:00
126,1,0,1,0.004346147609863273,2019-03-27 02:45:00,2019-03-27 03:00:00
157,2,1,1,0.02883510650873368,2019-03-27 02:45:00,2019-03-27 03:00:00
161,2,1,1,0.02883510650873368,2019-03-27 02:45:00,2019-03-27 03:00:00
162,1,1,0,0.008040782404046858,2019-03-27 02:45:00,2019-03-27 03:00:00
203,1,0,1,0.004346147609863273,2019-03-27 02:45:00,2019-03-27 03:00:00
41,1,0,1,0.0043166467145478015,2019-03-27 03:00:00,2019-03-27 03:15:00
46,1,0,1,0.0043166467145478015,2019-03-27 03:00:00,2019-03-27 03:15:00
74,1,1,0,0.007986199818738328,2019-03-27 03:00:00,2019-03-27 03:15:00
85,1,1,0,0.011105731182633947,2019-03-27 03:00:00,2019-03-27 03:15:00
104,2,1,1,0.028639066648810288,2019-03-27 03:00:00,2019-03-27 03:15:00
110,2,1,1,0.028639066648810288,2019-03-27 03:00:00,2019-03-27 03:15:00
126,1,0,1,0.0043166467145478015,2019-03-27 03:00:00,2019-03-27 03:15:00
157,2,1,1,0.028639066648810288,2019-03-27 03:00:00,2019-03-27 03:15:00
161,2,1,1,0.028639066648810288,2019-03-27 03:00:00,2019-03-27 03:15:00
162,1,1,0,0.007986199818738328,2019-03-27 03:00:00,2019-03-27 03:15:00
203,2,1,1,0.007986199818738328,2019-03-27 03:00:00,2019-03-27 03:15:00
41,1,0,1,0.0043166467145478015,2019-03-27 03:15:00,2019-03-27 03:30:00
46,1,0,1,0.0043166467145478015,2019-03-27 03:15:00,2019-03-27 03:30:00
74,1,1,0,0.007986199818738328,2019-03-27 03:15:00,2019-03-27 03:30:00
85,1,1,0,0.011105731182633947,2019-03-27 03:15:00,2019-03-27 03:30:00
104,2,1,1,0.028639066648810288,2019-03-27 03:15:00,2019-03-27 03:30:00
110,2,1,1,0.028639066648810288,2019-03-27 03:15:00,2019-03-27 03:30:00
126,1,0,1,0.0043166467145478015,2019-03-27 03:15:00,2019-03-27 03:30:00
157,2,1,1,0.028639066648810288,2019-03-27 03:15:00,2019-03-27 03:30:00
161,2,1,1,0.028639066648810288,2019-03-27 03:15:00,2019-03-27 03:30:00
162,1,1,0,0.007986199818738328,2019-03-27 03:15:00,2019-03-27 03:30:00
203,2,1,1,0.007986199818738328,2019-03-27 03:15:00,2019-03-27 03:30:00
41,1,0,1,0.0043008679594065385,2019-03-27 03:30:00,2019-03-27 03:45:00
46,1,0,1,0.0043008679594065385,2019-03-27 03:30:00,2019-03-27 03:45:00
58,1,0,1,0.0043008679594065385,2019-03-27 03:30:00,2019-03-27 03:45:00
74,1,1,0,0.007957006252019335,2019-03-27 03:30:00,2019-03-27 03:45:00
85,1,1,0,0.011065132062447046,2019-03-27 03:30:00,2019-03-27 03:45:00
89,1,1,0,0.007957006252019335,2019-03-27 03:30:00,2019-03-27 03:45:00
104,2,1,1,0.02853418072144806,2019-03-27 03:30:00,2019-03-27 03:45:00
110,2,1,1,0.02853418072144806,2019-03-27 03:30:00,2019-03-27 03:45:00
140,1,0,1,0.0043008679594065385,2019-03-27 03:30:00,2019-03-27 03:45:00
157,2,1,1,0.02853418072144806,2019-03-27 03:30:00,2019-03-27 03:45:00
161,2,1,1,0.02853418072144806,2019-03-27 03:30:00,2019-03-27 03:45:00
191,1,1,0,0.007957006252019335,2019-03-27 03:30:00,2019-03-27 03:45:00
203,2,1,1,0.007957006252019335,2019-03-27 03:30:00,2019-03-27 03:45:00
41,1,0,1,0.00433015287020663,2019-03-27 03:45:00,2019-03-27 04:00:00
57,1,0,1,0.00433015287020663,2019-03-27 03:45:00,2019-03-27 04:00:00
74,1,1,0,0.00801118920310601,2019-03-27 03:45:00,2019-03-27 04:00:00
85,1,1,0,0.00801118920310601,2019-03-27 03:45:00,2019-03-27 04:00:00
89,1,1,0,0.00801118920310601,2019-03-27 03:45:00,2019-03-27 04:00:00
104,2,1,1,0.028728781939215957,2019-03-27 03:45:00,2019-03-27 04:00:00
110,2,1,1,0.028728781939215957,2019-03-27 03:45:00,2019-03-27 04:00:00
140,1,0,1,0.00433015287020663,2019-03-27 03:45:00,2019-03-27 04:00:00
157,2,1,1,0.028728781939215957,2019-03-27 03:45:00,2019-03-27 04:00:00
161,2,1,1,0.028728781939215957,2019-03-27 03:45:00,2019-03-27 04:00:00
191,1,1,0,0.00801118920310601,2019-03-27 03:45:00,2019-03-27 04:00:00
203,1,0,1,0.00433015287020663,2019-03-27 03:45:00,2019-03-27 04:00:00
18,1,1,0,0.008040782404046858,2019-03-27 04:00:00,2019-03-27 04:15:00
41,1,0,1,0.004346147609863273,2019-03-27 04:00:00,2019-03-27 04:15:00
74,1,1,0,0.008040782404046858,2019-03-27 04:00:00,2019-03-27 04:15:00
85,1,1,0,0.008040782404046858,2019-03-27 04:00:00,2019-03-27 04:15:00
104,2,1,1,0.02883510650873368,2019-03-27 04:00:00,2019-03-27 04:15:00
109,1,0,1,0.004346147609863273,2019-03-27 04:00:00,2019-03-27 04:15:00
110,2,1,1,0.02883510650873368,2019-03-27 04:00:00,2019-03-27 04:15:00
157,2,1,1,0.02883510650873368,2019-03-27 04:00:00,2019-03-27 04:15:00
161,2,1,1,0.02883510650873368,2019-03-27 04:00:00,2019-03-27 04:15:00
203,1,0,1,0.004346147609863273,2019-03-27 04:00:00,2019-03-27 04:15:00
41,1,0,1,0.004346147609863273,2019-03-27 04:15:00,2019-03-27 04:30:00
74,1,1,0,0.008040782404046858,2019-03-27 04:15:00,2019-03-27 04:30:00
85,1,1,0,0.008040782404046858,2019-03-27 04:15:00,2019-03-27 04:30:00
104,2,1,1,0.02883510650873368,2019-03-27 04:15:00,2019-03-27 04:30:00
110,2,1,1,0.02883510650873368,2019-03-27 04:15:00,2019-03-27 04:30:00
127,1,1,0,0.008040782404046858,2019-03-27 04:15:00,2019-03-27 04:30:00
141,1,0,1,0.004346147609863273,2019-03-27 04:15:00,2019-03-27 04:30:00
157,2,1,1,0.02883510650873368,2019-03-27 04:15:00,2019-03-27 04:30:00
161,2,1,1,0.02883510650873368,2019-03-27 04:15:00,2019-03-27 04:30:00
203,1,0,1,0.004346147609863273,2019-03-27 04:15:00,2019-03-27 04:30:00
19,1,1,0,0.007818963449821796,2019-03-27 04:30:00,2019-03-27 04:45:00
41,1,0,1,0.004226268095442559,2019-03-27 04:30:00,2019-03-27 04:45:00
57,1,0,1,0.004226268095442559,2019-03-27 04:30:00,2019-03-27 04:45:00
74,1,1,0,0.007818963449821796,2019-03-27 04:30:00,2019-03-27 04:45:00
85,1,1,0,0.007818963449821796,2019-03-27 04:30:00,2019-03-27 04:45:00
104,2,1,1,0.02807511989879371,2019-03-27 04:30:00,2019-03-27 04:45:00
110,3,2,1,0.051923971702144855,2019-03-27 04:30:00,2019-03-27 04:45:00
127,1,1,0,0.007818963449821796,2019-03-27 04:30:00,2019-03-27 04:45:00
141,1,0,1,0.004226268095442559,2019-03-27 04:30:00,2019-03-27 04:45:00
157,2,1,1,0.02807511989879371,2019-03-27 04:30:00,2019-03-27 04:45:00
161,2,1,1,0.02807511989879371,2019-03-27 04:30:00,2019-03-27 04:45:00
191,1,0,1,0.004226268095442559,2019-03-27 04:30:00,2019-03-27 04:45:00
203,1,0,1,0.004226268095442559,2019-03-27 04:30:00,2019-03-27 04:45:00
19,1,1,0,0.00784714830297484,2019-03-27 04:45:00,2019-03-27 05:00:00
41,1,0,1,0.004241501868047338,2019-03-27 04:45:00,2019-03-27 05:00:00
57,1,0,1,0.004241501868047338,2019-03-27 04:45:00,2019-03-27 05:00:00
74,1,1,0,0.00784714830297484,2019-03-27 04:45:00,2019-03-27 05:00:00
85,1,1,0,0.00784714830297484,2019-03-27 04:45:00,2019-03-27 05:00:00
104,2,1,1,0.028176537417149556,2019-03-27 04:45:00,2019-03-27 05:00:00
110,3,2,1,0.052111572966251775,2019-03-27 04:45:00,2019-03-27 05:00:00
157,2,1,1,0.028176537417149556,2019-03-27 04:45:00,2019-03-27 05:00:00
161,2,1,1,0.028176537417149556,2019-03-27 04:45:00,2019-03-27 05:00:00
191,1,0,1,0.004241501868047338,2019-03-27 04:45:00,2019-03-27 05:00:00
203,1,0,1,0.004241501868047338,2019-03-27 04:45:00,2019-03-27 05:00:00
21,1,1,0,0.007728490562622862,2019-03-27 05:00:00,2019-03-27 05:15:00
41,1,0,1,0.0044434590845686345,2019-03-27 05:00:00,2019-03-27 05:15:00
74,1,1,0,0.008220816138057453,2019-03-27 05:00:00,2019-03-27 05:15:00
85,1,1,0,0.008220816138057453,2019-03-27 05:00:00,2019-03-27 05:15:00
104,2,1,1,0.02943216261801527,2019-03-27 05:00:00,2019-03-27 05:15:00
110,2,1,1,0.02943216261801527,2019-03-27 05:00:00,2019-03-27 05:15:00
157,3,1,2,0.007728490562622862,2019-03-27 05:00:00,2019-03-27 05:15:00
161,2,1,1,0.02943216261801527,2019-03-27 05:00:00,2019-03-27 05:15:00
203,1,0,1,0.0044434590845686345,2019-03-27 05:00:00,2019-03-27 05:15:00
21,2,2,0,0.01146255033015361,2019-03-27 05:15:00,2019-03-27 05:30:00
41,1,0,1,0.004426739869947351,2019-03-27 05:15:00,2019-03-27 05:30:00
74,1,1,0,0.008189882333744628,2019-03-27 05:15:00,2019-03-27 05:30:00
85,1,1,0,0.008189882333744628,2019-03-27 05:15:00,2019-03-27 05:30:00
104,2,1,1,0.029321260962140605,2019-03-27 05:15:00,2019-03-27 05:30:00
110,2,1,1,0.029321260962140605,2019-03-27 05:15:00,2019-03-27 05:30:00
151,1,0,1,0.004426739869947351,2019-03-27 05:15:00,2019-03-27 05:30:00
157,3,1,2,0.007699407866356332,2019-03-27 05:15:00,2019-03-27 05:30:00
161,2,1,1,0.029321260962140605,2019-03-27 05:15:00,2019-03-27 05:30:00
203,1,0,1,0.004426739869947351,2019-03-27 05:15:00,2019-03-27 05:30:00
19,1,1,0,0.008128707884704621,2019-03-27 05:30:00,2019-03-27 05:45:00
21,4,4,0,0.015111957839148902,2019-03-27 05:30:00,2019-03-27 05:45:00
41,1,0,1,0.004393676060255662,2019-03-27 05:30:00,2019-03-27 05:45:00
69,1,0,1,0.004393676060255662,2019-03-27 05:30:00,2019-03-27 05:45:00
74,1,1,0,0.008128707884704621,2019-03-27 05:30:00,2019-03-27 05:45:00
85,1,1,0,0.008128707884704621,2019-03-27 05:30:00,2019-03-27 05:45:00
104,2,1,1,0.029101946815374945,2019-03-27 05:30:00,2019-03-27 05:45:00
110,2,1,1,0.029101946815374945,2019-03-27 05:30:00,2019-03-27 05:45:00
140,1,0,1,0.004393676060255662,2019-03-27 05:30:00,2019-03-27 05:45:00
151,2,0,2,0.004393676060255662,2019-03-27 05:30:00,2019-03-27 05:45:00
157,3,1,2,0.007641894190250981,2019-03-27 05:30:00,2019-03-27 05:45:00
161,2,1,1,0.029101946815374945,2019-03-27 05:30:00,2019-03-27 05:45:00
203,1,0,1,0.004393676060255662,2019-03-27 05:30:00,2019-03-27 05:45:00
16,1,1,0,0.007842335252959961,2019-03-27 05:45:00,2019-03-27 06:00:00
18,1,0,1,0.004238889680289642,2019-03-27 05:45:00,2019-03-27 06:00:00
19,1,1,0,0.007842335252959961,2019-03-27 05:45:00,2019-03-27 06:00:00
21,2,2,0,0.01144578082563028,2019-03-27 05:45:00,2019-03-27 06:00:00
41,1,0,1,0.004238889680289642,2019-03-27 05:45:00,2019-03-27 06:00:00
67,1,1,0,0.007842335252959961,2019-03-27 05:45:00,2019-03-27 06:00:00
69,1,0,1,0.004238889680289642,2019-03-27 05:45:00,2019-03-27 06:00:00
74,1,1,0,0.007842335252959961,2019-03-27 05:45:00,2019-03-27 06:00:00
85,2,1,1,0.007842335252959961,2019-03-27 05:45:00,2019-03-27 06:00:00
104,2,1,1,0.028122209663227205,2019-03-27 05:45:00,2019-03-27 06:00:00
106,1,0,1,0.004238889680289642,2019-03-27 05:45:00,2019-03-27 06:00:00
110,2,1,1,0.028122209663227205,2019-03-27 05:45:00,2019-03-27 06:00:00
111,1,1,0,0.010905660707798116,2019-03-27 05:45:00,2019-03-27 06:00:00
127,1,1,0,0.007842335252959961,2019-03-27 05:45:00,2019-03-27 06:00:00
140,1,0,1,0.004238889680289642,2019-03-27 05:45:00,2019-03-27 06:00:00
151,1,0,1,0.004238889680289642,2019-03-27 05:45:00,2019-03-27 06:00:00
157,2,1,1,0.028122209663227205,2019-03-27 05:45:00,2019-03-27 06:00:00
158,1,0,1,0.004238889680289642,2019-03-27 05:45:00,2019-03-27 06:00:00
161,2,1,1,0.028122209663227205,2019-03-27 05:45:00,2019-03-27 06:00:00
203,1,0,1,0.004238889680289642,2019-03-27 05:45:00,2019-03-27 06:00:00
1,1,0,1,0.0041991222254633784,2019-03-27 06:00:00,2019-03-27 06:15:00
16,1,1,0,0.007768757115620804,2019-03-27 06:00:00,2019-03-27 06:15:00
18,1,0,1,0.0041991222254633784,2019-03-27 06:00:00,2019-03-27 06:15:00
19,1,1,0,0.007303496469610074,2019-03-27 06:00:00,2019-03-27 06:15:00
41,1,0,1,0.0041991222254633784,2019-03-27 06:00:00,2019-03-27 06:15:00
67,1,1,0,0.007768757115620804,2019-03-27 06:00:00,2019-03-27 06:15:00
74,1,1,0,0.007768757115620804,2019-03-27 06:00:00,2019-03-27 06:15:00
85,1,1,0,0.007768757115620804,2019-03-27 06:00:00,2019-03-27 06:15:00
87,1,1,0,0.007768757115620804,2019-03-27 06:00:00,2019-03-27 06:15:00
104,2,1,1,0.027858055423464888,2019-03-27 06:00:00,2019-03-27 06:15:00
106,1,0,1,0.0041991222254633784,2019-03-27 06:00:00,2019-03-27 06:15:00
109,2,2,0,0.0108731313597675,2019-03-27 06:00:00,2019-03-27 06:15:00
110,3,1,2,0.007303496469610074,2019-03-27 06:00:00,2019-03-27 06:15:00
116,1,1,0,0.007768757115620804,2019-03-27 06:00:00,2019-03-27 06:15:00
118,1,1,0,0.007768757115620804,2019-03-27 06:00:00,2019-03-27 06:15:00
120,1,0,1,0.0041991222254633784,2019-03-27 06:00:00,2019-03-27 06:15:00
141,1,0,1,0.0041991222254633784,2019-03-27 06:00:00,2019-03-27 06:15:00
157,2,1,1,0.027858055423464888,2019-03-27 06:00:00,2019-03-27 06:15:00
158,1,0,1,0.0041991222254633784,2019-03-27 06:00:00,2019-03-27 06:15:00
161,2,1,1,0.027858055423464888,2019-03-27 06:00:00,2019-03-27 06:15:00
171,2,1,1,0.027858055423464888,2019-03-27 06:00:00,2019-03-27 06:15:00
177,3,1,2,0.007303496469610074,2019-03-27 06:00:00,2019-03-27 06:15:00
190,1,1,0,0.007768757115620804,2019-03-27 06:00:00,2019-03-27 06:15:00
191,1,0,1,0.0041991222254633784,2019-03-27 06:00:00,2019-03-27 06:15:00
203,1,0,1,0.0041991222254633784,2019-03-27 06:00:00,2019-03-27 06:15:00
1,1,0,1,0.003910456749429939,2019-03-27 06:15:00,2019-03-27 06:30:00
10,1,1,0,0.007234713019499326,2019-03-27 06:15:00,2019-03-27 06:30:00
18,1,0,1,0.003910456749429939,2019-03-27 06:15:00,2019-03-27 06:30:00
19,4,2,2,0.012583455270267448,2019-03-27 06:15:00,2019-03-27 06:30:00
22,1,0,1,0.003910456749429939,2019-03-27 06:15:00,2019-03-27 06:30:00
27,1,1,0,0.007234713019499326,2019-03-27 06:15:00,2019-03-27 06:30:00
41,1,0,1,0.003910456749429939,2019-03-27 06:15:00,2019-03-27 06:30:00
50,1,0,1,0.003910456749429939,2019-03-27 06:15:00,2019-03-27 06:30:00
62,1,1,0,0.008647712025869822,2019-03-27 06:15:00,2019-03-27 06:30:00
67,1,1,0,0.007234713019499326,2019-03-27 06:15:00,2019-03-27 06:30:00
70,3,2,1,0.04518932849272325,2019-03-27 06:15:00,2019-03-27 06:30:00
74,1,1,0,0.007234713019499326,2019-03-27 06:15:00,2019-03-27 06:30:00
85,1,1,0,0.007234713019499326,2019-03-27 06:15:00,2019-03-27 06:30:00
90,1,0,1,0.003910456749429939,2019-03-27 06:15:00,2019-03-27 06:30:00
104,2,1,1,0.02599539237454951,2019-03-27 06:15:00,2019-03-27 06:30:00
106,1,0,1,0.003910456749429939,2019-03-27 06:15:00,2019-03-27 06:30:00
109,2,2,0,0.008463584391410468,2019-03-27 06:15:00,2019-03-27 06:30:00
110,3,1,2,0.006801456256375775,2019-03-27 06:15:00,2019-03-27 06:30:00
113,1,0,1,0.003910456749429939,2019-03-27 06:15:00,2019-03-27 06:30:00
118,1,1,0,0.007234713019499326,2019-03-27 06:15:00,2019-03-27 06:30:00
120,2,0,2,0.003910456749429939,2019-03-27 06:15:00,2019-03-27 06:30:00
127,1,1,0,0.007234713019499326,2019-03-27 06:15:00,2019-03-27 06:30:00
151,1,1,0,0.007234713019499326,2019-03-27 06:15:00,2019-03-27 06:30:00
154,2,1,1,0.005572584884464632,2019-03-27 06:15:00,2019-03-27 06:30:00
157,3,2,1,0.061492265103951144,2019-03-27 06:15:00,2019-03-27 06:30:00
161,2,1,1,0.02599539237454951,2019-03-27 06:15:00,2019-03-27 06:30:00
164,1,1,0,0.007234713019499326,2019-03-27 06:15:00,2019-03-27 06:30:00
171,3,1,2,0.006801456256375775,2019-03-27 06:15:00,2019-03-27 06:30:00
177,1,0,1,0.003910456749429939,2019-03-27 06:15:00,2019-03-27 06:30:00
203,1,0,1,0.003910456749429939,2019-03-27 06:15:00,2019-03-27 06:30:00
1,1,0,1,0.003840571129300382,2019-03-27 06:30:00,2019-03-27 06:45:00
10,1,1,0,0.0071054146066602715,2019-03-27 06:30:00,2019-03-27 06:45:00
16,1,0,1,0.003840571129300382,2019-03-27 06:30:00,2019-03-27 06:45:00
18,1,0,1,0.003840571129300382,2019-03-27 06:30:00,2019-03-27 06:45:00
19,5,2,3,0.009915047894399055,2019-03-27 06:30:00,2019-03-27 06:45:00
20,1,1,0,0.004928852288420345,2019-03-27 06:30:00,2019-03-27 06:45:00
26,1,0,1,0.003840571129300382,2019-03-27 06:30:00,2019-03-27 06:45:00
27,1,1,0,0.0071054146066602715,2019-03-27 06:30:00,2019-03-27 06:45:00
37,1,1,0,0.004928852288420345,2019-03-27 06:30:00,2019-03-27 06:45:00
41,3,0,3,0.003840571129300382,2019-03-27 06:30:00,2019-03-27 06:45:00
46,1,0,1,0.003840571129300382,2019-03-27 06:30:00,2019-03-27 06:45:00
50,1,0,1,0.003840571129300382,2019-03-27 06:30:00,2019-03-27 06:45:00
61,1,0,1,0.003840571129300382,2019-03-27 06:30:00,2019-03-27 06:45:00
62,1,1,0,0.009880901091964493,2019-03-27 06:30:00,2019-03-27 06:45:00
69,1,1,0,0.0071054146066602715,2019-03-27 06:30:00,2019-03-27 06:45:00
70,2,1,1,0.025529580372167876,2019-03-27 06:30:00,2019-03-27 06:45:00
74,3,3,0,0.009370907314839073,2019-03-27 06:30:00,2019-03-27 06:45:00
85,1,1,0,0.0071054146066602715,2019-03-27 06:30:00,2019-03-27 06:45:00
87,1,1,0,0.0071054146066602715,2019-03-27 06:30:00,2019-03-27 06:45:00
104,2,1,1,0.025529580372167876,2019-03-27 06:30:00,2019-03-27 06:45:00
109,1,0,1,0.003840571129300382,2019-03-27 06:30:00,2019-03-27 06:45:00
110,2,1,1,0.025529580372167876,2019-03-27 06:30:00,2019-03-27 06:45:00
112,1,1,0,0.0071054146066602715,2019-03-27 06:30:00,2019-03-27 06:45:00
113,1,1,0,0.0071054146066602715,2019-03-27 06:30:00,2019-03-27 06:45:00
120,1,0,1,0.003840571129300382,2019-03-27 06:30:00,2019-03-27 06:45:00
133,1,1,0,0.0071054146066602715,2019-03-27 06:30:00,2019-03-27 06:45:00
137,2,1,1,0.025529580372167876,2019-03-27 06:30:00,2019-03-27 06:45:00
138,1,1,0,0.0071054146066602715,2019-03-27 06:30:00,2019-03-27 06:45:00
141,1,1,0,0.0071054146066602715,2019-03-27 06:30:00,2019-03-27 06:45:00
147,2,0,2,0.003840571129300382,2019-03-27 06:30:00,2019-03-27 06:45:00
151,1,1,0,0.0071054146066602715,2019-03-27 06:30:00,2019-03-27 06:45:00
154,2,1,1,0.0071054146066602715,2019-03-27 06:30:00,2019-03-27 06:45:00
156,1,1,0,0.005472992867980327,2019-03-27 06:30:00,2019-03-27 06:45:00
157,3,2,1,0.04418135123248604,2019-03-27 06:30:00,2019-03-27 06:45:00
160,1,0,1,0.003840571129300382,2019-03-27 06:30:00,2019-03-27 06:45:00
161,2,1,1,0.025529580372167876,2019-03-27 06:30:00,2019-03-27 06:45:00
164,1,0,1,0.003840571129300382,2019-03-27 06:30:00,2019-03-27 06:45:00
170,1,1,0,0.0071054146066602715,2019-03-27 06:30:00,2019-03-27 06:45:00
173,1,0,1,0.003840571129300382,2019-03-27 06:30:00,2019-03-27 06:45:00
177,1,0,1,0.003840571129300382,2019-03-27 06:30:00,2019-03-27 06:45:00
203,1,0,1,0.003840571129300382,2019-03-27 06:30:00,2019-03-27 06:45:00
2,1,1,0,0.004882824138832859,2019-03-27 06:45:00,2019-03-27 07:00:00
10,1,1,0,0.004882824138832859,2019-03-27 06:45:00,2019-03-27 07:00:00
11,2,0,2,0.0038047118746940235,2019-03-27 06:45:00,2019-03-27 07:00:00
15,2,1,1,0.007039048667110529,2019-03-27 06:45:00,2019-03-27 07:00:00
18,4,0,4,0.0038047118746940235,2019-03-27 06:45:00,2019-03-27 07:00:00
19,3,0,3,0.0038047118746940235,2019-03-27 06:45:00,2019-03-27 07:00:00
20,1,0,1,0.0038047118746940235,2019-03-27 06:45:00,2019-03-27 07:00:00
21,1,1,0,0.009788575333862633,2019-03-27 06:45:00,2019-03-27 07:00:00
26,1,0,1,0.0038047118746940235,2019-03-27 06:45:00,2019-03-27 07:00:00
35,1,1,0,0.007039048667110529,2019-03-27 06:45:00,2019-03-27 07:00:00
37,2,2,0,0.007605227802382454,2019-03-27 06:45:00,2019-03-27 07:00:00
41,4,2,2,0.007039048667110529,2019-03-27 06:45:00,2019-03-27 07:00:00
46,1,0,1,0.0038047118746940235,2019-03-27 06:45:00,2019-03-27 07:00:00
57,1,0,1,0.0038047118746940235,2019-03-27 06:45:00,2019-03-27 07:00:00
61,1,0,1,0.0038047118746940235,2019-03-27 06:45:00,2019-03-27 07:00:00
62,1,1,0,0.007039048667110529,2019-03-27 06:45:00,2019-03-27 07:00:00
66,3,0,3,0.0038047118746940235,2019-03-27 06:45:00,2019-03-27 07:00:00
68,1,1,0,0.005309134781287717,2019-03-27 06:45:00,2019-03-27 07:00:00
69,2,1,1,0.007039048667110529,2019-03-27 06:45:00,2019-03-27 07:00:00
70,2,1,1,0.025280380566026467,2019-03-27 06:45:00,2019-03-27 07:00:00
74,3,3,0,0.01385861932758577,2019-03-27 06:45:00,2019-03-27 07:00:00
85,1,1,0,0.007039048667110529,2019-03-27 06:45:00,2019-03-27 07:00:00
87,1,1,0,0.007039048667110529,2019-03-27 06:45:00,2019-03-27 07:00:00
89,1,0,1,0.0038047118746940235,2019-03-27 06:45:00,2019-03-27 07:00:00
104,2,1,1,0.025280380566026467,2019-03-27 06:45:00,2019-03-27 07:00:00
109,1,1,0,0.004882824138832859,2019-03-27 06:45:00,2019-03-27 07:00:00
110,2,1,1,0.025280380566026467,2019-03-27 06:45:00,2019-03-27 07:00:00
112,1,1,0,0.007039048667110529,2019-03-27 06:45:00,2019-03-27 07:00:00
113,1,1,0,0.004882824138832859,2019-03-27 06:45:00,2019-03-27 07:00:00
115,1,1,0,0.00461329607279815,2019-03-27 06:45:00,2019-03-27 07:00:00
119,1,0,1,0.0038047118746940235,2019-03-27 06:45:00,2019-03-27 07:00:00
126,2,2,0,0.010273385459527036,2019-03-27 06:45:00,2019-03-27 07:00:00
133,1,1,0,0.00461329607279815,2019-03-27 06:45:00,2019-03-27 07:00:00
135,1,1,0,0.004882824138832859,2019-03-27 06:45:00,2019-03-27 07:00:00
137,2,1,1,0.025280380566026467,2019-03-27 06:45:00,2019-03-27 07:00:00
138,1,0,1,0.0038047118746940235,2019-03-27 06:45:00,2019-03-27 07:00:00
147,2,1,1,0.005309134781287717,2019-03-27 06:45:00,2019-03-27 07:00:00
151,2,1,1,0.007039048667110529,2019-03-27 06:45:00,2019-03-27 07:00:00
153,2,2,0,0.008117160931249366,2019-03-27 06:45:00,2019-03-27 07:00:00
154,1,0,1,0.0038047118746940235,2019-03-27 06:45:00,2019-03-27 07:00:00
156,1,1,0,0.008317980594475104,2019-03-27 06:45:00,2019-03-27 07:00:00
157,2,1,1,0.025280380566026467,2019-03-27 06:45:00,2019-03-27 07:00:00
158,1,1,0,0.00461329607279815,2019-03-27 06:45:00,2019-03-27 07:00:00
159,4,1,3,0.005309134781287717,2019-03-27 06:45:00,2019-03-27 07:00:00
160,1,0,1,0.0038047118746940235,2019-03-27 06:45:00,2019-03-27 07:00:00
161,2,1,1,0.025280380566026467,2019-03-27 06:45:00,2019-03-27 07:00:00
164,2,2,0,0.005960936402971694,2019-03-27 06:45:00,2019-03-27 07:00:00
170,1,1,0,0.009788575333862633,2019-03-27 06:45:00,2019-03-27 07:00:00
173,3,0,3,0.0038047118746940235,2019-03-27 06:45:00,2019-03-27 07:00:00
189,1,1,0,0.007039048667110529,2019-03-27 06:45:00,2019-03-27 07:00:00
195,1,1,0,0.007039048667110529,2019-03-27 06:45:00,2019-03-27 07:00:00
196,1,0,1,0.0038047118746940235,2019-03-27 06:45:00,2019-03-27 07:00:00
197,1,0,1,0.0038047118746940235,2019-03-27 06:45:00,2019-03-27 07:00:00
203,1,0,1,0.0038047118746940235,2019-03-27 06:45:00,2019-03-27 07:00:00
2,2,2,0,0.010772900028370185,2019-03-27 07:00:00,2019-03-27 07:15:00
10,1,1,0,0.004216666502718361,2019-03-27 07:00:00,2019-03-27 07:15:00
11,2,0,2,0.0036192405047261664,2019-03-27 07:00:00,2019-03-27 07:15:00
15,2,0,2,0.0036192405047261664,2019-03-27 07:00:00,2019-03-27 07:15:00
16,2,0,2,0.0036192405047261664,2019-03-27 07:00:00,2019-03-27 07:15:00
18,9,2,7,0.01200994023293143,2019-03-27 07:00:00,2019-03-27 07:15:00
19,7,1,6,0.004216666502718361,2019-03-27 07:00:00,2019-03-27 07:15:00
20,1,0,1,0.0036192405047261664,2019-03-27 07:00:00,2019-03-27 07:15:00
21,1,1,0,0.005157579509635342,2019-03-27 07:00:00,2019-03-27 07:15:00
27,1,1,0,0.006388469656886312,2019-03-27 07:00:00,2019-03-27 07:15:00
28,1,0,1,0.0036192405047261664,2019-03-27 07:00:00,2019-03-27 07:15:00
35,2,1,1,0.010551391492699251,2019-03-27 07:00:00,2019-03-27 07:15:00
37,4,4,0,0.011597984619343587,2019-03-27 07:00:00,2019-03-27 07:15:00
41,4,2,2,0.0066959185145445185,2019-03-27 07:00:00,2019-03-27 07:15:00
46,2,2,0,0.006481420461139016,2019-03-27 07:00:00,2019-03-27 07:15:00
58,1,1,0,0.0066959185145445185,2019-03-27 07:00:00,2019-03-27 07:15:00
61,1,0,1,0.0036192405047261664,2019-03-27 07:00:00,2019-03-27 07:15:00
62,3,2,1,0.006481420461139016,2019-03-27 07:00:00,2019-03-27 07:15:00
66,1,0,1,0.0036192405047261664,2019-03-27 07:00:00,2019-03-27 07:15:00
67,1,1,0,0.009129102364146362,2019-03-27 07:00:00,2019-03-27 07:15:00
68,2,1,1,0.005157579509635342,2019-03-27 07:00:00,2019-03-27 07:15:00
70,4,1,3,0.005050330482932591,2019-03-27 07:00:00,2019-03-27 07:15:00
74,2,2,0,0.007062757869293057,2019-03-27 07:00:00,2019-03-27 07:15:00
85,1,1,0,0.0066959185145445185,2019-03-27 07:00:00,2019-03-27 07:15:00
89,3,2,1,0.008154467254776697,2019-03-27 07:00:00,2019-03-27 07:15:00
90,2,1,1,0.023983875403052714,2019-03-27 07:00:00,2019-03-27 07:15:00
104,4,1,3,0.005050330482932591,2019-03-27 07:00:00,2019-03-27 07:15:00
109,2,2,0,0.007926808661795487,2019-03-27 07:00:00,2019-03-27 07:15:00
110,2,1,1,0.023983875403052714,2019-03-27 07:00:00,2019-03-27 07:15:00
113,1,0,1,0.0036192405047261664,2019-03-27 07:00:00,2019-03-27 07:15:00
114,1,1,0,0.013234680322872125,2019-03-27 07:00:00,2019-03-27 07:15:00
115,2,1,1,0.0050777892449583445,2019-03-27 07:00:00,2019-03-27 07:15:00
120,1,0,1,0.0036192405047261664,2019-03-27 07:00:00,2019-03-27 07:15:00
122,1,0,1,0.0036192405047261664,2019-03-27 07:00:00,2019-03-27 07:15:00
126,4,3,1,0.011310935529272046,2019-03-27 07:00:00,2019-03-27 07:15:00
127,1,1,0,0.005157579509635342,2019-03-27 07:00:00,2019-03-27 07:15:00
135,1,1,0,0.0066959185145445185,2019-03-27 07:00:00,2019-03-27 07:15:00
137,1,1,0,0.0066959185145445185,2019-03-27 07:00:00,2019-03-27 07:15:00
138,1,1,0,0.011605569350129658,2019-03-27 07:00:00,2019-03-27 07:15:00
140,1,0,1,0.0036192405047261664,2019-03-27 07:00:00,2019-03-27 07:15:00
141,2,1,1,0.005157579509635342,2019-03-27 07:00:00,2019-03-27 07:15:00
147,3,2,1,0.014127452436436896,2019-03-27 07:00:00,2019-03-27 07:15:00
151,2,0,2,0.0036192405047261664,2019-03-27 07:00:00,2019-03-27 07:15:00
153,2,1,1,0.004216666502718361,2019-03-27 07:00:00,2019-03-27 07:15:00
156,2,1,1,0.015629270802545468,2019-03-27 07:00:00,2019-03-27 07:15:00
157,2,1,1,0.023983875403052714,2019-03-27 07:00:00,2019-03-27 07:15:00
158,3,2,1,0.008154467254776697,2019-03-27 07:00:00,2019-03-27 07:15:00
159,2,0,2,0.0036192405047261664,2019-03-27 07:00:00,2019-03-27 07:15:00
161,2,1,1,0.023983875403052714,2019-03-27 07:00:00,2019-03-27 07:15:00
164,3,2,1,0.009394435509600386,2019-03-27 07:00:00,2019-03-27 07:15:00
168,1,0,1,0.0036192405047261664,2019-03-27 07:00:00,2019-03-27 07:15:00
170,2,2,0,0.00661612824986752,2019-03-27 07:00:00,2019-03-27 07:15:00
173,5,2,3,0.00977259652436287,2019-03-27 07:00:00,2019-03-27 07:15:00
189,2,2,0,0.011080348886028392,2019-03-27 07:00:00,2019-03-27 07:15:00
191,1,0,1,0.0036192405047261664,2019-03-27 07:00:00,2019-03-27 07:15:00
195,1,1,0,0.016906165328101515,2019-03-27 07:00:00,2019-03-27 07:15:00
196,1,1,0,0.004216666502718361,2019-03-27 07:00:00,2019-03-27 07:15:00
197,1,0,1,0.0036192405047261664,2019-03-27 07:00:00,2019-03-27 07:15:00
199,1,1,0,0.0072037964926793315,2019-03-27 07:00:00,2019-03-27 07:15:00
203,1,0,1,0.0036192405047261664,2019-03-27 07:00:00,2019-03-27 07:15:00
2,3,2,1,0.010013322449777345,2019-03-27 07:15:00,2019-03-27 07:30:00
5,7,2,5,0.004770263608015893,2019-03-27 07:15:00,2019-03-27 07:30:00
10,2,2,0,0.007509884819743012,2019-03-27 07:15:00,2019-03-27 07:30:00
11,2,0,2,0.0031481947949351563,2019-03-27 07:15:00,2019-03-27 07:30:00
15,1,0,1,0.0031481947949351563,2019-03-27 07:15:00,2019-03-27 07:30:00
16,3,0,3,0.0031481947949351563,2019-03-27 07:15:00,2019-03-27 07:30:00
18,5,1,4,0.0058244237868242885,2019-03-27 07:15:00,2019-03-27 07:30:00
19,6,1,5,0.003959229201475525,2019-03-27 07:15:00,2019-03-27 07:30:00
20,1,1,0,0.003959229201475525,2019-03-27 07:15:00,2019-03-27 07:30:00
21,1,1,0,0.004040271125564867,2019-03-27 07:15:00,2019-03-27 07:30:00
22,1,1,0,0.010610574656115897,2019-03-27 07:15:00,2019-03-27 07:30:00
27,1,1,0,0.006192608748723513,2019-03-27 07:15:00,2019-03-27 07:30:00
35,2,0,2,0.0031481947949351563,2019-03-27 07:15:00,2019-03-27 07:30:00
37,5,4,1,0.008834897885460491,2019-03-27 07:15:00,2019-03-27 07:30:00
41,5,2,3,0.0058244237868242885,2019-03-27 07:15:00,2019-03-27 07:30:00
46,6,5,1,0.013172069393794531,2019-03-27 07:15:00,2019-03-27 07:30:00
57,2,0,2,0.0031481947949351563,2019-03-27 07:15:00,2019-03-27 07:30:00
58,5,2,3,0.018948812575159974,2019-03-27 07:15:00,2019-03-27 07:30:00
61,2,0,2,0.0031481947949351563,2019-03-27 07:15:00,2019-03-27 07:30:00
62,4,3,1,0.007259746294114129,2019-03-27 07:15:00,2019-03-27 07:30:00
67,2,1,1,0.00931970309996874,2019-03-27 07:15:00,2019-03-27 07:30:00
68,3,2,1,0.004494474999853351,2019-03-27 07:15:00,2019-03-27 07:30:00
70,4,1,3,0.004393016517346475,2019-03-27 07:15:00,2019-03-27 07:30:00
74,1,1,0,0.004798626440162107,2019-03-27 07:15:00,2019-03-27 07:30:00
85,3,3,0,0.01015108442394037,2019-03-27 07:15:00,2019-03-27 07:30:00
89,3,3,0,0.00787328192728487,2019-03-27 07:15:00,2019-03-27 07:30:00
90,1,0,1,0.0031481947949351563,2019-03-27 07:15:00,2019-03-27 07:30:00
104,3,0,3,0.0031481947949351563,2019-03-27 07:15:00,2019-03-27 07:30:00
109,2,1,1,0.004040271125564867,2019-03-27 07:15:00,2019-03-27 07:30:00
110,3,2,1,0.05654345775069443,2019-03-27 07:15:00,2019-03-27 07:30:00
113,1,0,1,0.0031481947949351563,2019-03-27 07:15:00,2019-03-27 07:30:00
114,1,1,0,0.008099489730616008,2019-03-27 07:15:00,2019-03-27 07:30:00
116,2,2,0,0.010168256011993972,2019-03-27 07:15:00,2019-03-27 07:30:00
118,2,2,0,0.00515944939333882,2019-03-27 07:15:00,2019-03-27 07:30:00
119,3,3,0,0.013234683949387897,2019-03-27 07:15:00,2019-03-27 07:30:00
120,3,1,2,0.0058244237868242885,2019-03-27 07:15:00,2019-03-27 07:30:00
122,8,3,5,0.006425731616232514,2019-03-27 07:15:00,2019-03-27 07:30:00
126,2,1,1,0.0058244237868242885,2019-03-27 07:15:00,2019-03-27 07:30:00
127,1,1,0,0.0058244237868242885,2019-03-27 07:15:00,2019-03-27 07:30:00
135,4,1,3,0.004393016517346475,2019-03-27 07:15:00,2019-03-27 07:30:00
137,1,1,0,0.005623842262775583,2019-03-27 07:15:00,2019-03-27 07:30:00
138,2,2,0,0.006136740936106673,2019-03-27 07:15:00,2019-03-27 07:30:00
140,1,0,1,0.0031481947949351563,2019-03-27 07:15:00,2019-03-27 07:30:00
141,4,1,3,0.010669961320404367,2019-03-27 07:15:00,2019-03-27 07:30:00
147,4,2,2,0.017555965250622592,2019-03-27 07:15:00,2019-03-27 07:30:00
151,1,0,1,0.0031481947949351563,2019-03-27 07:15:00,2019-03-27 07:30:00
153,1,0,1,0.0031481947949351563,2019-03-27 07:15:00,2019-03-27 07:30:00
154,4,4,0,0.009738476512633633,2019-03-27 07:15:00,2019-03-27 07:30:00
156,2,1,1,0.010610574656115897,2019-03-27 07:15:00,2019-03-27 07:30:00
157,3,2,1,0.05654345775069443,2019-03-27 07:15:00,2019-03-27 07:30:00
158,3,2,1,0.015438328975600924,2019-03-27 07:15:00,2019-03-27 07:30:00
161,2,1,1,0.020929294396081464,2019-03-27 07:15:00,2019-03-27 07:30:00
162,2,0,2,0.0031481947949351563,2019-03-27 07:15:00,2019-03-27 07:30:00
164,1,0,1,0.0031481947949351563,2019-03-27 07:15:00,2019-03-27 07:30:00
168,1,0,1,0.0031481947949351563,2019-03-27 07:15:00,2019-03-27 07:30:00
170,4,3,1,0.015374020933016892,2019-03-27 07:15:00,2019-03-27 07:30:00
171,2,0,2,0.0031481947949351563,2019-03-27 07:15:00,2019-03-27 07:30:00
172,1,0,1,0.0031481947949351563,2019-03-27 07:15:00,2019-03-27 07:30:00
173,4,2,2,0.007162538282768853,2019-03-27 07:15:00,2019-03-27 07:30:00
177,3,1,2,0.005475593632854709,2019-03-27 07:15:00,2019-03-27 07:30:00
189,3,2,1,0.008847999315687577,2019-03-27 07:15:00,2019-03-27 07:30:00
191,1,0,1,0.0031481947949351563,2019-03-27 07:15:00,2019-03-27 07:30:00
195,3,3,0,0.02311490626681465,2019-03-27 07:15:00,2019-03-27 07:30:00
196,3,3,0,0.00605152572396853,2019-03-27 07:15:00,2019-03-27 07:30:00
199,2,1,1,0.0058244237868242885,2019-03-27 07:15:00,2019-03-27 07:30:00
202,1,0,1,0.0031481947949351563,2019-03-27 07:15:00,2019-03-27 07:30:00
203,1,0,1,0.0031481947949351563,2019-03-27 07:15:00,2019-03-27 07:30:00
1,1,0,1,0.0032488431181402007,2019-03-27 07:30:00,2019-03-27 07:45:00
2,2,1,1,0.008323733330748012,2019-03-27 07:30:00,2019-03-27 07:45:00
5,6,1,5,0.010420387414787903,2019-03-27 07:30:00,2019-03-27 07:45:00
10,5,5,0,0.010228448692740259,2019-03-27 07:30:00,2019-03-27 07:45:00
11,2,0,2,0.0032488431181402007,2019-03-27 07:30:00,2019-03-27 07:45:00
15,1,1,0,0.004629729327342856,2019-03-27 07:30:00,2019-03-27 07:45:00
16,2,0,2,0.0032488431181402007,2019-03-27 07:30:00,2019-03-27 07:45:00
18,6,2,4,0.009928946852052072,2019-03-27 07:30:00,2019-03-27 07:45:00
19,6,2,4,0.006401445698502433,2019-03-27 07:30:00,2019-03-27 07:45:00
20,1,1,0,0.005020559489299779,2019-03-27 07:30:00,2019-03-27 07:45:00
21,5,5,0,0.016918292316488077,2019-03-27 07:30:00,2019-03-27 07:45:00
23,1,1,0,0.004169433924275304,2019-03-27 07:30:00,2019-03-27 07:45:00
26,1,0,1,0.0032488431181402007,2019-03-27 07:30:00,2019-03-27 07:45:00
35,1,0,1,0.0032488431181402007,2019-03-27 07:30:00,2019-03-27 07:45:00
37,3,2,1,0.007391501745748166,2019-03-27 07:30:00,2019-03-27 07:45:00
41,6,2,4,0.0060106155365455115,2019-03-27 07:30:00,2019-03-27 07:45:00
46,7,6,1,0.01607892251133273,2019-03-27 07:30:00,2019-03-27 07:45:00
57,3,0,3,0.0032488431181402007,2019-03-27 07:30:00,2019-03-27 07:45:00
58,8,4,4,0.018395936305284487,2019-03-27 07:30:00,2019-03-27 07:45:00
61,2,0,2,0.0032488431181402007,2019-03-27 07:30:00,2019-03-27 07:45:00
62,3,2,1,0.008772387954950823,2019-03-27 07:30:00,2019-03-27 07:45:00
67,2,1,1,0.010706147010524223,2019-03-27 07:30:00,2019-03-27 07:45:00
68,3,2,1,0.00596977714593323,2019-03-27 07:30:00,2019-03-27 07:45:00
70,3,1,2,0.005650612777114572,2019-03-27 07:30:00,2019-03-27 07:45:00
74,2,1,1,0.004526227656988867,2019-03-27 07:30:00,2019-03-27 07:45:00
85,1,1,0,0.0060106155365455115,2019-03-27 07:30:00,2019-03-27 07:45:00
89,1,1,0,0.005020559489299779,2019-03-27 07:30:00,2019-03-27 07:45:00
90,1,0,1,0.0032488431181402007,2019-03-27 07:30:00,2019-03-27 07:45:00
104,2,1,1,0.007184297354297601,2019-03-27 07:30:00,2019-03-27 07:45:00
109,2,1,1,0.00718449840504019,2019-03-27 07:30:00,2019-03-27 07:45:00
110,4,1,3,0.004533449108722663,2019-03-27 07:30:00,2019-03-27 07:45:00
111,1,0,1,0.0032488431181402007,2019-03-27 07:30:00,2019-03-27 07:45:00
112,2,1,1,0.007184297354297601,2019-03-27 07:30:00,2019-03-27 07:45:00
113,2,1,1,0.0060106155365455115,2019-03-27 07:30:00,2019-03-27 07:45:00
114,1,0,1,0.0032488431181402007,2019-03-27 07:30:00,2019-03-27 07:45:00
116,3,2,1,0.00843595369077601,2019-03-27 07:30:00,2019-03-27 07:45:00
118,4,2,2,0.007371082550442026,2019-03-27 07:30:00,2019-03-27 07:45:00
119,3,3,0,0.01302328611386455,2019-03-27 07:30:00,2019-03-27 07:45:00
120,1,0,1,0.0032488431181402007,2019-03-27 07:30:00,2019-03-27 07:45:00
122,1,0,1,0.0032488431181402007,2019-03-27 07:30:00,2019-03-27 07:45:00
126,2,1,1,0.004629729327342856,2019-03-27 07:30:00,2019-03-27 07:45:00
135,2,0,2,0.0032488431181402007,2019-03-27 07:30:00,2019-03-27 07:45:00
137,3,3,0,0.015206787723736891,2019-03-27 07:30:00,2019-03-27 07:45:00
138,6,6,0,0.01934249684494803,2019-03-27 07:30:00,2019-03-27 07:45:00
140,2,1,1,0.0060106155365455115,2019-03-27 07:30:00,2019-03-27 07:45:00
141,3,0,3,0.0032488431181402007,2019-03-27 07:30:00,2019-03-27 07:45:00
147,9,4,5,0.02314677660182604,2019-03-27 07:30:00,2019-03-27 07:45:00
153,1,1,0,0.004526227656988867,2019-03-27 07:30:00,2019-03-27 07:45:00
154,3,3,0,0.00812075129917786,2019-03-27 07:30:00,2019-03-27 07:45:00
156,1,1,0,0.007184297354297601,2019-03-27 07:30:00,2019-03-27 07:45:00
157,3,2,1,0.047297555545658974,2019-03-27 07:30:00,2019-03-27 07:45:00
158,6,2,4,0.021483429585940655,2019-03-27 07:30:00,2019-03-27 07:45:00
161,2,1,1,0.021531178957985894,2019-03-27 07:30:00,2019-03-27 07:45:00
162,2,0,2,0.0032488431181402007,2019-03-27 07:30:00,2019-03-27 07:45:00
164,1,1,0,0.008358381273534866,2019-03-27 07:30:00,2019-03-27 07:45:00
168,1,0,1,0.0032488431181402007,2019-03-27 07:30:00,2019-03-27 07:45:00
170,4,3,1,0.014007222814366038,2019-03-27 07:30:00,2019-03-27 07:45:00
171,2,0,2,0.0032488431181402007,2019-03-27 07:30:00,2019-03-27 07:45:00
172,2,0,2,0.0032488431181402007,2019-03-27 07:30:00,2019-03-27 07:45:00
173,1,0,1,0.0032488431181402007,2019-03-27 07:30:00,2019-03-27 07:45:00
177,1,0,1,0.0032488431181402007,2019-03-27 07:30:00,2019-03-27 07:45:00
189,3,1,2,0.004533449108722663,2019-03-27 07:30:00,2019-03-27 07:45:00
190,2,2,0,0.008772387954950823,2019-03-27 07:30:00,2019-03-27 07:45:00
191,2,1,1,0.004609310132036715,2019-03-27 07:30:00,2019-03-27 07:45:00
195,2,2,0,0.01327069911348945,2019-03-27 07:30:00,2019-03-27 07:45:00
196,4,4,0,0.018616280563085418,2019-03-27 07:30:00,2019-03-27 07:45:00
197,1,0,1,0.0032488431181402007,2019-03-27 07:30:00,2019-03-27 07:45:00
199,1,0,1,0.0032488431181402007,2019-03-27 07:30:00,2019-03-27 07:45:00
201,4,1,3,0.004533449108722663,2019-03-27 07:30:00,2019-03-27 07:45:00
203,1,0,1,0.0032488431181402007,2019-03-27 07:30:00,2019-03-27 07:45:00
2,1,1,0,0.003967284871543667,2019-03-27 07:45:00,2019-03-27 08:00:00
5,6,1,5,0.003967284871543667,2019-03-27 07:45:00,2019-03-27 08:00:00
10,4,4,0,0.008327945512348923,2019-03-27 07:45:00,2019-03-27 08:00:00
15,1,1,0,0.005259970017523992,2019-03-27 07:45:00,2019-03-27 08:00:00
16,2,1,1,0.004051536650558131,2019-03-27 07:45:00,2019-03-27 08:00:00
18,3,1,2,0.004051536650558131,2019-03-27 07:45:00,2019-03-27 08:00:00
19,4,0,4,0.00284310328359227,2019-03-27 07:45:00,2019-03-27 08:00:00
21,5,5,0,0.016303302488682628,2019-03-27 07:45:00,2019-03-27 08:00:00
23,5,4,1,0.01544164153332286,2019-03-27 07:45:00,2019-03-27 08:00:00
26,3,2,1,0.0062590123918787955,2019-03-27 07:45:00,2019-03-27 08:00:00
27,1,0,1,0.00284310328359227,2019-03-27 07:45:00,2019-03-27 08:00:00
30,2,0,2,0.00284310328359227,2019-03-27 07:45:00,2019-03-27 08:00:00
35,2,1,1,0.005259970017523992,2019-03-27 07:45:00,2019-03-27 08:00:00
40,1,1,0,0.003967284871543667,2019-03-27 07:45:00,2019-03-27 08:00:00
41,2,0,2,0.00284310328359227,2019-03-27 07:45:00,2019-03-27 08:00:00
46,5,5,0,0.010385617005026104,2019-03-27 07:45:00,2019-03-27 08:00:00
57,3,1,2,0.005391653006935221,2019-03-27 07:45:00,2019-03-27 08:00:00
58,4,1,3,0.003967284871543667,2019-03-27 07:45:00,2019-03-27 08:00:00
61,1,0,1,0.00284310328359227,2019-03-27 07:45:00,2019-03-27 08:00:00
62,2,0,2,0.00284310328359227,2019-03-27 07:45:00,2019-03-27 08:00:00
66,1,1,0,0.004051536650558131,2019-03-27 07:45:00,2019-03-27 08:00:00
67,2,1,1,0.004051536650558131,2019-03-27 07:45:00,2019-03-27 08:00:00
68,5,1,4,0.003610388507986317,2019-03-27 07:45:00,2019-03-27 08:00:00
70,1,0,1,0.00284310328359227,2019-03-27 07:45:00,2019-03-27 08:00:00
74,2,1,1,0.004051536650558131,2019-03-27 07:45:00,2019-03-27 08:00:00
79,1,0,1,0.00284310328359227,2019-03-27 07:45:00,2019-03-27 08:00:00
85,1,1,0,0.005259970017523992,2019-03-27 07:45:00,2019-03-27 08:00:00
87,1,1,0,0.004051536650558131,2019-03-27 07:45:00,2019-03-27 08:00:00
88,2,0,2,0.00284310328359227,2019-03-27 07:45:00,2019-03-27 08:00:00
89,3,1,2,0.003517612236363108,2019-03-27 07:45:00,2019-03-27 08:00:00
90,2,0,2,0.00284310328359227,2019-03-27 07:45:00,2019-03-27 08:00:00
104,3,1,2,0.005823778749206562,2019-03-27 07:45:00,2019-03-27 08:00:00
109,2,1,1,0.004051536650558131,2019-03-27 07:45:00,2019-03-27 08:00:00
110,5,2,3,0.006562187539310411,2019-03-27 07:45:00,2019-03-27 08:00:00
112,2,2,0,0.00969663481229012,2019-03-27 07:45:00,2019-03-27 08:00:00
113,4,2,2,0.011397919278524873,2019-03-27 07:45:00,2019-03-27 08:00:00
114,4,3,1,0.007151436829869436,2019-03-27 07:45:00,2019-03-27 08:00:00
116,4,1,3,0.003967284871543667,2019-03-27 07:45:00,2019-03-27 08:00:00
118,2,1,1,0.0034473199670752,2019-03-27 07:45:00,2019-03-27 08:00:00
119,3,3,0,0.014843101009196762,2019-03-27 07:45:00,2019-03-27 08:00:00
120,2,0,2,0.00284310328359227,2019-03-27 07:45:00,2019-03-27 08:00:00
122,1,0,1,0.00284310328359227,2019-03-27 07:45:00,2019-03-27 08:00:00
126,2,0,2,0.00284310328359227,2019-03-27 07:45:00,2019-03-27 08:00:00
127,3,1,2,0.004944947554809525,2019-03-27 07:45:00,2019-03-27 08:00:00
135,1,1,0,0.003967284871543667,2019-03-27 07:45:00,2019-03-27 08:00:00
137,5,4,1,0.027345752626865533,2019-03-27 07:45:00,2019-03-27 08:00:00
138,5,5,0,0.013378021551443579,2019-03-27 07:45:00,2019-03-27 08:00:00
140,2,1,1,0.005259970017523992,2019-03-27 07:45:00,2019-03-27 08:00:00
141,2,0,2,0.00284310328359227,2019-03-27 07:45:00,2019-03-27 08:00:00
147,7,3,4,0.014024928076210374,2019-03-27 07:45:00,2019-03-27 08:00:00
153,5,5,0,0.008547476835736006,2019-03-27 07:45:00,2019-03-27 08:00:00
154,3,2,1,0.008704125563487004,2019-03-27 07:45:00,2019-03-27 08:00:00
156,2,2,0,0.006591063973600609,2019-03-27 07:45:00,2019-03-27 08:00:00
157,4,2,2,0.0059958696904181515,2019-03-27 07:45:00,2019-03-27 08:00:00
158,8,3,5,0.039537104886165346,2019-03-27 07:45:00,2019-03-27 08:00:00
160,4,1,3,0.003967284871543667,2019-03-27 07:45:00,2019-03-27 08:00:00
161,2,1,1,0.01892479699770245,2019-03-27 07:45:00,2019-03-27 08:00:00
162,2,1,1,0.004051536650558131,2019-03-27 07:45:00,2019-03-27 08:00:00
164,6,5,1,0.09163835613358227,2019-03-27 07:45:00,2019-03-27 08:00:00
168,1,0,1,0.00284310328359227,2019-03-27 07:45:00,2019-03-27 08:00:00
170,5,4,1,0.08805053248905513,2019-03-27 07:45:00,2019-03-27 08:00:00
171,1,0,1,0.00284310328359227,2019-03-27 07:45:00,2019-03-27 08:00:00
172,1,1,0,0.0034473199670752,2019-03-27 07:45:00,2019-03-27 08:00:00
173,3,0,3,0.00284310328359227,2019-03-27 07:45:00,2019-03-27 08:00:00
189,2,0,2,0.00284310328359227,2019-03-27 07:45:00,2019-03-27 08:00:00
190,2,2,0,0.004772907116187574,2019-03-27 07:45:00,2019-03-27 08:00:00
195,4,4,0,0.0070586605582462275,2019-03-27 07:45:00,2019-03-27 08:00:00
196,4,2,2,0.004726045603328969,2019-03-27 07:45:00,2019-03-27 08:00:00
197,4,1,3,0.003967284871543667,2019-03-27 07:45:00,2019-03-27 08:00:00
199,2,0,2,0.00284310328359227,2019-03-27 07:45:00,2019-03-27 08:00:00
201,4,1,3,0.003967284871543667,2019-03-27 07:45:00,2019-03-27 08:00:00
202,1,0,1,0.00284310328359227,2019-03-27 07:45:00,2019-03-27 08:00:00
203,1,0,1,0.00284310328359227,2019-03-27 07:45:00,2019-03-27 08:00:00
2,1,0,1,0.0031646390152874787,2019-03-27 08:00:00,2019-03-27 08:15:00
5,5,0,5,0.0031646390152874787,2019-03-27 08:00:00,2019-03-27 08:15:00
10,3,3,0,0.010183233615073938,2019-03-27 08:00:00,2019-03-27 08:15:00
15,4,1,3,0.005854834538301676,2019-03-27 08:00:00,2019-03-27 08:15:00
16,1,1,0,0.007947699467183971,2019-03-27 08:00:00,2019-03-27 08:15:00
18,2,2,0,0.007191885176195253,2019-03-27 08:00:00,2019-03-27 08:15:00
19,5,2,3,0.008239911041743358,2019-03-27 08:00:00,2019-03-27 08:15:00
21,2,2,0,0.014651959003336108,2019-03-27 08:00:00,2019-03-27 08:15:00
23,3,2,1,0.01337544964146491,2019-03-27 08:00:00,2019-03-27 08:15:00
26,2,2,0,0.00748928913896906,2019-03-27 08:00:00,2019-03-27 08:15:00
28,1,0,1,0.0031646390152874787,2019-03-27 08:00:00,2019-03-27 08:15:00
30,3,0,3,0.0031646390152874787,2019-03-27 08:00:00,2019-03-27 08:15:00
40,3,3,0,0.015581335669246766,2019-03-27 08:00:00,2019-03-27 08:15:00
41,1,0,1,0.0031646390152874787,2019-03-27 08:00:00,2019-03-27 08:15:00
46,6,5,1,0.008913914252463,2019-03-27 08:00:00,2019-03-27 08:15:00
57,3,1,2,0.007230439437467191,2019-03-27 08:00:00,2019-03-27 08:15:00
58,3,0,3,0.0031646390152874787,2019-03-27 08:00:00,2019-03-27 08:15:00
61,3,2,1,0.004915428813342093,2019-03-27 08:00:00,2019-03-27 08:15:00
62,2,1,1,0.004315473642042751,2019-03-27 08:00:00,2019-03-27 08:15:00
66,4,3,1,0.018824789609954724,2019-03-27 08:00:00,2019-03-27 08:15:00
67,2,1,1,0.008141759610056531,2019-03-27 08:00:00,2019-03-27 08:15:00
68,4,0,4,0.0031646390152874787,2019-03-27 08:00:00,2019-03-27 08:15:00
69,2,0,2,0.0031646390152874787,2019-03-27 08:00:00,2019-03-27 08:15:00
74,2,1,1,0.005854834538301676,2019-03-27 08:00:00,2019-03-27 08:15:00
79,2,0,2,0.0031646390152874787,2019-03-27 08:00:00,2019-03-27 08:15:00
85,1,1,0,0.005854834538301676,2019-03-27 08:00:00,2019-03-27 08:15:00
88,4,1,3,0.004415953738489747,2019-03-27 08:00:00,2019-03-27 08:15:00
89,2,0,2,0.0031646390152874787,2019-03-27 08:00:00,2019-03-27 08:15:00
104,5,1,4,0.00401869697233736,2019-03-27 08:00:00,2019-03-27 08:15:00
109,4,3,1,0.005626541723846136,2019-03-27 08:00:00,2019-03-27 08:15:00
110,4,2,2,0.010183233615073938,2019-03-27 08:00:00,2019-03-27 08:15:00
112,4,3,1,0.01451479920963645,2019-03-27 08:00:00,2019-03-27 08:15:00
113,2,1,1,0.00401869697233736,2019-03-27 08:00:00,2019-03-27 08:15:00
114,5,2,3,0.007106149261503945,2019-03-27 08:00:00,2019-03-27 08:15:00
116,4,1,3,0.0040613708562922115,2019-03-27 08:00:00,2019-03-27 08:15:00
118,1,1,0,0.00549953892381672,2019-03-27 08:00:00,2019-03-27 08:15:00
119,1,0,1,0.0031646390152874787,2019-03-27 08:00:00,2019-03-27 08:15:00
120,2,0,2,0.0031646390152874787,2019-03-27 08:00:00,2019-03-27 08:15:00
122,5,2,3,0.007304241181204886,2019-03-27 08:00:00,2019-03-27 08:15:00
127,1,0,1,0.0031646390152874787,2019-03-27 08:00:00,2019-03-27 08:15:00
135,1,1,0,0.004415953738489747,2019-03-27 08:00:00,2019-03-27 08:15:00
137,5,3,2,0.017131566555618493,2019-03-27 08:00:00,2019-03-27 08:15:00
138,3,3,0,0.0073196116018062005,2019-03-27 08:00:00,2019-03-27 08:15:00
147,3,1,2,0.010742317205164225,2019-03-27 08:00:00,2019-03-27 08:15:00
151,1,1,0,0.004509736776794578,2019-03-27 08:00:00,2019-03-27 08:15:00
153,4,4,0,0.008168110582022353,2019-03-27 08:00:00,2019-03-27 08:15:00
154,1,1,0,0.004509736776794578,2019-03-27 08:00:00,2019-03-27 08:15:00
156,3,3,0,0.009748333177085912,2019-03-27 08:00:00,2019-03-27 08:15:00
157,4,2,2,0.009565339345996432,2019-03-27 08:00:00,2019-03-27 08:15:00
158,3,2,1,0.06932257084511498,2019-03-27 08:00:00,2019-03-27 08:15:00
160,4,1,3,0.004415953738489747,2019-03-27 08:00:00,2019-03-27 08:15:00
161,2,1,1,0.021032445448788854,2019-03-27 08:00:00,2019-03-27 08:15:00
162,2,1,1,0.0068331597704134935,2019-03-27 08:00:00,2019-03-27 08:15:00
164,3,2,1,0.011300578510451508,2019-03-27 08:00:00,2019-03-27 08:15:00
170,2,2,0,0.020512957427684782,2019-03-27 08:00:00,2019-03-27 08:15:00
172,1,1,0,0.00549953892381672,2019-03-27 08:00:00,2019-03-27 08:15:00
173,2,1,1,0.005178262095741366,2019-03-27 08:00:00,2019-03-27 08:15:00
189,2,0,2,0.0031646390152874787,2019-03-27 08:00:00,2019-03-27 08:15:00
191,2,1,1,0.021032445448788854,2019-03-27 08:00:00,2019-03-27 08:15:00
195,5,5,0,0.007737971404411615,2019-03-27 08:00:00,2019-03-27 08:15:00
196,4,3,1,0.007381441376105107,2019-03-27 08:00:00,2019-03-27 08:15:00
197,4,1,3,0.004415953738489747,2019-03-27 08:00:00,2019-03-27 08:15:00
199,5,1,4,0.00401869697233736,2019-03-27 08:00:00,2019-03-27 08:15:00
201,2,1,1,0.021032445448788854,2019-03-27 08:00:00,2019-03-27 08:15:00
202,3,1,2,0.005504170548549632,2019-03-27 08:00:00,2019-03-27 08:15:00
203,1,0,1,0.0031646390152874787,2019-03-27 08:00:00,2019-03-27 08:15:00
1,2,2,0,0.006963677420273698,2019-03-27 08:15:00,2019-03-27 08:30:00
2,3,1,2,0.00562523081568494,2019-03-27 08:15:00,2019-03-27 08:30:00
5,3,0,3,0.003148965401702606,2019-03-27 08:15:00,2019-03-27 08:30:00
10,3,2,1,0.005825858610880123,2019-03-27 08:15:00,2019-03-27 08:30:00
15,2,0,2,0.003148965401702606,2019-03-27 08:15:00,2019-03-27 08:30:00
16,1,0,1,0.003148965401702606,2019-03-27 08:15:00,2019-03-27 08:30:00
18,5,3,2,0.007989727020129659,2019-03-27 08:15:00,2019-03-27 08:30:00
19,4,3,1,0.0077465847650966604,2019-03-27 08:15:00,2019-03-27 08:30:00
20,1,0,1,0.003148965401702606,2019-03-27 08:15:00,2019-03-27 08:30:00
21,1,1,0,0.011823024313198548,2019-03-27 08:15:00,2019-03-27 08:30:00
23,1,1,0,0.004487412006291365,2019-03-27 08:15:00,2019-03-27 08:30:00
26,4,2,2,0.008378513702661114,2019-03-27 08:15:00,2019-03-27 08:30:00
28,2,0,2,0.003148965401702606,2019-03-27 08:15:00,2019-03-27 08:30:00
30,1,0,1,0.003148965401702606,2019-03-27 08:15:00,2019-03-27 08:30:00
40,3,3,0,0.009841198424646399,2019-03-27 08:15:00,2019-03-27 08:30:00
41,3,1,2,0.01678276827610842,2019-03-27 08:15:00,2019-03-27 08:30:00
46,4,3,1,0.006884361533328673,2019-03-27 08:15:00,2019-03-27 08:30:00
50,1,0,1,0.003148965401702606,2019-03-27 08:15:00,2019-03-27 08:30:00
57,6,1,5,0.0054769459437063895,2019-03-27 08:15:00,2019-03-27 08:30:00
58,4,1,3,0.004394097445577961,2019-03-27 08:15:00,2019-03-27 08:30:00
61,2,0,2,0.003148965401702606,2019-03-27 08:15:00,2019-03-27 08:30:00
62,1,0,1,0.003148965401702606,2019-03-27 08:15:00,2019-03-27 08:30:00
66,4,1,3,0.004487412006291365,2019-03-27 08:15:00,2019-03-27 08:30:00
67,3,2,1,0.010203291561802457,2019-03-27 08:15:00,2019-03-27 08:30:00
68,5,2,3,0.011903831303547274,2019-03-27 08:15:00,2019-03-27 08:30:00
69,2,0,2,0.003148965401702606,2019-03-27 08:15:00,2019-03-27 08:30:00
74,6,3,3,0.015447309181719826,2019-03-27 08:15:00,2019-03-27 08:30:00
75,1,0,1,0.003148965401702606,2019-03-27 08:15:00,2019-03-27 08:30:00
79,2,0,2,0.003148965401702606,2019-03-27 08:15:00,2019-03-27 08:30:00
85,1,1,0,0.00562523081568494,2019-03-27 08:15:00,2019-03-27 08:30:00
86,1,0,1,0.003148965401702606,2019-03-27 08:15:00,2019-03-27 08:30:00
88,2,1,1,0.02090728213726703,2019-03-27 08:15:00,2019-03-27 08:30:00
89,1,1,0,0.005056321410988152,2019-03-27 08:15:00,2019-03-27 08:30:00
90,2,1,1,0.004394097445577961,2019-03-27 08:15:00,2019-03-27 08:30:00
104,1,0,1,0.003148965401702606,2019-03-27 08:15:00,2019-03-27 08:30:00
109,2,2,0,0.007414579596841799,2019-03-27 08:15:00,2019-03-27 08:30:00
110,3,2,1,0.03675824286354591,2019-03-27 08:15:00,2019-03-27 08:30:00
111,2,2,0,0.011497522205107292,2019-03-27 08:15:00,2019-03-27 08:30:00
112,2,2,0,0.011553774547156927,2019-03-27 08:15:00,2019-03-27 08:30:00
113,1,1,0,0.010282790440310984,2019-03-27 08:15:00,2019-03-27 08:30:00
114,4,4,0,0.010772390641447912,2019-03-27 08:15:00,2019-03-27 08:30:00
116,1,0,1,0.003148965401702606,2019-03-27 08:15:00,2019-03-27 08:30:00
118,4,3,1,0.01603743580460043,2019-03-27 08:15:00,2019-03-27 08:30:00
120,1,0,1,0.003148965401702606,2019-03-27 08:15:00,2019-03-27 08:30:00
126,1,0,1,0.003148965401702606,2019-03-27 08:15:00,2019-03-27 08:30:00
135,1,1,0,0.005825858610880123,2019-03-27 08:15:00,2019-03-27 08:30:00
137,4,2,2,0.007164305215468882,2019-03-27 08:15:00,2019-03-27 08:30:00
138,4,4,0,0.018700327722956003,2019-03-27 08:15:00,2019-03-27 08:30:00
140,1,0,1,0.003148965401702606,2019-03-27 08:15:00,2019-03-27 08:30:00
147,3,1,2,0.009001367378225773,2019-03-27 08:15:00,2019-03-27 08:30:00
151,3,1,2,0.004487412006291365,2019-03-27 08:15:00,2019-03-27 08:30:00
153,7,5,2,0.019150025371735768,2019-03-27 08:15:00,2019-03-27 08:30:00
154,2,2,0,0.007164305215468882,2019-03-27 08:15:00,2019-03-27 08:30:00
156,2,2,0,0.008313484143111447,2019-03-27 08:15:00,2019-03-27 08:30:00
157,3,1,2,0.0054769459437063895,2019-03-27 08:15:00,2019-03-27 08:30:00
159,2,1,1,0.005056321410988152,2019-03-27 08:15:00,2019-03-27 08:30:00
160,3,2,1,0.04450797108111103,2019-03-27 08:15:00,2019-03-27 08:30:00
161,2,1,1,0.02090728213726703,2019-03-27 08:15:00,2019-03-27 08:30:00
162,2,0,2,0.003148965401702606,2019-03-27 08:15:00,2019-03-27 08:30:00
164,1,1,0,0.0061941402203817275,2019-03-27 08:15:00,2019-03-27 08:30:00
168,1,0,1,0.003148965401702606,2019-03-27 08:15:00,2019-03-27 08:30:00
170,6,6,0,0.018577611908589704,2019-03-27 08:15:00,2019-03-27 08:30:00
171,1,0,1,0.003148965401702606,2019-03-27 08:15:00,2019-03-27 08:30:00
172,1,0,1,0.003148965401702606,2019-03-27 08:15:00,2019-03-27 08:30:00
173,1,0,1,0.003148965401702606,2019-03-27 08:15:00,2019-03-27 08:30:00
189,2,0,2,0.003148965401702606,2019-03-27 08:15:00,2019-03-27 08:30:00
191,3,1,2,0.0054769459437063895,2019-03-27 08:15:00,2019-03-27 08:30:00
195,2,2,0,0.007164305215468882,2019-03-27 08:15:00,2019-03-27 08:30:00
196,6,4,2,0.011837095500518688,2019-03-27 08:15:00,2019-03-27 08:30:00
197,2,0,2,0.003148965401702606,2019-03-27 08:15:00,2019-03-27 08:30:00
199,3,1,2,0.005825858610880123,2019-03-27 08:15:00,2019-03-27 08:30:00
202,4,1,3,0.004394097445577961,2019-03-27 08:15:00,2019-03-27 08:30:00
203,3,1,2,0.005825858610880123,2019-03-27 08:15:00,2019-03-27 08:30:00
1,1,1,0,0.003668119274471915,2019-03-27 08:30:00,2019-03-27 08:45:00
2,4,2,2,0.007210307620722589,2019-03-27 08:30:00,2019-03-27 08:45:00
5,4,1,3,0.004030712096694942,2019-03-27 08:30:00,2019-03-27 08:45:00
10,5,1,4,0.003668119274471915,2019-03-27 08:30:00,2019-03-27 08:45:00
15,2,1,1,0.00806899933939292,2019-03-27 08:30:00,2019-03-27 08:45:00
16,4,2,2,0.012187846496820687,2019-03-27 08:30:00,2019-03-27 08:45:00
18,5,3,2,0.01043887685026518,2019-03-27 08:30:00,2019-03-27 08:45:00
19,5,2,3,0.008915243477375243,2019-03-27 08:30:00,2019-03-27 08:45:00
20,2,1,1,0.005752855923960418,2019-03-27 08:30:00,2019-03-27 08:45:00
21,2,1,1,0.014928755917914288,2019-03-27 08:30:00,2019-03-27 08:45:00
26,4,2,2,0.008436230459029043,2019-03-27 08:30:00,2019-03-27 08:45:00
30,1,0,1,0.0028885782970671232,2019-03-27 08:30:00,2019-03-27 08:45:00
37,2,1,1,0.0074314289569863134,2019-03-27 08:30:00,2019-03-27 08:45:00
40,5,4,1,0.05294318729443447,2019-03-27 08:30:00,2019-03-27 08:45:00
41,5,2,3,0.010107921319066467,2019-03-27 08:30:00,2019-03-27 08:45:00
46,5,4,1,0.008844888736180523,2019-03-27 08:30:00,2019-03-27 08:45:00
57,4,1,3,0.0050239604759395925,2019-03-27 08:30:00,2019-03-27 08:45:00
58,5,1,4,0.003668119274471915,2019-03-27 08:30:00,2019-03-27 08:45:00
61,2,0,2,0.0028885782970671232,2019-03-27 08:30:00,2019-03-27 08:45:00
62,2,1,1,0.005572692972903425,2019-03-27 08:30:00,2019-03-27 08:45:00
64,1,1,0,0.005953277331555476,2019-03-27 08:30:00,2019-03-27 08:45:00
66,2,0,2,0.0028885782970671232,2019-03-27 08:30:00,2019-03-27 08:45:00
67,4,3,1,0.0141631290938713,2019-03-27 08:30:00,2019-03-27 08:45:00
68,9,3,6,0.009325625533983552,2019-03-27 08:30:00,2019-03-27 08:45:00
69,1,0,1,0.0028885782970671232,2019-03-27 08:30:00,2019-03-27 08:45:00
74,6,3,3,0.009026839153945592,2019-03-27 08:30:00,2019-03-27 08:45:00
75,1,0,1,0.0028885782970671232,2019-03-27 08:30:00,2019-03-27 08:45:00
79,1,0,1,0.0028885782970671232,2019-03-27 08:30:00,2019-03-27 08:45:00
85,4,4,0,0.019531622923342082,2019-03-27 08:30:00,2019-03-27 08:45:00
86,2,1,1,0.007581666676797204,2019-03-27 08:30:00,2019-03-27 08:45:00
87,2,2,0,0.007211438681826902,2019-03-27 08:30:00,2019-03-27 08:45:00
88,7,2,5,0.004376833712971633,2019-03-27 08:30:00,2019-03-27 08:45:00
89,1,1,0,0.005081778014500729,2019-03-27 08:30:00,2019-03-27 08:45:00
90,1,0,1,0.0028885782970671232,2019-03-27 08:30:00,2019-03-27 08:45:00
104,2,1,1,0.003668119274471915,2019-03-27 08:30:00,2019-03-27 08:45:00
109,2,1,1,0.004209861084512312,2019-03-27 08:30:00,2019-03-27 08:45:00
110,3,2,1,0.024105727478002346,2019-03-27 08:30:00,2019-03-27 08:45:00
111,2,2,0,0.008105137454655067,2019-03-27 08:30:00,2019-03-27 08:45:00
112,2,2,0,0.02044798314968839,2019-03-27 08:30:00,2019-03-27 08:45:00
113,3,3,0,0.014874892042110215,2019-03-27 08:30:00,2019-03-27 08:45:00
114,2,2,0,0.006767653838804316,2019-03-27 08:30:00,2019-03-27 08:45:00
115,1,1,0,0.009205889744312667,2019-03-27 08:30:00,2019-03-27 08:45:00
116,2,1,1,0.009813356083371276,2019-03-27 08:30:00,2019-03-27 08:45:00
118,4,2,2,0.011041099794615716,2019-03-27 08:30:00,2019-03-27 08:45:00
119,1,0,1,0.0028885782970671232,2019-03-27 08:30:00,2019-03-27 08:45:00
126,3,1,2,0.0063149796959505785,2019-03-27 08:30:00,2019-03-27 08:45:00
135,3,1,2,0.005344065719556004,2019-03-27 08:30:00,2019-03-27 08:45:00
137,5,4,1,0.01099916827248602,2019-03-27 08:30:00,2019-03-27 08:45:00
138,6,4,2,0.016101211371836534,2019-03-27 08:30:00,2019-03-27 08:45:00
140,1,0,1,0.0028885782970671232,2019-03-27 08:30:00,2019-03-27 08:45:00
141,1,1,0,0.01223873099048313,2019-03-27 08:30:00,2019-03-27 08:45:00
147,3,0,3,0.0028885782970671232,2019-03-27 08:30:00,2019-03-27 08:45:00
151,3,1,2,0.0051600036270267186,2019-03-27 08:30:00,2019-03-27 08:45:00
153,4,3,1,0.014178644343008598,2019-03-27 08:30:00,2019-03-27 08:45:00
154,2,1,1,0.005344065719556004,2019-03-27 08:30:00,2019-03-27 08:45:00
156,1,1,0,0.0037070741045634164,2019-03-27 08:30:00,2019-03-27 08:45:00
157,3,1,2,0.0050239604759395925,2019-03-27 08:30:00,2019-03-27 08:45:00
158,2,1,1,0.003668119274471915,2019-03-27 08:30:00,2019-03-27 08:45:00
159,2,1,1,0.005081778014500729,2019-03-27 08:30:00,2019-03-27 08:45:00
160,1,1,0,0.006474325579299655,2019-03-27 08:30:00,2019-03-27 08:45:00
161,2,1,1,0.019173504036744664,2019-03-27 08:30:00,2019-03-27 08:45:00
162,1,0,1,0.0028885782970671232,2019-03-27 08:30:00,2019-03-27 08:45:00
164,2,1,1,0.004209861084512312,2019-03-27 08:30:00,2019-03-27 08:45:00
168,1,0,1,0.0028885782970671232,2019-03-27 08:30:00,2019-03-27 08:45:00
170,6,5,1,0.019101539030466273,2019-03-27 08:30:00,2019-03-27 08:45:00
172,1,0,1,0.0028885782970671232,2019-03-27 08:30:00,2019-03-27 08:45:00
173,1,0,1,0.0028885782970671232,2019-03-27 08:30:00,2019-03-27 08:45:00
190,2,1,1,0.004030712096694942,2019-03-27 08:30:00,2019-03-27 08:45:00
191,2,1,1,0.005414832939336384,2019-03-27 08:30:00,2019-03-27 08:45:00
195,1,1,0,0.015579758257473148,2019-03-27 08:30:00,2019-03-27 08:45:00
196,7,4,3,0.024437102515479224,2019-03-27 08:30:00,2019-03-27 08:45:00
199,5,1,4,0.003668119274471915,2019-03-27 08:30:00,2019-03-27 08:45:00
203,4,1,3,0.007625815375901278,2019-03-27 08:30:00,2019-03-27 08:45:00
2,3,1,2,0.0056423335477515345,2019-03-27 08:45:00,2019-03-27 09:00:00
10,2,0,2,0.0029572888878354824,2019-03-27 08:45:00,2019-03-27 09:00:00
15,2,2,0,0.010006633344053467,2019-03-27 08:45:00,2019-03-27 09:00:00
16,2,1,1,0.005471232105707978,2019-03-27 08:45:00,2019-03-27 09:00:00
18,3,1,2,0.012528419944200371,2019-03-27 08:45:00,2019-03-27 09:00:00
19,8,4,4,0.02791909263708245,2019-03-27 08:45:00,2019-03-27 09:00:00
20,2,1,1,0.005648350501813117,2019-03-27 08:45:00,2019-03-27 09:00:00
21,1,0,1,0.0029572888878354824,2019-03-27 08:45:00,2019-03-27 09:00:00
23,1,1,0,0.004544317850254472,2019-03-27 08:45:00,2019-03-27 09:00:00
26,2,1,1,0.004214260496771731,2019-03-27 08:45:00,2019-03-27 09:00:00
28,1,0,1,0.0029572888878354824,2019-03-27 08:45:00,2019-03-27 09:00:00
35,1,0,1,0.0029572888878354824,2019-03-27 08:45:00,2019-03-27 09:00:00
37,4,4,0,0.017788569631047982,2019-03-27 08:45:00,2019-03-27 09:00:00
40,4,3,1,0.027977476851840235,2019-03-27 08:45:00,2019-03-27 09:00:00
41,7,3,4,0.01266195155878129,2019-03-27 08:45:00,2019-03-27 09:00:00
46,2,1,1,0.00583864476553703,2019-03-27 08:45:00,2019-03-27 09:00:00
57,3,2,1,0.010422013684682704,2019-03-27 08:45:00,2019-03-27 09:00:00
58,1,1,0,0.004126624251405555,2019-03-27 08:45:00,2019-03-27 09:00:00
61,2,0,2,0.0029572888878354824,2019-03-27 08:45:00,2019-03-27 09:00:00
62,4,2,2,0.007903947046433237,2019-03-27 08:45:00,2019-03-27 09:00:00
64,1,1,0,0.005355585474857605,2019-03-27 08:45:00,2019-03-27 09:00:00
66,1,1,0,0.005471232105707978,2019-03-27 08:45:00,2019-03-27 09:00:00
67,1,1,0,0.009896144452787501,2019-03-27 08:45:00,2019-03-27 09:00:00
68,4,0,4,0.0029572888878354824,2019-03-27 08:45:00,2019-03-27 09:00:00
69,1,0,1,0.0029572888878354824,2019-03-27 08:45:00,2019-03-27 09:00:00
74,3,2,1,0.008162293719685612,2019-03-27 08:45:00,2019-03-27 09:00:00
85,4,4,0,0.021864915761660976,2019-03-27 08:45:00,2019-03-27 09:00:00
86,1,1,0,0.004214260496771731,2019-03-27 08:45:00,2019-03-27 09:00:00
87,3,2,1,0.007405440887719668,2019-03-27 08:45:00,2019-03-27 09:00:00
88,9,2,7,0.0039059852086404576,2019-03-27 08:45:00,2019-03-27 09:00:00
89,2,1,1,0.005471232105707978,2019-03-27 08:45:00,2019-03-27 09:00:00
90,2,0,2,0.0029572888878354824,2019-03-27 08:45:00,2019-03-27 09:00:00
104,1,0,1,0.0029572888878354824,2019-03-27 08:45:00,2019-03-27 09:00:00
109,6,3,3,0.010168075210294955,2019-03-27 08:45:00,2019-03-27 09:00:00
110,3,2,1,0.02278369999487829,2019-03-27 08:45:00,2019-03-27 09:00:00
111,3,2,1,0.0048427463012398544,2019-03-27 08:45:00,2019-03-27 09:00:00
112,3,2,1,0.014296632557611209,2019-03-27 08:45:00,2019-03-27 09:00:00
113,1,0,1,0.0029572888878354824,2019-03-27 08:45:00,2019-03-27 09:00:00
114,3,2,1,0.011258710454594045,2019-03-27 08:45:00,2019-03-27 09:00:00
115,5,2,3,0.006825706451858862,2019-03-27 08:45:00,2019-03-27 09:00:00
118,2,0,2,0.0029572888878354824,2019-03-27 08:45:00,2019-03-27 09:00:00
119,2,0,2,0.0029572888878354824,2019-03-27 08:45:00,2019-03-27 09:00:00
120,2,0,2,0.0029572888878354824,2019-03-27 08:45:00,2019-03-27 09:00:00
122,1,1,0,0.00583864476553703,2019-03-27 08:45:00,2019-03-27 09:00:00
126,7,2,5,0.0093343443961059,2019-03-27 08:45:00,2019-03-27 09:00:00
127,1,0,1,0.0029572888878354824,2019-03-27 08:45:00,2019-03-27 09:00:00
133,2,1,1,0.019637414197171986,2019-03-27 08:45:00,2019-03-27 09:00:00
137,10,8,2,0.016573210891856295,2019-03-27 08:45:00,2019-03-27 09:00:00
138,4,4,0,0.013192055135879953,2019-03-27 08:45:00,2019-03-27 09:00:00
140,1,0,1,0.0029572888878354824,2019-03-27 08:45:00,2019-03-27 09:00:00
141,2,1,1,0.010001738845657797,2019-03-27 08:45:00,2019-03-27 09:00:00
147,1,0,1,0.0029572888878354824,2019-03-27 08:45:00,2019-03-27 09:00:00
151,1,0,1,0.0029572888878354824,2019-03-27 08:45:00,2019-03-27 09:00:00
153,4,4,0,0.022913934998156894,2019-03-27 08:45:00,2019-03-27 09:00:00
156,1,1,0,0.005471232105707978,2019-03-27 08:45:00,2019-03-27 09:00:00
157,4,1,3,0.004126624251405555,2019-03-27 08:45:00,2019-03-27 09:00:00
158,5,3,2,0.037450421115206606,2019-03-27 08:45:00,2019-03-27 09:00:00
161,2,1,1,0.019637414197171986,2019-03-27 08:45:00,2019-03-27 09:00:00
162,1,0,1,0.0029572888878354824,2019-03-27 08:45:00,2019-03-27 09:00:00
164,1,0,1,0.0029572888878354824,2019-03-27 08:45:00,2019-03-27 09:00:00
168,3,1,2,0.010039487008988998,2019-03-27 08:45:00,2019-03-27 09:00:00
169,1,1,0,0.0072246137775233005,2019-03-27 08:45:00,2019-03-27 09:00:00
170,4,3,1,0.01186001198175562,2019-03-27 08:45:00,2019-03-27 09:00:00
173,2,0,2,0.0029572888878354824,2019-03-27 08:45:00,2019-03-27 09:00:00
189,3,2,1,0.00833103220313675,2019-03-27 08:45:00,2019-03-27 09:00:00
190,2,1,1,0.004544317850254472,2019-03-27 08:45:00,2019-03-27 09:00:00
191,2,1,1,0.008891036731972547,2019-03-27 08:45:00,2019-03-27 09:00:00
195,1,1,0,0.005471232105707978,2019-03-27 08:45:00,2019-03-27 09:00:00
196,3,2,1,0.010148008340908794,2019-03-27 08:45:00,2019-03-27 09:00:00
197,1,0,1,0.0029572888878354824,2019-03-27 08:45:00,2019-03-27 09:00:00
202,1,0,1,0.0029572888878354824,2019-03-27 08:45:00,2019-03-27 09:00:00
203,3,1,2,0.006316918084014248,2019-03-27 08:45:00,2019-03-27 09:00:00
1,1,0,1,0.002791147746836496,2019-03-27 09:00:00,2019-03-27 09:15:00
2,1,0,1,0.002791147746836496,2019-03-27 09:00:00,2019-03-27 09:15:00
5,1,1,0,0.006379143539343896,2019-03-27 09:00:00,2019-03-27 09:15:00
10,2,1,1,0.0179274447172577,2019-03-27 09:00:00,2019-03-27 09:15:00
15,1,1,0,0.0051638075124061655,2019-03-27 09:00:00,2019-03-27 09:15:00
16,2,1,1,0.003977477629621331,2019-03-27 09:00:00,2019-03-27 09:15:00
18,2,2,0,0.00968849626515264,2019-03-27 09:00:00,2019-03-27 09:15:00
19,8,6,2,0.03560972766750249,2019-03-27 09:00:00,2019-03-27 09:15:00
23,2,2,0,0.00679641966922089,2019-03-27 09:00:00,2019-03-27 09:15:00
26,2,1,1,0.005502667246579553,2019-03-27 09:00:00,2019-03-27 09:15:00
28,1,0,1,0.002791147746836496,2019-03-27 09:00:00,2019-03-27 09:15:00
35,4,0,4,0.002791147746836496,2019-03-27 09:00:00,2019-03-27 09:15:00
37,3,3,0,0.007891269760542476,2019-03-27 09:00:00,2019-03-27 09:15:00
40,3,2,1,0.03672369867096869,2019-03-27 09:00:00,2019-03-27 09:15:00
41,4,1,3,0.0051638075124061655,2019-03-27 09:00:00,2019-03-27 09:15:00
46,1,1,0,0.003362884417552745,2019-03-27 09:00:00,2019-03-27 09:15:00
57,3,2,1,0.004671041414948843,2019-03-27 09:00:00,2019-03-27 09:15:00
58,1,1,0,0.003362884417552745,2019-03-27 09:00:00,2019-03-27 09:15:00
62,2,1,1,0.004423759903651221,2019-03-27 09:00:00,2019-03-27 09:15:00
66,2,1,1,0.0051638075124061655,2019-03-27 09:00:00,2019-03-27 09:15:00
67,3,2,1,0.04257624401250904,2019-03-27 09:00:00,2019-03-27 09:15:00
68,2,0,2,0.002791147746836496,2019-03-27 09:00:00,2019-03-27 09:15:00
69,2,0,2,0.002791147746836496,2019-03-27 09:00:00,2019-03-27 09:15:00
70,1,1,0,0.008677798760636764,2019-03-27 09:00:00,2019-03-27 09:15:00
74,2,1,1,0.0042543507846400635,2019-03-27 09:00:00,2019-03-27 09:15:00
85,3,2,1,0.008932526252717142,2019-03-27 09:00:00,2019-03-27 09:15:00
86,1,0,1,0.002791147746836496,2019-03-27 09:00:00,2019-03-27 09:15:00
87,4,1,3,0.0046165751531054705,2019-03-27 09:00:00,2019-03-27 09:15:00
88,6,2,4,0.00515175981684998,2019-03-27 09:00:00,2019-03-27 09:15:00
89,2,0,2,0.002791147746836496,2019-03-27 09:00:00,2019-03-27 09:15:00
90,2,1,1,0.00873470743943907,2019-03-27 09:00:00,2019-03-27 09:15:00
109,4,2,2,0.01608767984153792,2019-03-27 09:00:00,2019-03-27 09:15:00
110,3,2,1,0.034320537165836,2019-03-27 09:00:00,2019-03-27 09:15:00
111,7,5,2,0.012636240443365426,2019-03-27 09:00:00,2019-03-27 09:15:00
112,5,4,1,0.011926076391386538,2019-03-27 09:00:00,2019-03-27 09:15:00
113,1,0,1,0.002791147746836496,2019-03-27 09:00:00,2019-03-27 09:15:00
114,3,2,1,0.0053226717042202925,2019-03-27 09:00:00,2019-03-27 09:15:00
115,5,2,3,0.006442002559374444,2019-03-27 09:00:00,2019-03-27 09:15:00
116,3,1,2,0.006379143539343896,2019-03-27 09:00:00,2019-03-27 09:15:00
118,1,0,1,0.002791147746836496,2019-03-27 09:00:00,2019-03-27 09:15:00
119,2,2,0,0.012242922313136128,2019-03-27 09:00:00,2019-03-27 09:15:00
120,3,1,2,0.008162141173620527,2019-03-27 09:00:00,2019-03-27 09:15:00
122,2,1,1,0.009629307493314091,2019-03-27 09:00:00,2019-03-27 09:15:00
126,6,1,5,0.009602158159477615,2019-03-27 09:00:00,2019-03-27 09:15:00
127,3,2,1,0.008011755696158621,2019-03-27 09:00:00,2019-03-27 09:15:00
133,1,0,1,0.002791147746836496,2019-03-27 09:00:00,2019-03-27 09:15:00
137,8,3,5,0.0074449874865125856,2019-03-27 09:00:00,2019-03-27 09:15:00
138,3,3,0,0.0233028827567171,2019-03-27 09:00:00,2019-03-27 09:15:00
141,1,0,1,0.002791147746836496,2019-03-27 09:00:00,2019-03-27 09:15:00
147,2,0,2,0.002791147746836496,2019-03-27 09:00:00,2019-03-27 09:15:00
153,5,2,3,0.01266150517664843,2019-03-27 09:00:00,2019-03-27 09:15:00
154,3,3,0,0.011571001225430129,2019-03-27 09:00:00,2019-03-27 09:15:00
156,1,1,0,0.003977477629621331,2019-03-27 09:00:00,2019-03-27 09:15:00
157,6,1,5,0.003362884417552745,2019-03-27 09:00:00,2019-03-27 09:15:00
158,3,2,1,0.0069917170185005185,2019-03-27 09:00:00,2019-03-27 09:15:00
161,2,1,1,0.018555842456336246,2019-03-27 09:00:00,2019-03-27 09:15:00
162,1,0,1,0.002791147746836496,2019-03-27 09:00:00,2019-03-27 09:15:00
164,7,3,4,0.012880395611717867,2019-03-27 09:00:00,2019-03-27 09:15:00
168,5,2,3,0.009970536872920613,2019-03-27 09:00:00,2019-03-27 09:15:00
169,3,2,1,0.006924658335625116,2019-03-27 09:00:00,2019-03-27 09:15:00
170,1,1,0,0.0051638075124061655,2019-03-27 09:00:00,2019-03-27 09:15:00
173,2,1,1,0.018555842456336246,2019-03-27 09:00:00,2019-03-27 09:15:00
189,5,3,2,0.013812848356405569,2019-03-27 09:00:00,2019-03-27 09:15:00
191,5,3,2,0.021825294099785585,2019-03-27 09:00:00,2019-03-27 09:15:00
195,1,1,0,0.0038859978381580815,2019-03-27 09:00:00,2019-03-27 09:15:00
202,1,0,1,0.002791147746836496,2019-03-27 09:00:00,2019-03-27 09:15:00
203,2,1,1,0.0065517789255611705,2019-03-27 09:00:00,2019-03-27 09:15:00
1,3,2,1,0.011113822242749904,2019-03-27 09:15:00,2019-03-27 09:30:00
5,1,1,0,0.0039597004147581055,2019-03-27 09:15:00,2019-03-27 09:30:00
10,5,3,2,0.047762862123550825,2019-03-27 09:15:00,2019-03-27 09:30:00
11,1,0,1,0.0027786641172806038,2019-03-27 09:15:00,2019-03-27 09:30:00
18,2,1,1,0.005140736712235607,2019-03-27 09:15:00,2019-03-27 09:30:00
19,5,3,2,0.011991177516675687,2019-03-27 09:15:00,2019-03-27 09:30:00
20,3,2,1,0.0056131512312266076,2019-03-27 09:15:00,2019-03-27 09:30:00
23,6,4,2,0.02119834992034119,2019-03-27 09:15:00,2019-03-27 09:30:00
26,1,1,0,0.0035660216489322716,2019-03-27 09:15:00,2019-03-27 09:30:00
28,2,1,1,0.007026113031998873,2019-03-27 09:15:00,2019-03-27 09:30:00
30,1,1,0,0.0032510786362716045,2019-03-27 09:15:00,2019-03-27 09:30:00
35,4,0,4,0.0027786641172806038,2019-03-27 09:15:00,2019-03-27 09:30:00
41,2,1,1,0.0035660216489322716,2019-03-27 09:15:00,2019-03-27 09:30:00
46,1,1,0,0.005960596706482353,2019-03-27 09:15:00,2019-03-27 09:30:00
57,2,1,1,0.005960596706482353,2019-03-27 09:15:00,2019-03-27 09:30:00
58,1,0,1,0.0027786641172806038,2019-03-27 09:15:00,2019-03-27 09:30:00
62,1,1,0,0.0032510786362716045,2019-03-27 09:15:00,2019-03-27 09:30:00
66,3,0,3,0.0027786641172806038,2019-03-27 09:15:00,2019-03-27 09:30:00
67,3,2,1,0.051309148765697844,2019-03-27 09:15:00,2019-03-27 09:30:00
68,1,0,1,0.0027786641172806038,2019-03-27 09:15:00,2019-03-27 09:30:00
69,2,1,1,0.0039597004147581055,2019-03-27 09:15:00,2019-03-27 09:30:00
70,1,1,0,0.004963688837381625,2019-03-27 09:15:00,2019-03-27 09:30:00
71,2,1,1,0.018483436234312478,2019-03-27 09:15:00,2019-03-27 09:30:00
74,2,1,1,0.0058100623273179535,2019-03-27 09:15:00,2019-03-27 09:30:00
85,3,2,1,0.008824663512749116,2019-03-27 09:15:00,2019-03-27 09:30:00
86,2,0,2,0.0027786641172806038,2019-03-27 09:15:00,2019-03-27 09:30:00
87,1,0,1,0.0027786641172806038,2019-03-27 09:15:00,2019-03-27 09:30:00
88,3,1,2,0.00483283392077768,2019-03-27 09:15:00,2019-03-27 09:30:00
89,1,0,1,0.0027786641172806038,2019-03-27 09:15:00,2019-03-27 09:30:00
90,1,1,0,0.005140736712235607,2019-03-27 09:15:00,2019-03-27 09:30:00
99,1,0,1,0.0027786641172806038,2019-03-27 09:15:00,2019-03-27 09:30:00
104,5,2,3,0.014988670048092461,2019-03-27 09:15:00,2019-03-27 09:30:00
109,3,2,1,0.007502809307190611,2019-03-27 09:15:00,2019-03-27 09:30:00
110,4,2,2,0.020506053967048875,2019-03-27 09:15:00,2019-03-27 09:30:00
111,5,4,1,0.027431518028677195,2019-03-27 09:15:00,2019-03-27 09:30:00
112,4,4,0,0.007699648690103528,2019-03-27 09:15:00,2019-03-27 09:30:00
114,1,1,0,0.004918148360527743,2019-03-27 09:15:00,2019-03-27 09:30:00
116,3,0,3,0.0027786641172806038,2019-03-27 09:15:00,2019-03-27 09:30:00
118,1,0,1,0.0027786641172806038,2019-03-27 09:15:00,2019-03-27 09:30:00
119,3,3,0,0.01871157902853646,2019-03-27 09:15:00,2019-03-27 09:30:00
120,1,1,0,0.026099417028811953,2019-03-27 09:15:00,2019-03-27 09:30:00
122,2,1,1,0.0039597004147581055,2019-03-27 09:15:00,2019-03-27 09:30:00
126,5,0,5,0.0027786641172806038,2019-03-27 09:15:00,2019-03-27 09:30:00
127,2,2,0,0.004432114933749107,2019-03-27 09:15:00,2019-03-27 09:30:00
135,2,1,1,0.012265709126977217,2019-03-27 09:15:00,2019-03-27 09:30:00
137,4,1,3,0.007550308926532053,2019-03-27 09:15:00,2019-03-27 09:30:00
138,5,4,1,0.01115974007317013,2019-03-27 09:15:00,2019-03-27 09:30:00
147,1,0,1,0.0027786641172806038,2019-03-27 09:15:00,2019-03-27 09:30:00
153,2,0,2,0.0027786641172806038,2019-03-27 09:15:00,2019-03-27 09:30:00
154,5,4,1,0.012445900570995505,2019-03-27 09:15:00,2019-03-27 09:30:00
156,1,1,0,0.005140736712235607,2019-03-27 09:15:00,2019-03-27 09:30:00
157,6,2,4,0.014971249413527005,2019-03-27 09:15:00,2019-03-27 09:30:00
158,1,0,1,0.0027786641172806038,2019-03-27 09:15:00,2019-03-27 09:30:00
161,2,1,1,0.018483436234312478,2019-03-27 09:15:00,2019-03-27 09:30:00
162,1,0,1,0.0027786641172806038,2019-03-27 09:15:00,2019-03-27 09:30:00
164,3,2,1,0.012215989268587718,2019-03-27 09:15:00,2019-03-27 09:30:00
169,3,1,2,0.005140736712235607,2019-03-27 09:15:00,2019-03-27 09:30:00
170,2,0,2,0.0027786641172806038,2019-03-27 09:15:00,2019-03-27 09:30:00
171,3,2,1,0.032699815851414,2019-03-27 09:15:00,2019-03-27 09:30:00
172,1,0,1,0.0027786641172806038,2019-03-27 09:15:00,2019-03-27 09:30:00
173,1,0,1,0.0027786641172806038,2019-03-27 09:15:00,2019-03-27 09:30:00
189,1,0,1,0.0027786641172806038,2019-03-27 09:15:00,2019-03-27 09:30:00
191,3,3,0,0.011024907812419332,2019-03-27 09:15:00,2019-03-27 09:30:00
195,1,1,0,0.00483283392077768,2019-03-27 09:15:00,2019-03-27 09:30:00
196,1,0,1,0.0027786641172806038,2019-03-27 09:15:00,2019-03-27 09:30:00
197,2,1,1,0.02306808855470447,2019-03-27 09:15:00,2019-03-27 09:30:00
199,7,3,4,0.007667196316121713,2019-03-27 09:15:00,2019-03-27 09:30:00
203,2,1,1,0.0033691822660193546,2019-03-27 09:15:00,2019-03-27 09:30:00
1,1,1,0,0.0054714218895661505,2019-03-27 09:30:00,2019-03-27 09:45:00
5,1,1,0,0.004214409233191826,2019-03-27 09:30:00,2019-03-27 09:45:00
10,4,2,2,0.010690296070529993,2019-03-27 09:30:00,2019-03-27 09:45:00
11,1,0,1,0.002957396576817501,2019-03-27 09:30:00,2019-03-27 09:45:00
15,1,0,1,0.002957396576817501,2019-03-27 09:30:00,2019-03-27 09:45:00
18,3,1,2,0.004214409233191826,2019-03-27 09:30:00,2019-03-27 09:45:00
19,1,0,1,0.002957396576817501,2019-03-27 09:30:00,2019-03-27 09:45:00
20,3,2,1,0.008618204449651935,2019-03-27 09:30:00,2019-03-27 09:45:00
21,1,0,1,0.002957396576817501,2019-03-27 09:30:00,2019-03-27 09:45:00
23,6,4,2,0.011561705020782711,2019-03-27 09:30:00,2019-03-27 09:45:00
26,2,1,1,0.004214409233191826,2019-03-27 09:30:00,2019-03-27 09:45:00
28,1,1,0,0.004214409233191826,2019-03-27 09:30:00,2019-03-27 09:45:00
30,1,1,0,0.006104179136903285,2019-03-27 09:30:00,2019-03-27 09:45:00
35,2,0,2,0.002957396576817501,2019-03-27 09:30:00,2019-03-27 09:45:00
40,1,1,0,0.02105787187287192,2019-03-27 09:30:00,2019-03-27 09:45:00
41,2,0,2,0.002957396576817501,2019-03-27 09:30:00,2019-03-27 09:45:00
46,1,0,1,0.002957396576817501,2019-03-27 09:30:00,2019-03-27 09:45:00
57,3,2,1,0.021291520314698123,2019-03-27 09:30:00,2019-03-27 09:45:00
58,2,2,0,0.0054714218895661505,2019-03-27 09:30:00,2019-03-27 09:45:00
62,1,0,1,0.002957396576817501,2019-03-27 09:30:00,2019-03-27 09:45:00
66,2,0,2,0.002957396576817501,2019-03-27 09:30:00,2019-03-27 09:45:00
67,3,2,1,0.06369373852653368,2019-03-27 09:30:00,2019-03-27 09:45:00
69,1,0,1,0.002957396576817501,2019-03-27 09:30:00,2019-03-27 09:45:00
70,2,1,1,0.0054714218895661505,2019-03-27 09:30:00,2019-03-27 09:45:00
71,2,1,1,0.019665640634923754,2019-03-27 09:30:00,2019-03-27 09:45:00
74,3,2,1,0.007797018203152029,2019-03-27 09:30:00,2019-03-27 09:45:00
80,3,1,2,0.0051437263407525,2019-03-27 09:30:00,2019-03-27 09:45:00
85,1,1,0,0.004748701061797603,2019-03-27 09:30:00,2019-03-27 09:45:00
86,1,0,1,0.002957396576817501,2019-03-27 09:30:00,2019-03-27 09:45:00
87,1,1,0,0.00528299289040338,2019-03-27 09:30:00,2019-03-27 09:45:00
88,3,1,2,0.0051437263407525,2019-03-27 09:30:00,2019-03-27 09:45:00
90,2,1,1,0.019665640634923754,2019-03-27 09:30:00,2019-03-27 09:45:00
99,1,0,1,0.002957396576817501,2019-03-27 09:30:00,2019-03-27 09:45:00
104,11,4,7,0.010298341212916094,2019-03-27 09:30:00,2019-03-27 09:45:00
110,1,1,0,0.007871687669681045,2019-03-27 09:30:00,2019-03-27 09:45:00
111,3,2,1,0.006722083394448183,2019-03-27 09:30:00,2019-03-27 09:45:00
112,1,1,0,0.0054714218895661505,2019-03-27 09:30:00,2019-03-27 09:45:00
116,2,0,2,0.002957396576817501,2019-03-27 09:30:00,2019-03-27 09:45:00
118,3,1,2,0.0054714218895661505,2019-03-27 09:30:00,2019-03-27 09:45:00
119,2,2,0,0.01620477851662353,2019-03-27 09:30:00,2019-03-27 09:45:00
120,1,1,0,0.004748701061797603,2019-03-27 09:30:00,2019-03-27 09:45:00
122,2,1,1,0.019665640634923754,2019-03-27 09:30:00,2019-03-27 09:45:00
126,4,2,2,0.007403119942495231,2019-03-27 09:30:00,2019-03-27 09:45:00
133,2,0,2,0.002957396576817501,2019-03-27 09:30:00,2019-03-27 09:45:00
135,2,1,1,0.01262581802938345,2019-03-27 09:30:00,2019-03-27 09:45:00
137,4,2,2,0.012797849591621467,2019-03-27 09:30:00,2019-03-27 09:45:00
138,4,3,1,0.01137327602161994,2019-03-27 09:30:00,2019-03-27 09:45:00
147,2,1,1,0.00528299289040338,2019-03-27 09:30:00,2019-03-27 09:45:00
153,1,1,0,0.004208058081699533,2019-03-27 09:30:00,2019-03-27 09:45:00
154,4,2,2,0.0054714218895661505,2019-03-27 09:30:00,2019-03-27 09:45:00
156,1,1,0,0.007448428470828121,2019-03-27 09:30:00,2019-03-27 09:45:00
157,5,3,2,0.017494138657150195,2019-03-27 09:30:00,2019-03-27 09:45:00
158,4,2,2,0.019665640634923754,2019-03-27 09:30:00,2019-03-27 09:45:00
161,2,1,1,0.019665640634923754,2019-03-27 09:30:00,2019-03-27 09:45:00
162,2,0,2,0.002957396576817501,2019-03-27 09:30:00,2019-03-27 09:45:00
164,3,3,0,0.01197982502882465,2019-03-27 09:30:00,2019-03-27 09:45:00
169,1,0,1,0.002957396576817501,2019-03-27 09:30:00,2019-03-27 09:45:00
170,1,0,1,0.002957396576817501,2019-03-27 09:30:00,2019-03-27 09:45:00
171,4,2,2,0.014605637239634182,2019-03-27 09:30:00,2019-03-27 09:45:00
172,1,0,1,0.002957396576817501,2019-03-27 09:30:00,2019-03-27 09:45:00
173,2,1,1,0.004208058081699533,2019-03-27 09:30:00,2019-03-27 09:45:00
177,2,1,1,0.019665640634923754,2019-03-27 09:30:00,2019-03-27 09:45:00
189,1,1,0,0.00867180486685951,2019-03-27 09:30:00,2019-03-27 09:45:00
191,5,4,1,0.012819700834308025,2019-03-27 09:30:00,2019-03-27 09:45:00
195,2,2,0,0.011352147521522235,2019-03-27 09:30:00,2019-03-27 09:45:00
197,3,1,2,0.0075015853612265876,2019-03-27 09:30:00,2019-03-27 09:45:00
199,1,0,1,0.002957396576817501,2019-03-27 09:30:00,2019-03-27 09:45:00
202,1,0,1,0.002957396576817501,2019-03-27 09:30:00,2019-03-27 09:45:00
203,3,1,2,0.004214409233191826,2019-03-27 09:30:00,2019-03-27 09:45:00
1,1,1,0,0.005194535731798348,2019-03-27 09:45:00,2019-03-27 10:00:00
5,1,1,0,0.0035654604472204134,2019-03-27 09:45:00,2019-03-27 10:00:00
11,1,0,1,0.002807701100511783,2019-03-27 09:45:00,2019-03-27 10:00:00
15,2,0,2,0.002807701100511783,2019-03-27 09:45:00,2019-03-27 10:00:00
18,3,1,2,0.004001118416155066,2019-03-27 09:45:00,2019-03-27 10:00:00
19,1,0,1,0.002807701100511783,2019-03-27 09:45:00,2019-03-27 10:00:00
20,3,1,2,0.005194535731798348,2019-03-27 09:45:00,2019-03-27 10:00:00
21,2,1,1,0.004001118416155066,2019-03-27 09:45:00,2019-03-27 10:00:00
23,2,2,0,0.0063879530474416305,2019-03-27 09:45:00,2019-03-27 10:00:00
26,1,0,1,0.002807701100511783,2019-03-27 09:45:00,2019-03-27 10:00:00
28,1,1,0,0.004001118416155066,2019-03-27 09:45:00,2019-03-27 10:00:00
35,5,1,4,0.0035654604472204134,2019-03-27 09:45:00,2019-03-27 10:00:00
40,1,1,0,0.00907001627778755,2019-03-27 09:45:00,2019-03-27 10:00:00
41,2,1,1,0.004454650721346412,2019-03-27 09:45:00,2019-03-27 10:00:00
46,2,0,2,0.002807701100511783,2019-03-27 09:45:00,2019-03-27 10:00:00
57,3,1,2,0.014732089209164575,2019-03-27 09:45:00,2019-03-27 10:00:00
58,2,2,0,0.010305645180409693,2019-03-27 09:45:00,2019-03-27 10:00:00
62,1,0,1,0.002807701100511783,2019-03-27 09:45:00,2019-03-27 10:00:00
67,3,2,1,0.04408888886295016,2019-03-27 09:45:00,2019-03-27 10:00:00
70,1,0,1,0.002807701100511783,2019-03-27 09:45:00,2019-03-27 10:00:00
71,2,1,1,0.01869506185964607,2019-03-27 09:45:00,2019-03-27 10:00:00
74,4,2,2,0.00898169164710223,2019-03-27 09:45:00,2019-03-27 10:00:00
80,3,1,2,0.004883506525949657,2019-03-27 09:45:00,2019-03-27 10:00:00
85,1,1,0,0.004323219793929044,2019-03-27 09:45:00,2019-03-27 10:00:00
87,1,1,0,0.005194535731798348,2019-03-27 09:45:00,2019-03-27 10:00:00
88,3,2,1,0.03435485126017625,2019-03-27 09:45:00,2019-03-27 10:00:00
99,1,0,1,0.002807701100511783,2019-03-27 09:45:00,2019-03-27 10:00:00
104,3,1,2,0.005194535731798348,2019-03-27 09:45:00,2019-03-27 10:00:00
106,1,1,0,0.0066256012395888774,2019-03-27 09:45:00,2019-03-27 10:00:00
109,2,2,0,0.010263433593430835,2019-03-27 09:45:00,2019-03-27 10:00:00
110,1,1,0,0.0045083990063817456,2019-03-27 09:45:00,2019-03-27 10:00:00
111,2,1,1,0.005015679596608426,2019-03-27 09:45:00,2019-03-27 10:00:00
113,1,0,1,0.002807701100511783,2019-03-27 09:45:00,2019-03-27 10:00:00
115,3,1,2,0.004883506525949657,2019-03-27 09:45:00,2019-03-27 10:00:00
116,1,1,0,0.005194535731798348,2019-03-27 09:45:00,2019-03-27 10:00:00
119,1,1,0,0.005194535731798348,2019-03-27 09:45:00,2019-03-27 10:00:00
120,1,1,0,0.0045083990063817456,2019-03-27 09:45:00,2019-03-27 10:00:00
126,3,1,2,0.005194535731798348,2019-03-27 09:45:00,2019-03-27 10:00:00
133,3,1,2,0.008819553133963872,2019-03-27 09:45:00,2019-03-27 10:00:00
137,5,4,1,0.013190744670921482,2019-03-27 09:45:00,2019-03-27 10:00:00
138,6,3,3,0.008306044288528564,2019-03-27 09:45:00,2019-03-27 10:00:00
140,1,1,0,0.00516145031053337,2019-03-27 09:45:00,2019-03-27 10:00:00
141,2,1,1,0.004001118416155066,2019-03-27 09:45:00,2019-03-27 10:00:00
147,2,0,2,0.002807701100511783,2019-03-27 09:45:00,2019-03-27 10:00:00
153,2,1,1,0.005015679596608426,2019-03-27 09:45:00,2019-03-27 10:00:00
154,1,0,1,0.002807701100511783,2019-03-27 09:45:00,2019-03-27 10:00:00
156,1,1,0,0.004001118416155066,2019-03-27 09:45:00,2019-03-27 10:00:00
157,3,2,1,0.032506617193342476,2019-03-27 09:45:00,2019-03-27 10:00:00
158,7,3,4,0.00774854996301567,2019-03-27 09:45:00,2019-03-27 10:00:00
161,2,1,1,0.01869506185964607,2019-03-27 09:45:00,2019-03-27 10:00:00
162,2,0,2,0.002807701100511783,2019-03-27 09:45:00,2019-03-27 10:00:00
164,6,5,1,0.14557694981503055,2019-03-27 09:45:00,2019-03-27 10:00:00
170,1,0,1,0.002807701100511783,2019-03-27 09:45:00,2019-03-27 10:00:00
177,2,1,1,0.01869506185964607,2019-03-27 09:45:00,2019-03-27 10:00:00
189,2,1,1,0.007071643510913226,2019-03-27 09:45:00,2019-03-27 10:00:00
191,6,5,1,0.01402644971618492,2019-03-27 09:45:00,2019-03-27 10:00:00
196,1,0,1,0.002807701100511783,2019-03-27 09:45:00,2019-03-27 10:00:00
197,1,0,1,0.002807701100511783,2019-03-27 09:45:00,2019-03-27 10:00:00
202,1,0,1,0.002807701100511783,2019-03-27 09:45:00,2019-03-27 10:00:00
203,3,1,2,0.0035654604472204134,2019-03-27 09:45:00,2019-03-27 10:00:00
1,1,1,0,0.006738391399293841,2019-03-27 10:00:00,2019-03-27 10:15:00
5,1,1,0,0.006738391399293841,2019-03-27 10:00:00,2019-03-27 10:15:00
10,5,2,3,0.008839709028152287,2019-03-27 10:00:00,2019-03-27 10:15:00
15,3,0,3,0.003642212158335961,2019-03-27 10:00:00,2019-03-27 10:15:00
18,1,0,1,0.003642212158335961,2019-03-27 10:00:00,2019-03-27 10:15:00
19,1,0,1,0.003642212158335961,2019-03-27 10:00:00,2019-03-27 10:15:00
20,3,2,1,0.008652000739371515,2019-03-27 10:00:00,2019-03-27 10:15:00
21,2,1,1,0.005190301778814901,2019-03-27 10:00:00,2019-03-27 10:15:00
23,1,1,0,0.0046742719053219205,2019-03-27 10:00:00,2019-03-27 10:15:00
28,2,2,0,0.00828648101977278,2019-03-27 10:00:00,2019-03-27 10:15:00
35,1,0,1,0.003642212158335961,2019-03-27 10:00:00,2019-03-27 10:15:00
37,1,1,0,0.007615744229757956,2019-03-27 10:00:00,2019-03-27 10:15:00
40,1,1,0,0.006945007439743135,2019-03-27 10:00:00,2019-03-27 10:15:00
41,3,1,2,0.006334814737634509,2019-03-27 10:00:00,2019-03-27 10:15:00
46,3,0,3,0.003642212158335961,2019-03-27 10:00:00,2019-03-27 10:15:00
50,1,1,0,0.006738391399293841,2019-03-27 10:00:00,2019-03-27 10:15:00
57,1,0,1,0.003642212158335961,2019-03-27 10:00:00,2019-03-27 10:15:00
61,2,0,2,0.003642212158335961,2019-03-27 10:00:00,2019-03-27 10:15:00
66,1,1,0,0.008438469699549339,2019-03-27 10:00:00,2019-03-27 10:15:00
67,3,2,1,0.04206325152111619,2019-03-27 10:00:00,2019-03-27 10:15:00
68,1,0,1,0.003642212158335961,2019-03-27 10:00:00,2019-03-27 10:15:00
71,2,1,1,0.024199033129375346,2019-03-27 10:00:00,2019-03-27 10:15:00
74,3,1,2,0.006334814737634509,2019-03-27 10:00:00,2019-03-27 10:15:00
80,3,1,2,0.006334814737634509,2019-03-27 10:00:00,2019-03-27 10:15:00
85,1,1,0,0.010973410660819142,2019-03-27 10:00:00,2019-03-27 10:15:00
88,4,2,2,0.011283794972088796,2019-03-27 10:00:00,2019-03-27 10:15:00
99,1,0,1,0.003642212158335961,2019-03-27 10:00:00,2019-03-27 10:15:00
104,2,1,1,0.005190301778814901,2019-03-27 10:00:00,2019-03-27 10:15:00
106,1,1,0,0.006334814737634509,2019-03-27 10:00:00,2019-03-27 10:15:00
109,4,2,2,0.0077704511462798,2019-03-27 10:00:00,2019-03-27 10:15:00
110,1,1,0,0.006738391399293841,2019-03-27 10:00:00,2019-03-27 10:15:00
111,1,1,0,0.008054420644990016,2019-03-27 10:00:00,2019-03-27 10:15:00
112,1,1,0,0.0046742719053219205,2019-03-27 10:00:00,2019-03-27 10:15:00
113,2,0,2,0.003642212158335961,2019-03-27 10:00:00,2019-03-27 10:15:00
114,1,1,0,0.0064875374308754185,2019-03-27 10:00:00,2019-03-27 10:15:00
115,1,0,1,0.003642212158335961,2019-03-27 10:00:00,2019-03-27 10:15:00
116,1,1,0,0.006738391399293841,2019-03-27 10:00:00,2019-03-27 10:15:00
137,2,2,0,0.00983457064025172,2019-03-27 10:00:00,2019-03-27 10:15:00
138,6,3,3,0.010041186680701015,2019-03-27 10:00:00,2019-03-27 10:15:00
140,1,1,0,0.0064875374308754185,2019-03-27 10:00:00,2019-03-27 10:15:00
141,2,1,1,0.0046742719053219205,2019-03-27 10:00:00,2019-03-27 10:15:00
147,2,0,2,0.003642212158335961,2019-03-27 10:00:00,2019-03-27 10:15:00
156,1,1,0,0.005190301778814901,2019-03-27 10:00:00,2019-03-27 10:15:00
157,3,2,1,0.04206325152111618,2019-03-27 10:00:00,2019-03-27 10:15:00
158,3,1,2,0.006334814737634509,2019-03-27 10:00:00,2019-03-27 10:15:00
159,1,1,0,0.005190301778814901,2019-03-27 10:00:00,2019-03-27 10:15:00
161,2,1,1,0.024199033129375346,2019-03-27 10:00:00,2019-03-27 10:15:00
162,2,0,2,0.003642212158335961,2019-03-27 10:00:00,2019-03-27 10:15:00
164,4,2,2,0.011720019896231608,2019-03-27 10:00:00,2019-03-27 10:15:00
170,1,1,0,0.0046742719053219205,2019-03-27 10:00:00,2019-03-27 10:15:00
172,1,0,1,0.003642212158335961,2019-03-27 10:00:00,2019-03-27 10:15:00
191,3,3,0,0.016441615058846323,2019-03-27 10:00:00,2019-03-27 10:15:00
196,1,0,1,0.003642212158335961,2019-03-27 10:00:00,2019-03-27 10:15:00
197,1,0,1,0.003642212158335961,2019-03-27 10:00:00,2019-03-27 10:15:00
199,1,1,0,0.005190301778814901,2019-03-27 10:00:00,2019-03-27 10:15:00
203,2,1,1,0.008623840655273728,2019-03-27 10:00:00,2019-03-27 10:15:00
1,3,2,1,0.008596362427155262,2019-03-27 10:15:00,2019-03-27 10:30:00
2,1,0,1,0.0033198847377382016,2019-03-27 10:15:00,2019-03-27 10:30:00
10,5,1,4,0.007130090396771998,2019-03-27 10:15:00,2019-03-27 10:30:00
15,1,0,1,0.0033198847377382016,2019-03-27 10:15:00,2019-03-27 10:30:00
18,1,0,1,0.0033198847377382016,2019-03-27 10:15:00,2019-03-27 10:30:00
19,1,0,1,0.0033198847377382016,2019-03-27 10:15:00,2019-03-27 10:30:00
20,3,3,0,0.007865833885359937,2019-03-27 10:15:00,2019-03-27 10:30:00
26,2,2,0,0.016164683150809066,2019-03-27 10:15:00,2019-03-27 10:30:00
28,3,2,1,0.013449789939707878,2019-03-27 10:15:00,2019-03-27 10:30:00
37,3,2,1,0.014269828144305191,2019-03-27 10:15:00,2019-03-27 10:30:00
40,1,1,0,0.006949865026113829,2019-03-27 10:15:00,2019-03-27 10:30:00
41,4,2,2,0.008964225852269189,2019-03-27 10:15:00,2019-03-27 10:30:00
46,3,1,2,0.009228019393812847,2019-03-27 10:15:00,2019-03-27 10:30:00
50,1,1,0,0.006142055295003695,2019-03-27 10:15:00,2019-03-27 10:30:00
58,1,0,1,0.0033198847377382016,2019-03-27 10:15:00,2019-03-27 10:30:00
61,1,0,1,0.0033198847377382016,2019-03-27 10:15:00,2019-03-27 10:30:00
66,2,2,0,0.016523067236137008,2019-03-27 10:15:00,2019-03-27 10:30:00
67,3,2,1,0.06228721219068982,2019-03-27 10:15:00,2019-03-27 10:30:00
68,2,0,2,0.0033198847377382016,2019-03-27 10:15:00,2019-03-27 10:30:00
69,1,0,1,0.0033198847377382016,2019-03-27 10:15:00,2019-03-27 10:30:00
74,2,1,1,0.007130090396771998,2019-03-27 10:15:00,2019-03-27 10:30:00
80,4,2,2,0.010043056574423354,2019-03-27 10:15:00,2019-03-27 10:30:00
85,2,1,1,0.007341615485204219,2019-03-27 10:15:00,2019-03-27 10:30:00
87,1,1,0,0.008541175675404744,2019-03-27 10:15:00,2019-03-27 10:30:00
88,4,1,3,0.004632587085018746,2019-03-27 10:15:00,2019-03-27 10:30:00
89,1,1,0,0.006949865026113829,2019-03-27 10:15:00,2019-03-27 10:30:00
90,1,0,1,0.0033198847377382016,2019-03-27 10:15:00,2019-03-27 10:30:00
99,1,0,1,0.0033198847377382016,2019-03-27 10:15:00,2019-03-27 10:30:00
104,3,1,2,0.005774191869889768,2019-03-27 10:15:00,2019-03-27 10:30:00
109,5,2,3,0.012810040379938329,2019-03-27 10:15:00,2019-03-27 10:30:00
110,2,1,1,0.006142055295003695,2019-03-27 10:15:00,2019-03-27 10:30:00
111,4,1,3,0.004632587085018746,2019-03-27 10:15:00,2019-03-27 10:30:00
112,4,3,1,0.013986908884124623,2019-03-27 10:15:00,2019-03-27 10:30:00
114,1,1,0,0.010940296055805793,2019-03-27 10:15:00,2019-03-27 10:30:00
115,2,1,1,0.006949865026113829,2019-03-27 10:15:00,2019-03-27 10:30:00
122,2,1,1,0.022062657214667034,2019-03-27 10:15:00,2019-03-27 10:30:00
137,4,4,0,0.011392864684125875,2019-03-27 10:15:00,2019-03-27 10:30:00
138,3,2,1,0.008964225852269189,2019-03-27 10:15:00,2019-03-27 10:30:00
141,2,1,1,0.009560943066752894,2019-03-27 10:15:00,2019-03-27 10:30:00
153,1,1,0,0.006142055295003695,2019-03-27 10:15:00,2019-03-27 10:30:00
157,3,1,2,0.005774191869889768,2019-03-27 10:15:00,2019-03-27 10:30:00
158,1,0,1,0.0033198847377382016,2019-03-27 10:15:00,2019-03-27 10:30:00
159,1,1,0,0.006142055295003695,2019-03-27 10:15:00,2019-03-27 10:30:00
161,2,1,1,0.022062657214667034,2019-03-27 10:15:00,2019-03-27 10:30:00
162,1,0,1,0.0033198847377382016,2019-03-27 10:15:00,2019-03-27 10:30:00
164,2,0,2,0.0033198847377382016,2019-03-27 10:15:00,2019-03-27 10:30:00
168,2,1,1,0.006142055295003695,2019-03-27 10:15:00,2019-03-27 10:30:00
170,2,2,0,0.018272949268761104,2019-03-27 10:15:00,2019-03-27 10:30:00
172,1,0,1,0.0033198847377382016,2019-03-27 10:15:00,2019-03-27 10:30:00
177,3,2,1,0.03211879595867273,2019-03-27 10:15:00,2019-03-27 10:30:00
189,2,1,1,0.004632587085018746,2019-03-27 10:15:00,2019-03-27 10:30:00
191,1,0,1,0.0033198847377382016,2019-03-27 10:15:00,2019-03-27 10:30:00
196,1,0,1,0.0033198847377382016,2019-03-27 10:15:00,2019-03-27 10:30:00
197,1,0,1,0.0033198847377382016,2019-03-27 10:15:00,2019-03-27 10:30:00
199,1,1,0,0.004632587085018746,2019-03-27 10:15:00,2019-03-27 10:30:00
201,1,1,0,0.006142055295003695,2019-03-27 10:15:00,2019-03-27 10:30:00
203,2,1,1,0.004730970016370948,2019-03-27 10:15:00,2019-03-27 10:30:00
1,2,1,1,0.006361482655250204,2019-03-27 10:30:00,2019-03-27 10:45:00
2,6,2,4,0.005980467954454913,2019-03-27 10:30:00,2019-03-27 10:45:00
10,3,0,3,0.003438493871720427,2019-03-27 10:30:00,2019-03-27 10:45:00
18,1,0,1,0.003438493871720427,2019-03-27 10:30:00,2019-03-27 10:45:00
26,1,1,0,0.016011646781145843,2019-03-27 10:30:00,2019-03-27 10:45:00
28,4,2,2,0.015386334883802281,2019-03-27 10:30:00,2019-03-27 10:45:00
37,1,0,1,0.003438493871720427,2019-03-27 10:30:00,2019-03-27 10:45:00
41,2,0,2,0.003438493871720427,2019-03-27 10:30:00,2019-03-27 10:45:00
46,1,1,0,0.00914852120565804,2019-03-27 10:30:00,2019-03-27 10:45:00
57,1,1,0,0.012249665329166352,2019-03-27 10:30:00,2019-03-27 10:45:00
58,1,0,1,0.003438493871720427,2019-03-27 10:30:00,2019-03-27 10:45:00
61,1,1,0,0.006361482655250204,2019-03-27 10:30:00,2019-03-27 10:45:00
66,2,2,0,0.010591157317857536,2019-03-27 10:30:00,2019-03-27 10:45:00
67,3,2,1,0.007603890419242521,2019-03-27 10:30:00,2019-03-27 10:45:00
68,2,1,1,0.006361482655250204,2019-03-27 10:30:00,2019-03-27 10:45:00
69,1,0,1,0.003438493871720427,2019-03-27 10:30:00,2019-03-27 10:45:00
74,3,1,2,0.004899988263485315,2019-03-27 10:30:00,2019-03-27 10:45:00
80,2,1,1,0.00444222906716867,2019-03-27 10:30:00,2019-03-27 10:45:00
85,3,2,1,0.018851292489869595,2019-03-27 10:30:00,2019-03-27 10:45:00
87,3,2,1,0.01036495112974958,2019-03-27 10:30:00,2019-03-27 10:45:00
88,5,2,3,0.006157682600853051,2019-03-27 10:30:00,2019-03-27 10:45:00
90,1,0,1,0.003438493871720427,2019-03-27 10:30:00,2019-03-27 10:45:00
99,1,0,1,0.003438493871720427,2019-03-27 10:30:00,2019-03-27 10:45:00
109,2,2,0,0.009918664240726528,2019-03-27 10:30:00,2019-03-27 10:45:00
110,3,1,2,0.006361482655250204,2019-03-27 10:30:00,2019-03-27 10:45:00
111,2,0,2,0.003438493871720427,2019-03-27 10:30:00,2019-03-27 10:45:00
112,2,1,1,0.006361482655250204,2019-03-27 10:30:00,2019-03-27 10:45:00
114,1,1,0,0.00997853057228787,2019-03-27 10:30:00,2019-03-27 10:45:00
115,4,3,1,0.006716951303984155,2019-03-27 10:30:00,2019-03-27 10:45:00
116,4,3,1,0.03739780640187248,2019-03-27 10:30:00,2019-03-27 10:45:00
118,2,1,1,0.022843815317521603,2019-03-27 10:30:00,2019-03-27 10:45:00
119,3,0,3,0.003438493871720427,2019-03-27 10:30:00,2019-03-27 10:45:00
122,1,0,1,0.003438493871720427,2019-03-27 10:30:00,2019-03-27 10:45:00
133,2,1,1,0.00444222906716867,2019-03-27 10:30:00,2019-03-27 10:45:00
137,4,3,1,0.014692275750294392,2019-03-27 10:30:00,2019-03-27 10:45:00
141,1,1,0,0.019464043024442948,2019-03-27 10:30:00,2019-03-27 10:45:00
153,4,3,1,0.0056307354593677595,2019-03-27 10:30:00,2019-03-27 10:45:00
157,7,2,5,0.005903723458933557,2019-03-27 10:30:00,2019-03-27 10:45:00
158,2,1,1,0.022843815317521603,2019-03-27 10:30:00,2019-03-27 10:45:00
159,1,1,0,0.007189754497911748,2019-03-27 10:30:00,2019-03-27 10:45:00
161,2,1,1,0.022843815317521603,2019-03-27 10:30:00,2019-03-27 10:45:00
162,2,1,1,0.004412823466230353,2019-03-27 10:30:00,2019-03-27 10:45:00
164,6,5,1,0.014790312213276157,2019-03-27 10:30:00,2019-03-27 10:45:00
168,2,1,1,0.00470948091308767,2019-03-27 10:30:00,2019-03-27 10:45:00
170,1,0,1,0.003438493871720427,2019-03-27 10:30:00,2019-03-27 10:45:00
173,1,0,1,0.003438493871720427,2019-03-27 10:30:00,2019-03-27 10:45:00
177,3,2,1,0.029312255799455327,2019-03-27 10:30:00,2019-03-27 10:45:00
189,2,2,0,0.009969953435861378,2019-03-27 10:30:00,2019-03-27 10:45:00
191,4,0,4,0.003438493871720427,2019-03-27 10:30:00,2019-03-27 10:45:00
195,1,1,0,0.009902485416802694,2019-03-27 10:30:00,2019-03-27 10:45:00
197,1,1,0,0.004412823466230353,2019-03-27 10:30:00,2019-03-27 10:45:00
199,1,1,0,0.004899988263485315,2019-03-27 10:30:00,2019-03-27 10:45:00
203,1,0,1,0.003438493871720427,2019-03-27 10:30:00,2019-03-27 10:45:00
1,2,2,0,0.00859555396047183,2019-03-27 10:45:00,2019-03-27 11:00:00
2,2,0,2,0.0031833544016816014,2019-03-27 10:45:00,2019-03-27 11:00:00
5,3,1,2,0.004132049205855173,2019-03-27 10:45:00,2019-03-27 11:00:00
10,2,1,1,0.004360033774070549,2019-03-27 10:45:00,2019-03-27 11:00:00
15,3,1,2,0.017662777844075897,2019-03-27 10:45:00,2019-03-27 11:00:00
23,1,1,0,0.006475065520962915,2019-03-27 10:45:00,2019-03-27 11:00:00
28,2,1,1,0.007103174985904548,2019-03-27 10:45:00,2019-03-27 11:00:00
37,7,1,6,0.006695949554791612,2019-03-27 10:45:00,2019-03-27 11:00:00
41,3,1,2,0.004132049205855173,2019-03-27 10:45:00,2019-03-27 11:00:00
57,2,2,0,0.020032356970336146,2019-03-27 10:45:00,2019-03-27 11:00:00
58,1,0,1,0.0031833544016816014,2019-03-27 10:45:00,2019-03-27 11:00:00
61,1,1,0,0.005889454181076715,2019-03-27 10:45:00,2019-03-27 11:00:00
66,3,1,2,0.007727859115473053,2019-03-27 10:45:00,2019-03-27 11:00:00
67,3,3,0,0.015222129872345766,2019-03-27 10:45:00,2019-03-27 11:00:00
68,2,1,1,0.004132049205855173,2019-03-27 10:45:00,2019-03-27 11:00:00
70,1,0,1,0.0031833544016816014,2019-03-27 10:45:00,2019-03-27 11:00:00
74,4,2,2,0.010978147976306215,2019-03-27 10:45:00,2019-03-27 11:00:00
80,1,0,1,0.0031833544016816014,2019-03-27 10:45:00,2019-03-27 11:00:00
85,7,5,2,0.01632068524921734,2019-03-27 10:45:00,2019-03-27 11:00:00
87,3,1,2,0.010691223154249344,2019-03-27 10:45:00,2019-03-27 11:00:00
88,4,3,1,0.04927367050333903,2019-03-27 10:45:00,2019-03-27 11:00:00
89,1,1,0,0.0064681964429727234,2019-03-27 10:45:00,2019-03-27 11:00:00
99,1,0,1,0.0031833544016816014,2019-03-27 10:45:00,2019-03-27 11:00:00
104,2,1,1,0.02116286759376633,2019-03-27 10:45:00,2019-03-27 11:00:00
109,1,1,0,0.005889454181076715,2019-03-27 10:45:00,2019-03-27 11:00:00
110,3,1,2,0.004360033774070549,2019-03-27 10:45:00,2019-03-27 11:00:00
111,5,1,4,0.005536713146459496,2019-03-27 10:45:00,2019-03-27 11:00:00
114,3,1,2,0.009221850399751211,2019-03-27 10:45:00,2019-03-27 11:00:00
115,3,3,0,0.007984410472984909,2019-03-27 10:45:00,2019-03-27 11:00:00
116,2,1,1,0.02116286759376633,2019-03-27 10:45:00,2019-03-27 11:00:00
118,2,1,1,0.02116286759376633,2019-03-27 10:45:00,2019-03-27 11:00:00
119,5,1,4,0.015487852256544692,2019-03-27 10:45:00,2019-03-27 11:00:00
120,1,0,1,0.0031833544016816014,2019-03-27 10:45:00,2019-03-27 11:00:00
122,3,1,2,0.005536713146459496,2019-03-27 10:45:00,2019-03-27 11:00:00
133,1,0,1,0.0031833544016816014,2019-03-27 10:45:00,2019-03-27 11:00:00
137,4,2,2,0.008549153872029338,2019-03-27 10:45:00,2019-03-27 11:00:00
138,2,1,1,0.007103174985904548,2019-03-27 10:45:00,2019-03-27 11:00:00
140,2,1,1,0.004132049205855173,2019-03-27 10:45:00,2019-03-27 11:00:00
141,1,1,0,0.010120544547297557,2019-03-27 10:45:00,2019-03-27 11:00:00
151,1,0,1,0.0031833544016816014,2019-03-27 10:45:00,2019-03-27 11:00:00
153,2,1,1,0.009040292025951819,2019-03-27 10:45:00,2019-03-27 11:00:00
154,1,1,0,0.005889454181076715,2019-03-27 10:45:00,2019-03-27 11:00:00
157,5,2,3,0.006084036864873425,2019-03-27 10:45:00,2019-03-27 11:00:00
158,1,1,0,0.004939651978236606,2019-03-27 10:45:00,2019-03-27 11:00:00
161,2,1,1,0.02116286759376633,2019-03-27 10:45:00,2019-03-27 11:00:00
162,2,1,1,0.006889763036157053,2019-03-27 10:45:00,2019-03-27 11:00:00
164,6,5,1,0.01703218051627218,2019-03-27 10:45:00,2019-03-27 11:00:00
168,2,2,0,0.005485099095552729,2019-03-27 10:45:00,2019-03-27 11:00:00
173,1,0,1,0.0031833544016816014,2019-03-27 10:45:00,2019-03-27 11:00:00
189,6,4,2,0.028947360774966065,2019-03-27 10:45:00,2019-03-27 11:00:00
195,2,1,1,0.02116286759376633,2019-03-27 10:45:00,2019-03-27 11:00:00
199,1,1,0,0.004360033774070549,2019-03-27 10:45:00,2019-03-27 11:00:00
203,1,0,1,0.0031833544016816014,2019-03-27 10:45:00,2019-03-27 11:00:00
1,1,1,0,0.0062687045620216375,2019-03-27 11:00:00,2019-03-27 11:15:00
5,3,1,2,0.008023652994502336,2019-03-27 11:00:00,2019-03-27 11:15:00
10,4,2,2,0.018608861453914924,2019-03-27 11:00:00,2019-03-27 11:15:00
11,2,0,2,0.0033883469403965323,2019-03-27 11:00:00,2019-03-27 11:15:00
15,3,0,3,0.0033883469403965323,2019-03-27 11:00:00,2019-03-27 11:15:00
18,1,1,0,0.0062687045620216375,2019-03-27 11:00:00,2019-03-27 11:15:00
23,1,1,0,0.0062687045620216375,2019-03-27 11:00:00,2019-03-27 11:15:00
28,2,1,1,0.007560520593634717,2019-03-27 11:00:00,2019-03-27 11:15:00
37,8,4,4,0.021809654950226756,2019-03-27 11:00:00,2019-03-27 11:15:00
40,1,1,0,0.0062687045620216375,2019-03-27 11:00:00,2019-03-27 11:15:00
41,1,1,0,0.008023652994502336,2019-03-27 11:00:00,2019-03-27 11:15:00
46,1,1,0,0.0063312452069815015,2019-03-27 11:00:00,2019-03-27 11:15:00
57,2,2,0,0.01988563496350199,2019-03-27 11:00:00,2019-03-27 11:15:00
66,2,1,1,0.007084894307899556,2019-03-27 11:00:00,2019-03-27 11:15:00
67,1,1,0,0.01008327122086821,2019-03-27 11:00:00,2019-03-27 11:15:00
68,1,0,1,0.0033883469403965323,2019-03-27 11:00:00,2019-03-27 11:15:00
74,3,2,1,0.00787551793778618,2019-03-27 11:00:00,2019-03-27 11:15:00
80,2,2,0,0.0062687045620216375,2019-03-27 11:00:00,2019-03-27 11:15:00
85,11,5,6,0.021617500521892423,2019-03-27 11:00:00,2019-03-27 11:15:00
87,2,1,1,0.004348466147604901,2019-03-27 11:00:00,2019-03-27 11:15:00
88,7,3,4,0.013846908882712408,2019-03-27 11:00:00,2019-03-27 11:15:00
89,4,1,3,0.004728110166175076,2019-03-27 11:00:00,2019-03-27 11:15:00
104,6,3,3,0.022395837235671262,2019-03-27 11:00:00,2019-03-27 11:15:00
109,1,0,1,0.0033883469403965323,2019-03-27 11:00:00,2019-03-27 11:15:00
110,1,0,1,0.0033883469403965323,2019-03-27 11:00:00,2019-03-27 11:15:00
111,6,4,2,0.017197935068130287,2019-03-27 11:00:00,2019-03-27 11:15:00
112,1,1,0,0.0062687045620216375,2019-03-27 11:00:00,2019-03-27 11:15:00
114,3,1,2,0.009815600443454708,2019-03-27 11:00:00,2019-03-27 11:15:00
118,1,0,1,0.0033883469403965323,2019-03-27 11:00:00,2019-03-27 11:15:00
119,1,0,1,0.0033883469403965323,2019-03-27 11:00:00,2019-03-27 11:15:00
120,1,0,1,0.0033883469403965323,2019-03-27 11:00:00,2019-03-27 11:15:00
122,7,4,3,0.027226611484625046,2019-03-27 11:00:00,2019-03-27 11:15:00
133,1,0,1,0.0033883469403965323,2019-03-27 11:00:00,2019-03-27 11:15:00
137,8,5,3,0.014834027546748663,2019-03-27 11:00:00,2019-03-27 11:15:00
138,5,1,4,0.007560520593634717,2019-03-27 11:00:00,2019-03-27 11:15:00
140,3,2,1,0.015333948399635077,2019-03-27 11:00:00,2019-03-27 11:15:00
141,1,1,0,0.0064512345534372805,2019-03-27 11:00:00,2019-03-27 11:15:00
151,1,0,1,0.0033883469403965323,2019-03-27 11:00:00,2019-03-27 11:15:00
153,2,1,1,0.0062687045620216375,2019-03-27 11:00:00,2019-03-27 11:15:00
154,2,2,0,0.008551994665139595,2019-03-27 11:00:00,2019-03-27 11:15:00
157,3,1,2,0.005893238914806179,2019-03-27 11:00:00,2019-03-27 11:15:00
158,2,2,0,0.00951412216647803,2019-03-27 11:00:00,2019-03-27 11:15:00
161,2,1,1,0.022395837235671262,2019-03-27 11:00:00,2019-03-27 11:15:00
162,1,0,1,0.0033883469403965323,2019-03-27 11:00:00,2019-03-27 11:15:00
164,1,1,0,0.0062687045620216375,2019-03-27 11:00:00,2019-03-27 11:15:00
168,6,2,4,0.005893238914806179,2019-03-27 11:00:00,2019-03-27 11:15:00
170,1,0,1,0.0033883469403965323,2019-03-27 11:00:00,2019-03-27 11:15:00
172,1,1,0,0.004995160316161076,2019-03-27 11:00:00,2019-03-27 11:15:00
189,5,4,1,0.01580316823294526,2019-03-27 11:00:00,2019-03-27 11:15:00
191,4,2,2,0.022395837235671262,2019-03-27 11:00:00,2019-03-27 11:15:00
197,1,1,0,0.011298566048782184,2019-03-27 11:00:00,2019-03-27 11:15:00
200,1,0,1,0.0033883469403965323,2019-03-27 11:00:00,2019-03-27 11:15:00
202,1,0,1,0.0033883469403965323,2019-03-27 11:00:00,2019-03-27 11:15:00
203,1,0,1,0.0033883469403965323,2019-03-27 11:00:00,2019-03-27 11:15:00
2,1,1,0,0.0060905349256744285,2019-03-27 11:15:00,2019-03-27 11:30:00
10,7,4,3,0.016282215385397314,2019-03-27 11:15:00,2019-03-27 11:30:00
11,2,0,2,0.0035017910465623484,2019-03-27 11:15:00,2019-03-27 11:30:00
15,2,0,2,0.0035017910465623484,2019-03-27 11:15:00,2019-03-27 11:30:00
16,2,2,0,0.007966968119032327,2019-03-27 11:15:00,2019-03-27 11:30:00
18,2,2,0,0.013501142135669542,2019-03-27 11:15:00,2019-03-27 11:30:00
23,1,1,0,0.004550878930966624,2019-03-27 11:15:00,2019-03-27 11:30:00
35,1,1,0,0.012804908591489172,2019-03-27 11:15:00,2019-03-27 11:30:00
37,1,1,0,0.006478575761542335,2019-03-27 11:15:00,2019-03-27 11:30:00
40,1,1,0,0.0049901834040523415,2019-03-27 11:15:00,2019-03-27 11:30:00
41,3,1,2,0.009602469014564699,2019-03-27 11:15:00,2019-03-27 11:30:00
46,1,1,0,0.00757424306723517,2019-03-27 11:15:00,2019-03-27 11:30:00
62,2,2,0,0.010560382018056789,2019-03-27 11:15:00,2019-03-27 11:30:00
66,1,0,1,0.0035017910465623484,2019-03-27 11:15:00,2019-03-27 11:30:00
67,2,2,0,0.011985893751650553,2019-03-27 11:15:00,2019-03-27 11:30:00
68,2,1,1,0.023213178820799343,2019-03-27 11:15:00,2019-03-27 11:30:00
74,2,1,1,0.006478575761542335,2019-03-27 11:15:00,2019-03-27 11:30:00
80,2,2,0,0.006478575761542335,2019-03-27 11:15:00,2019-03-27 11:30:00
85,5,1,4,0.006478575761542335,2019-03-27 11:15:00,2019-03-27 11:30:00
88,5,3,2,0.009580972494261014,2019-03-27 11:15:00,2019-03-27 11:30:00
89,6,1,5,0.004219104671822058,2019-03-27 11:15:00,2019-03-27 11:30:00
90,1,1,0,0.006005151075739049,2019-03-27 11:15:00,2019-03-27 11:30:00
109,2,0,2,0.0035017910465623484,2019-03-27 11:15:00,2019-03-27 11:30:00
111,7,4,3,0.008834281645148729,2019-03-27 11:15:00,2019-03-27 11:30:00
112,4,3,1,0.011793903845666183,2019-03-27 11:15:00,2019-03-27 11:30:00
114,2,1,1,0.0049901834040523415,2019-03-27 11:15:00,2019-03-27 11:30:00
116,1,0,1,0.0035017910465623484,2019-03-27 11:15:00,2019-03-27 11:30:00
118,2,0,2,0.0035017910465623484,2019-03-27 11:15:00,2019-03-27 11:30:00
119,4,3,1,0.01094348147963765,2019-03-27 11:15:00,2019-03-27 11:30:00
120,1,0,1,0.0035017910465623484,2019-03-27 11:15:00,2019-03-27 11:30:00
122,11,6,5,0.017506020257792194,2019-03-27 11:15:00,2019-03-27 11:30:00
133,1,1,0,0.0072504596993814485,2019-03-27 11:15:00,2019-03-27 11:30:00
137,6,2,4,0.004936418297081766,2019-03-27 11:15:00,2019-03-27 11:30:00
138,6,1,5,0.007583597303076803,2019-03-27 11:15:00,2019-03-27 11:30:00
141,2,2,0,0.014244990423167167,2019-03-27 11:15:00,2019-03-27 11:30:00
153,5,2,3,0.009040244850612073,2019-03-27 11:15:00,2019-03-27 11:30:00
154,3,3,0,0.008782959234995178,2019-03-27 11:15:00,2019-03-27 11:30:00
156,1,0,1,0.0035017910465623484,2019-03-27 11:15:00,2019-03-27 11:30:00
157,2,1,1,0.023213178820799343,2019-03-27 11:15:00,2019-03-27 11:30:00
158,4,2,2,0.006255450041616458,2019-03-27 11:15:00,2019-03-27 11:30:00
161,2,1,1,0.023213178820799343,2019-03-27 11:15:00,2019-03-27 11:30:00
162,1,0,1,0.0035017910465623484,2019-03-27 11:15:00,2019-03-27 11:30:00
164,2,1,1,0.023213178820799343,2019-03-27 11:15:00,2019-03-27 11:30:00
168,1,0,1,0.0035017910465623484,2019-03-27 11:15:00,2019-03-27 11:30:00
170,4,2,2,0.008819454245678229,2019-03-27 11:15:00,2019-03-27 11:30:00
172,3,2,1,0.007352875937398222,2019-03-27 11:15:00,2019-03-27 11:30:00
173,1,0,1,0.0035017910465623484,2019-03-27 11:15:00,2019-03-27 11:30:00
191,8,4,4,0.028703200790522198,2019-03-27 11:15:00,2019-03-27 11:30:00
196,1,1,0,0.006478575761542335,2019-03-27 11:15:00,2019-03-27 11:30:00
197,2,1,1,0.008115779259189344,2019-03-27 11:15:00,2019-03-27 11:30:00
200,1,0,1,0.0035017910465623484,2019-03-27 11:15:00,2019-03-27 11:30:00
201,3,1,2,0.0060905349256744285,2019-03-27 11:15:00,2019-03-27 11:30:00
203,1,0,1,0.0035017910465623484,2019-03-27 11:15:00,2019-03-27 11:30:00
2,1,1,0,0.005869224533550624,2019-03-27 11:30:00,2019-03-27 11:45:00
5,2,1,1,0.0052176399508022915,2019-03-27 11:30:00,2019-03-27 11:45:00
10,3,2,1,0.009653171142651497,2019-03-27 11:30:00,2019-03-27 11:45:00
11,4,2,2,0.021102228295278885,2019-03-27 11:30:00,2019-03-27 11:45:00
15,1,0,1,0.0031723999776762397,2019-03-27 11:30:00,2019-03-27 11:45:00
16,2,2,0,0.008566049089425008,2019-03-27 11:30:00,2019-03-27 11:45:00
18,3,3,0,0.0075828204150604735,2019-03-27 11:30:00,2019-03-27 11:45:00
19,4,1,3,0.0113786915543756,2019-03-27 11:30:00,2019-03-27 11:45:00
23,2,2,0,0.006566052228739484,2019-03-27 11:30:00,2019-03-27 11:45:00
28,1,0,1,0.0031723999776762397,2019-03-27 11:30:00,2019-03-27 11:45:00
30,2,1,1,0.006396837527567343,2019-03-27 11:30:00,2019-03-27 11:45:00
37,1,0,1,0.0031723999776762397,2019-03-27 11:30:00,2019-03-27 11:45:00
40,1,1,0,0.004345066506700265,2019-03-27 11:30:00,2019-03-27 11:45:00
41,1,0,1,0.0031723999776762397,2019-03-27 11:30:00,2019-03-27 11:45:00
46,2,0,2,0.0031723999776762397,2019-03-27 11:30:00,2019-03-27 11:45:00
50,3,2,1,0.038458427020504976,2019-03-27 11:30:00,2019-03-27 11:45:00
57,1,0,1,0.0031723999776762397,2019-03-27 11:30:00,2019-03-27 11:45:00
58,2,2,0,0.009330248059092513,2019-03-27 11:30:00,2019-03-27 11:45:00
61,1,1,0,0.0040285665102409085,2019-03-27 11:30:00,2019-03-27 11:45:00
62,1,1,0,0.00816182144255314,2019-03-27 11:30:00,2019-03-27 11:45:00
66,1,0,1,0.0031723999776762397,2019-03-27 11:30:00,2019-03-27 11:45:00
67,4,4,0,0.011690216242573673,2019-03-27 11:30:00,2019-03-27 11:45:00
68,1,1,0,0.009338332097841583,2019-03-27 11:30:00,2019-03-27 11:45:00
74,4,1,3,0.005869224533550624,2019-03-27 11:30:00,2019-03-27 11:45:00
80,4,2,2,0.021102228295278885,2019-03-27 11:30:00,2019-03-27 11:45:00
85,2,1,1,0.004071341496301034,2019-03-27 11:30:00,2019-03-27 11:45:00
87,1,0,1,0.0031723999776762397,2019-03-27 11:30:00,2019-03-27 11:45:00
88,4,3,1,0.06322997453341112,2019-03-27 11:30:00,2019-03-27 11:45:00
89,2,0,2,0.0031723999776762397,2019-03-27 11:30:00,2019-03-27 11:45:00
90,2,1,1,0.008811493220091348,2019-03-27 11:30:00,2019-03-27 11:45:00
101,1,1,0,0.004071341496301034,2019-03-27 11:30:00,2019-03-27 11:45:00
104,4,2,2,0.021102228295278885,2019-03-27 11:30:00,2019-03-27 11:45:00
106,1,1,0,0.010663164574040724,2019-03-27 11:30:00,2019-03-27 11:45:00
109,1,0,1,0.0031723999776762397,2019-03-27 11:30:00,2019-03-27 11:45:00
110,1,0,1,0.0031723999776762397,2019-03-27 11:30:00,2019-03-27 11:45:00
111,2,1,1,0.006633423503218129,2019-03-27 11:30:00,2019-03-27 11:45:00
112,4,3,1,0.009220101798553742,2019-03-27 11:30:00,2019-03-27 11:45:00
113,1,0,1,0.0031723999776762397,2019-03-27 11:30:00,2019-03-27 11:45:00
114,3,1,2,0.005869224533550624,2019-03-27 11:30:00,2019-03-27 11:45:00
116,2,1,1,0.005869224533550624,2019-03-27 11:30:00,2019-03-27 11:45:00
118,1,0,1,0.0031723999776762397,2019-03-27 11:30:00,2019-03-27 11:45:00
119,3,2,1,0.007041891062574649,2019-03-27 11:30:00,2019-03-27 11:45:00
122,6,2,4,0.00551773303572429,2019-03-27 11:30:00,2019-03-27 11:45:00
126,1,1,0,0.006396837527567343,2019-03-27 11:30:00,2019-03-27 11:45:00
133,1,1,0,0.004520812255613432,2019-03-27 11:30:00,2019-03-27 11:45:00
137,5,2,3,0.007217636811487816,2019-03-27 11:30:00,2019-03-27 11:45:00
138,2,1,1,0.005869224533550624,2019-03-27 11:30:00,2019-03-27 11:45:00
141,2,2,0,0.012358881415683195,2019-03-27 11:30:00,2019-03-27 11:45:00
153,5,1,4,0.0040285665102409085,2019-03-27 11:30:00,2019-03-27 11:45:00
154,2,1,1,0.004071341496301034,2019-03-27 11:30:00,2019-03-27 11:45:00
156,1,0,1,0.0031723999776762397,2019-03-27 11:30:00,2019-03-27 11:45:00
157,2,1,1,0.021102228295278885,2019-03-27 11:30:00,2019-03-27 11:45:00
158,2,2,0,0.01123371792444039,2019-03-27 11:30:00,2019-03-27 11:45:00
161,2,1,1,0.021102228295278885,2019-03-27 11:30:00,2019-03-27 11:45:00
162,1,0,1,0.0031723999776762397,2019-03-27 11:30:00,2019-03-27 11:45:00
164,3,2,1,0.007253004060132013,2019-03-27 11:30:00,2019-03-27 11:45:00
169,5,2,3,0.007322351381229029,2019-03-27 11:30:00,2019-03-27 11:45:00
170,2,0,2,0.0031723999776762397,2019-03-27 11:30:00,2019-03-27 11:45:00
172,3,0,3,0.0031723999776762397,2019-03-27 11:30:00,2019-03-27 11:45:00
177,1,1,0,0.005869224533550624,2019-03-27 11:30:00,2019-03-27 11:45:00
191,4,2,2,0.006146317198077429,2019-03-27 11:30:00,2019-03-27 11:45:00
195,2,2,0,0.006183952743905732,2019-03-27 11:30:00,2019-03-27 11:45:00
196,3,3,0,0.014004139635206062,2019-03-27 11:30:00,2019-03-27 11:45:00
197,5,2,3,0.007322351381229029,2019-03-27 11:30:00,2019-03-27 11:45:00
200,1,0,1,0.0031723999776762397,2019-03-27 11:30:00,2019-03-27 11:45:00
201,1,0,1,0.0031723999776762397,2019-03-27 11:30:00,2019-03-27 11:45:00
203,3,0,3,0.0031723999776762397,2019-03-27 11:30:00,2019-03-27 11:45:00
5,2,1,1,0.004619892706904275,2019-03-27 11:45:00,2019-03-27 12:00:00
10,3,2,1,0.008547368423211958,2019-03-27 11:45:00,2019-03-27 12:00:00
11,2,2,0,0.00559721885321348,2019-03-27 11:45:00,2019-03-27 12:00:00
15,1,1,0,0.004221650668852774,2019-03-27 11:45:00,2019-03-27 12:00:00
18,5,4,1,0.012142744189607846,2019-03-27 11:45:00,2019-03-27 12:00:00
19,4,1,3,0.010291791841876872,2019-03-27 11:45:00,2019-03-27 12:00:00
23,3,2,1,0.03724832570967211,2019-03-27 11:45:00,2019-03-27 12:00:00
26,2,2,0,0.004739932281293402,2019-03-27 11:45:00,2019-03-27 12:00:00
28,3,0,3,0.003025359137453246,2019-03-27 11:45:00,2019-03-27 12:00:00
30,2,1,1,0.005941882716352919,2019-03-27 11:45:00,2019-03-27 12:00:00
37,3,2,1,0.015920099408206836,2019-03-27 11:45:00,2019-03-27 12:00:00
40,1,1,0,0.00559721885321348,2019-03-27 11:45:00,2019-03-27 12:00:00
46,1,1,0,0.00559721885321348,2019-03-27 11:45:00,2019-03-27 12:00:00
50,4,1,3,0.004221650668852774,2019-03-27 11:45:00,2019-03-27 12:00:00
58,2,2,0,0.01986037840189125,2019-03-27 11:45:00,2019-03-27 12:00:00
61,1,1,0,0.003882645709373324,2019-03-27 11:45:00,2019-03-27 12:00:00
67,6,5,1,0.014539606260916736,2019-03-27 11:45:00,2019-03-27 12:00:00
68,3,2,1,0.10703935370020833,2019-03-27 11:45:00,2019-03-27 12:00:00
70,2,1,1,0.015386284299455048,2019-03-27 11:45:00,2019-03-27 12:00:00
74,3,1,2,0.0077836232398194516,2019-03-27 11:45:00,2019-03-27 12:00:00
80,2,0,2,0.003025359137453246,2019-03-27 11:45:00,2019-03-27 12:00:00
85,2,2,0,0.006454505425133558,2019-03-27 11:45:00,2019-03-27 12:00:00
87,2,0,2,0.003025359137453246,2019-03-27 11:45:00,2019-03-27 12:00:00
88,3,2,1,0.03724832570967211,2019-03-27 11:45:00,2019-03-27 12:00:00
89,1,0,1,0.003025359137453246,2019-03-27 11:45:00,2019-03-27 12:00:00
90,1,0,1,0.003025359137453246,2019-03-27 11:45:00,2019-03-27 12:00:00
101,1,1,0,0.003882645709373324,2019-03-27 11:45:00,2019-03-27 12:00:00
104,2,2,0,0.006883148711093598,2019-03-27 11:45:00,2019-03-27 12:00:00
106,2,1,1,0.00559721885321348,2019-03-27 11:45:00,2019-03-27 12:00:00
109,1,0,1,0.003025359137453246,2019-03-27 11:45:00,2019-03-27 12:00:00
111,2,1,1,0.00559721885321348,2019-03-27 11:45:00,2019-03-27 12:00:00
112,3,3,0,0.00645450542513356,2019-03-27 11:45:00,2019-03-27 12:00:00
113,1,0,1,0.003025359137453246,2019-03-27 11:45:00,2019-03-27 12:00:00
114,2,0,2,0.003025359137453246,2019-03-27 11:45:00,2019-03-27 12:00:00
116,1,1,0,0.003882645709373324,2019-03-27 11:45:00,2019-03-27 12:00:00
118,1,0,1,0.003025359137453246,2019-03-27 11:45:00,2019-03-27 12:00:00
119,2,0,2,0.003025359137453246,2019-03-27 11:45:00,2019-03-27 12:00:00
120,1,0,1,0.003025359137453246,2019-03-27 11:45:00,2019-03-27 12:00:00
122,1,0,1,0.003025359137453246,2019-03-27 11:45:00,2019-03-27 12:00:00
126,2,2,0,0.007138174247752447,2019-03-27 11:45:00,2019-03-27 12:00:00
127,1,0,1,0.003025359137453246,2019-03-27 11:45:00,2019-03-27 12:00:00
137,7,2,5,0.00937815680927048,2019-03-27 11:45:00,2019-03-27 12:00:00
141,1,1,0,0.004311288995333363,2019-03-27 11:45:00,2019-03-27 12:00:00
151,1,0,1,0.003025359137453246,2019-03-27 11:45:00,2019-03-27 12:00:00
153,3,0,3,0.003025359137453246,2019-03-27 11:45:00,2019-03-27 12:00:00
154,2,1,1,0.003882645709373324,2019-03-27 11:45:00,2019-03-27 12:00:00
156,3,1,2,0.005262059226283252,2019-03-27 11:45:00,2019-03-27 12:00:00
157,2,1,1,0.02013684242356268,2019-03-27 11:45:00,2019-03-27 12:00:00
158,2,2,0,0.006883148711093598,2019-03-27 11:45:00,2019-03-27 12:00:00
159,1,1,0,0.00559721885321348,2019-03-27 11:45:00,2019-03-27 12:00:00
161,2,1,1,0.02013684242356268,2019-03-27 11:45:00,2019-03-27 12:00:00
164,2,2,0,0.0067991692882729965,2019-03-27 11:45:00,2019-03-27 12:00:00
168,1,0,1,0.003025359137453246,2019-03-27 11:45:00,2019-03-27 12:00:00
169,1,0,1,0.003025359137453246,2019-03-27 11:45:00,2019-03-27 12:00:00
170,1,1,0,0.004619892706904275,2019-03-27 11:45:00,2019-03-27 12:00:00
171,1,0,1,0.003025359137453246,2019-03-27 11:45:00,2019-03-27 12:00:00
172,2,0,2,0.003025359137453246,2019-03-27 11:45:00,2019-03-27 12:00:00
191,2,1,1,0.004311288995333363,2019-03-27 11:45:00,2019-03-27 12:00:00
195,7,3,4,0.011016976314206613,2019-03-27 11:45:00,2019-03-27 12:00:00
196,1,1,0,0.008076812285051067,2019-03-27 11:45:00,2019-03-27 12:00:00
197,4,2,2,0.02013684242356268,2019-03-27 11:45:00,2019-03-27 12:00:00
203,3,0,3,0.003025359137453246,2019-03-27 11:45:00,2019-03-27 12:00:00
1,1,0,1,0.002982562114559032,2019-03-27 12:00:00,2019-03-27 12:15:00
2,3,1,2,0.005187488228289873,2019-03-27 12:00:00,2019-03-27 12:15:00
5,2,1,1,0.004831456869105229,2019-03-27 12:00:00,2019-03-27 12:15:00
10,1,1,0,0.008875799189825598,2019-03-27 12:00:00,2019-03-27 12:15:00
11,2,2,0,0.005517976496678883,2019-03-27 12:00:00,2019-03-27 12:15:00
15,1,1,0,0.004831456869105229,2019-03-27 12:00:00,2019-03-27 12:15:00
16,1,0,1,0.002982562114559032,2019-03-27 12:00:00,2019-03-27 12:15:00
18,4,3,1,0.00990228563334493,2019-03-27 12:00:00,2019-03-27 12:15:00
19,5,1,4,0.0037874815774536752,2019-03-27 12:00:00,2019-03-27 12:15:00
20,2,0,2,0.002982562114559032,2019-03-27 12:00:00,2019-03-27 12:15:00
23,1,1,0,0.007673322134740389,2019-03-27 12:00:00,2019-03-27 12:15:00
26,2,2,0,0.0183447565611458,2019-03-27 12:00:00,2019-03-27 12:15:00
28,4,2,2,0.022156589787705024,2019-03-27 12:00:00,2019-03-27 12:15:00
30,1,1,0,0.0037874815774536752,2019-03-27 12:00:00,2019-03-27 12:15:00
37,2,1,1,0.005517976496678883,2019-03-27 12:00:00,2019-03-27 12:15:00
40,2,1,1,0.011400451104640176,2019-03-27 12:00:00,2019-03-27 12:15:00
46,2,1,1,0.005517976496678883,2019-03-27 12:00:00,2019-03-27 12:15:00
67,5,4,1,0.018099631412750485,2019-03-27 12:00:00,2019-03-27 12:15:00
69,1,1,0,0.006904810595233339,2019-03-27 12:00:00,2019-03-27 12:15:00
70,1,1,0,0.018369398079504936,2019-03-27 12:00:00,2019-03-27 12:15:00
74,3,1,2,0.006904810595233339,2019-03-27 12:00:00,2019-03-27 12:15:00
80,2,0,2,0.002982562114559032,2019-03-27 12:00:00,2019-03-27 12:15:00
85,2,2,0,0.0067856836877388076,2019-03-27 12:00:00,2019-03-27 12:15:00
87,1,0,1,0.002982562114559032,2019-03-27 12:00:00,2019-03-27 12:15:00
88,5,2,3,0.007699841874525202,2019-03-27 12:00:00,2019-03-27 12:15:00
89,1,0,1,0.002982562114559032,2019-03-27 12:00:00,2019-03-27 12:15:00
90,3,2,1,0.00734629287025167,2019-03-27 12:00:00,2019-03-27 12:15:00
104,4,3,1,0.014618588744321918,2019-03-27 12:00:00,2019-03-27 12:15:00
106,3,1,2,0.009227648723394087,2019-03-27 12:00:00,2019-03-27 12:15:00
109,4,1,3,0.0041618820545505746,2019-03-27 12:00:00,2019-03-27 12:15:00
110,2,1,1,0.027577104266088406,2019-03-27 12:00:00,2019-03-27 12:15:00
111,6,3,3,0.008387543035882645,2019-03-27 12:00:00,2019-03-27 12:15:00
112,3,2,1,0.005517976496678883,2019-03-27 12:00:00,2019-03-27 12:15:00
113,1,0,1,0.002982562114559032,2019-03-27 12:00:00,2019-03-27 12:15:00
114,2,0,2,0.002982562114559032,2019-03-27 12:00:00,2019-03-27 12:15:00
115,3,1,2,0.005187488228289873,2019-03-27 12:00:00,2019-03-27 12:15:00
118,1,0,1,0.002982562114559032,2019-03-27 12:00:00,2019-03-27 12:15:00
119,2,1,1,0.005187488228289873,2019-03-27 12:00:00,2019-03-27 12:15:00
120,1,0,1,0.002982562114559032,2019-03-27 12:00:00,2019-03-27 12:15:00
127,2,1,1,0.005517976496678883,2019-03-27 12:00:00,2019-03-27 12:15:00
133,1,1,0,0.005517976496678883,2019-03-27 12:00:00,2019-03-27 12:15:00
137,7,3,4,0.008699662186359399,2019-03-27 12:00:00,2019-03-27 12:15:00
138,4,3,1,0.007634515359341339,2019-03-27 12:00:00,2019-03-27 12:15:00
141,3,2,1,0.028927629723643225,2019-03-27 12:00:00,2019-03-27 12:15:00
151,1,0,1,0.002982562114559032,2019-03-27 12:00:00,2019-03-27 12:15:00
153,1,0,1,0.002982562114559032,2019-03-27 12:00:00,2019-03-27 12:15:00
154,4,3,1,0.011476443707920163,2019-03-27 12:00:00,2019-03-27 12:15:00
156,2,1,1,0.01982909870143022,2019-03-27 12:00:00,2019-03-27 12:15:00
157,3,2,1,0.03560393223941362,2019-03-27 12:00:00,2019-03-27 12:15:00
158,3,2,1,0.03667563528830141,2019-03-27 12:00:00,2019-03-27 12:15:00
159,1,1,0,0.005517976496678883,2019-03-27 12:00:00,2019-03-27 12:15:00
161,2,1,1,0.01982909870143022,2019-03-27 12:00:00,2019-03-27 12:15:00
164,1,1,0,0.0037874815774536752,2019-03-27 12:00:00,2019-03-27 12:15:00
168,1,0,1,0.002982562114559032,2019-03-27 12:00:00,2019-03-27 12:15:00
169,1,0,1,0.002982562114559032,2019-03-27 12:00:00,2019-03-27 12:15:00
170,1,1,0,0.012400517079003737,2019-03-27 12:00:00,2019-03-27 12:15:00
171,1,0,1,0.002982562114559032,2019-03-27 12:00:00,2019-03-27 12:15:00
173,1,1,0,0.004250269305618957,2019-03-27 12:00:00,2019-03-27 12:15:00
189,1,0,1,0.002982562114559032,2019-03-27 12:00:00,2019-03-27 12:15:00
191,2,1,1,0.007089759828517164,2019-03-27 12:00:00,2019-03-27 12:15:00
195,5,2,3,0.013218327804795005,2019-03-27 12:00:00,2019-03-27 12:15:00
196,1,0,1,0.002982562114559032,2019-03-27 12:00:00,2019-03-27 12:15:00
197,6,3,3,0.020796041339252756,2019-03-27 12:00:00,2019-03-27 12:15:00
202,1,1,0,0.012674155651574969,2019-03-27 12:00:00,2019-03-27 12:15:00
203,2,0,2,0.002982562114559032,2019-03-27 12:00:00,2019-03-27 12:15:00
1,1,0,1,0.0028772781572314835,2019-03-27 12:15:00,2019-03-27 12:30:00
2,1,0,1,0.0028772781572314835,2019-03-27 12:15:00,2019-03-27 12:30:00
5,1,0,1,0.0028772781572314835,2019-03-27 12:15:00,2019-03-27 12:30:00
10,4,2,2,0.01342564646710785,2019-03-27 12:15:00,2019-03-27 12:30:00
15,1,1,0,0.0051398099711517185,2019-03-27 12:15:00,2019-03-27 12:30:00
16,1,0,1,0.0028772781572314835,2019-03-27 12:15:00,2019-03-27 12:30:00
18,1,1,0,0.004100214418418393,2019-03-27 12:15:00,2019-03-27 12:30:00
19,1,0,1,0.0028772781572314835,2019-03-27 12:15:00,2019-03-27 12:30:00
20,3,1,2,0.012040172570331725,2019-03-27 12:15:00,2019-03-27 12:30:00
23,3,3,0,0.013989895765074437,2019-03-27 12:15:00,2019-03-27 12:30:00
26,5,2,3,0.02788322323313308,2019-03-27 12:15:00,2019-03-27 12:30:00
28,5,4,1,0.024638057038342286,2019-03-27 12:15:00,2019-03-27 12:30:00
37,4,2,2,0.013665917494826702,2019-03-27 12:15:00,2019-03-27 12:30:00
40,1,0,1,0.0028772781572314835,2019-03-27 12:15:00,2019-03-27 12:30:00
46,3,1,2,0.005004305016072333,2019-03-27 12:15:00,2019-03-27 12:30:00
58,1,0,1,0.0028772781572314835,2019-03-27 12:15:00,2019-03-27 12:30:00
67,4,2,2,0.005323150679605303,2019-03-27 12:15:00,2019-03-27 12:30:00
69,2,2,0,0.009127807509953489,2019-03-27 12:15:00,2019-03-27 12:30:00
74,2,0,2,0.0028772781572314835,2019-03-27 12:15:00,2019-03-27 12:30:00
79,1,1,0,0.004100214418418393,2019-03-27 12:15:00,2019-03-27 12:30:00
85,3,1,2,0.0060162143814275195,2019-03-27 12:15:00,2019-03-27 12:30:00
87,2,1,1,0.01912840755709304,2019-03-27 12:15:00,2019-03-27 12:30:00
88,4,1,3,0.0040149405109523315,2019-03-27 12:15:00,2019-03-27 12:30:00
90,6,3,3,0.007598475387046999,2019-03-27 12:15:00,2019-03-27 12:30:00
104,2,1,1,0.027978100205110046,2019-03-27 12:15:00,2019-03-27 12:30:00
106,2,1,1,0.005030375725704124,2019-03-27 12:15:00,2019-03-27 12:30:00
109,3,2,1,0.04839935697052801,2019-03-27 12:15:00,2019-03-27 12:30:00
110,2,1,1,0.0074023417850719525,2019-03-27 12:15:00,2019-03-27 12:30:00
111,2,1,1,0.0051398099711517185,2019-03-27 12:15:00,2019-03-27 12:30:00
112,5,4,1,0.02952468707442054,2019-03-27 12:15:00,2019-03-27 12:30:00
114,1,0,1,0.0028772781572314835,2019-03-27 12:15:00,2019-03-27 12:30:00
115,1,0,1,0.0028772781572314835,2019-03-27 12:15:00,2019-03-27 12:30:00
116,2,1,1,0.01078043095153323,2019-03-27 12:15:00,2019-03-27 12:30:00
118,2,2,0,0.0074023417850719525,2019-03-27 12:15:00,2019-03-27 12:30:00
119,4,4,0,0.014986553376207471,2019-03-27 12:15:00,2019-03-27 12:30:00
120,2,0,2,0.0028772781572314835,2019-03-27 12:15:00,2019-03-27 12:30:00
122,1,0,1,0.0028772781572314835,2019-03-27 12:15:00,2019-03-27 12:30:00
127,1,1,0,0.005323150679605303,2019-03-27 12:15:00,2019-03-27 12:30:00
133,2,1,1,0.005004305016072333,2019-03-27 12:15:00,2019-03-27 12:30:00
137,3,1,2,0.005323150679605303,2019-03-27 12:15:00,2019-03-27 12:30:00
138,4,2,2,0.01044180589034912,2019-03-27 12:15:00,2019-03-27 12:30:00
140,2,2,0,0.009908857033216558,2019-03-27 12:15:00,2019-03-27 12:30:00
141,3,3,0,0.012431019992668059,2019-03-27 12:15:00,2019-03-27 12:30:00
151,2,0,2,0.0028772781572314835,2019-03-27 12:15:00,2019-03-27 12:30:00
153,1,1,0,0.00858412143470005,2019-03-27 12:15:00,2019-03-27 12:30:00
154,4,2,2,0.011131793294403468,2019-03-27 12:15:00,2019-03-27 12:30:00
157,2,1,1,0.01912840755709304,2019-03-27 12:15:00,2019-03-27 12:30:00
158,4,2,2,0.012603711214211022,2019-03-27 12:15:00,2019-03-27 12:30:00
161,2,1,1,0.01912840755709304,2019-03-27 12:15:00,2019-03-27 12:30:00
164,2,0,2,0.0028772781572314835,2019-03-27 12:15:00,2019-03-27 12:30:00
168,5,4,1,0.011252676763047384,2019-03-27 12:15:00,2019-03-27 12:30:00
170,2,1,1,0.023819145718913477,2019-03-27 12:15:00,2019-03-27 12:30:00
173,1,1,0,0.0079959333679753,2019-03-27 12:15:00,2019-03-27 12:30:00
189,3,0,3,0.0028772781572314835,2019-03-27 12:15:00,2019-03-27 12:30:00
191,2,1,1,0.005323150679605303,2019-03-27 12:15:00,2019-03-27 12:30:00
195,6,2,4,0.009289991157063332,2019-03-27 12:15:00,2019-03-27 12:30:00
196,3,1,2,0.005004305016072333,2019-03-27 12:15:00,2019-03-27 12:30:00
197,6,3,3,0.017085391849887555,2019-03-27 12:15:00,2019-03-27 12:30:00
201,1,0,1,0.0028772781572314835,2019-03-27 12:15:00,2019-03-27 12:30:00
202,2,1,1,0.005323150679605303,2019-03-27 12:15:00,2019-03-27 12:30:00
203,2,1,1,0.0036925689980227567,2019-03-27 12:15:00,2019-03-27 12:30:00
1,2,1,1,0.007717399575215538,2019-03-27 12:30:00,2019-03-27 12:45:00
2,1,0,1,0.002999728996493645,2019-03-27 12:30:00,2019-03-27 12:45:00
5,1,0,1,0.002999728996493645,2019-03-27 12:30:00,2019-03-27 12:45:00
10,3,2,1,0.023410845011602115,2019-03-27 12:30:00,2019-03-27 12:45:00
16,3,1,2,0.0035097245696333844,2019-03-27 12:30:00,2019-03-27 12:45:00
18,3,3,0,0.030658517187305227,2019-03-27 12:30:00,2019-03-27 12:45:00
20,2,2,0,0.008331864866641347,2019-03-27 12:30:00,2019-03-27 12:45:00
23,2,2,0,0.005371900606872917,2019-03-27 12:30:00,2019-03-27 12:45:00
26,1,0,1,0.002999728996493645,2019-03-27 12:30:00,2019-03-27 12:45:00
28,1,1,0,0.0035097245696333844,2019-03-27 12:30:00,2019-03-27 12:45:00
30,1,0,1,0.002999728996493645,2019-03-27 12:30:00,2019-03-27 12:45:00
37,5,3,2,0.02694423584886337,2019-03-27 12:30:00,2019-03-27 12:45:00
46,4,1,3,0.004185814801683281,2019-03-27 12:30:00,2019-03-27 12:45:00
57,3,1,2,0.005217287976653018,2019-03-27 12:30:00,2019-03-27 12:45:00
58,2,1,1,0.003614194287919453,2019-03-27 12:30:00,2019-03-27 12:45:00
62,2,1,1,0.0055497068621923416,2019-03-27 12:30:00,2019-03-27 12:45:00
67,3,2,1,0.010267377440914235,2019-03-27 12:30:00,2019-03-27 12:45:00
69,1,1,0,0.004185814801683281,2019-03-27 12:30:00,2019-03-27 12:45:00
74,1,0,1,0.002999728996493645,2019-03-27 12:30:00,2019-03-27 12:45:00
79,1,0,1,0.002999728996493645,2019-03-27 12:30:00,2019-03-27 12:45:00
85,3,1,2,0.006633553218703941,2019-03-27 12:30:00,2019-03-27 12:45:00
86,2,2,0,0.012913931799337024,2019-03-27 12:30:00,2019-03-27 12:45:00
88,3,2,1,0.03863679129498189,2019-03-27 12:30:00,2019-03-27 12:45:00
90,7,4,3,0.01624149881253788,2019-03-27 12:30:00,2019-03-27 12:45:00
106,1,1,0,0.005217287976653018,2019-03-27 12:30:00,2019-03-27 12:45:00
108,1,0,1,0.002999728996493645,2019-03-27 12:30:00,2019-03-27 12:45:00
109,4,2,2,0.01744701813655854,2019-03-27 12:30:00,2019-03-27 12:45:00
110,3,3,0,0.014457370564773243,2019-03-27 12:30:00,2019-03-27 12:45:00
111,2,1,1,0.004274717929342994,2019-03-27 12:30:00,2019-03-27 12:45:00
112,2,2,0,0.006996416684437472,2019-03-27 12:30:00,2019-03-27 12:45:00
114,4,2,2,0.0064033737818426535,2019-03-27 12:30:00,2019-03-27 12:45:00
116,2,1,1,0.0055497068621923416,2019-03-27 12:30:00,2019-03-27 12:45:00
119,6,5,1,0.023864703055056016,2019-03-27 12:30:00,2019-03-27 12:45:00
120,2,1,1,0.006633553218703941,2019-03-27 12:30:00,2019-03-27 12:45:00
122,2,1,1,0.0035097245696333844,2019-03-27 12:30:00,2019-03-27 12:45:00
126,2,1,1,0.023287097937534827,2019-03-27 12:30:00,2019-03-27 12:45:00
127,1,0,1,0.002999728996493645,2019-03-27 12:30:00,2019-03-27 12:45:00
133,4,1,3,0.004185814801683281,2019-03-27 12:30:00,2019-03-27 12:45:00
135,1,1,0,0.014452545655170979,2019-03-27 12:30:00,2019-03-27 12:45:00
137,9,4,5,0.016633409522954775,2019-03-27 12:30:00,2019-03-27 12:45:00
138,3,2,1,0.00827140561728682,2019-03-27 12:30:00,2019-03-27 12:45:00
140,2,1,1,0.0035097245696333844,2019-03-27 12:30:00,2019-03-27 12:45:00
141,3,2,1,0.006824695795041691,2019-03-27 12:30:00,2019-03-27 12:45:00
151,2,1,1,0.0055497068621923416,2019-03-27 12:30:00,2019-03-27 12:45:00
153,2,1,1,0.022901867853199222,2019-03-27 12:30:00,2019-03-27 12:45:00
154,2,1,1,0.0044914872006453135,2019-03-27 12:30:00,2019-03-27 12:45:00
157,2,1,1,0.019910843101939326,2019-03-27 12:30:00,2019-03-27 12:45:00
158,1,0,1,0.002999728996493645,2019-03-27 12:30:00,2019-03-27 12:45:00
161,2,1,1,0.019910843101939326,2019-03-27 12:30:00,2019-03-27 12:45:00
164,5,0,5,0.002999728996493645,2019-03-27 12:30:00,2019-03-27 12:45:00
168,6,4,2,0.01469461929360224,2019-03-27 12:30:00,2019-03-27 12:45:00
170,2,0,2,0.002999728996493645,2019-03-27 12:30:00,2019-03-27 12:45:00
171,1,1,0,0.0055497068621923416,2019-03-27 12:30:00,2019-03-27 12:45:00
173,1,1,0,0.005827707189730486,2019-03-27 12:30:00,2019-03-27 12:45:00
189,2,0,2,0.002999728996493645,2019-03-27 12:30:00,2019-03-27 12:45:00
191,6,1,5,0.003614194287919453,2019-03-27 12:30:00,2019-03-27 12:45:00
195,4,1,3,0.004185814801683281,2019-03-27 12:30:00,2019-03-27 12:45:00
196,1,1,0,0.0035097245696333844,2019-03-27 12:30:00,2019-03-27 12:45:00
197,5,3,2,0.023985005305444295,2019-03-27 12:30:00,2019-03-27 12:45:00
199,3,1,2,0.005217287976653018,2019-03-27 12:30:00,2019-03-27 12:45:00
201,1,0,1,0.002999728996493645,2019-03-27 12:30:00,2019-03-27 12:45:00
202,1,0,1,0.002999728996493645,2019-03-27 12:30:00,2019-03-27 12:45:00
203,2,1,1,0.004274717929342994,2019-03-27 12:30:00,2019-03-27 12:45:00
1,2,0,2,0.003159787258980315,2019-03-27 12:45:00,2019-03-27 13:00:00
5,4,3,1,0.006293538195125592,2019-03-27 12:45:00,2019-03-27 13:00:00
10,3,2,1,0.00846391960672212,2019-03-27 12:45:00,2019-03-27 13:00:00
13,1,0,1,0.003159787258980315,2019-03-27 12:45:00,2019-03-27 13:00:00
15,1,0,1,0.003159787258980315,2019-03-27 12:45:00,2019-03-27 13:00:00
16,2,2,0,0.005383722916250809,2019-03-27 12:45:00,2019-03-27 13:00:00
18,5,4,1,0.02193846126003845,2019-03-27 12:45:00,2019-03-27 13:00:00
19,2,0,2,0.003159787258980315,2019-03-27 12:45:00,2019-03-27 13:00:00
20,2,1,1,0.004502823374471148,2019-03-27 12:45:00,2019-03-27 13:00:00
23,2,1,1,0.004466404206737695,2019-03-27 12:45:00,2019-03-27 13:00:00
28,2,1,1,0.0037844852865610646,2019-03-27 12:45:00,2019-03-27 13:00:00
37,9,6,3,0.025006804209089878,2019-03-27 12:45:00,2019-03-27 13:00:00
40,1,1,0,0.004466404206737695,2019-03-27 12:45:00,2019-03-27 13:00:00
41,2,0,2,0.003159787258980315,2019-03-27 12:45:00,2019-03-27 13:00:00
46,4,3,1,0.00920910790636146,2019-03-27 12:45:00,2019-03-27 13:00:00
50,1,1,0,0.007120883491231288,2019-03-27 12:45:00,2019-03-27 13:00:00
57,4,2,2,0.009673640769630412,2019-03-27 12:45:00,2019-03-27 13:00:00
58,3,2,1,0.011294500539169331,2019-03-27 12:45:00,2019-03-27 13:00:00
66,1,0,1,0.003159787258980315,2019-03-27 12:45:00,2019-03-27 13:00:00
67,4,1,3,0.005845859489961981,2019-03-27 12:45:00,2019-03-27 13:00:00
69,2,2,0,0.013041018903344501,2019-03-27 12:45:00,2019-03-27 13:00:00
70,1,1,0,0.008129277587335509,2019-03-27 12:45:00,2019-03-27 13:00:00
74,1,0,1,0.003159787258980315,2019-03-27 12:45:00,2019-03-27 13:00:00
79,1,0,1,0.003159787258980315,2019-03-27 12:45:00,2019-03-27 13:00:00
85,6,3,3,0.014353581858936218,2019-03-27 12:45:00,2019-03-27 13:00:00
86,1,1,0,0.01098849338396135,2019-03-27 12:45:00,2019-03-27 13:00:00
87,4,4,0,0.028563421758565577,2019-03-27 12:45:00,2019-03-27 13:00:00
88,5,5,0,0.011284488044735693,2019-03-27 12:45:00,2019-03-27 13:00:00
90,3,2,1,0.03152525351556754,2019-03-27 12:45:00,2019-03-27 13:00:00
106,2,1,1,0.005845859489961981,2019-03-27 12:45:00,2019-03-27 13:00:00
108,1,0,1,0.003159787258980315,2019-03-27 12:45:00,2019-03-27 13:00:00
109,6,2,4,0.006148028414937433,2019-03-27 12:45:00,2019-03-27 13:00:00
110,3,3,0,0.007078341621413728,2019-03-27 12:45:00,2019-03-27 13:00:00
111,9,4,5,0.007463219443717332,2019-03-27 12:45:00,2019-03-27 13:00:00
112,3,3,0,0.01441550371213467,2019-03-27 12:45:00,2019-03-27 13:00:00
113,1,0,1,0.003159787258980315,2019-03-27 12:45:00,2019-03-27 13:00:00
114,5,3,2,0.010177425751197946,2019-03-27 12:45:00,2019-03-27 13:00:00
116,3,0,3,0.003159787258980315,2019-03-27 12:45:00,2019-03-27 13:00:00
118,1,0,1,0.003159787258980315,2019-03-27 12:45:00,2019-03-27 13:00:00
119,5,2,3,0.005643754933257015,2019-03-27 12:45:00,2019-03-27 13:00:00
120,8,3,5,0.0067105516757372495,2019-03-27 12:45:00,2019-03-27 13:00:00
122,2,2,0,0.005498016968714168,2019-03-27 12:45:00,2019-03-27 13:00:00
126,5,3,2,0.009319191202393976,2019-03-27 12:45:00,2019-03-27 13:00:00
127,4,2,2,0.007053023096136705,2019-03-27 12:45:00,2019-03-27 13:00:00
133,4,2,2,0.020946396103728275,2019-03-27 12:45:00,2019-03-27 13:00:00
135,2,2,0,0.011495679836761129,2019-03-27 12:45:00,2019-03-27 13:00:00
137,11,4,7,0.00962691175950494,2019-03-27 12:45:00,2019-03-27 13:00:00
138,11,4,7,0.013846824809918626,2019-03-27 12:45:00,2019-03-27 13:00:00
140,1,0,1,0.003159787258980315,2019-03-27 12:45:00,2019-03-27 13:00:00
141,2,0,2,0.003159787258980315,2019-03-27 12:45:00,2019-03-27 13:00:00
151,1,1,0,0.005845859489961981,2019-03-27 12:45:00,2019-03-27 13:00:00
153,1,0,1,0.003159787258980315,2019-03-27 12:45:00,2019-03-27 13:00:00
154,1,0,1,0.003159787258980315,2019-03-27 12:45:00,2019-03-27 13:00:00
157,3,1,2,0.00549572876127415,2019-03-27 12:45:00,2019-03-27 13:00:00
161,2,1,1,0.020946396103728275,2019-03-27 12:45:00,2019-03-27 13:00:00
162,1,1,0,0.005845859489961981,2019-03-27 12:45:00,2019-03-27 13:00:00
164,8,2,6,0.004409183314141814,2019-03-27 12:45:00,2019-03-27 13:00:00
168,5,2,3,0.012932356012581298,2019-03-27 12:45:00,2019-03-27 13:00:00
170,3,1,2,0.007370799720093867,2019-03-27 12:45:00,2019-03-27 13:00:00
171,2,2,0,0.00750235626608038,2019-03-27 12:45:00,2019-03-27 13:00:00
173,1,1,0,0.0043289021138472415,2019-03-27 12:45:00,2019-03-27 13:00:00
189,7,3,4,0.011402028002312119,2019-03-27 12:45:00,2019-03-27 13:00:00
191,2,0,2,0.003159787258980315,2019-03-27 12:45:00,2019-03-27 13:00:00
195,4,1,3,0.004409183314141814,2019-03-27 12:45:00,2019-03-27 13:00:00
196,3,2,1,0.0049536001414279916,2019-03-27 12:45:00,2019-03-27 13:00:00
197,4,2,2,0.020946396103728275,2019-03-27 12:45:00,2019-03-27 13:00:00
199,1,0,1,0.003159787258980315,2019-03-27 12:45:00,2019-03-27 13:00:00
200,1,1,0,0.004816284035098713,2019-03-27 12:45:00,2019-03-27 13:00:00
203,2,1,1,0.0055830099186023625,2019-03-27 12:45:00,2019-03-27 13:00:00
1,2,0,2,0.0029383321451717627,2019-03-27 13:00:00,2019-03-27 13:15:00
2,1,0,1,0.0029383321451717627,2019-03-27 13:00:00,2019-03-27 13:15:00
5,2,2,0,0.005555146593781259,2019-03-27 13:00:00,2019-03-27 13:15:00
10,3,1,2,0.007240791232654077,2019-03-27 13:00:00,2019-03-27 13:15:00
13,1,0,1,0.0029383321451717627,2019-03-27 13:00:00,2019-03-27 13:15:00
15,1,0,1,0.0029383321451717627,2019-03-27 13:00:00,2019-03-27 13:15:00
16,2,1,1,0.004543757875515657,2019-03-27 13:00:00,2019-03-27 13:15:00
18,2,1,1,0.004543757875515657,2019-03-27 13:00:00,2019-03-27 13:15:00
19,1,0,1,0.0029383321451717627,2019-03-27 13:00:00,2019-03-27 13:15:00
20,2,0,2,0.0029383321451717627,2019-03-27 13:00:00,2019-03-27 13:15:00
21,1,0,1,0.0029383321451717627,2019-03-27 13:00:00,2019-03-27 13:15:00
23,3,1,2,0.015049661407251707,2019-03-27 13:00:00,2019-03-27 13:15:00
26,2,2,0,0.005566698256098849,2019-03-27 13:00:00,2019-03-27 13:15:00
27,1,1,0,0.007727866350876429,2019-03-27 13:00:00,2019-03-27 13:15:00
28,6,2,4,0.006183794813504038,2019-03-27 13:00:00,2019-03-27 13:15:00
35,1,1,0,0.003770923370560951,2019-03-27 13:00:00,2019-03-27 13:15:00
37,8,4,4,0.02338823084485836,2019-03-27 13:00:00,2019-03-27 13:15:00
40,2,2,0,0.007284137025511645,2019-03-27 13:00:00,2019-03-27 13:15:00
41,3,1,2,0.006015970943172058,2019-03-27 13:00:00,2019-03-27 13:15:00
46,3,2,1,0.007115268217527507,2019-03-27 13:00:00,2019-03-27 13:15:00
50,3,1,2,0.007240791232654077,2019-03-27 13:00:00,2019-03-27 13:15:00
57,3,2,1,0.008197895415849877,2019-03-27 13:00:00,2019-03-27 13:15:00
58,1,1,0,0.003974420401247322,2019-03-27 13:00:00,2019-03-27 13:15:00
61,1,1,0,0.009335751127309633,2019-03-27 13:00:00,2019-03-27 13:15:00
66,2,1,1,0.004718044626597055,2019-03-27 13:00:00,2019-03-27 13:15:00
67,5,1,4,0.00846191133419286,2019-03-27 13:00:00,2019-03-27 13:15:00
68,1,1,0,0.004187218983255546,2019-03-27 13:00:00,2019-03-27 13:15:00
69,7,4,3,0.03990941921977828,2019-03-27 13:00:00,2019-03-27 13:15:00
70,2,1,1,0.006497757108022346,2019-03-27 13:00:00,2019-03-27 13:15:00
85,2,1,1,0.009907177021375734,2019-03-27 13:00:00,2019-03-27 13:15:00
86,1,1,0,0.008986856391452046,2019-03-27 13:00:00,2019-03-27 13:15:00
87,3,3,0,0.013220488150055627,2019-03-27 13:00:00,2019-03-27 13:15:00
88,2,2,0,0.004452214183357512,2019-03-27 13:00:00,2019-03-27 13:15:00
89,2,0,2,0.0029383321451717627,2019-03-27 13:00:00,2019-03-27 13:15:00
90,4,2,2,0.005754132882672614,2019-03-27 13:00:00,2019-03-27 13:15:00
101,2,2,0,0.005436105821339328,2019-03-27 13:00:00,2019-03-27 13:15:00
106,2,1,1,0.004187218983255546,2019-03-27 13:00:00,2019-03-27 13:15:00
109,8,5,3,0.042737288459365905,2019-03-27 13:00:00,2019-03-27 13:15:00
110,5,2,3,0.0076682721387506415,2019-03-27 13:00:00,2019-03-27 13:15:00
111,13,6,7,0.013219750881315303,2019-03-27 13:00:00,2019-03-27 13:15:00
112,5,3,2,0.009989149099742918,2019-03-27 13:00:00,2019-03-27 13:15:00
113,1,0,1,0.0029383321451717627,2019-03-27 13:00:00,2019-03-27 13:15:00
114,5,1,4,0.004736659877548838,2019-03-27 13:00:00,2019-03-27 13:15:00
116,4,1,3,0.004617494541359942,2019-03-27 13:00:00,2019-03-27 13:15:00
119,3,1,2,0.004187218983255546,2019-03-27 13:00:00,2019-03-27 13:15:00
120,1,0,1,0.0029383321451717627,2019-03-27 13:00:00,2019-03-27 13:15:00
122,2,2,0,0.0050105086573228805,2019-03-27 13:00:00,2019-03-27 13:15:00
126,5,3,2,0.010122478288252692,2019-03-27 13:00:00,2019-03-27 13:15:00
127,5,2,3,0.00592590176566469,2019-03-27 13:00:00,2019-03-27 13:15:00
129,2,2,0,0.005436105821339328,2019-03-27 13:00:00,2019-03-27 13:15:00
135,1,1,0,0.007909245289792855,2019-03-27 13:00:00,2019-03-27 13:15:00
137,12,4,8,0.009750510233226428,2019-03-27 13:00:00,2019-03-27 13:15:00
138,7,2,5,0.004452214183357512,2019-03-27 13:00:00,2019-03-27 13:15:00
140,1,1,0,0.0053840570755941146,2019-03-27 13:00:00,2019-03-27 13:15:00
141,3,0,3,0.0029383321451717627,2019-03-27 13:00:00,2019-03-27 13:15:00
147,1,1,0,0.005436105821339328,2019-03-27 13:00:00,2019-03-27 13:15:00
153,2,1,1,0.005436105821339328,2019-03-27 13:00:00,2019-03-27 13:15:00
154,1,1,0,0.011250671843105662,2019-03-27 13:00:00,2019-03-27 13:15:00
157,2,1,1,0.01951314521018123,2019-03-27 13:00:00,2019-03-27 13:15:00
158,3,3,0,0.010100241528586486,2019-03-27 13:00:00,2019-03-27 13:15:00
161,2,1,1,0.01951314521018123,2019-03-27 13:00:00,2019-03-27 13:15:00
162,1,1,0,0.005436105821339328,2019-03-27 13:00:00,2019-03-27 13:15:00
164,3,1,2,0.004543757875515657,2019-03-27 13:00:00,2019-03-27 13:15:00
168,5,3,2,0.017228216775140887,2019-03-27 13:00:00,2019-03-27 13:15:00
170,3,2,1,0.008873463132160678,2019-03-27 13:00:00,2019-03-27 13:15:00
171,1,1,0,0.004736659877548838,2019-03-27 13:00:00,2019-03-27 13:15:00
173,3,2,1,0.005634237484794864,2019-03-27 13:00:00,2019-03-27 13:15:00
189,6,4,2,0.019555705915581097,2019-03-27 13:00:00,2019-03-27 13:15:00
191,1,1,0,0.004187218983255546,2019-03-27 13:00:00,2019-03-27 13:15:00
196,3,1,2,0.003974420401247322,2019-03-27 13:00:00,2019-03-27 13:15:00
197,4,2,2,0.01951314521018123,2019-03-27 13:00:00,2019-03-27 13:15:00
199,2,0,2,0.0029383321451717627,2019-03-27 13:00:00,2019-03-27 13:15:00
200,1,1,0,0.004736659877548838,2019-03-27 13:00:00,2019-03-27 13:15:00
201,2,1,1,0.01951314521018123,2019-03-27 13:00:00,2019-03-27 13:15:00
202,1,1,0,0.003974420401247322,2019-03-27 13:00:00,2019-03-27 13:15:00
203,2,0,2,0.0029383321451717627,2019-03-27 13:00:00,2019-03-27 13:15:00
2,1,0,1,0.0031257638792937547,2019-03-27 13:15:00,2019-03-27 13:30:00
5,1,1,0,0.014625412728759142,2019-03-27 13:15:00,2019-03-27 13:30:00
10,3,1,2,0.006055849262919647,2019-03-27 13:15:00,2019-03-27 13:30:00
13,1,1,0,0.006055849262919647,2019-03-27 13:15:00,2019-03-27 13:30:00
16,3,2,1,0.012014498080428126,2019-03-27 13:15:00,2019-03-27 13:30:00
18,3,2,1,0.015731426863449645,2019-03-27 13:15:00,2019-03-27 13:30:00
19,1,0,1,0.0031257638792937547,2019-03-27 13:15:00,2019-03-27 13:30:00
20,2,1,1,0.006453429334799803,2019-03-27 13:15:00,2019-03-27 13:30:00
23,2,1,1,0.0054460018990090744,2019-03-27 13:15:00,2019-03-27 13:30:00
26,2,2,0,0.00941744080485374,2019-03-27 13:15:00,2019-03-27 13:30:00
27,1,1,0,0.004744200627077727,2019-03-27 13:15:00,2019-03-27 13:30:00
28,4,2,2,0.007401311637529379,2019-03-27 13:15:00,2019-03-27 13:30:00
35,2,2,0,0.01230019297652961,2019-03-27 13:15:00,2019-03-27 13:30:00
37,6,2,4,0.005436483689664069,2019-03-27 13:15:00,2019-03-27 13:30:00
40,2,0,2,0.0031257638792937547,2019-03-27 13:15:00,2019-03-27 13:30:00
41,4,2,2,0.00782902554572252,2019-03-27 13:15:00,2019-03-27 13:30:00
46,3,2,1,0.0076667191801903685,2019-03-27 13:15:00,2019-03-27 13:30:00
50,2,0,2,0.0031257638792937547,2019-03-27 13:15:00,2019-03-27 13:30:00
57,2,1,1,0.005782874889745406,2019-03-27 13:15:00,2019-03-27 13:30:00
58,1,1,0,0.006001542634819399,2019-03-27 13:15:00,2019-03-27 13:30:00
61,2,1,1,0.0077553274920609296,2019-03-27 13:15:00,2019-03-27 13:30:00
62,1,1,0,0.004281123784478912,2019-03-27 13:15:00,2019-03-27 13:30:00
66,1,0,1,0.0031257638792937547,2019-03-27 13:15:00,2019-03-27 13:30:00
67,5,1,4,0.010917603086150562,2019-03-27 13:15:00,2019-03-27 13:30:00
68,1,1,0,0.00445431938451958,2019-03-27 13:15:00,2019-03-27 13:30:00
69,5,2,3,0.007953456919214088,2019-03-27 13:15:00,2019-03-27 13:30:00
70,3,2,1,0.009165965306629076,2019-03-27 13:15:00,2019-03-27 13:30:00
85,2,1,1,0.00445431938451958,2019-03-27 13:15:00,2019-03-27 13:30:00
87,2,2,0,0.021270158867624143,2019-03-27 13:15:00,2019-03-27 13:30:00
88,1,0,1,0.0031257638792937547,2019-03-27 13:15:00,2019-03-27 13:30:00
89,2,0,2,0.0031257638792937547,2019-03-27 13:15:00,2019-03-27 13:30:00
90,3,1,2,0.006001542634819399,2019-03-27 13:15:00,2019-03-27 13:30:00
101,2,2,0,0.005782874889745406,2019-03-27 13:15:00,2019-03-27 13:30:00
106,2,1,1,0.00445431938451958,2019-03-27 13:15:00,2019-03-27 13:30:00
108,1,1,0,0.0040114675494443055,2019-03-27 13:15:00,2019-03-27 13:30:00
109,10,5,5,0.018655898188994553,2019-03-27 13:15:00,2019-03-27 13:30:00
110,4,2,2,0.01122431484960369,2019-03-27 13:15:00,2019-03-27 13:30:00
111,6,3,3,0.021219070376930105,2019-03-27 13:15:00,2019-03-27 13:30:00
112,7,3,4,0.007781818142319088,2019-03-27 13:15:00,2019-03-27 13:30:00
113,1,1,0,0.004764387077650462,2019-03-27 13:15:00,2019-03-27 13:30:00
114,6,1,5,0.0040114675494443055,2019-03-27 13:15:00,2019-03-27 13:30:00
115,1,1,0,0.0038077699870253164,2019-03-27 13:15:00,2019-03-27 13:30:00
116,3,1,2,0.0050096081697387175,2019-03-27 13:15:00,2019-03-27 13:30:00
118,1,0,1,0.0031257638792937547,2019-03-27 13:15:00,2019-03-27 13:30:00
119,3,2,1,0.014668119924374725,2019-03-27 13:15:00,2019-03-27 13:30:00
126,4,2,2,0.006893666828733328,2019-03-27 13:15:00,2019-03-27 13:30:00
127,5,2,3,0.006648231368095425,2019-03-27 13:15:00,2019-03-27 13:30:00
129,2,2,0,0.005782874889745406,2019-03-27 13:15:00,2019-03-27 13:30:00
137,16,8,8,0.027062733021062362,2019-03-27 13:15:00,2019-03-27 13:30:00
138,3,0,3,0.0031257638792937547,2019-03-27 13:15:00,2019-03-27 13:30:00
141,1,0,1,0.0031257638792937547,2019-03-27 13:15:00,2019-03-27 13:30:00
147,1,1,0,0.0053794750038681895,2019-03-27 13:15:00,2019-03-27 13:30:00
153,4,1,3,0.005782874889745406,2019-03-27 13:15:00,2019-03-27 13:30:00
154,2,2,0,0.011315052634453034,2019-03-27 13:15:00,2019-03-27 13:30:00
157,3,2,1,0.038899481092991336,2019-03-27 13:15:00,2019-03-27 13:30:00
158,5,3,2,0.006464880997476968,2019-03-27 13:15:00,2019-03-27 13:30:00
161,2,1,1,0.020718816757326997,2019-03-27 13:15:00,2019-03-27 13:30:00
164,1,1,0,0.009138719324902482,2019-03-27 13:15:00,2019-03-27 13:30:00
168,3,2,1,0.00648458351059461,2019-03-27 13:15:00,2019-03-27 13:30:00
169,1,1,0,0.006001542634819399,2019-03-27 13:15:00,2019-03-27 13:30:00
170,1,1,0,0.004779574014872208,2019-03-27 13:15:00,2019-03-27 13:30:00
173,3,1,2,0.0038077699870253164,2019-03-27 13:15:00,2019-03-27 13:30:00
189,3,1,2,0.0062976633565053446,2019-03-27 13:15:00,2019-03-27 13:30:00
191,3,2,1,0.013527593602056465,2019-03-27 13:15:00,2019-03-27 13:30:00
195,4,3,1,0.00875362217016598,2019-03-27 13:15:00,2019-03-27 13:30:00
197,2,1,1,0.020718816757326997,2019-03-27 13:15:00,2019-03-27 13:30:00
199,2,0,2,0.0031257638792937547,2019-03-27 13:15:00,2019-03-27 13:30:00
200,1,1,0,0.0054460018990090744,2019-03-27 13:15:00,2019-03-27 13:30:00
202,1,1,0,0.006001542634819399,2019-03-27 13:15:00,2019-03-27 13:30:00
203,2,0,2,0.0031257638792937547,2019-03-27 13:15:00,2019-03-27 13:30:00
1,1,1,0,0.0056198811153338815,2019-03-27 13:30:00,2019-03-27 13:45:00
2,5,2,3,0.007457860342166934,2019-03-27 13:30:00,2019-03-27 13:45:00
5,2,2,0,0.00881552654297334,2019-03-27 13:30:00,2019-03-27 13:45:00
10,2,0,2,0.0032311436001809927,2019-03-27 13:30:00,2019-03-27 13:45:00
13,1,1,0,0.0069395449416347265,2019-03-27 13:30:00,2019-03-27 13:45:00
16,2,1,1,0.006134971188776636,2019-03-27 13:30:00,2019-03-27 13:45:00
18,4,1,3,0.0059778944148914746,2019-03-27 13:30:00,2019-03-27 13:45:00
20,3,2,1,0.04286940298652568,2019-03-27 13:30:00,2019-03-27 13:45:00
22,1,0,1,0.0032311436001809927,2019-03-27 13:30:00,2019-03-27 13:45:00
23,2,1,1,0.004604519007536233,2019-03-27 13:30:00,2019-03-27 13:45:00
26,2,0,2,0.0032311436001809927,2019-03-27 13:30:00,2019-03-27 13:45:00
28,3,3,0,0.009275755747436672,2019-03-27 13:30:00,2019-03-27 13:45:00
35,3,3,0,0.01259835649405328,2019-03-27 13:30:00,2019-03-27 13:45:00
37,4,1,3,0.0045087701316864565,2019-03-27 13:30:00,2019-03-27 13:45:00
40,1,0,1,0.0032311436001809927,2019-03-27 13:30:00,2019-03-27 13:45:00
46,3,0,3,0.0032311436001809927,2019-03-27 13:30:00,2019-03-27 13:45:00
57,3,1,2,0.004604519007536233,2019-03-27 13:30:00,2019-03-27 13:45:00
58,2,0,2,0.0032311436001809927,2019-03-27 13:30:00,2019-03-27 13:45:00
61,1,0,1,0.0032311436001809927,2019-03-27 13:30:00,2019-03-27 13:45:00
62,4,3,1,0.009619276257708313,2019-03-27 13:30:00,2019-03-27 13:45:00
64,1,0,1,0.0032311436001809927,2019-03-27 13:30:00,2019-03-27 13:45:00
66,2,2,0,0.007038427554110289,2019-03-27 13:30:00,2019-03-27 13:45:00
67,2,0,2,0.0032311436001809927,2019-03-27 13:30:00,2019-03-27 13:45:00
68,1,1,0,0.0059778944148914746,2019-03-27 13:30:00,2019-03-27 13:45:00
69,3,3,0,0.00826685342715021,2019-03-27 13:30:00,2019-03-27 13:45:00
87,3,3,0,0.01336669594709012,2019-03-27 13:30:00,2019-03-27 13:45:00
88,3,1,2,0.007758506582394067,2019-03-27 13:30:00,2019-03-27 13:45:00
89,1,1,0,0.008446557663752607,2019-03-27 13:30:00,2019-03-27 13:45:00
90,2,1,1,0.0045087701316864565,2019-03-27 13:30:00,2019-03-27 13:45:00
104,3,1,2,0.0056198811153338815,2019-03-27 13:30:00,2019-03-27 13:45:00
108,1,1,0,0.006845111403795626,2019-03-27 13:30:00,2019-03-27 13:45:00
109,7,3,4,0.013663202774150996,2019-03-27 13:30:00,2019-03-27 13:45:00
110,6,3,3,0.015976489223029786,2019-03-27 13:30:00,2019-03-27 13:45:00
111,2,2,0,0.007145407381940721,2019-03-27 13:30:00,2019-03-27 13:45:00
112,2,1,1,0.003917831303858613,2019-03-27 13:30:00,2019-03-27 13:45:00
113,5,3,2,0.04882366302911623,2019-03-27 13:30:00,2019-03-27 13:45:00
114,4,0,4,0.0032311436001809927,2019-03-27 13:30:00,2019-03-27 13:45:00
115,2,2,0,0.012095226017598642,2019-03-27 13:30:00,2019-03-27 13:45:00
116,1,0,1,0.0032311436001809927,2019-03-27 13:30:00,2019-03-27 13:45:00
119,3,1,2,0.0059778944148914746,2019-03-27 13:30:00,2019-03-27 13:45:00
126,4,2,2,0.008724645229601957,2019-03-27 13:30:00,2019-03-27 13:45:00
127,3,2,1,0.04882366302911623,2019-03-27 13:30:00,2019-03-27 13:45:00
137,5,3,2,0.01287167837188867,2019-03-27 13:30:00,2019-03-27 13:45:00
138,7,4,3,0.012753596746636774,2019-03-27 13:30:00,2019-03-27 13:45:00
141,4,3,1,0.00913407041605436,2019-03-27 13:30:00,2019-03-27 13:45:00
153,4,2,2,0.009686295756345208,2019-03-27 13:30:00,2019-03-27 13:45:00
154,1,1,0,0.006561650898416098,2019-03-27 13:30:00,2019-03-27 13:45:00
157,5,2,3,0.00834164972620285,2019-03-27 13:30:00,2019-03-27 13:45:00
158,1,0,1,0.0032311436001809927,2019-03-27 13:30:00,2019-03-27 13:45:00
161,2,1,1,0.02148331484177102,2019-03-27 13:30:00,2019-03-27 13:45:00
162,1,0,1,0.0032311436001809927,2019-03-27 13:30:00,2019-03-27 13:45:00
164,3,1,2,0.0056198811153338815,2019-03-27 13:30:00,2019-03-27 13:45:00
168,2,1,1,0.003917831303858613,2019-03-27 13:30:00,2019-03-27 13:45:00
171,1,0,1,0.0032311436001809927,2019-03-27 13:30:00,2019-03-27 13:45:00
189,1,1,0,0.00870237542610623,2019-03-27 13:30:00,2019-03-27 13:45:00
190,1,0,1,0.0032311436001809927,2019-03-27 13:30:00,2019-03-27 13:45:00
191,4,2,2,0.007577013006213745,2019-03-27 13:30:00,2019-03-27 13:45:00
195,2,1,1,0.004604519007536233,2019-03-27 13:30:00,2019-03-27 13:45:00
196,1,0,1,0.0032311436001809927,2019-03-27 13:30:00,2019-03-27 13:45:00
203,1,1,0,0.006529004932726189,2019-03-27 13:30:00,2019-03-27 13:45:00
2,3,1,2,0.005591846881935323,2019-03-27 13:45:00,2019-03-27 14:00:00
5,1,1,0,0.004486301405679481,2019-03-27 13:45:00,2019-03-27 14:00:00
10,1,0,1,0.003215055672557949,2019-03-27 13:45:00,2019-03-27 14:00:00
13,1,1,0,0.005026645463647488,2019-03-27 13:45:00,2019-03-27 14:00:00
16,1,0,1,0.003215055672557949,2019-03-27 13:45:00,2019-03-27 14:00:00
18,6,3,3,0.00847630326052909,2019-03-27 13:45:00,2019-03-27 14:00:00
20,2,1,1,0.02133859732522885,2019-03-27 13:45:00,2019-03-27 14:00:00
22,1,0,1,0.003215055672557949,2019-03-27 13:45:00,2019-03-27 14:00:00
23,3,2,1,0.016151074907132145,2019-03-27 13:45:00,2019-03-27 14:00:00
28,2,1,1,0.005219270539564801,2019-03-27 13:45:00,2019-03-27 14:00:00
30,1,1,0,0.005924299441776206,2019-03-27 13:45:00,2019-03-27 14:00:00
35,3,3,0,0.011081038635402139,2019-03-27 13:45:00,2019-03-27 14:00:00
37,2,1,1,0.02133859732522885,2019-03-27 13:45:00,2019-03-27 14:00:00
40,1,1,0,0.00943030102975079,2019-03-27 13:45:00,2019-03-27 14:00:00
41,2,2,0,0.011613083686304058,2019-03-27 13:45:00,2019-03-27 14:00:00
46,3,0,3,0.003215055672557949,2019-03-27 13:45:00,2019-03-27 14:00:00
57,2,1,1,0.005948104755986532,2019-03-27 13:45:00,2019-03-27 14:00:00
58,2,0,2,0.003215055672557949,2019-03-27 13:45:00,2019-03-27 14:00:00
61,1,0,1,0.003215055672557949,2019-03-27 13:45:00,2019-03-27 14:00:00
62,3,2,1,0.007219350489108064,2019-03-27 13:45:00,2019-03-27 14:00:00
64,1,0,1,0.003215055672557949,2019-03-27 13:45:00,2019-03-27 14:00:00
66,2,2,0,0.007993721616397567,2019-03-27 13:45:00,2019-03-27 14:00:00
67,2,0,2,0.003215055672557949,2019-03-27 13:45:00,2019-03-27 14:00:00
68,3,1,2,0.005948104755986532,2019-03-27 13:45:00,2019-03-27 14:00:00
69,2,2,0,0.006502863243078184,2019-03-27 13:45:00,2019-03-27 14:00:00
70,1,1,0,0.005743254177100508,2019-03-27 13:45:00,2019-03-27 14:00:00
74,4,2,2,0.013309175838302049,2019-03-27 13:45:00,2019-03-27 14:00:00
85,1,1,0,0.004581580214272241,2019-03-27 13:45:00,2019-03-27 14:00:00
87,2,2,0,0.019347227892393296,2019-03-27 13:45:00,2019-03-27 14:00:00
88,5,1,4,0.00943030102975079,2019-03-27 13:45:00,2019-03-27 14:00:00
89,3,1,2,0.005948104755986532,2019-03-27 13:45:00,2019-03-27 14:00:00
99,1,1,0,0.008181703434567898,2019-03-27 13:45:00,2019-03-27 14:00:00
104,2,1,1,0.005948104755986532,2019-03-27 13:45:00,2019-03-27 14:00:00
108,1,1,0,0.005924299441776206,2019-03-27 13:45:00,2019-03-27 14:00:00
110,5,3,2,0.012722220510067446,2019-03-27 13:45:00,2019-03-27 14:00:00
111,3,2,1,0.0304003681515643,2019-03-27 13:45:00,2019-03-27 14:00:00
112,2,1,1,0.00412607203370081,2019-03-27 13:45:00,2019-03-27 14:00:00
113,2,1,1,0.02133859732522885,2019-03-27 13:45:00,2019-03-27 14:00:00
114,3,0,3,0.003215055672557949,2019-03-27 13:45:00,2019-03-27 14:00:00
115,2,2,0,0.01431878855958903,2019-03-27 13:45:00,2019-03-27 14:00:00
118,1,1,0,0.00887226335081313,2019-03-27 13:45:00,2019-03-27 14:00:00
119,2,0,2,0.003215055672557949,2019-03-27 13:45:00,2019-03-27 14:00:00
120,2,1,1,0.0071097787188148,2019-03-27 13:45:00,2019-03-27 14:00:00
126,5,2,3,0.006393170005361781,2019-03-27 13:45:00,2019-03-27 14:00:00
127,5,3,2,0.013496365472591906,2019-03-27 13:45:00,2019-03-27 14:00:00
137,9,6,3,0.021933205758489602,2019-03-27 13:45:00,2019-03-27 14:00:00
138,13,6,7,0.022308557115740844,2019-03-27 13:45:00,2019-03-27 14:00:00
141,5,4,1,0.013609431556999979,2019-03-27 13:45:00,2019-03-27 14:00:00
147,1,0,1,0.003215055672557949,2019-03-27 13:45:00,2019-03-27 14:00:00
151,1,1,0,0.005948104755986532,2019-03-27 13:45:00,2019-03-27 14:00:00
153,4,2,2,0.011684775681502365,2019-03-27 13:45:00,2019-03-27 14:00:00
154,2,1,1,0.004581580214272241,2019-03-27 13:45:00,2019-03-27 14:00:00
157,4,1,3,0.004486301405679481,2019-03-27 13:45:00,2019-03-27 14:00:00
158,1,0,1,0.003215055672557949,2019-03-27 13:45:00,2019-03-27 14:00:00
161,2,1,1,0.02133859732522885,2019-03-27 13:45:00,2019-03-27 14:00:00
162,1,1,0,0.007651968160046867,2019-03-27 13:45:00,2019-03-27 14:00:00
164,1,1,0,0.00412607203370081,2019-03-27 13:45:00,2019-03-27 14:00:00
168,2,0,2,0.003215055672557949,2019-03-27 13:45:00,2019-03-27 14:00:00
171,3,1,2,0.005591846881935323,2019-03-27 13:45:00,2019-03-27 14:00:00
189,2,0,2,0.003215055672557949,2019-03-27 13:45:00,2019-03-27 14:00:00
190,1,0,1,0.003215055672557949,2019-03-27 13:45:00,2019-03-27 14:00:00
191,2,1,1,0.008271452681643067,2019-03-27 13:45:00,2019-03-27 14:00:00
195,1,0,1,0.003215055672557949,2019-03-27 13:45:00,2019-03-27 14:00:00
196,1,0,1,0.003215055672557949,2019-03-27 13:45:00,2019-03-27 14:00:00
201,1,1,0,0.005219270539564801,2019-03-27 13:45:00,2019-03-27 14:00:00
203,2,1,1,0.005219270539564801,2019-03-27 13:45:00,2019-03-27 14:00:00
1,1,1,0,0.0038572274438624147,2019-03-27 14:00:00,2019-03-27 14:15:00
2,3,2,1,0.03088701833383285,2019-03-27 14:00:00,2019-03-27 14:15:00
11,1,1,0,0.004283058870067834,2019-03-27 14:00:00,2019-03-27 14:15:00
15,3,3,0,0.008504069047762481,2019-03-27 14:00:00,2019-03-27 14:15:00
16,3,1,2,0.005227540678861673,2019-03-27 14:00:00,2019-03-27 14:15:00
18,4,3,1,0.008124398835432419,2019-03-27 14:00:00,2019-03-27 14:15:00
19,1,1,0,0.011406385765562096,2019-03-27 14:00:00,2019-03-27 14:15:00
20,2,0,2,0.003005564591451576,2019-03-27 14:00:00,2019-03-27 14:15:00
21,5,1,4,0.0038167011681448973,2019-03-27 14:00:00,2019-03-27 14:15:00
22,1,0,1,0.003005564591451576,2019-03-27 14:00:00,2019-03-27 14:15:00
23,1,1,0,0.004283058870067834,2019-03-27 14:00:00,2019-03-27 14:15:00
26,4,3,1,0.0062953252150463905,2019-03-27 14:00:00,2019-03-27 14:15:00
27,2,0,2,0.003005564591451576,2019-03-27 14:00:00,2019-03-27 14:15:00
28,1,0,1,0.003005564591451576,2019-03-27 14:00:00,2019-03-27 14:15:00
30,1,1,0,0.003740336657813875,2019-03-27 14:00:00,2019-03-27 14:15:00
35,2,2,0,0.0142676103857281,2019-03-27 14:00:00,2019-03-27 14:15:00
37,4,2,2,0.006946334578960225,2019-03-27 14:00:00,2019-03-27 14:15:00
40,1,1,0,0.00464382877590198,2019-03-27 14:00:00,2019-03-27 14:15:00
41,4,3,1,0.009882066207958505,2019-03-27 14:00:00,2019-03-27 14:15:00
46,3,0,3,0.003005564591451576,2019-03-27 14:00:00,2019-03-27 14:15:00
58,7,3,4,0.008293694413980897,2019-03-27 14:00:00,2019-03-27 14:15:00
61,1,0,1,0.003005564591451576,2019-03-27 14:00:00,2019-03-27 14:15:00
62,4,2,2,0.007782529236094188,2019-03-27 14:00:00,2019-03-27 14:15:00
66,1,1,0,0.003740336657813875,2019-03-27 14:00:00,2019-03-27 14:15:00
67,1,0,1,0.003005564591451576,2019-03-27 14:00:00,2019-03-27 14:15:00
68,2,1,1,0.0038572274438624147,2019-03-27 14:00:00,2019-03-27 14:15:00
69,1,0,1,0.003005564591451576,2019-03-27 14:00:00,2019-03-27 14:15:00
70,1,1,0,0.0038167011681448973,2019-03-27 14:00:00,2019-03-27 14:15:00
74,4,3,1,0.036994573200406916,2019-03-27 14:00:00,2019-03-27 14:15:00
79,1,1,0,0.005560553148684092,2019-03-27 14:00:00,2019-03-27 14:15:00
85,1,1,0,0.005032367404424486,2019-03-27 14:00:00,2019-03-27 14:15:00
87,1,1,0,0.009912139019294173,2019-03-27 14:00:00,2019-03-27 14:15:00
88,5,1,4,0.00464382877590198,2019-03-27 14:00:00,2019-03-27 14:15:00
89,2,0,2,0.003005564591451576,2019-03-27 14:00:00,2019-03-27 14:15:00
99,1,1,0,0.0038572274438624147,2019-03-27 14:00:00,2019-03-27 14:15:00
104,4,1,3,0.004283058870067834,2019-03-27 14:00:00,2019-03-27 14:15:00
106,2,2,0,0.008115541705916607,2019-03-27 14:00:00,2019-03-27 14:15:00
108,1,0,1,0.003005564591451576,2019-03-27 14:00:00,2019-03-27 14:15:00
109,4,2,2,0.006505625825299386,2019-03-27 14:00:00,2019-03-27 14:15:00
110,6,5,1,0.05354635740646975,2019-03-27 14:00:00,2019-03-27 14:15:00
112,3,1,2,0.010110159036006088,2019-03-27 14:00:00,2019-03-27 14:15:00
114,2,1,1,0.008357241353562262,2019-03-27 14:00:00,2019-03-27 14:15:00
115,2,2,0,0.007165209021180817,2019-03-27 14:00:00,2019-03-27 14:15:00
119,10,4,6,0.006974563749288128,2019-03-27 14:00:00,2019-03-27 14:15:00
120,5,4,1,0.009994765269591364,2019-03-27 14:00:00,2019-03-27 14:15:00
126,3,3,0,0.012042319587362266,2019-03-27 14:00:00,2019-03-27 14:15:00
127,5,3,2,0.0111528102452886,2019-03-27 14:00:00,2019-03-27 14:15:00
137,18,9,9,0.017343866311054928,2019-03-27 14:00:00,2019-03-27 14:15:00
138,15,4,11,0.009507319246514555,2019-03-27 14:00:00,2019-03-27 14:15:00
141,2,0,2,0.003005564591451576,2019-03-27 14:00:00,2019-03-27 14:15:00
147,3,2,1,0.03851105982649864,2019-03-27 14:00:00,2019-03-27 14:15:00
151,4,3,1,0.04083456530059076,2019-03-27 14:00:00,2019-03-27 14:15:00
153,3,0,3,0.003005564591451576,2019-03-27 14:00:00,2019-03-27 14:15:00
154,2,1,1,0.005032367404424486,2019-03-27 14:00:00,2019-03-27 14:15:00
157,3,1,2,0.005227540678861673,2019-03-27 14:00:00,2019-03-27 14:15:00
158,1,0,1,0.003005564591451576,2019-03-27 14:00:00,2019-03-27 14:15:00
161,2,1,1,0.020000068895929247,2019-03-27 14:00:00,2019-03-27 14:15:00
162,1,1,0,0.005560553148684092,2019-03-27 14:00:00,2019-03-27 14:15:00
164,3,2,1,0.005432893956212123,2019-03-27 14:00:00,2019-03-27 14:15:00
168,3,1,2,0.0047682745322946835,2019-03-27 14:00:00,2019-03-27 14:15:00
170,2,0,2,0.003005564591451576,2019-03-27 14:00:00,2019-03-27 14:15:00
171,1,1,0,0.003740336657813875,2019-03-27 14:00:00,2019-03-27 14:15:00
172,2,2,0,0.0068380474273003495,2019-03-27 14:00:00,2019-03-27 14:15:00
173,1,0,1,0.003005564591451576,2019-03-27 14:00:00,2019-03-27 14:15:00
189,3,0,3,0.003005564591451576,2019-03-27 14:00:00,2019-03-27 14:15:00
191,2,1,1,0.004219229273831849,2019-03-27 14:00:00,2019-03-27 14:15:00
195,2,0,2,0.003005564591451576,2019-03-27 14:00:00,2019-03-27 14:15:00
196,1,0,1,0.003005564591451576,2019-03-27 14:00:00,2019-03-27 14:15:00
199,1,1,0,0.0076240580200432895,2019-03-27 14:00:00,2019-03-27 14:15:00
201,3,3,0,0.005966381825898355,2019-03-27 14:00:00,2019-03-27 14:15:00
202,1,1,0,0.00464382877590198,2019-03-27 14:00:00,2019-03-27 14:15:00
203,2,0,2,0.003005564591451576,2019-03-27 14:00:00,2019-03-27 14:15:00
1,1,1,0,0.007203616697500446,2019-03-27 14:15:00,2019-03-27 14:30:00
2,4,2,2,0.006269003672481062,2019-03-27 14:15:00,2019-03-27 14:30:00
5,2,1,1,0.006277904476299213,2019-03-27 14:15:00,2019-03-27 14:30:00
10,1,1,0,0.008269348931387725,2019-03-27 14:15:00,2019-03-27 14:30:00
11,1,1,0,0.004464474487836726,2019-03-27 14:15:00,2019-03-27 14:30:00
15,3,2,1,0.00427625983202144,2019-03-27 14:15:00,2019-03-27 14:30:00
16,6,5,1,0.07632850152190696,2019-03-27 14:15:00,2019-03-27 14:30:00
18,2,1,1,0.00444762575660152,2019-03-27 14:15:00,2019-03-27 14:30:00
19,5,2,3,0.011805931952567308,2019-03-27 14:15:00,2019-03-27 14:30:00
20,3,1,2,0.003604363715112299,2019-03-27 14:15:00,2019-03-27 14:30:00
21,4,0,4,0.002932467598203158,2019-03-27 14:15:00,2019-03-27 14:30:00
22,1,0,1,0.002932467598203158,2019-03-27 14:15:00,2019-03-27 14:30:00
23,1,1,0,0.0043384018204034635,2019-03-27 14:15:00,2019-03-27 14:30:00
26,5,4,1,0.01438333531569984,2019-03-27 14:15:00,2019-03-27 14:30:00
27,3,1,2,0.009481560413112582,2019-03-27 14:15:00,2019-03-27 14:30:00
28,1,0,1,0.002932467598203158,2019-03-27 14:15:00,2019-03-27 14:30:00
37,6,3,3,0.009592713032611845,2019-03-27 14:15:00,2019-03-27 14:30:00
41,3,2,1,0.008971945126849845,2019-03-27 14:15:00,2019-03-27 14:30:00
46,4,0,4,0.002932467598203158,2019-03-27 14:15:00,2019-03-27 14:30:00
57,1,0,1,0.002932467598203158,2019-03-27 14:15:00,2019-03-27 14:30:00
58,2,0,2,0.002932467598203158,2019-03-27 14:15:00,2019-03-27 14:30:00
62,4,2,2,0.007918118243786593,2019-03-27 14:15:00,2019-03-27 14:30:00
66,1,1,0,0.0038302000932962385,2019-03-27 14:15:00,2019-03-27 14:30:00
67,3,2,1,0.006048499251692805,2019-03-27 14:15:00,2019-03-27 14:30:00
68,2,2,0,0.0053453582516946015,2019-03-27 14:15:00,2019-03-27 14:30:00
69,2,1,1,0.005764134706625413,2019-03-27 14:15:00,2019-03-27 14:30:00
70,1,1,0,0.003555673928901087,2019-03-27 14:15:00,2019-03-27 14:30:00
74,7,4,3,0.015198536371288946,2019-03-27 14:15:00,2019-03-27 14:30:00
79,1,1,0,0.005425292920994876,2019-03-27 14:15:00,2019-03-27 14:30:00
87,2,1,1,0.006713333064491041,2019-03-27 14:15:00,2019-03-27 14:30:00
88,2,0,2,0.002932467598203158,2019-03-27 14:15:00,2019-03-27 14:30:00
89,2,0,2,0.002932467598203158,2019-03-27 14:15:00,2019-03-27 14:30:00
90,3,3,0,0.007374509788626875,2019-03-27 14:15:00,2019-03-27 14:30:00
99,1,1,0,0.007203616697500446,2019-03-27 14:15:00,2019-03-27 14:30:00
104,3,1,2,0.008846791121113586,2019-03-27 14:15:00,2019-03-27 14:30:00
106,2,2,0,0.010325419293967485,2019-03-27 14:15:00,2019-03-27 14:30:00
108,1,0,1,0.002932467598203158,2019-03-27 14:15:00,2019-03-27 14:30:00
109,8,2,6,0.004462454120074342,2019-03-27 14:15:00,2019-03-27 14:30:00
110,2,2,0,0.008515606878422163,2019-03-27 14:15:00,2019-03-27 14:30:00
111,2,2,0,0.0041969756517593665,2019-03-27 14:15:00,2019-03-27 14:30:00
112,3,1,2,0.009376370447023632,2019-03-27 14:15:00,2019-03-27 14:30:00
113,1,1,0,0.005425292920994876,2019-03-27 14:15:00,2019-03-27 14:30:00
114,3,1,2,0.01515991103500511,2019-03-27 14:15:00,2019-03-27 14:30:00
115,2,2,0,0.007544428689604386,2019-03-27 14:15:00,2019-03-27 14:30:00
119,8,4,4,0.006010285263878578,2019-03-27 14:15:00,2019-03-27 14:30:00
120,3,2,1,0.005487109099648875,2019-03-27 14:15:00,2019-03-27 14:30:00
122,1,0,1,0.002932467598203158,2019-03-27 14:15:00,2019-03-27 14:30:00
126,3,2,1,0.007703950250408833,2019-03-27 14:15:00,2019-03-27 14:30:00
127,5,2,3,0.004961608151101393,2019-03-27 14:15:00,2019-03-27 14:30:00
129,2,1,1,0.01949552718665229,2019-03-27 14:15:00,2019-03-27 14:30:00
135,1,0,1,0.002932467598203158,2019-03-27 14:15:00,2019-03-27 14:30:00
137,11,3,8,0.006323025416087956,2019-03-27 14:15:00,2019-03-27 14:30:00
138,11,3,8,0.008448008991133921,2019-03-27 14:15:00,2019-03-27 14:30:00
140,1,0,1,0.002932467598203158,2019-03-27 14:15:00,2019-03-27 14:30:00
147,3,3,0,0.014803270217535403,2019-03-27 14:15:00,2019-03-27 14:30:00
151,4,3,1,0.008164435130658594,2019-03-27 14:15:00,2019-03-27 14:30:00
153,4,2,2,0.010048266563932772,2019-03-27 14:15:00,2019-03-27 14:30:00
154,1,1,0,0.012084093348663902,2019-03-27 14:15:00,2019-03-27 14:30:00
157,3,2,1,0.0360585867751014,2019-03-27 14:15:00,2019-03-27 14:30:00
158,1,0,1,0.002932467598203158,2019-03-27 14:15:00,2019-03-27 14:30:00
160,1,0,1,0.002932467598203158,2019-03-27 14:15:00,2019-03-27 14:30:00
161,2,1,1,0.01949552718665229,2019-03-27 14:15:00,2019-03-27 14:30:00
164,3,3,0,0.015117652352471887,2019-03-27 14:15:00,2019-03-27 14:30:00
168,6,4,2,0.02153028661499901,2019-03-27 14:15:00,2019-03-27 14:30:00
169,1,0,1,0.002932467598203158,2019-03-27 14:15:00,2019-03-27 14:30:00
170,3,1,2,0.0065676698339457145,2019-03-27 14:15:00,2019-03-27 14:30:00
171,4,2,2,0.006661867201718493,2019-03-27 14:15:00,2019-03-27 14:30:00
172,3,2,1,0.006957299810628445,2019-03-27 14:15:00,2019-03-27 14:30:00
173,1,0,1,0.002932467598203158,2019-03-27 14:15:00,2019-03-27 14:30:00
189,3,1,2,0.003564721624981262,2019-03-27 14:15:00,2019-03-27 14:30:00
191,2,2,0,0.009623341354395269,2019-03-27 14:15:00,2019-03-27 14:30:00
195,1,0,1,0.002932467598203158,2019-03-27 14:15:00,2019-03-27 14:30:00
196,1,0,1,0.002932467598203158,2019-03-27 14:15:00,2019-03-27 14:30:00
201,1,1,0,0.004178880259599017,2019-03-27 14:15:00,2019-03-27 14:30:00
202,1,1,0,0.003604363715112299,2019-03-27 14:15:00,2019-03-27 14:30:00
203,4,1,3,0.004091976485573578,2019-03-27 14:15:00,2019-03-27 14:30:00
1,1,1,0,0.007718719386545211,2019-03-27 14:30:00,2019-03-27 14:45:00
2,3,1,2,0.004150454878071126,2019-03-27 14:30:00,2019-03-27 14:45:00
5,1,0,1,0.0029743831209096947,2019-03-27 14:30:00,2019-03-27 14:45:00
10,2,1,1,0.005502825359308631,2019-03-27 14:30:00,2019-03-27 14:45:00
11,1,1,0,0.006471821513342085,2019-03-27 14:30:00,2019-03-27 14:45:00
15,5,4,1,0.009199801584712154,2019-03-27 14:30:00,2019-03-27 14:45:00
16,5,2,3,0.005741022208394734,2019-03-27 14:30:00,2019-03-27 14:45:00
18,7,3,4,0.011675644142561602,2019-03-27 14:30:00,2019-03-27 14:45:00
19,4,2,2,0.00947514367110354,2019-03-27 14:30:00,2019-03-27 14:45:00
20,2,1,1,0.004114222676560116,2019-03-27 14:30:00,2019-03-27 14:45:00
21,1,0,1,0.0029743831209096947,2019-03-27 14:30:00,2019-03-27 14:45:00
22,1,0,1,0.0029743831209096947,2019-03-27 14:30:00,2019-03-27 14:45:00
23,1,1,0,0.0038487427190177924,2019-03-27 14:30:00,2019-03-27 14:45:00
26,2,1,1,0.005502825359308631,2019-03-27 14:30:00,2019-03-27 14:45:00
27,1,1,0,0.005313302953182199,2019-03-27 14:30:00,2019-03-27 14:45:00
28,1,1,0,0.003792317412612965,2019-03-27 14:30:00,2019-03-27 14:45:00
37,6,5,1,0.04390318056541246,2019-03-27 14:30:00,2019-03-27 14:45:00
41,5,2,3,0.010247161624944146,2019-03-27 14:30:00,2019-03-27 14:45:00
46,3,2,1,0.016371891795860148,2019-03-27 14:30:00,2019-03-27 14:45:00
50,1,0,1,0.0029743831209096947,2019-03-27 14:30:00,2019-03-27 14:45:00
57,3,2,1,0.016192371151998654,2019-03-27 14:30:00,2019-03-27 14:45:00
58,6,3,3,0.0064331725899650725,2019-03-27 14:30:00,2019-03-27 14:45:00
61,1,0,1,0.0029743831209096947,2019-03-27 14:30:00,2019-03-27 14:45:00
62,1,1,0,0.003792317412612965,2019-03-27 14:30:00,2019-03-27 14:45:00
67,3,3,0,0.024851008444779926,2019-03-27 14:30:00,2019-03-27 14:45:00
68,1,1,0,0.003598336305893559,2019-03-27 14:30:00,2019-03-27 14:45:00
69,4,2,2,0.008031267597707567,2019-03-27 14:30:00,2019-03-27 14:45:00
70,1,0,1,0.0029743831209096947,2019-03-27 14:30:00,2019-03-27 14:45:00
74,3,1,2,0.005173225672304584,2019-03-27 14:30:00,2019-03-27 14:45:00
79,1,1,0,0.005502825359308631,2019-03-27 14:30:00,2019-03-27 14:45:00
85,2,1,1,0.003598336305893559,2019-03-27 14:30:00,2019-03-27 14:45:00
86,1,0,1,0.0029743831209096947,2019-03-27 14:30:00,2019-03-27 14:45:00
87,3,1,2,0.005455737422518994,2019-03-27 14:30:00,2019-03-27 14:45:00
88,2,1,1,0.006246120287722775,2019-03-27 14:30:00,2019-03-27 14:45:00
89,3,1,2,0.004114222676560116,2019-03-27 14:30:00,2019-03-27 14:45:00
90,2,1,1,0.0038487427190177924,2019-03-27 14:30:00,2019-03-27 14:45:00
99,3,1,2,0.005173225672304584,2019-03-27 14:30:00,2019-03-27 14:45:00
104,1,1,0,0.005502825359308631,2019-03-27 14:30:00,2019-03-27 14:45:00
106,2,1,1,0.006388001666255234,2019-03-27 14:30:00,2019-03-27 14:45:00
108,7,3,4,0.008207114179472409,2019-03-27 14:30:00,2019-03-27 14:45:00
109,6,1,5,0.004738490756651842,2019-03-27 14:30:00,2019-03-27 14:45:00
111,3,2,1,0.004585623836120484,2019-03-27 14:30:00,2019-03-27 14:45:00
112,3,1,2,0.006226910146896187,2019-03-27 14:30:00,2019-03-27 14:45:00
113,2,2,0,0.010247161624944148,2019-03-27 14:30:00,2019-03-27 14:45:00
114,3,1,2,0.007652222785454703,2019-03-27 14:30:00,2019-03-27 14:45:00
115,4,3,1,0.011685524953098273,2019-03-27 14:30:00,2019-03-27 14:45:00
116,2,2,0,0.01231430873921402,2019-03-27 14:30:00,2019-03-27 14:45:00
118,1,1,0,0.005502825359308631,2019-03-27 14:30:00,2019-03-27 14:45:00
119,5,1,4,0.004114222676560116,2019-03-27 14:30:00,2019-03-27 14:45:00
120,1,1,0,0.003780003478515089,2019-03-27 14:30:00,2019-03-27 14:45:00
122,1,1,0,0.005455737422518994,2019-03-27 14:30:00,2019-03-27 14:45:00
126,3,1,2,0.005502825359308631,2019-03-27 14:30:00,2019-03-27 14:45:00
127,2,1,1,0.019765842012456954,2019-03-27 14:30:00,2019-03-27 14:45:00
135,1,0,1,0.0029743831209096947,2019-03-27 14:30:00,2019-03-27 14:45:00
137,14,4,10,0.013408352705735108,2019-03-27 14:30:00,2019-03-27 14:45:00
138,7,6,1,0.014419210683392554,2019-03-27 14:30:00,2019-03-27 14:45:00
140,1,1,0,0.004114222676560116,2019-03-27 14:30:00,2019-03-27 14:45:00
141,1,0,1,0.0029743831209096947,2019-03-27 14:30:00,2019-03-27 14:45:00
147,1,1,0,0.005173225672304584,2019-03-27 14:30:00,2019-03-27 14:45:00
151,1,1,0,0.005621098186773154,2019-03-27 14:30:00,2019-03-27 14:45:00
153,6,3,3,0.016742589436243377,2019-03-27 14:30:00,2019-03-27 14:45:00
154,2,1,1,0.008235401846900038,2019-03-27 14:30:00,2019-03-27 14:45:00
156,1,0,1,0.0029743831209096947,2019-03-27 14:30:00,2019-03-27 14:45:00
157,5,2,3,0.02333931287291525,2019-03-27 14:30:00,2019-03-27 14:45:00
158,5,1,4,0.0038487427190177924,2019-03-27 14:30:00,2019-03-27 14:45:00
160,1,0,1,0.0029743831209096947,2019-03-27 14:30:00,2019-03-27 14:45:00
161,2,1,1,0.019765842012456954,2019-03-27 14:30:00,2019-03-27 14:45:00
164,1,1,0,0.005455737422518994,2019-03-27 14:30:00,2019-03-27 14:45:00
168,5,3,2,0.012377262553215874,2019-03-27 14:30:00,2019-03-27 14:45:00
170,1,1,0,0.010795133828928029,2019-03-27 14:30:00,2019-03-27 14:45:00
171,1,0,1,0.0029743831209096947,2019-03-27 14:30:00,2019-03-27 14:45:00
172,4,1,3,0.004150454878071126,2019-03-27 14:30:00,2019-03-27 14:45:00
189,8,2,6,0.004403956663498953,2019-03-27 14:30:00,2019-03-27 14:45:00
190,2,2,0,0.015107216979127413,2019-03-27 14:30:00,2019-03-27 14:45:00
191,3,2,1,0.011029112880350517,2019-03-27 14:30:00,2019-03-27 14:45:00
195,1,0,1,0.0029743831209096947,2019-03-27 14:30:00,2019-03-27 14:45:00
200,1,1,0,0.005502825359308631,2019-03-27 14:30:00,2019-03-27 14:45:00
201,1,1,0,0.005455737422518994,2019-03-27 14:30:00,2019-03-27 14:45:00
202,1,1,0,0.004114222676560116,2019-03-27 14:30:00,2019-03-27 14:45:00
203,2,1,1,0.019765842012456954,2019-03-27 14:30:00,2019-03-27 14:45:00
1,1,1,0,0.005189157380896863,2019-03-27 14:45:00,2019-03-27 15:00:00
2,2,1,1,0.004267396847087353,2019-03-27 14:45:00,2019-03-27 15:00:00
5,3,3,0,0.009119170722259986,2019-03-27 14:45:00,2019-03-27 15:00:00
10,1,0,1,0.0029945920534465726,2019-03-27 14:45:00,2019-03-27 15:00:00
15,7,4,3,0.010107739739216555,2019-03-27 14:45:00,2019-03-27 15:00:00
16,15,8,7,0.01618507100760707,2019-03-27 14:45:00,2019-03-27 15:00:00
18,8,4,4,0.010654340755198262,2019-03-27 14:45:00,2019-03-27 15:00:00
19,1,1,0,0.0055402016407281336,2019-03-27 14:45:00,2019-03-27 15:00:00
20,2,2,0,0.006528408563268944,2019-03-27 14:45:00,2019-03-27 15:00:00
21,2,0,2,0.0029945920534465726,2019-03-27 14:45:00,2019-03-27 15:00:00
23,4,3,1,0.009082524045926754,2019-03-27 14:45:00,2019-03-27 15:00:00
26,3,2,1,0.008085811228009694,2019-03-27 14:45:00,2019-03-27 15:00:00
28,2,2,0,0.006847812482874926,2019-03-27 14:45:00,2019-03-27 15:00:00
37,7,4,3,0.006990298295077966,2019-03-27 14:45:00,2019-03-27 15:00:00
40,1,0,1,0.0029945920534465726,2019-03-27 14:45:00,2019-03-27 15:00:00
41,7,3,4,0.008583303497272278,2019-03-27 14:45:00,2019-03-27 15:00:00
46,5,3,2,0.023124878087261866,2019-03-27 14:45:00,2019-03-27 15:00:00
50,3,2,1,0.009719313241254876,2019-03-27 14:45:00,2019-03-27 15:00:00
57,1,1,0,0.00524708561563493,2019-03-27 14:45:00,2019-03-27 15:00:00
58,3,1,2,0.005208349328236607,2019-03-27 14:45:00,2019-03-27 15:00:00
61,1,0,1,0.0029945920534465726,2019-03-27 14:45:00,2019-03-27 15:00:00
62,2,1,1,0.004988722490519969,2019-03-27 14:45:00,2019-03-27 15:00:00
66,2,1,1,0.0058587678236421805,2019-03-27 14:45:00,2019-03-27 15:00:00
67,2,2,0,0.01834375632123704,2019-03-27 14:45:00,2019-03-27 15:00:00
68,1,0,1,0.0029945920534465726,2019-03-27 14:45:00,2019-03-27 15:00:00
69,4,2,2,0.010520680544015143,2019-03-27 14:45:00,2019-03-27 15:00:00
70,1,1,0,0.0055402016407281336,2019-03-27 14:45:00,2019-03-27 15:00:00
74,3,1,2,0.005208349328236607,2019-03-27 14:45:00,2019-03-27 15:00:00
85,2,1,1,0.00524708561563493,2019-03-27 14:45:00,2019-03-27 15:00:00
86,2,0,2,0.0029945920534465726,2019-03-27 14:45:00,2019-03-27 15:00:00
87,4,0,4,0.0029945920534465726,2019-03-27 14:45:00,2019-03-27 15:00:00
88,1,0,1,0.0029945920534465726,2019-03-27 14:45:00,2019-03-27 15:00:00
89,6,2,4,0.0049510536852992995,2019-03-27 14:45:00,2019-03-27 15:00:00
90,2,2,0,0.007178827058674517,2019-03-27 14:45:00,2019-03-27 15:00:00
99,3,1,2,0.005208349328236607,2019-03-27 14:45:00,2019-03-27 15:00:00
104,1,0,1,0.0029945920534465726,2019-03-27 14:45:00,2019-03-27 15:00:00
106,4,2,2,0.012986172187484147,2019-03-27 14:45:00,2019-03-27 15:00:00
108,1,0,1,0.0029945920534465726,2019-03-27 14:45:00,2019-03-27 15:00:00
109,5,4,1,0.020962714704975217,2019-03-27 14:45:00,2019-03-27 15:00:00
110,6,1,5,0.0037383678153574316,2019-03-27 14:45:00,2019-03-27 15:00:00
111,9,3,6,0.006647936630687162,2019-03-27 14:45:00,2019-03-27 15:00:00
112,2,1,1,0.011383361849753528,2019-03-27 14:45:00,2019-03-27 15:00:00
113,1,1,0,0.0055402016407281336,2019-03-27 14:45:00,2019-03-27 15:00:00
114,2,1,1,0.00986815550132383,2019-03-27 14:45:00,2019-03-27 15:00:00
115,4,3,1,0.008466971314771043,2019-03-27 14:45:00,2019-03-27 15:00:00
116,1,1,0,0.004853682045801529,2019-03-27 14:45:00,2019-03-27 15:00:00
118,2,2,0,0.0055402016407281336,2019-03-27 14:45:00,2019-03-27 15:00:00
119,5,1,4,0.0038431285825404264,2019-03-27 14:45:00,2019-03-27 15:00:00
120,2,2,0,0.021631892530478466,2019-03-27 14:45:00,2019-03-27 15:00:00
122,5,3,2,0.024053686854062423,2019-03-27 14:45:00,2019-03-27 15:00:00
126,3,2,1,0.013080999763568857,2019-03-27 14:45:00,2019-03-27 15:00:00
127,3,0,3,0.0029945920534465726,2019-03-27 14:45:00,2019-03-27 15:00:00
137,10,4,6,0.009317053088490158,2019-03-27 14:45:00,2019-03-27 15:00:00
138,5,4,1,0.02062982858053576,2019-03-27 14:45:00,2019-03-27 15:00:00
140,2,2,0,0.005611771099195565,2019-03-27 14:45:00,2019-03-27 15:00:00
141,3,0,3,0.0029945920534465726,2019-03-27 14:45:00,2019-03-27 15:00:00
147,1,0,1,0.0029945920534465726,2019-03-27 14:45:00,2019-03-27 15:00:00
153,4,2,2,0.005163187817572763,2019-03-27 14:45:00,2019-03-27 15:00:00
154,4,2,2,0.004373944730753398,2019-03-27 14:45:00,2019-03-27 15:00:00
156,1,0,1,0.0029945920534465726,2019-03-27 14:45:00,2019-03-27 15:00:00
157,5,2,3,0.006911572329545088,2019-03-27 14:45:00,2019-03-27 15:00:00
158,4,2,2,0.00469166511163428,2019-03-27 14:45:00,2019-03-27 15:00:00
160,1,0,1,0.0029945920534465726,2019-03-27 14:45:00,2019-03-27 15:00:00
161,2,1,1,0.01984754956705812,2019-03-27 14:45:00,2019-03-27 15:00:00
164,4,2,2,0.006200766682021945,2019-03-27 14:45:00,2019-03-27 15:00:00
168,7,2,5,0.004374770212177822,2019-03-27 14:45:00,2019-03-27 15:00:00
169,1,1,0,0.003936483755077407,2019-03-27 14:45:00,2019-03-27 15:00:00
170,1,1,0,0.0049753687023751745,2019-03-27 14:45:00,2019-03-27 15:00:00
172,2,0,2,0.0029945920534465726,2019-03-27 14:45:00,2019-03-27 15:00:00
173,2,2,0,0.02183567446806145,2019-03-27 14:45:00,2019-03-27 15:00:00
175,2,1,1,0.01984754956705812,2019-03-27 14:45:00,2019-03-27 15:00:00
189,7,4,3,0.00794924773941139,2019-03-27 14:45:00,2019-03-27 15:00:00
190,2,2,0,0.012406010753655598,2019-03-27 14:45:00,2019-03-27 15:00:00
191,1,0,1,0.0029945920534465726,2019-03-27 14:45:00,2019-03-27 15:00:00
195,3,1,2,0.005208349328236607,2019-03-27 14:45:00,2019-03-27 15:00:00
200,1,1,0,0.004267396847087353,2019-03-27 14:45:00,2019-03-27 15:00:00
201,1,1,0,0.0052588749803911105,2019-03-27 14:45:00,2019-03-27 15:00:00
203,2,1,1,0.01984754956705812,2019-03-27 14:45:00,2019-03-27 15:00:00
1,1,1,0,0.0028106801594203483,2019-03-27 15:00:00,2019-03-27 15:15:00
2,4,2,2,0.006702514293862802,2019-03-27 15:00:00,2019-03-27 15:15:00
5,6,5,1,0.0734613532472929,2019-03-27 15:00:00,2019-03-27 15:15:00
10,2,1,1,0.014570533388069178,2019-03-27 15:00:00,2019-03-27 15:15:00
15,4,3,1,0.013989915625330753,2019-03-27 15:00:00,2019-03-27 15:15:00
16,6,5,1,0.01508414112982785,2019-03-27 15:00:00,2019-03-27 15:15:00
18,11,6,5,0.02978785364437327,2019-03-27 15:00:00,2019-03-27 15:15:00
19,7,5,2,0.009966130438473593,2019-03-27 15:00:00,2019-03-27 15:15:00
20,1,1,0,0.004051802599571844,2019-03-27 15:00:00,2019-03-27 15:15:00
21,2,0,2,0.002190118939344601,2019-03-27 15:00:00,2019-03-27 15:15:00
23,9,2,7,0.007115585057808545,2019-03-27 15:00:00,2019-03-27 15:15:00
27,1,0,1,0.002190118939344601,2019-03-27 15:00:00,2019-03-27 15:15:00
28,3,2,1,0.010180810971284662,2019-03-27 15:00:00,2019-03-27 15:15:00
37,7,4,3,0.007638461904489037,2019-03-27 15:00:00,2019-03-27 15:15:00
40,2,0,2,0.002190118939344601,2019-03-27 15:00:00,2019-03-27 15:15:00
41,5,2,3,0.008978123437422027,2019-03-27 15:00:00,2019-03-27 15:15:00
46,4,3,1,0.01242654735400657,2019-03-27 15:00:00,2019-03-27 15:15:00
50,1,1,0,0.004933176494836073,2019-03-27 15:00:00,2019-03-27 15:15:00
57,2,2,0,0.00804514114857818,2019-03-27 15:00:00,2019-03-27 15:15:00
62,2,1,1,0.0033300115261833364,2019-03-27 15:00:00,2019-03-27 15:15:00
66,3,0,3,0.002190118939344601,2019-03-27 15:00:00,2019-03-27 15:15:00
67,2,2,0,0.004051802599571844,2019-03-27 15:00:00,2019-03-27 15:15:00
68,3,3,0,0.017667124351924027,2019-03-27 15:00:00,2019-03-27 15:15:00
69,3,3,0,0.006700565991908696,2019-03-27 15:00:00,2019-03-27 15:15:00
70,1,1,0,0.003829442401890003,2019-03-27 15:00:00,2019-03-27 15:15:00
74,4,2,2,0.006660197347483913,2019-03-27 15:00:00,2019-03-27 15:15:00
85,9,2,7,0.022585742049055824,2019-03-27 15:00:00,2019-03-27 15:15:00
86,1,0,1,0.002190118939344601,2019-03-27 15:00:00,2019-03-27 15:15:00
87,2,1,1,0.0033300115261833364,2019-03-27 15:00:00,2019-03-27 15:15:00
88,5,2,3,0.007491542327926517,2019-03-27 15:00:00,2019-03-27 15:15:00
89,5,2,3,0.007887870815558844,2019-03-27 15:00:00,2019-03-27 15:15:00
90,5,4,1,0.020764343594435363,2019-03-27 15:00:00,2019-03-27 15:15:00
99,3,1,2,0.0038090487085271647,2019-03-27 15:00:00,2019-03-27 15:15:00
106,4,2,2,0.014570533388069178,2019-03-27 15:00:00,2019-03-27 15:15:00
108,1,0,1,0.002190118939344601,2019-03-27 15:00:00,2019-03-27 15:15:00
109,10,6,4,0.024036787963311695,2019-03-27 15:00:00,2019-03-27 15:15:00
110,8,2,6,0.0075661039662343514,2019-03-27 15:00:00,2019-03-27 15:15:00
111,9,2,7,0.017248351417712474,2019-03-27 15:00:00,2019-03-27 15:15:00
112,6,3,3,0.014586301951052889,2019-03-27 15:00:00,2019-03-27 15:15:00
114,4,2,2,0.020929242455591086,2019-03-27 15:00:00,2019-03-27 15:15:00
115,7,5,2,0.021166032309088395,2019-03-27 15:00:00,2019-03-27 15:15:00
118,3,2,1,0.004051802599571844,2019-03-27 15:00:00,2019-03-27 15:15:00
119,8,5,3,0.005780046664036219,2019-03-27 15:00:00,2019-03-27 15:15:00
120,1,1,0,0.0028106801594203483,2019-03-27 15:00:00,2019-03-27 15:15:00
122,1,1,0,0.003262105880810522,2019-03-27 15:00:00,2019-03-27 15:15:00
126,1,1,0,0.004456777911140896,2019-03-27 15:00:00,2019-03-27 15:15:00
127,3,1,2,0.007254810413717055,2019-03-27 15:00:00,2019-03-27 15:15:00
129,1,0,1,0.002190118939344601,2019-03-27 15:00:00,2019-03-27 15:15:00
133,1,0,1,0.002190118939344601,2019-03-27 15:00:00,2019-03-27 15:15:00
137,9,4,5,0.015589838918848974,2019-03-27 15:00:00,2019-03-27 15:15:00
138,6,2,4,0.008446528206504027,2019-03-27 15:00:00,2019-03-27 15:15:00
140,1,0,1,0.002190118939344601,2019-03-27 15:00:00,2019-03-27 15:15:00
141,3,0,3,0.002190118939344601,2019-03-27 15:00:00,2019-03-27 15:15:00
147,3,1,2,0.003857034377981731,2019-03-27 15:00:00,2019-03-27 15:15:00
153,3,0,3,0.002190118939344601,2019-03-27 15:00:00,2019-03-27 15:15:00
154,5,3,2,0.005332840297762879,2019-03-27 15:00:00,2019-03-27 15:15:00
156,4,2,2,0.003921957118511768,2019-03-27 15:00:00,2019-03-27 15:15:00
157,5,3,2,0.01746657298069137,2019-03-27 15:00:00,2019-03-27 15:15:00
158,5,3,2,0.01346620262897022,2019-03-27 15:00:00,2019-03-27 15:15:00
161,2,1,1,0.014570533388069178,2019-03-27 15:00:00,2019-03-27 15:15:00
164,8,6,2,0.014668106917040253,2019-03-27 15:00:00,2019-03-27 15:15:00
168,11,3,8,0.010726976824264383,2019-03-27 15:00:00,2019-03-27 15:15:00
170,3,1,2,0.0043545954347184584,2019-03-27 15:00:00,2019-03-27 15:15:00
172,1,0,1,0.002190118939344601,2019-03-27 15:00:00,2019-03-27 15:15:00
173,4,3,1,0.01608442519989012,2019-03-27 15:00:00,2019-03-27 15:15:00
175,2,1,1,0.014570533388069178,2019-03-27 15:00:00,2019-03-27 15:15:00
189,7,5,2,0.012310072794850507,2019-03-27 15:00:00,2019-03-27 15:15:00
190,3,2,1,0.01280605356456294,2019-03-27 15:00:00,2019-03-27 15:15:00
191,2,1,1,0.007254810413717055,2019-03-27 15:00:00,2019-03-27 15:15:00
195,4,1,3,0.0030560380289281846,2019-03-27 15:00:00,2019-03-27 15:15:00
196,3,1,2,0.0038090487085271647,2019-03-27 15:00:00,2019-03-27 15:15:00
200,2,0,2,0.002190118939344601,2019-03-27 15:00:00,2019-03-27 15:15:00
203,2,1,1,0.014570533388069178,2019-03-27 15:00:00,2019-03-27 15:15:00
1,1,1,0,0.0030406983442128974,2019-03-27 15:15:00,2019-03-27 15:30:00
2,6,3,3,0.007392548732213184,2019-03-27 15:15:00,2019-03-27 15:30:00
5,7,6,1,0.0751709569761964,2019-03-27 15:15:00,2019-03-27 15:30:00
15,3,2,1,0.014659300711348643,2019-03-27 15:15:00,2019-03-27 15:30:00
16,3,3,0,0.00907511176245644,2019-03-27 15:15:00,2019-03-27 15:30:00
18,12,8,4,0.015518481239674906,2019-03-27 15:15:00,2019-03-27 15:30:00
19,10,4,6,0.014965837847319915,2019-03-27 15:15:00,2019-03-27 15:30:00
20,3,1,2,0.006200841961797909,2019-03-27 15:15:00,2019-03-27 15:30:00
21,1,0,1,0.0023891172703225006,2019-03-27 15:15:00,2019-03-27 15:30:00
23,11,6,5,0.01141615867675156,2019-03-27 15:15:00,2019-03-27 15:30:00
27,2,1,1,0.004483931378974475,2019-03-27 15:15:00,2019-03-27 15:30:00
28,2,1,1,0.0034488276479828777,2019-03-27 15:15:00,2019-03-27 15:30:00
30,3,2,1,0.014361907222180777,2019-03-27 15:15:00,2019-03-27 15:30:00
35,2,0,2,0.0023891172703225006,2019-03-27 15:15:00,2019-03-27 15:30:00
37,2,1,1,0.015872348673862252,2019-03-27 15:15:00,2019-03-27 15:30:00
40,4,1,3,0.00333373683230676,2019-03-27 15:15:00,2019-03-27 15:30:00
41,2,2,0,0.005676310918586121,2019-03-27 15:15:00,2019-03-27 15:30:00
46,6,3,3,0.007959757503902723,2019-03-27 15:15:00,2019-03-27 15:30:00
57,4,2,2,0.005186489447730442,2019-03-27 15:15:00,2019-03-27 15:30:00
61,2,2,0,0.005161113782560506,2019-03-27 15:15:00,2019-03-27 15:30:00
62,2,1,1,0.004304535599147869,2019-03-27 15:15:00,2019-03-27 15:30:00
64,1,1,0,0.006609466920849334,2019-03-27 15:15:00,2019-03-27 15:30:00
66,3,2,1,0.011344700759562627,2019-03-27 15:15:00,2019-03-27 15:30:00
67,3,3,0,0.005435422596093998,2019-03-27 15:15:00,2019-03-27 15:30:00
68,5,4,1,0.011308209126613334,2019-03-27 15:15:00,2019-03-27 15:30:00
69,4,3,1,0.020588379035794337,2019-03-27 15:15:00,2019-03-27 15:30:00
70,2,1,1,0.004964632217745683,2019-03-27 15:15:00,2019-03-27 15:30:00
74,4,2,2,0.008634886881841783,2019-03-27 15:15:00,2019-03-27 15:30:00
85,4,2,2,0.010322837073123621,2019-03-27 15:15:00,2019-03-27 15:30:00
87,9,2,7,0.003155502023256076,2019-03-27 15:15:00,2019-03-27 15:30:00
88,4,3,1,0.013455984870024343,2019-03-27 15:15:00,2019-03-27 15:30:00
89,8,4,4,0.01144243641420569,2019-03-27 15:15:00,2019-03-27 15:30:00
90,8,5,3,0.025796625071542158,2019-03-27 15:15:00,2019-03-27 15:30:00
99,1,0,1,0.0023891172703225006,2019-03-27 15:15:00,2019-03-27 15:30:00
106,5,2,3,0.02775926499611998,2019-03-27 15:15:00,2019-03-27 15:30:00
108,1,1,0,0.010255936173938772,2019-03-27 15:15:00,2019-03-27 15:30:00
109,5,0,5,0.0023891172703225006,2019-03-27 15:15:00,2019-03-27 15:30:00
110,6,3,3,0.00830319537109705,2019-03-27 15:15:00,2019-03-27 15:30:00
111,9,2,7,0.005132873578972531,2019-03-27 15:15:00,2019-03-27 15:30:00
112,6,3,3,0.017043534253256994,2019-03-27 15:15:00,2019-03-27 15:30:00
114,4,2,2,0.011190519227300962,2019-03-27 15:15:00,2019-03-27 15:30:00
115,5,4,1,0.007610401481562459,2019-03-27 15:15:00,2019-03-27 15:30:00
116,2,2,0,0.007145145283043332,2019-03-27 15:15:00,2019-03-27 15:30:00
118,2,1,1,0.012002593447578125,2019-03-27 15:15:00,2019-03-27 15:30:00
119,5,3,2,0.008301869488057107,2019-03-27 15:15:00,2019-03-27 15:30:00
120,2,2,0,0.0037662341931270285,2019-03-27 15:15:00,2019-03-27 15:30:00
122,2,1,1,0.009681006885977143,2019-03-27 15:15:00,2019-03-27 15:30:00
126,1,1,0,0.004404682881035477,2019-03-27 15:15:00,2019-03-27 15:30:00
129,1,0,1,0.0023891172703225006,2019-03-27 15:15:00,2019-03-27 15:30:00
133,1,0,1,0.0023891172703225006,2019-03-27 15:15:00,2019-03-27 15:30:00
135,2,2,0,0.003404552378913,2019-03-27 15:15:00,2019-03-27 15:30:00
137,14,7,7,0.015465446131947053,2019-03-27 15:15:00,2019-03-27 15:30:00
138,4,2,2,0.01865868664817424,2019-03-27 15:15:00,2019-03-27 15:30:00
140,6,1,5,0.004267361603924072,2019-03-27 15:15:00,2019-03-27 15:30:00
141,4,3,1,0.008577451400815264,2019-03-27 15:15:00,2019-03-27 15:30:00
147,3,1,2,0.006059371934418601,2019-03-27 15:15:00,2019-03-27 15:30:00
151,1,1,0,0.004419987487503499,2019-03-27 15:15:00,2019-03-27 15:30:00
153,5,1,4,0.0030660740093828333,2019-03-27 15:15:00,2019-03-27 15:30:00
154,3,1,2,0.004741997335719794,2019-03-27 15:15:00,2019-03-27 15:30:00
156,3,2,1,0.003404552378913,2019-03-27 15:15:00,2019-03-27 15:30:00
157,4,2,2,0.004861633166376021,2019-03-27 15:15:00,2019-03-27 15:30:00
158,5,2,3,0.0037399108757429594,2019-03-27 15:15:00,2019-03-27 15:30:00
161,2,1,1,0.015872348673862252,2019-03-27 15:15:00,2019-03-27 15:30:00
162,1,1,0,0.0042677334964838845,2019-03-27 15:15:00,2019-03-27 15:30:00
164,8,3,5,0.009190701102641034,2019-03-27 15:15:00,2019-03-27 15:30:00
168,9,4,5,0.011265760657902378,2019-03-27 15:15:00,2019-03-27 15:30:00
170,1,0,1,0.0023891172703225006,2019-03-27 15:15:00,2019-03-27 15:30:00
172,1,1,0,0.014598480928734985,2019-03-27 15:15:00,2019-03-27 15:30:00
173,7,4,3,0.019420047632180287,2019-03-27 15:15:00,2019-03-27 15:30:00
189,4,1,3,0.0027723096467892885,2019-03-27 15:15:00,2019-03-27 15:30:00
190,3,1,2,0.004419987487503499,2019-03-27 15:15:00,2019-03-27 15:30:00
191,1,1,0,0.005687166538219674,2019-03-27 15:15:00,2019-03-27 15:30:00
195,4,0,4,0.0023891172703225006,2019-03-27 15:15:00,2019-03-27 15:30:00
196,3,0,3,0.0023891172703225006,2019-03-27 15:15:00,2019-03-27 15:30:00
197,3,1,2,0.004155200053217872,2019-03-27 15:15:00,2019-03-27 15:30:00
200,2,0,2,0.0023891172703225006,2019-03-27 15:15:00,2019-03-27 15:30:00
201,1,1,0,0.00333373683230676,2019-03-27 15:15:00,2019-03-27 15:30:00
203,3,1,2,0.004155200053217872,2019-03-27 15:15:00,2019-03-27 15:30:00
1,1,1,0,0.006371365424181102,2019-03-27 15:30:00,2019-03-27 15:45:00
2,3,2,1,0.010148441756541582,2019-03-27 15:30:00,2019-03-27 15:45:00
5,8,5,3,0.014358728870645519,2019-03-27 15:30:00,2019-03-27 15:45:00
16,4,4,0,0.006732113167568541,2019-03-27 15:30:00,2019-03-27 15:45:00
18,10,8,2,0.011390175116378073,2019-03-27 15:30:00,2019-03-27 15:45:00
19,9,3,6,0.011122729120512214,2019-03-27 15:30:00,2019-03-27 15:45:00
20,4,0,4,0.0030257677492149327,2019-03-27 15:30:00,2019-03-27 15:45:00
21,1,0,1,0.0030257677492149327,2019-03-27 15:30:00,2019-03-27 15:45:00
23,11,7,4,0.022118758775675717,2019-03-27 15:30:00,2019-03-27 15:45:00
26,1,0,1,0.0030257677492149327,2019-03-27 15:30:00,2019-03-27 15:45:00
27,2,2,0,0.012656160439996818,2019-03-27 15:30:00,2019-03-27 15:45:00
30,4,3,1,0.014386284784761083,2019-03-27 15:30:00,2019-03-27 15:45:00
35,3,0,3,0.0030257677492149327,2019-03-27 15:30:00,2019-03-27 15:45:00
37,2,1,1,0.019996181564219548,2019-03-27 15:30:00,2019-03-27 15:45:00
40,3,1,2,0.003883138629053248,2019-03-27 15:30:00,2019-03-27 15:45:00
41,3,3,0,0.00767458327664288,2019-03-27 15:30:00,2019-03-27 15:45:00
46,5,2,3,0.006983526304859214,2019-03-27 15:30:00,2019-03-27 15:45:00
57,3,0,3,0.0030257677492149327,2019-03-27 15:30:00,2019-03-27 15:45:00
58,7,3,4,0.0115393711296057,2019-03-27 15:30:00,2019-03-27 15:45:00
61,2,2,0,0.007947269947462688,2019-03-27 15:30:00,2019-03-27 15:45:00
62,1,1,0,0.012061671032435144,2019-03-27 15:30:00,2019-03-27 15:45:00
64,1,1,0,0.0055978803887298785,2019-03-27 15:30:00,2019-03-27 15:45:00
66,4,3,1,0.007143652238251329,2019-03-27 15:30:00,2019-03-27 15:45:00
67,3,3,0,0.014111655845630993,2019-03-27 15:30:00,2019-03-27 15:45:00
68,1,1,0,0.004601672272496519,2019-03-27 15:30:00,2019-03-27 15:45:00
69,3,2,1,0.008404849316317216,2019-03-27 15:30:00,2019-03-27 15:45:00
70,1,0,1,0.0030257677492149327,2019-03-27 15:30:00,2019-03-27 15:45:00
74,3,1,2,0.005262573023111757,2019-03-27 15:30:00,2019-03-27 15:45:00
85,2,0,2,0.0030257677492149327,2019-03-27 15:30:00,2019-03-27 15:45:00
88,1,1,0,0.003964209162234156,2019-03-27 15:30:00,2019-03-27 15:45:00
89,6,2,4,0.005262573023111757,2019-03-27 15:30:00,2019-03-27 15:45:00
90,6,3,3,0.010280508819186464,2019-03-27 15:30:00,2019-03-27 15:45:00
106,3,1,2,0.010170771101198716,2019-03-27 15:30:00,2019-03-27 15:45:00
108,1,1,0,0.007348894729963,2019-03-27 15:30:00,2019-03-27 15:45:00
109,2,0,2,0.0030257677492149327,2019-03-27 15:30:00,2019-03-27 15:45:00
110,9,6,3,0.012735433578667625,2019-03-27 15:30:00,2019-03-27 15:45:00
111,3,0,3,0.0030257677492149327,2019-03-27 15:30:00,2019-03-27 15:45:00
112,11,7,4,0.021275833602546985,2019-03-27 15:30:00,2019-03-27 15:45:00
113,1,0,1,0.0030257677492149327,2019-03-27 15:30:00,2019-03-27 15:45:00
114,6,1,5,0.003883138629053248,2019-03-27 15:30:00,2019-03-27 15:45:00
115,3,2,1,0.004740509508891563,2019-03-27 15:30:00,2019-03-27 15:45:00
116,3,3,0,0.008452784196667016,2019-03-27 15:30:00,2019-03-27 15:45:00
119,2,2,0,0.010258247085125597,2019-03-27 15:30:00,2019-03-27 15:45:00
120,3,3,0,0.009337440216176409,2019-03-27 15:30:00,2019-03-27 15:45:00
122,6,3,3,0.009507625404629913,2019-03-27 15:30:00,2019-03-27 15:45:00
127,3,1,2,0.005478188067075998,2019-03-27 15:30:00,2019-03-27 15:45:00
129,2,0,2,0.0030257677492149327,2019-03-27 15:30:00,2019-03-27 15:45:00
133,5,1,4,0.0038423339088462117,2019-03-27 15:30:00,2019-03-27 15:45:00
135,2,2,0,0.004054612805020911,2019-03-27 15:30:00,2019-03-27 15:45:00
137,11,4,7,0.007727481986165671,2019-03-27 15:30:00,2019-03-27 15:45:00
138,3,1,2,0.007547478436478901,2019-03-27 15:30:00,2019-03-27 15:45:00
140,9,2,7,0.0039964083532478215,2019-03-27 15:30:00,2019-03-27 15:45:00
141,4,3,1,0.005417073103156368,2019-03-27 15:30:00,2019-03-27 15:45:00
147,2,1,1,0.005262573023111757,2019-03-27 15:30:00,2019-03-27 15:45:00
151,2,1,1,0.0055978803887298785,2019-03-27 15:30:00,2019-03-27 15:45:00
153,6,3,3,0.011806449018726007,2019-03-27 15:30:00,2019-03-27 15:45:00
154,4,2,2,0.009948526247038477,2019-03-27 15:30:00,2019-03-27 15:45:00
156,4,1,3,0.003540190277117922,2019-03-27 15:30:00,2019-03-27 15:45:00
157,2,1,1,0.019996181564219548,2019-03-27 15:30:00,2019-03-27 15:45:00
158,3,3,0,0.008414718618291076,2019-03-27 15:30:00,2019-03-27 15:45:00
160,1,1,0,0.0077843878589306656,2019-03-27 15:30:00,2019-03-27 15:45:00
161,2,1,1,0.019996181564219548,2019-03-27 15:30:00,2019-03-27 15:45:00
162,1,1,0,0.0055978803887298785,2019-03-27 15:30:00,2019-03-27 15:45:00
164,5,2,3,0.012567903138096921,2019-03-27 15:30:00,2019-03-27 15:45:00
168,6,4,2,0.021258075799594562,2019-03-27 15:30:00,2019-03-27 15:45:00
169,1,0,1,0.0030257677492149327,2019-03-27 15:30:00,2019-03-27 15:45:00
170,2,1,1,0.00749937829700858,2019-03-27 15:30:00,2019-03-27 15:45:00
172,1,1,0,0.015255310736955859,2019-03-27 15:30:00,2019-03-27 15:45:00
173,2,1,1,0.0055978803887298785,2019-03-27 15:30:00,2019-03-27 15:45:00
189,4,0,4,0.0030257677492149327,2019-03-27 15:30:00,2019-03-27 15:45:00
190,1,0,1,0.0030257677492149327,2019-03-27 15:30:00,2019-03-27 15:45:00
195,5,0,5,0.0030257677492149327,2019-03-27 15:30:00,2019-03-27 15:45:00
196,3,2,1,0.011427015908028526,2019-03-27 15:30:00,2019-03-27 15:45:00
197,1,0,1,0.0030257677492149327,2019-03-27 15:30:00,2019-03-27 15:45:00
201,1,1,0,0.004676241980672537,2019-03-27 15:30:00,2019-03-27 15:45:00
203,3,1,2,0.005262573023111757,2019-03-27 15:30:00,2019-03-27 15:45:00
1,1,1,0,0.004712576677216567,2019-03-27 15:45:00,2019-03-27 16:00:00
2,4,3,1,0.005193961898460993,2019-03-27 15:45:00,2019-03-27 16:00:00
5,7,4,3,0.009351104617156897,2019-03-27 15:45:00,2019-03-27 16:00:00
15,1,0,1,0.002807447079016975,2019-03-27 15:45:00,2019-03-27 16:00:00
16,9,8,1,0.0986596046623089,2019-03-27 15:45:00,2019-03-27 16:00:00
18,5,2,3,0.014270838946990046,2019-03-27 15:45:00,2019-03-27 16:00:00
19,9,6,3,0.029632935613977805,2019-03-27 15:45:00,2019-03-27 16:00:00
20,2,0,2,0.002807447079016975,2019-03-27 15:45:00,2019-03-27 16:00:00
23,8,4,4,0.012636609141797876,2019-03-27 15:45:00,2019-03-27 16:00:00
26,4,1,3,0.004712576677216567,2019-03-27 15:45:00,2019-03-27 16:00:00
27,2,2,0,0.009609203498345934,2019-03-27 15:45:00,2019-03-27 16:00:00
28,3,3,0,0.010864307421628056,2019-03-27 15:45:00,2019-03-27 16:00:00
30,3,3,0,0.009453124335449606,2019-03-27 15:45:00,2019-03-27 16:00:00
35,1,1,0,0.004000704488738984,2019-03-27 15:45:00,2019-03-27 16:00:00
37,5,3,2,0.01505117171585656,2019-03-27 15:45:00,2019-03-27 16:00:00
40,1,1,0,0.0051939618984609935,2019-03-27 15:45:00,2019-03-27 16:00:00
41,1,1,0,0.0034040757838779793,2019-03-27 15:45:00,2019-03-27 16:00:00
46,7,3,4,0.0090336433758167,2019-03-27 15:45:00,2019-03-27 16:00:00
57,1,0,1,0.002807447079016975,2019-03-27 15:45:00,2019-03-27 16:00:00
58,8,4,4,0.011105487479800879,2019-03-27 15:45:00,2019-03-27 16:00:00
62,1,1,0,0.007858096452940947,2019-03-27 15:45:00,2019-03-27 16:00:00
64,1,1,0,0.007633060836386256,2019-03-27 15:45:00,2019-03-27 16:00:00
66,2,1,1,0.006491757346177151,2019-03-27 15:45:00,2019-03-27 16:00:00
67,4,4,0,0.012669548855385944,2019-03-27 15:45:00,2019-03-27 16:00:00
69,1,1,0,0.0056764276668167055,2019-03-27 15:45:00,2019-03-27 16:00:00
70,2,1,1,0.0056764276668167055,2019-03-27 15:45:00,2019-03-27 16:00:00
74,3,0,3,0.002807447079016975,2019-03-27 15:45:00,2019-03-27 16:00:00
85,5,1,4,0.0035650910094439598,2019-03-27 15:45:00,2019-03-27 16:00:00
87,1,0,1,0.002807447079016975,2019-03-27 15:45:00,2019-03-27 16:00:00
88,1,1,0,0.0038646695315924158,2019-03-27 15:45:00,2019-03-27 16:00:00
89,3,1,2,0.004727287817694829,2019-03-27 15:45:00,2019-03-27 16:00:00
90,3,1,2,0.007939642243053463,2019-03-27 15:45:00,2019-03-27 16:00:00
104,1,1,0,0.0034040757838779793,2019-03-27 15:45:00,2019-03-27 16:00:00
106,1,0,1,0.002807447079016975,2019-03-27 15:45:00,2019-03-27 16:00:00
109,4,1,3,0.003917498493635773,2019-03-27 15:45:00,2019-03-27 16:00:00
110,8,4,4,0.011219529313760773,2019-03-27 15:45:00,2019-03-27 16:00:00
111,3,2,1,0.0050275499082545715,2019-03-27 15:45:00,2019-03-27 16:00:00
112,9,4,5,0.01687367841494552,2019-03-27 15:45:00,2019-03-27 16:00:00
113,2,0,2,0.002807447079016975,2019-03-27 15:45:00,2019-03-27 16:00:00
114,4,0,4,0.002807447079016975,2019-03-27 15:45:00,2019-03-27 16:00:00
115,3,0,3,0.002807447079016975,2019-03-27 15:45:00,2019-03-27 16:00:00
116,3,2,1,0.01633710994047329,2019-03-27 15:45:00,2019-03-27 16:00:00
118,2,0,2,0.002807447079016975,2019-03-27 15:45:00,2019-03-27 16:00:00
119,1,1,0,0.007081240747285748,2019-03-27 15:45:00,2019-03-27 16:00:00
120,2,2,0,0.00955709184982524,2019-03-27 15:45:00,2019-03-27 16:00:00
122,5,2,3,0.010176067613337328,2019-03-27 15:45:00,2019-03-27 16:00:00
126,3,1,2,0.004882845844616884,2019-03-27 15:45:00,2019-03-27 16:00:00
127,4,3,1,0.012080654990977048,2019-03-27 15:45:00,2019-03-27 16:00:00
129,2,0,2,0.002807447079016975,2019-03-27 15:45:00,2019-03-27 16:00:00
133,3,1,2,0.004000704488738984,2019-03-27 15:45:00,2019-03-27 16:00:00
135,2,2,0,0.004000704488738984,2019-03-27 15:45:00,2019-03-27 16:00:00
137,8,5,3,0.01300219902000943,2019-03-27 15:45:00,2019-03-27 16:00:00
138,4,2,2,0.012073997989917644,2019-03-27 15:45:00,2019-03-27 16:00:00
140,6,2,4,0.004974720946211214,2019-03-27 15:45:00,2019-03-27 16:00:00
141,2,2,0,0.004597333193599989,2019-03-27 15:45:00,2019-03-27 16:00:00
147,1,0,1,0.002807447079016975,2019-03-27 15:45:00,2019-03-27 16:00:00
151,1,1,0,0.004882845844616884,2019-03-27 15:45:00,2019-03-27 16:00:00
153,9,4,5,0.011205365267745872,2019-03-27 15:45:00,2019-03-27 16:00:00
156,1,0,1,0.002807447079016975,2019-03-27 15:45:00,2019-03-27 16:00:00
157,4,2,2,0.018664226560946483,2019-03-27 15:45:00,2019-03-27 16:00:00
158,1,1,0,0.005167637959257194,2019-03-27 15:45:00,2019-03-27 16:00:00
161,2,1,1,0.018664226560946483,2019-03-27 15:45:00,2019-03-27 16:00:00
162,1,1,0,0.0051939618984609935,2019-03-27 15:45:00,2019-03-27 16:00:00
164,3,0,3,0.002807447079016975,2019-03-27 15:45:00,2019-03-27 16:00:00
168,6,4,2,0.011882605098301764,2019-03-27 15:45:00,2019-03-27 16:00:00
169,1,0,1,0.002807447079016975,2019-03-27 15:45:00,2019-03-27 16:00:00
170,2,1,1,0.0051939618984609935,2019-03-27 15:45:00,2019-03-27 16:00:00
172,2,1,1,0.0041428129593201485,2019-03-27 15:45:00,2019-03-27 16:00:00
173,3,2,1,0.005478178839623321,2019-03-27 15:45:00,2019-03-27 16:00:00
189,2,0,2,0.002807447079016975,2019-03-27 15:45:00,2019-03-27 16:00:00
190,1,0,1,0.002807447079016975,2019-03-27 15:45:00,2019-03-27 16:00:00
195,4,0,4,0.002807447079016975,2019-03-27 15:45:00,2019-03-27 16:00:00
196,2,1,1,0.008325987870175987,2019-03-27 15:45:00,2019-03-27 16:00:00
197,1,1,0,0.011204914776436802,2019-03-27 15:45:00,2019-03-27 16:00:00
199,1,1,0,0.004000704488738984,2019-03-27 15:45:00,2019-03-27 16:00:00
201,4,1,3,0.003917498493635773,2019-03-27 15:45:00,2019-03-27 16:00:00
202,2,1,1,0.003917498493635773,2019-03-27 15:45:00,2019-03-27 16:00:00
203,3,1,2,0.004882845844616884,2019-03-27 15:45:00,2019-03-27 16:00:00
1,2,2,0,0.006902026533693695,2019-03-27 16:00:00,2019-03-27 16:15:00
2,4,3,1,0.005239510499979904,2019-03-27 16:00:00,2019-03-27 16:15:00
5,6,4,2,0.01827446056336003,2019-03-27 16:00:00,2019-03-27 16:15:00
10,3,2,1,0.009658537979480283,2019-03-27 16:00:00,2019-03-27 16:15:00
15,5,3,2,0.008154157763018094,2019-03-27 16:00:00,2019-03-27 16:15:00
16,10,6,4,0.013325777966846473,2019-03-27 16:00:00,2019-03-27 16:15:00
18,10,6,4,0.01627543628689381,2019-03-27 16:00:00,2019-03-27 16:15:00
19,6,5,1,0.013330337837968952,2019-03-27 16:00:00,2019-03-27 16:15:00
20,2,1,1,0.0029361600822818447,2019-03-27 16:00:00,2019-03-27 16:15:00
21,3,0,3,0.002421541646000135,2019-03-27 16:00:00,2019-03-27 16:15:00
22,1,0,1,0.002421541646000135,2019-03-27 16:00:00,2019-03-27 16:15:00
23,4,0,4,0.002421541646000135,2019-03-27 16:00:00,2019-03-27 16:15:00
26,4,1,3,0.007569126542800848,2019-03-27 16:00:00,2019-03-27 16:15:00
27,1,1,0,0.00687564263135706,2019-03-27 16:00:00,2019-03-27 16:15:00
28,4,3,1,0.003965396954845265,2019-03-27 16:00:00,2019-03-27 16:15:00
30,3,2,1,0.011722311697533586,2019-03-27 16:00:00,2019-03-27 16:15:00
35,1,1,0,0.00302877992735831,2019-03-27 16:00:00,2019-03-27 16:15:00
37,4,3,1,0.06280852541849691,2019-03-27 16:00:00,2019-03-27 16:15:00
40,1,0,1,0.002421541646000135,2019-03-27 16:00:00,2019-03-27 16:15:00
41,1,1,0,0.004917482828108517,2019-03-27 16:00:00,2019-03-27 16:15:00
46,6,2,4,0.004211667480181485,2019-03-27 16:00:00,2019-03-27 16:15:00
57,3,1,2,0.004211667480181485,2019-03-27 16:00:00,2019-03-27 16:15:00
58,3,1,2,0.0034507785185635548,2019-03-27 16:00:00,2019-03-27 16:15:00
62,5,2,3,0.010340953180957973,2019-03-27 16:00:00,2019-03-27 16:15:00
64,3,3,0,0.009854568345117411,2019-03-27 16:00:00,2019-03-27 16:15:00
66,1,0,1,0.002421541646000135,2019-03-27 16:00:00,2019-03-27 16:15:00
67,6,4,2,0.017802072325176273,2019-03-27 16:00:00,2019-03-27 16:15:00
68,5,4,1,0.008968381886475342,2019-03-27 16:00:00,2019-03-27 16:15:00
69,1,0,1,0.002421541646000135,2019-03-27 16:00:00,2019-03-27 16:15:00
70,2,1,1,0.0039716242950456025,2019-03-27 16:00:00,2019-03-27 16:15:00
74,1,0,1,0.002421541646000135,2019-03-27 16:00:00,2019-03-27 16:15:00
75,1,0,1,0.002421541646000135,2019-03-27 16:00:00,2019-03-27 16:15:00
80,4,1,3,0.0033790105946667516,2019-03-27 16:00:00,2019-03-27 16:15:00
85,2,0,2,0.002421541646000135,2019-03-27 16:00:00,2019-03-27 16:15:00
86,1,0,1,0.002421541646000135,2019-03-27 16:00:00,2019-03-27 16:15:00
87,1,1,0,0.003839462864133624,2019-03-27 16:00:00,2019-03-27 16:15:00
88,2,2,0,0.008255284457843128,2019-03-27 16:00:00,2019-03-27 16:15:00
89,3,1,2,0.0033166045630908104,2019-03-27 16:00:00,2019-03-27 16:15:00
90,4,4,0,0.00874542752564279,2019-03-27 16:00:00,2019-03-27 16:15:00
104,2,2,0,0.005002305573903234,2019-03-27 16:00:00,2019-03-27 16:15:00
109,6,2,4,0.00667161931445712,2019-03-27 16:00:00,2019-03-27 16:15:00
110,12,6,6,0.014103162038059076,2019-03-27 16:00:00,2019-03-27 16:15:00
111,4,2,2,0.007757229721114963,2019-03-27 16:00:00,2019-03-27 16:15:00
112,11,4,7,0.012763281448311788,2019-03-27 16:00:00,2019-03-27 16:15:00
113,1,1,0,0.0069713333064122945,2019-03-27 16:00:00,2019-03-27 16:15:00
114,3,1,2,0.0038882459555450973,2019-03-27 16:00:00,2019-03-27 16:15:00
115,6,0,6,0.002421541646000135,2019-03-27 16:00:00,2019-03-27 16:15:00
116,1,1,0,0.00302877992735831,2019-03-27 16:00:00,2019-03-27 16:15:00
118,5,1,4,0.0028573520984464507,2019-03-27 16:00:00,2019-03-27 16:15:00
119,3,3,0,0.01138324360103816,2019-03-27 16:00:00,2019-03-27 16:15:00
120,3,1,2,0.002764620603521275,2019-03-27 16:00:00,2019-03-27 16:15:00
122,2,1,1,0.016095813521709045,2019-03-27 16:00:00,2019-03-27 16:15:00
126,2,1,1,0.007569126542800848,2019-03-27 16:00:00,2019-03-27 16:15:00
127,3,2,1,0.007430773035292012,2019-03-27 16:00:00,2019-03-27 16:15:00
129,4,0,4,0.002421541646000135,2019-03-27 16:00:00,2019-03-27 16:15:00
133,2,0,2,0.002421541646000135,2019-03-27 16:00:00,2019-03-27 16:15:00
135,2,2,0,0.0032931625508927664,2019-03-27 16:00:00,2019-03-27 16:15:00
137,11,5,6,0.015269858252354704,2019-03-27 16:00:00,2019-03-27 16:15:00
138,9,4,5,0.023041300502777622,2019-03-27 16:00:00,2019-03-27 16:15:00
140,3,0,3,0.002421541646000135,2019-03-27 16:00:00,2019-03-27 16:15:00
141,3,2,1,0.005166173306169254,2019-03-27 16:00:00,2019-03-27 16:15:00
147,4,3,1,0.008028658266159349,2019-03-27 16:00:00,2019-03-27 16:15:00
151,1,1,0,0.008856402072370486,2019-03-27 16:00:00,2019-03-27 16:15:00
153,11,5,6,0.036329409614429216,2019-03-27 16:00:00,2019-03-27 16:15:00
154,3,1,2,0.005887477100596781,2019-03-27 16:00:00,2019-03-27 16:15:00
156,3,1,2,0.0031076995610424146,2019-03-27 16:00:00,2019-03-27 16:15:00
157,6,4,2,0.020653904146945345,2019-03-27 16:00:00,2019-03-27 16:15:00
158,2,1,1,0.0038882459555450973,2019-03-27 16:00:00,2019-03-27 16:15:00
160,1,1,0,0.0037424234765512498,2019-03-27 16:00:00,2019-03-27 16:15:00
161,3,2,1,0.029770085397417944,2019-03-27 16:00:00,2019-03-27 16:15:00
164,6,2,4,0.005822520601651919,2019-03-27 16:00:00,2019-03-27 16:15:00
168,9,6,3,0.017605654986380212,2019-03-27 16:00:00,2019-03-27 16:15:00
171,1,1,0,0.00924667688950486,2019-03-27 16:00:00,2019-03-27 16:15:00
172,2,1,1,0.004566495121456919,2019-03-27 16:00:00,2019-03-27 16:15:00
173,5,4,1,0.010537123613812729,2019-03-27 16:00:00,2019-03-27 16:15:00
177,2,1,1,0.005351943884648228,2019-03-27 16:00:00,2019-03-27 16:15:00
189,1,0,1,0.002421541646000135,2019-03-27 16:00:00,2019-03-27 16:15:00
190,1,0,1,0.002421541646000135,2019-03-27 16:00:00,2019-03-27 16:15:00
195,12,3,9,0.004614044381443881,2019-03-27 16:00:00,2019-03-27 16:15:00
196,4,2,2,0.00491582584357329,2019-03-27 16:00:00,2019-03-27 16:15:00
197,2,1,1,0.013753993555724417,2019-03-27 16:00:00,2019-03-27 16:15:00
199,2,2,0,0.010560219396577517,2019-03-27 16:00:00,2019-03-27 16:15:00
202,4,2,2,0.004525620779175904,2019-03-27 16:00:00,2019-03-27 16:15:00
203,2,1,1,0.016095813521709045,2019-03-27 16:00:00,2019-03-27 16:15:00
1,5,4,1,0.011244366095388139,2019-03-27 16:15:00,2019-03-27 16:30:00
2,3,2,1,0.015176891237147666,2019-03-27 16:15:00,2019-03-27 16:30:00
5,7,5,2,0.010958440817537857,2019-03-27 16:15:00,2019-03-27 16:30:00
10,3,2,1,0.004392672595953001,2019-03-27 16:15:00,2019-03-27 16:30:00
15,3,2,1,0.007718238392921439,2019-03-27 16:15:00,2019-03-27 16:30:00
16,7,5,2,0.015451346797628784,2019-03-27 16:15:00,2019-03-27 16:30:00
18,6,4,2,0.010861542996792404,2019-03-27 16:15:00,2019-03-27 16:30:00
19,4,2,2,0.004684129020617564,2019-03-27 16:15:00,2019-03-27 16:30:00
20,3,1,2,0.003607995419081784,2019-03-27 16:15:00,2019-03-27 16:30:00
21,4,0,4,0.0025318618175460043,2019-03-27 16:15:00,2019-03-27 16:30:00
22,2,1,1,0.0035029907567175945,2019-03-27 16:15:00,2019-03-27 16:30:00
26,8,3,5,0.005859937070156199,2019-03-27 16:15:00,2019-03-27 16:30:00
27,2,2,0,0.020198477318285796,2019-03-27 16:15:00,2019-03-27 16:30:00
28,3,1,2,0.003528172860422559,2019-03-27 16:15:00,2019-03-27 16:30:00
30,1,1,0,0.002962315258160316,2019-03-27 16:15:00,2019-03-27 16:30:00
37,5,1,4,0.00321514160484404,2019-03-27 16:15:00,2019-03-27 16:30:00
41,5,3,2,0.008131139063005248,2019-03-27 16:15:00,2019-03-27 16:30:00
46,7,2,5,0.0038363447339377693,2019-03-27 16:15:00,2019-03-27 16:30:00
50,2,2,0,0.008564728606393813,2019-03-27 16:15:00,2019-03-27 16:30:00
57,3,2,1,0.027835175983912046,2019-03-27 16:15:00,2019-03-27 16:30:00
58,4,3,1,0.010206254720290948,2019-03-27 16:15:00,2019-03-27 16:30:00
61,9,4,5,0.0068572784471408795,2019-03-27 16:15:00,2019-03-27 16:30:00
62,3,1,2,0.009512927532825526,2019-03-27 16:15:00,2019-03-27 16:30:00
64,3,3,0,0.005760262622153344,2019-03-27 16:15:00,2019-03-27 16:30:00
66,3,1,2,0.0031841032757418865,2019-03-27 16:15:00,2019-03-27 16:30:00
67,9,5,4,0.008970289868306492,2019-03-27 16:15:00,2019-03-27 16:30:00
68,2,1,1,0.005509689702130581,2019-03-27 16:15:00,2019-03-27 16:30:00
69,8,3,5,0.005167657821903636,2019-03-27 16:15:00,2019-03-27 16:30:00
70,1,1,0,0.0031841032757418865,2019-03-27 16:15:00,2019-03-27 16:30:00
74,2,0,2,0.0025318618175460043,2019-03-27 16:15:00,2019-03-27 16:30:00
75,1,0,1,0.0025318618175460043,2019-03-27 16:15:00,2019-03-27 16:30:00
80,2,0,2,0.0025318618175460043,2019-03-27 16:15:00,2019-03-27 16:30:00
85,2,1,1,0.00321514160484404,2019-03-27 16:15:00,2019-03-27 16:30:00
86,1,0,1,0.0025318618175460043,2019-03-27 16:15:00,2019-03-27 16:30:00
87,1,1,0,0.006457597137231463,2019-03-27 16:15:00,2019-03-27 16:30:00
88,3,2,1,0.02323591009906164,2019-03-27 16:15:00,2019-03-27 16:30:00
89,1,0,1,0.0025318618175460043,2019-03-27 16:15:00,2019-03-27 16:30:00
90,2,1,1,0.007148658812790462,2019-03-27 16:15:00,2019-03-27 16:30:00
104,1,1,0,0.003528172860422559,2019-03-27 16:15:00,2019-03-27 16:30:00
109,6,3,3,0.013853191096181135,2019-03-27 16:15:00,2019-03-27 16:30:00
110,4,0,4,0.0025318618175460043,2019-03-27 16:15:00,2019-03-27 16:30:00
111,2,1,1,0.0050640631035226615,2019-03-27 16:15:00,2019-03-27 16:30:00
112,7,3,4,0.01022478983277958,2019-03-27 16:15:00,2019-03-27 16:30:00
113,2,1,1,0.008121630752299203,2019-03-27 16:15:00,2019-03-27 16:30:00
114,3,1,2,0.011208268996848356,2019-03-27 16:15:00,2019-03-27 16:30:00
115,5,0,5,0.0025318618175460043,2019-03-27 16:15:00,2019-03-27 16:30:00
116,3,2,1,0.008212068562777357,2019-03-27 16:15:00,2019-03-27 16:30:00
118,4,1,3,0.003607995419081784,2019-03-27 16:15:00,2019-03-27 16:30:00
119,3,1,2,0.003885230441058747,2019-03-27 16:15:00,2019-03-27 16:30:00
120,2,2,0,0.005539020252258678,2019-03-27 16:15:00,2019-03-27 16:30:00
122,2,2,0,0.00579714042483909,2019-03-27 16:15:00,2019-03-27 16:30:00
126,5,3,2,0.015053802069630542,2019-03-27 16:15:00,2019-03-27 16:30:00
127,3,1,2,0.004704923716448824,2019-03-27 16:15:00,2019-03-27 16:30:00
129,2,0,2,0.0025318618175460043,2019-03-27 16:15:00,2019-03-27 16:30:00
135,3,2,1,0.003804368357161638,2019-03-27 16:15:00,2019-03-27 16:30:00
137,5,3,2,0.006074676809936378,2019-03-27 16:15:00,2019-03-27 16:30:00
138,11,5,6,0.0178717454489872,2019-03-27 16:15:00,2019-03-27 16:30:00
140,2,0,2,0.0025318618175460043,2019-03-27 16:15:00,2019-03-27 16:30:00
141,4,3,1,0.007891927528825646,2019-03-27 16:15:00,2019-03-27 16:30:00
147,6,2,4,0.004569557173244865,2019-03-27 16:15:00,2019-03-27 16:30:00
151,1,1,0,0.0035029907567175945,2019-03-27 16:15:00,2019-03-27 16:30:00
153,5,1,4,0.004531698319876872,2019-03-27 16:15:00,2019-03-27 16:30:00
154,4,1,3,0.009093119640339854,2019-03-27 16:15:00,2019-03-27 16:30:00
156,3,0,3,0.0025318618175460043,2019-03-27 16:15:00,2019-03-27 16:30:00
157,4,3,1,0.022562445164133593,2019-03-27 16:15:00,2019-03-27 16:30:00
158,3,1,2,0.004403569376450308,2019-03-27 16:15:00,2019-03-27 16:30:00
159,2,2,0,0.006737018636824278,2019-03-27 16:15:00,2019-03-27 16:30:00
160,1,1,0,0.0032492842185698574,2019-03-27 16:15:00,2019-03-27 16:30:00
161,3,2,1,0.02267530311528246,2019-03-27 16:15:00,2019-03-27 16:30:00
162,1,1,0,0.0045228041754928104,2019-03-27 16:15:00,2019-03-27 16:30:00
164,5,2,3,0.00584366671773366,2019-03-27 16:15:00,2019-03-27 16:30:00
168,7,6,1,0.0667878397140559,2019-03-27 16:15:00,2019-03-27 16:30:00
170,7,2,5,0.004868715705751519,2019-03-27 16:15:00,2019-03-27 16:30:00
171,4,4,0,0.007329465704666032,2019-03-27 16:15:00,2019-03-27 16:30:00
173,5,5,0,0.024329324777136653,2019-03-27 16:15:00,2019-03-27 16:30:00
177,2,1,1,0.006575364598677793,2019-03-27 16:15:00,2019-03-27 16:30:00
190,2,1,1,0.00893067094578618,2019-03-27 16:15:00,2019-03-27 16:30:00
191,1,1,0,0.003429577664742378,2019-03-27 16:15:00,2019-03-27 16:30:00
195,11,4,7,0.005239213159209345,2019-03-27 16:15:00,2019-03-27 16:30:00
196,4,1,3,0.0031681150873538212,2019-03-27 16:15:00,2019-03-27 16:30:00
197,2,1,1,0.0045228041754928104,2019-03-27 16:15:00,2019-03-27 16:30:00
199,3,3,0,0.01519601277012172,2019-03-27 16:15:00,2019-03-27 16:30:00
200,1,0,1,0.0025318618175460043,2019-03-27 16:15:00,2019-03-27 16:30:00
201,4,2,2,0.016072812645826294,2019-03-27 16:15:00,2019-03-27 16:30:00
202,2,1,1,0.0030699286183138944,2019-03-27 16:15:00,2019-03-27 16:30:00
1,4,3,1,0.008891544540762832,2019-03-27 16:30:00,2019-03-27 16:45:00
2,2,1,1,0.005677166654191148,2019-03-27 16:30:00,2019-03-27 16:45:00
5,7,4,3,0.007578193767077444,2019-03-27 16:30:00,2019-03-27 16:45:00
10,2,0,2,0.002201686808684359,2019-03-27 16:30:00,2019-03-27 16:45:00
15,5,5,0,0.00851835498872178,2019-03-27 16:30:00,2019-03-27 16:45:00
16,8,5,3,0.012264476301451274,2019-03-27 16:30:00,2019-03-27 16:45:00
18,1,1,0,0.0026298835225966577,2019-03-27 16:30:00,2019-03-27 16:45:00
19,8,4,4,0.011029499747456463,2019-03-27 16:30:00,2019-03-27 16:45:00
20,1,0,1,0.002201686808684359,2019-03-27 16:30:00,2019-03-27 16:45:00
21,2,0,2,0.002201686808684359,2019-03-27 16:30:00,2019-03-27 16:45:00
23,4,1,3,0.0035670653055247855,2019-03-27 16:30:00,2019-03-27 16:45:00
26,6,3,3,0.005936216620703125,2019-03-27 16:30:00,2019-03-27 16:45:00
27,3,3,0,0.00983529026004456,2019-03-27 16:30:00,2019-03-27 16:45:00
28,3,1,2,0.0038838029693609027,2019-03-27 16:30:00,2019-03-27 16:45:00
30,1,1,0,0.0031374628610691215,2019-03-27 16:30:00,2019-03-27 16:45:00
35,1,1,0,0.009517243514169266,2019-03-27 16:30:00,2019-03-27 16:45:00
37,6,2,4,0.00865287348650116,2019-03-27 16:30:00,2019-03-27 16:45:00
40,4,3,1,0.05677119417592643,2019-03-27 16:30:00,2019-03-27 16:45:00
41,3,2,1,0.00797693323518854,2019-03-27 16:30:00,2019-03-27 16:45:00
46,9,3,6,0.003829232943293558,2019-03-27 16:30:00,2019-03-27 16:45:00
50,1,1,0,0.0031374628610691215,2019-03-27 16:30:00,2019-03-27 16:45:00
57,7,6,1,0.08926691804752583,2019-03-27 16:30:00,2019-03-27 16:45:00
58,4,3,1,0.005024266164900775,2019-03-27 16:30:00,2019-03-27 16:45:00
61,7,3,4,0.006635557870271152,2019-03-27 16:30:00,2019-03-27 16:45:00
62,2,2,0,0.005810884949836394,2019-03-27 16:30:00,2019-03-27 16:45:00
64,8,5,3,0.013517533538129947,2019-03-27 16:30:00,2019-03-27 16:45:00
66,2,1,1,0.002744202186887425,2019-03-27 16:30:00,2019-03-27 16:45:00
67,5,3,2,0.008216289911194125,2019-03-27 16:30:00,2019-03-27 16:45:00
69,5,2,3,0.004405840083122626,2019-03-27 16:30:00,2019-03-27 16:45:00
70,2,1,1,0.002744202186887425,2019-03-27 16:30:00,2019-03-27 16:45:00
75,1,0,1,0.002201686808684359,2019-03-27 16:30:00,2019-03-27 16:45:00
80,2,0,2,0.002201686808684359,2019-03-27 16:30:00,2019-03-27 16:45:00
85,2,1,1,0.0030154598759889583,2019-03-27 16:30:00,2019-03-27 16:45:00
86,2,2,0,0.00631782812971961,2019-03-27 16:30:00,2019-03-27 16:45:00
87,1,1,0,0.010012912279750071,2019-03-27 16:30:00,2019-03-27 16:45:00
88,5,2,3,0.004977454901382772,2019-03-27 16:30:00,2019-03-27 16:45:00
89,2,1,1,0.005677166654191148,2019-03-27 16:30:00,2019-03-27 16:45:00
90,8,4,4,0.011548416591335032,2019-03-27 16:30:00,2019-03-27 16:45:00
101,1,1,0,0.0031574060838429566,2019-03-27 16:30:00,2019-03-27 16:45:00
104,1,0,1,0.002201686808684359,2019-03-27 16:30:00,2019-03-27 16:45:00
106,2,0,2,0.002201686808684359,2019-03-27 16:30:00,2019-03-27 16:45:00
109,5,3,2,0.009834312269568062,2019-03-27 16:30:00,2019-03-27 16:45:00
110,9,3,6,0.005983339335996601,2019-03-27 16:30:00,2019-03-27 16:45:00
111,10,6,4,0.014937325044161454,2019-03-27 16:30:00,2019-03-27 16:45:00
112,6,4,2,0.011334518331401573,2019-03-27 16:30:00,2019-03-27 16:45:00
113,2,1,1,0.004868709487881249,2019-03-27 16:30:00,2019-03-27 16:45:00
114,2,0,2,0.002201686808684359,2019-03-27 16:30:00,2019-03-27 16:45:00
115,2,0,2,0.002201686808684359,2019-03-27 16:30:00,2019-03-27 16:45:00
116,4,2,2,0.004777230339248197,2019-03-27 16:30:00,2019-03-27 16:45:00
118,3,1,2,0.007041157182803778,2019-03-27 16:30:00,2019-03-27 16:45:00
119,6,1,5,0.005376390319029501,2019-03-27 16:30:00,2019-03-27 16:45:00
120,6,5,1,0.022677393570815076,2019-03-27 16:30:00,2019-03-27 16:45:00
122,1,1,0,0.004040686443598023,2019-03-27 16:30:00,2019-03-27 16:45:00
126,8,1,7,0.0035260315115391103,2019-03-27 16:30:00,2019-03-27 16:45:00
127,3,1,2,0.0031158050851965327,2019-03-27 16:30:00,2019-03-27 16:45:00
133,2,2,0,0.0038971517498856234,2019-03-27 16:30:00,2019-03-27 16:45:00
135,3,2,1,0.004113125359001555,2019-03-27 16:30:00,2019-03-27 16:45:00
137,8,5,3,0.025813648788296464,2019-03-27 16:30:00,2019-03-27 16:45:00
138,8,4,4,0.022769926670706587,2019-03-27 16:30:00,2019-03-27 16:45:00
140,1,0,1,0.002201686808684359,2019-03-27 16:30:00,2019-03-27 16:45:00
141,4,1,3,0.008983152333997445,2019-03-27 16:30:00,2019-03-27 16:45:00
147,3,0,3,0.002201686808684359,2019-03-27 16:30:00,2019-03-27 16:45:00
151,2,1,1,0.002825537510274201,2019-03-27 16:30:00,2019-03-27 16:45:00
153,3,1,2,0.003212427952323097,2019-03-27 16:30:00,2019-03-27 16:45:00
154,2,0,2,0.002201686808684359,2019-03-27 16:30:00,2019-03-27 16:45:00
156,1,0,1,0.002201686808684359,2019-03-27 16:30:00,2019-03-27 16:45:00
157,6,2,4,0.003829232943293558,2019-03-27 16:30:00,2019-03-27 16:45:00
158,9,3,6,0.003829232943293558,2019-03-27 16:30:00,2019-03-27 16:45:00
159,2,2,0,0.0063220190790026585,2019-03-27 16:30:00,2019-03-27 16:45:00
161,3,2,1,0.022953799927294342,2019-03-27 16:30:00,2019-03-27 16:45:00
162,1,1,0,0.0045457605997838,2019-03-27 16:30:00,2019-03-27 16:45:00
164,1,0,1,0.002201686808684359,2019-03-27 16:30:00,2019-03-27 16:45:00
168,6,4,2,0.018376152005653016,2019-03-27 16:30:00,2019-03-27 16:45:00
170,4,1,3,0.005693977428129769,2019-03-27 16:30:00,2019-03-27 16:45:00
171,3,3,0,0.006541314180065795,2019-03-27 16:30:00,2019-03-27 16:45:00
172,3,2,1,0.0059868524330718344,2019-03-27 16:30:00,2019-03-27 16:45:00
173,8,5,3,0.01184681505366863,2019-03-27 16:30:00,2019-03-27 16:45:00
177,2,1,1,0.0031374628610691215,2019-03-27 16:30:00,2019-03-27 16:45:00
189,6,4,2,0.010850696767335055,2019-03-27 16:30:00,2019-03-27 16:45:00
190,4,3,1,0.011536231362676196,2019-03-27 16:30:00,2019-03-27 16:45:00
191,4,2,2,0.006575088559932165,2019-03-27 16:30:00,2019-03-27 16:45:00
195,12,3,9,0.010118321637610526,2019-03-27 16:30:00,2019-03-27 16:45:00
196,6,2,4,0.007428427868024804,2019-03-27 16:30:00,2019-03-27 16:45:00
197,7,4,3,0.029917602845073693,2019-03-27 16:30:00,2019-03-27 16:45:00
199,1,1,0,0.006340393082788068,2019-03-27 16:30:00,2019-03-27 16:45:00
200,1,0,1,0.002201686808684359,2019-03-27 16:30:00,2019-03-27 16:45:00
201,4,1,3,0.005376390319029501,2019-03-27 16:30:00,2019-03-27 16:45:00
202,1,1,0,0.0031374628610691215,2019-03-27 16:30:00,2019-03-27 16:45:00
1,3,1,2,0.0052077581157726205,2019-03-27 16:45:00,2019-03-27 17:00:00
2,2,0,2,0.002408551568008361,2019-03-27 16:45:00,2019-03-27 17:00:00
5,3,1,2,0.004455962216914368,2019-03-27 16:45:00,2019-03-27 17:00:00
10,1,0,1,0.002408551568008361,2019-03-27 16:45:00,2019-03-27 17:00:00
11,1,1,0,0.003867367776883462,2019-03-27 16:45:00,2019-03-27 17:00:00
15,11,8,3,0.014714904633034652,2019-03-27 16:45:00,2019-03-27 17:00:00
16,7,4,3,0.023790832562029733,2019-03-27 16:45:00,2019-03-27 17:00:00
18,8,7,1,0.017013446426872955,2019-03-27 16:45:00,2019-03-27 17:00:00
19,8,2,6,0.012079166636836143,2019-03-27 16:45:00,2019-03-27 17:00:00
20,2,1,1,0.004302478661305559,2019-03-27 16:45:00,2019-03-27 17:00:00
21,3,1,2,0.004189036790628532,2019-03-27 16:45:00,2019-03-27 17:00:00
23,5,2,3,0.004367784615096929,2019-03-27 16:45:00,2019-03-27 17:00:00
26,3,3,0,0.006446596857611417,2019-03-27 16:45:00,2019-03-27 17:00:00
27,2,2,0,0.011227910616452914,2019-03-27 16:45:00,2019-03-27 17:00:00
28,2,1,1,0.007880899623682207,2019-03-27 16:45:00,2019-03-27 17:00:00
30,1,1,0,0.0034322568924613646,2019-03-27 16:45:00,2019-03-27 17:00:00
35,4,2,2,0.007772165867362554,2019-03-27 16:45:00,2019-03-27 17:00:00
37,11,5,6,0.010336787090234265,2019-03-27 16:45:00,2019-03-27 17:00:00
40,3,1,2,0.004189036790628532,2019-03-27 16:45:00,2019-03-27 17:00:00
41,3,1,2,0.0034322568924613646,2019-03-27 16:45:00,2019-03-27 17:00:00
46,9,4,5,0.009178903570549334,2019-03-27 16:45:00,2019-03-27 17:00:00
50,1,1,0,0.0034322568924613646,2019-03-27 16:45:00,2019-03-27 17:00:00
57,8,8,0,0.02291748236868491,2019-03-27 16:45:00,2019-03-27 17:00:00
58,2,1,1,0.0029671131309925215,2019-03-27 16:45:00,2019-03-27 17:00:00
61,5,2,3,0.003932260287775253,2019-03-27 16:45:00,2019-03-27 17:00:00
62,2,2,0,0.0058410503011405894,2019-03-27 16:45:00,2019-03-27 17:00:00
64,5,3,2,0.010484788591371915,2019-03-27 16:45:00,2019-03-27 17:00:00
66,4,3,1,0.006437217917052912,2019-03-27 16:45:00,2019-03-27 17:00:00
67,9,6,3,0.017352844794562963,2019-03-27 16:45:00,2019-03-27 17:00:00
68,2,1,1,0.0033608695178626684,2019-03-27 16:45:00,2019-03-27 17:00:00
69,9,3,6,0.0039424793250838535,2019-03-27 16:45:00,2019-03-27 17:00:00
75,1,0,1,0.002408551568008361,2019-03-27 16:45:00,2019-03-27 17:00:00
85,2,1,1,0.0033608695178626684,2019-03-27 16:45:00,2019-03-27 17:00:00
86,1,1,0,0.0073258672246152914,2019-03-27 16:45:00,2019-03-27 17:00:00
87,5,3,2,0.014728318456480899,2019-03-27 16:45:00,2019-03-27 17:00:00
88,6,1,5,0.004468524909422034,2019-03-27 16:45:00,2019-03-27 17:00:00
89,5,5,0,0.014269402661007229,2019-03-27 16:45:00,2019-03-27 17:00:00
90,7,2,5,0.007233838672660012,2019-03-27 16:45:00,2019-03-27 17:00:00
99,1,1,0,0.0073258672246152914,2019-03-27 16:45:00,2019-03-27 17:00:00
101,4,2,2,0.004913969682282058,2019-03-27 16:45:00,2019-03-27 17:00:00
104,4,3,1,0.009170227259564208,2019-03-27 16:45:00,2019-03-27 17:00:00
106,2,0,2,0.002408551568008361,2019-03-27 16:45:00,2019-03-27 17:00:00
108,1,1,0,0.004120104144357073,2019-03-27 16:45:00,2019-03-27 17:00:00
109,8,5,3,0.012602964134566207,2019-03-27 16:45:00,2019-03-27 17:00:00
110,9,4,5,0.010232807057968278,2019-03-27 16:45:00,2019-03-27 17:00:00
111,15,9,6,0.02998348675017221,2019-03-27 16:45:00,2019-03-27 17:00:00
112,6,3,3,0.006920177496927547,2019-03-27 16:45:00,2019-03-27 17:00:00
113,2,1,1,0.016005354710940438,2019-03-27 16:45:00,2019-03-27 17:00:00
114,1,0,1,0.002408551568008361,2019-03-27 16:45:00,2019-03-27 17:00:00
115,2,0,2,0.002408551568008361,2019-03-27 16:45:00,2019-03-27 17:00:00
116,2,1,1,0.002701038803566362,2019-03-27 16:45:00,2019-03-27 17:00:00
118,5,2,3,0.006265176514470859,2019-03-27 16:45:00,2019-03-27 17:00:00
119,9,3,6,0.012771711861056256,2019-03-27 16:45:00,2019-03-27 17:00:00
120,7,5,2,0.010012017839677902,2019-03-27 16:45:00,2019-03-27 17:00:00
122,5,3,2,0.060551325994500194,2019-03-27 16:45:00,2019-03-27 17:00:00
126,7,0,7,0.002408551568008361,2019-03-27 16:45:00,2019-03-27 17:00:00
127,2,1,1,0.0043694225074745515,2019-03-27 16:45:00,2019-03-27 17:00:00
133,2,2,0,0.005888217279248953,2019-03-27 16:45:00,2019-03-27 17:00:00
135,4,2,2,0.0032421608302227044,2019-03-27 16:45:00,2019-03-27 17:00:00
137,13,6,7,0.01696189241539498,2019-03-27 16:45:00,2019-03-27 17:00:00
138,7,4,3,0.009920820639047378,2019-03-27 16:45:00,2019-03-27 17:00:00
140,1,0,1,0.002408551568008361,2019-03-27 16:45:00,2019-03-27 17:00:00
141,5,2,3,0.008716866061259407,2019-03-27 16:45:00,2019-03-27 17:00:00
147,1,0,1,0.002408551568008361,2019-03-27 16:45:00,2019-03-27 17:00:00
151,1,0,1,0.002408551568008361,2019-03-27 16:45:00,2019-03-27 17:00:00
153,3,1,2,0.0036461884838315246,2019-03-27 16:45:00,2019-03-27 17:00:00
154,4,1,3,0.0033608695178626684,2019-03-27 16:45:00,2019-03-27 17:00:00
157,4,1,3,0.0033608695178626684,2019-03-27 16:45:00,2019-03-27 17:00:00
158,2,0,2,0.002408551568008361,2019-03-27 16:45:00,2019-03-27 17:00:00
159,2,2,0,0.005833982635483159,2019-03-27 16:45:00,2019-03-27 17:00:00
161,2,1,1,0.016005354710940438,2019-03-27 16:45:00,2019-03-27 17:00:00
162,2,2,0,0.004678665707341233,2019-03-27 16:45:00,2019-03-27 17:00:00
164,6,2,4,0.00699502197771851,2019-03-27 16:45:00,2019-03-27 17:00:00
168,7,4,3,0.021839630276189605,2019-03-27 16:45:00,2019-03-27 17:00:00
170,5,0,5,0.002408551568008361,2019-03-27 16:45:00,2019-03-27 17:00:00
171,2,1,1,0.002701038803566362,2019-03-27 16:45:00,2019-03-27 17:00:00
172,2,0,2,0.002408551568008361,2019-03-27 16:45:00,2019-03-27 17:00:00
173,4,2,2,0.006585778534341411,2019-03-27 16:45:00,2019-03-27 17:00:00
177,2,2,0,0.0047484494524723695,2019-03-27 16:45:00,2019-03-27 17:00:00
189,11,8,3,0.028085467219364314,2019-03-27 16:45:00,2019-03-27 17:00:00
190,2,2,0,0.009739201978416519,2019-03-27 16:45:00,2019-03-27 17:00:00
191,2,1,1,0.003867367776883462,2019-03-27 16:45:00,2019-03-27 17:00:00
195,8,1,7,0.0034322568924613646,2019-03-27 16:45:00,2019-03-27 17:00:00
196,6,2,4,0.005347588665463125,2019-03-27 16:45:00,2019-03-27 17:00:00
197,3,2,1,0.008279441978543616,2019-03-27 16:45:00,2019-03-27 17:00:00
200,1,0,1,0.002408551568008361,2019-03-27 16:45:00,2019-03-27 17:00:00
201,4,2,2,0.007680598044298739,2019-03-27 16:45:00,2019-03-27 17:00:00
202,3,1,2,0.004189036790628532,2019-03-27 16:45:00,2019-03-27 17:00:00
203,1,1,0,0.003895140782073387,2019-03-27 16:45:00,2019-03-27 17:00:00
1,1,0,1,0.002131668886492583,2019-03-27 17:00:00,2019-03-27 17:15:00
2,4,2,2,0.004567469337304538,2019-03-27 17:00:00,2019-03-27 17:15:00
5,3,2,1,0.0063142251549629476,2019-03-27 17:00:00,2019-03-27 17:15:00
10,1,0,1,0.002131668886492583,2019-03-27 17:00:00,2019-03-27 17:15:00
11,1,1,0,0.0068620038268159995,2019-03-27 17:00:00,2019-03-27 17:15:00
15,10,8,2,0.03434630843251739,2019-03-27 17:00:00,2019-03-27 17:15:00
16,4,3,1,0.008211266954099954,2019-03-27 17:00:00,2019-03-27 17:15:00
18,7,5,2,0.03890917871555734,2019-03-27 17:00:00,2019-03-27 17:15:00
19,5,3,2,0.0077068327545385396,2019-03-27 17:00:00,2019-03-27 17:15:00
20,5,3,2,0.016959932288095756,2019-03-27 17:00:00,2019-03-27 17:15:00
21,2,0,2,0.002131668886492583,2019-03-27 17:00:00,2019-03-27 17:15:00
22,1,0,1,0.002131668886492583,2019-03-27 17:00:00,2019-03-27 17:15:00
23,5,3,2,0.0080971070442186,2019-03-27 17:00:00,2019-03-27 17:15:00
26,2,1,1,0.004356324020544821,2019-03-27 17:00:00,2019-03-27 17:15:00
27,2,2,0,0.0056487349059550366,2019-03-27 17:00:00,2019-03-27 17:15:00
28,1,1,0,0.006018706773003602,2019-03-27 17:00:00,2019-03-27 17:15:00
30,2,2,0,0.0035963786872077784,2019-03-27 17:00:00,2019-03-27 17:15:00
35,2,1,1,0.002747589154120593,2019-03-27 17:00:00,2019-03-27 17:15:00
37,11,3,8,0.014068326911670405,2019-03-27 17:00:00,2019-03-27 17:15:00
40,1,0,1,0.002131668886492583,2019-03-27 17:00:00,2019-03-27 17:15:00
41,6,3,3,0.016693585509879188,2019-03-27 17:00:00,2019-03-27 17:15:00
46,12,6,6,0.02098395470039102,2019-03-27 17:00:00,2019-03-27 17:15:00
57,4,4,0,0.006391217063770954,2019-03-27 17:00:00,2019-03-27 17:15:00
58,5,4,1,0.02090429166124394,2019-03-27 17:00:00,2019-03-27 17:15:00
61,4,3,1,0.007042823831711833,2019-03-27 17:00:00,2019-03-27 17:15:00
62,3,2,1,0.0038983779787036435,2019-03-27 17:00:00,2019-03-27 17:15:00
64,5,3,2,0.007614844839361101,2019-03-27 17:00:00,2019-03-27 17:15:00
66,2,1,1,0.004572679381474138,2019-03-27 17:00:00,2019-03-27 17:15:00
67,7,4,3,0.008799468469644661,2019-03-27 17:00:00,2019-03-27 17:15:00
68,4,2,2,0.005504931589377429,2019-03-27 17:00:00,2019-03-27 17:15:00
69,6,1,5,0.0025682991980118955,2019-03-27 17:00:00,2019-03-27 17:15:00
70,2,1,1,0.004625076472533874,2019-03-27 17:00:00,2019-03-27 17:15:00
75,1,0,1,0.002131668886492583,2019-03-27 17:00:00,2019-03-27 17:15:00
85,1,0,1,0.002131668886492583,2019-03-27 17:00:00,2019-03-27 17:15:00
87,3,2,1,0.017848323095558033,2019-03-27 17:00:00,2019-03-27 17:15:00
88,3,2,1,0.009978307762604123,2019-03-27 17:00:00,2019-03-27 17:15:00
89,6,5,1,0.01788310085500213,2019-03-27 17:00:00,2019-03-27 17:15:00
90,3,2,1,0.0063838786714335745,2019-03-27 17:00:00,2019-03-27 17:15:00
99,1,1,0,0.004625076472533874,2019-03-27 17:00:00,2019-03-27 17:15:00
101,3,1,2,0.0037073900068210494,2019-03-27 17:00:00,2019-03-27 17:15:00
104,4,4,0,0.011243671691974908,2019-03-27 17:00:00,2019-03-27 17:15:00
106,2,1,1,0.0067282530944301625,2019-03-27 17:00:00,2019-03-27 17:15:00
108,2,1,1,0.00540733829165055,2019-03-27 17:00:00,2019-03-27 17:15:00
109,7,3,4,0.009827400803132932,2019-03-27 17:00:00,2019-03-27 17:15:00
110,5,3,2,0.0134406161961741,2019-03-27 17:00:00,2019-03-27 17:15:00
111,9,4,5,0.01626338283933289,2019-03-27 17:00:00,2019-03-27 17:15:00
112,4,1,3,0.003943664635467772,2019-03-27 17:00:00,2019-03-27 17:15:00
113,3,1,2,0.0037073900068210494,2019-03-27 17:00:00,2019-03-27 17:15:00
114,1,0,1,0.002131668886492583,2019-03-27 17:00:00,2019-03-27 17:15:00
115,6,0,6,0.002131668886492583,2019-03-27 17:00:00,2019-03-27 17:15:00
116,3,0,3,0.002131668886492583,2019-03-27 17:00:00,2019-03-27 17:15:00
118,3,1,2,0.005104727833350605,2019-03-27 17:00:00,2019-03-27 17:15:00
119,8,3,5,0.01308505636156286,2019-03-27 17:00:00,2019-03-27 17:15:00
120,3,1,2,0.004502229405987759,2019-03-27 17:00:00,2019-03-27 17:15:00
122,8,4,4,0.014189895481769391,2019-03-27 17:00:00,2019-03-27 17:15:00
126,7,1,6,0.01673089924310283,2019-03-27 17:00:00,2019-03-27 17:15:00
127,7,4,3,0.01769730407649239,2019-03-27 17:00:00,2019-03-27 17:15:00
129,3,2,1,0.019503857709269268,2019-03-27 17:00:00,2019-03-27 17:15:00
135,3,2,1,0.0033396660524760424,2019-03-27 17:00:00,2019-03-27 17:15:00
137,18,9,9,0.022590503059623294,2019-03-27 17:00:00,2019-03-27 17:15:00
138,5,3,2,0.007083803478041286,2019-03-27 17:00:00,2019-03-27 17:15:00
140,1,0,1,0.002131668886492583,2019-03-27 17:00:00,2019-03-27 17:15:00
141,6,4,2,0.013730379311823093,2019-03-27 17:00:00,2019-03-27 17:15:00
147,5,4,1,0.007520722165317523,2019-03-27 17:00:00,2019-03-27 17:15:00
151,1,1,0,0.0054454472477448446,2019-03-27 17:00:00,2019-03-27 17:15:00
153,7,3,4,0.0076873826189561975,2019-03-27 17:00:00,2019-03-27 17:15:00
154,5,0,5,0.002131668886492583,2019-03-27 17:00:00,2019-03-27 17:15:00
157,3,2,1,0.03361951550850233,2019-03-27 17:00:00,2019-03-27 17:15:00
161,2,1,1,0.014131815516189708,2019-03-27 17:00:00,2019-03-27 17:15:00
162,4,4,0,0.01148366282137461,2019-03-27 17:00:00,2019-03-27 17:15:00
164,10,2,8,0.005796330653326147,2019-03-27 17:00:00,2019-03-27 17:15:00
168,5,2,3,0.0052478578676878156,2019-03-27 17:00:00,2019-03-27 17:15:00
170,7,2,5,0.02334495237542961,2019-03-27 17:00:00,2019-03-27 17:15:00
171,2,2,0,0.005240996740161883,2019-03-27 17:00:00,2019-03-27 17:15:00
172,1,1,0,0.004572679381474138,2019-03-27 17:00:00,2019-03-27 17:15:00
173,8,4,4,0.011486255623392602,2019-03-27 17:00:00,2019-03-27 17:15:00
177,1,1,0,0.004502229405987759,2019-03-27 17:00:00,2019-03-27 17:15:00
189,4,1,3,0.0036266100285678045,2019-03-27 17:00:00,2019-03-27 17:15:00
191,2,1,1,0.004045327742775544,2019-03-27 17:00:00,2019-03-27 17:15:00
195,3,0,3,0.002131668886492583,2019-03-27 17:00:00,2019-03-27 17:15:00
196,3,1,2,0.0027356674694843128,2019-03-27 17:00:00,2019-03-27 17:15:00
197,2,2,0,0.007704284644745619,2019-03-27 17:00:00,2019-03-27 17:15:00
199,1,0,1,0.002131668886492583,2019-03-27 17:00:00,2019-03-27 17:15:00
200,1,0,1,0.002131668886492583,2019-03-27 17:00:00,2019-03-27 17:15:00
201,2,1,1,0.00407301378562657,2019-03-27 17:00:00,2019-03-27 17:15:00
202,5,2,3,0.0049196452524677406,2019-03-27 17:00:00,2019-03-27 17:15:00
203,1,1,0,0.002747589154120593,2019-03-27 17:00:00,2019-03-27 17:15:00
2,4,3,1,0.010541887711594165,2019-03-27 17:15:00,2019-03-27 17:30:00
5,6,6,0,0.01197916280080381,2019-03-27 17:15:00,2019-03-27 17:30:00
10,2,1,1,0.018564358189768874,2019-03-27 17:15:00,2019-03-27 17:30:00
11,1,1,0,0.004568564397802121,2019-03-27 17:15:00,2019-03-27 17:30:00
15,8,6,2,0.008944853904146325,2019-03-27 17:15:00,2019-03-27 17:30:00
16,9,4,5,0.007986626865874213,2019-03-27 17:15:00,2019-03-27 17:30:00
18,8,6,2,0.03490779850313718,2019-03-27 17:15:00,2019-03-27 17:30:00
19,8,3,5,0.008708764320404535,2019-03-27 17:15:00,2019-03-27 17:30:00
20,7,2,5,0.006950616401314625,2019-03-27 17:15:00,2019-03-27 17:30:00
21,3,1,2,0.0038028460906939297,2019-03-27 17:15:00,2019-03-27 17:30:00
23,4,2,2,0.003909949479868469,2019-03-27 17:15:00,2019-03-27 17:30:00
26,3,0,3,0.002186512394289616,2019-03-27 17:15:00,2019-03-27 17:30:00
27,2,2,0,0.01207759536950247,2019-03-27 17:15:00,2019-03-27 17:30:00
28,1,1,0,0.0026511758436927593,2019-03-27 17:15:00,2019-03-27 17:30:00
30,4,4,0,0.0061207042002141485,2019-03-27 17:15:00,2019-03-27 17:30:00
35,3,2,1,0.023586333490200916,2019-03-27 17:15:00,2019-03-27 17:30:00
37,5,1,4,0.0027765745289123045,2019-03-27 17:15:00,2019-03-27 17:30:00
40,8,3,5,0.004462659856958031,2019-03-27 17:15:00,2019-03-27 17:30:00
41,16,9,7,0.019612954772421982,2019-03-27 17:15:00,2019-03-27 17:30:00
46,11,6,5,0.01579553343367754,2019-03-27 17:15:00,2019-03-27 17:30:00
50,1,0,1,0.002186512394289616,2019-03-27 17:15:00,2019-03-27 17:30:00
57,4,1,3,0.0029732619071198675,2019-03-27 17:15:00,2019-03-27 17:30:00
58,7,3,4,0.022078737624992253,2019-03-27 17:15:00,2019-03-27 17:30:00
61,4,3,1,0.0037353905589667604,2019-03-27 17:15:00,2019-03-27 17:30:00
62,5,2,3,0.003923920555034344,2019-03-27 17:15:00,2019-03-27 17:30:00
64,4,2,2,0.006164737506799843,2019-03-27 17:15:00,2019-03-27 17:30:00
66,2,2,0,0.006697910583470487,2019-03-27 17:15:00,2019-03-27 17:30:00
67,3,1,2,0.004806814458171542,2019-03-27 17:15:00,2019-03-27 17:30:00
68,3,1,2,0.00353462138823149,2019-03-27 17:15:00,2019-03-27 17:30:00
69,7,1,6,0.002547420897918155,2019-03-27 17:15:00,2019-03-27 17:30:00
70,2,1,1,0.005755500405744733,2019-03-27 17:15:00,2019-03-27 17:30:00
86,1,1,0,0.002547420897918155,2019-03-27 17:15:00,2019-03-27 17:30:00
88,2,1,1,0.014559629035771167,2019-03-27 17:15:00,2019-03-27 17:30:00
89,4,3,1,0.005831635493502125,2019-03-27 17:15:00,2019-03-27 17:30:00
90,5,4,1,0.008180975357683442,2019-03-27 17:15:00,2019-03-27 17:30:00
99,1,1,0,0.004229618632422329,2019-03-27 17:15:00,2019-03-27 17:30:00
101,3,1,2,0.0038028460906939297,2019-03-27 17:15:00,2019-03-27 17:30:00
104,3,2,1,0.005665124385214578,2019-03-27 17:15:00,2019-03-27 17:30:00
108,1,1,0,0.0036672262548095814,2019-03-27 17:15:00,2019-03-27 17:30:00
109,8,4,4,0.01344897788379438,2019-03-27 17:15:00,2019-03-27 17:30:00
110,3,2,1,0.008993412407137146,2019-03-27 17:15:00,2019-03-27 17:30:00
111,9,5,4,0.011113301991522502,2019-03-27 17:15:00,2019-03-27 17:30:00
112,4,2,2,0.008395986214143626,2019-03-27 17:15:00,2019-03-27 17:30:00
113,2,0,2,0.002186512394289616,2019-03-27 17:15:00,2019-03-27 17:30:00
114,2,1,1,0.006879266649234803,2019-03-27 17:15:00,2019-03-27 17:30:00
115,6,0,6,0.002186512394289616,2019-03-27 17:15:00,2019-03-27 17:30:00
116,4,0,4,0.002186512394289616,2019-03-27 17:15:00,2019-03-27 17:30:00
118,1,0,1,0.002186512394289616,2019-03-27 17:15:00,2019-03-27 17:30:00
119,5,2,3,0.01008758162068974,2019-03-27 17:15:00,2019-03-27 17:30:00
120,2,1,1,0.003459257105631201,2019-03-27 17:15:00,2019-03-27 17:30:00
122,10,5,5,0.011051370534736668,2019-03-27 17:15:00,2019-03-27 17:30:00
126,5,1,4,0.005988600863455193,2019-03-27 17:15:00,2019-03-27 17:30:00
127,6,3,3,0.013760434369639158,2019-03-27 17:15:00,2019-03-27 17:30:00
129,2,2,0,0.009002595664843604,2019-03-27 17:15:00,2019-03-27 17:30:00
133,1,0,1,0.002186512394289616,2019-03-27 17:15:00,2019-03-27 17:30:00
135,3,2,1,0.0034256149260313315,2019-03-27 17:15:00,2019-03-27 17:30:00
137,14,8,6,0.007699783681860854,2019-03-27 17:15:00,2019-03-27 17:30:00
138,14,6,8,0.012685701312422012,2019-03-27 17:15:00,2019-03-27 17:30:00
140,1,0,1,0.002186512394289616,2019-03-27 17:15:00,2019-03-27 17:30:00
141,5,4,1,0.03358281423446316,2019-03-27 17:15:00,2019-03-27 17:30:00
147,4,3,1,0.005491638783402588,2019-03-27 17:15:00,2019-03-27 17:30:00
151,1,1,0,0.0032983978787417727,2019-03-27 17:15:00,2019-03-27 17:30:00
153,5,2,3,0.007670057371937681,2019-03-27 17:15:00,2019-03-27 17:30:00
154,8,2,6,0.004316250713803622,2019-03-27 17:15:00,2019-03-27 17:30:00
157,6,5,1,0.056001073945365513,2019-03-27 17:15:00,2019-03-27 17:30:00
158,4,4,0,0.007844158103213296,2019-03-27 17:15:00,2019-03-27 17:30:00
161,2,1,1,0.014559629035771167,2019-03-27 17:15:00,2019-03-27 17:30:00
162,9,6,3,0.05783242083107429,2019-03-27 17:15:00,2019-03-27 17:30:00
164,4,1,3,0.0027765745289123045,2019-03-27 17:15:00,2019-03-27 17:30:00
168,3,0,3,0.002186512394289616,2019-03-27 17:15:00,2019-03-27 17:30:00
170,9,3,6,0.010714643077299175,2019-03-27 17:15:00,2019-03-27 17:30:00
171,2,2,0,0.005016368145252579,2019-03-27 17:15:00,2019-03-27 17:30:00
173,5,2,3,0.005644590896200856,2019-03-27 17:15:00,2019-03-27 17:30:00
177,4,2,2,0.014559629035771167,2019-03-27 17:15:00,2019-03-27 17:30:00
189,2,0,2,0.002186512394289616,2019-03-27 17:15:00,2019-03-27 17:30:00
190,3,1,2,0.0038028460906939297,2019-03-27 17:15:00,2019-03-27 17:30:00
191,3,1,2,0.005127173964919976,2019-03-27 17:15:00,2019-03-27 17:30:00
195,3,0,3,0.002186512394289616,2019-03-27 17:15:00,2019-03-27 17:30:00
196,2,1,1,0.0028060636601604737,2019-03-27 17:15:00,2019-03-27 17:30:00
197,3,3,0,0.006568605192784441,2019-03-27 17:15:00,2019-03-27 17:30:00
199,2,1,1,0.006085907115208547,2019-03-27 17:15:00,2019-03-27 17:30:00
201,2,1,1,0.00353462138823149,2019-03-27 17:15:00,2019-03-27 17:30:00
202,4,2,2,0.005700416449273153,2019-03-27 17:15:00,2019-03-27 17:30:00
203,2,1,1,0.0038028460906939297,2019-03-27 17:15:00,2019-03-27 17:30:00
1,3,2,1,0.006067200716716448,2019-03-27 17:30:00,2019-03-27 17:45:00
2,5,2,3,0.017259536323929615,2019-03-27 17:30:00,2019-03-27 17:45:00
5,5,5,0,0.01088040321695873,2019-03-27 17:30:00,2019-03-27 17:45:00
10,1,1,0,0.005099516340298569,2019-03-27 17:30:00,2019-03-27 17:45:00
11,1,1,0,0.003753418409528198,2019-03-27 17:30:00,2019-03-27 17:45:00
15,5,2,3,0.00601096862040496,2019-03-27 17:30:00,2019-03-27 17:45:00
16,6,2,4,0.006133462045456302,2019-03-27 17:30:00,2019-03-27 17:45:00
18,8,5,3,0.026991106421731918,2019-03-27 17:30:00,2019-03-27 17:45:00
19,13,3,10,0.004954687965087131,2019-03-27 17:30:00,2019-03-27 17:45:00
20,1,0,1,0.002377666905532765,2019-03-27 17:30:00,2019-03-27 17:45:00
23,4,2,2,0.010859912495797,2019-03-27 17:30:00,2019-03-27 17:45:00
26,3,0,3,0.002377666905532765,2019-03-27 17:30:00,2019-03-27 17:45:00
27,1,1,0,0.007268640526966845,2019-03-27 17:30:00,2019-03-27 17:45:00
28,2,2,0,0.0059901826455634865,2019-03-27 17:30:00,2019-03-27 17:45:00
30,4,3,1,0.004129338810714268,2019-03-27 17:30:00,2019-03-27 17:45:00
35,2,2,0,0.005245779357004199,2019-03-27 17:30:00,2019-03-27 17:45:00
37,3,1,2,0.0041353323407859865,2019-03-27 17:30:00,2019-03-27 17:45:00
40,6,2,4,0.007767762168547259,2019-03-27 17:30:00,2019-03-27 17:45:00
41,9,5,4,0.03467881258778719,2019-03-27 17:30:00,2019-03-27 17:45:00
46,10,6,4,0.017637421148888353,2019-03-27 17:30:00,2019-03-27 17:45:00
50,1,0,1,0.002377666905532765,2019-03-27 17:30:00,2019-03-27 17:45:00
57,5,2,3,0.010447765316391123,2019-03-27 17:30:00,2019-03-27 17:45:00
58,4,2,2,0.006307981943952162,2019-03-27 17:30:00,2019-03-27 17:45:00
61,1,1,0,0.0027988598106452006,2019-03-27 17:30:00,2019-03-27 17:45:00
62,4,2,2,0.007821365775064372,2019-03-27 17:30:00,2019-03-27 17:45:00
64,3,1,2,0.0064731307807583925,2019-03-27 17:30:00,2019-03-27 17:45:00
66,1,1,0,0.005544250010596082,2019-03-27 17:30:00,2019-03-27 17:45:00
67,2,2,0,0.007150329804117673,2019-03-27 17:30:00,2019-03-27 17:45:00
68,3,1,2,0.004081022750662288,2019-03-27 17:30:00,2019-03-27 17:45:00
69,3,1,2,0.005298171798927134,2019-03-27 17:30:00,2019-03-27 17:45:00
70,1,1,0,0.005298171798927134,2019-03-27 17:30:00,2019-03-27 17:45:00
86,2,2,0,0.0032200527157576356,2019-03-27 17:30:00,2019-03-27 17:45:00
89,1,1,0,0.0036811527635124968,2019-03-27 17:30:00,2019-03-27 17:45:00
90,4,3,1,0.01175244758797405,2019-03-27 17:30:00,2019-03-27 17:45:00
101,3,1,2,0.0041353323407859865,2019-03-27 17:30:00,2019-03-27 17:45:00
104,3,2,1,0.008958306981884736,2019-03-27 17:30:00,2019-03-27 17:45:00
106,1,0,1,0.002377666905532765,2019-03-27 17:30:00,2019-03-27 17:45:00
109,12,6,6,0.018509756929422878,2019-03-27 17:30:00,2019-03-27 17:45:00
110,4,4,0,0.008359585134580533,2019-03-27 17:30:00,2019-03-27 17:45:00
111,10,6,4,0.01926959896977624,2019-03-27 17:30:00,2019-03-27 17:45:00
112,6,3,3,0.010306159464446445,2019-03-27 17:30:00,2019-03-27 17:45:00
113,1,0,1,0.002377666905532765,2019-03-27 17:30:00,2019-03-27 17:45:00
114,2,1,1,0.005058985608196733,2019-03-27 17:30:00,2019-03-27 17:45:00
115,5,0,5,0.002377666905532765,2019-03-27 17:30:00,2019-03-27 17:45:00
116,1,0,1,0.002377666905532765,2019-03-27 17:30:00,2019-03-27 17:45:00
118,1,0,1,0.002377666905532765,2019-03-27 17:30:00,2019-03-27 17:45:00
119,1,1,0,0.006116961617830719,2019-03-27 17:30:00,2019-03-27 17:45:00
120,3,1,2,0.004046040826122407,2019-03-27 17:30:00,2019-03-27 17:45:00
122,6,3,3,0.01582787236881143,2019-03-27 17:30:00,2019-03-27 17:45:00
126,4,1,3,0.005887876974936864,2019-03-27 17:30:00,2019-03-27 17:45:00
127,4,1,3,0.00999358991300757,2019-03-27 17:30:00,2019-03-27 17:45:00
129,2,1,1,0.004398826796126807,2019-03-27 17:30:00,2019-03-27 17:45:00
133,1,0,1,0.002377666905532765,2019-03-27 17:30:00,2019-03-27 17:45:00
135,3,2,1,0.0037251068325954598,2019-03-27 17:30:00,2019-03-27 17:45:00
137,7,5,2,0.009892150688562362,2019-03-27 17:30:00,2019-03-27 17:45:00
138,18,10,8,0.02765413997035084,2019-03-27 17:30:00,2019-03-27 17:45:00
140,1,0,1,0.002377666905532765,2019-03-27 17:30:00,2019-03-27 17:45:00
141,3,2,1,0.029278077832090094,2019-03-27 17:30:00,2019-03-27 17:45:00
147,2,2,0,0.003186130861770382,2019-03-27 17:30:00,2019-03-27 17:45:00
151,1,1,0,0.0057023519610923555,2019-03-27 17:30:00,2019-03-27 17:45:00
153,5,1,4,0.0064731307807583925,2019-03-27 17:30:00,2019-03-27 17:45:00
154,4,1,3,0.005209704320242134,2019-03-27 17:30:00,2019-03-27 17:45:00
157,5,4,1,0.06856611907050557,2019-03-27 17:30:00,2019-03-27 17:45:00
158,4,2,2,0.008255258458531513,2019-03-27 17:30:00,2019-03-27 17:45:00
161,2,1,1,0.01582787236881143,2019-03-27 17:30:00,2019-03-27 17:45:00
162,8,4,4,0.01280629193072102,2019-03-27 17:30:00,2019-03-27 17:45:00
164,1,1,0,0.00500038867510794,2019-03-27 17:30:00,2019-03-27 17:45:00
168,1,0,1,0.002377666905532765,2019-03-27 17:30:00,2019-03-27 17:45:00
170,5,3,2,0.00709644616414638,2019-03-27 17:30:00,2019-03-27 17:45:00
173,3,2,1,0.029278077832090094,2019-03-27 17:30:00,2019-03-27 17:45:00
177,4,2,2,0.01582787236881143,2019-03-27 17:30:00,2019-03-27 17:45:00
189,2,0,2,0.002377666905532765,2019-03-27 17:30:00,2019-03-27 17:45:00
190,1,0,1,0.002377666905532765,2019-03-27 17:30:00,2019-03-27 17:45:00
191,4,1,3,0.010026572411278687,2019-03-27 17:30:00,2019-03-27 17:45:00
195,3,0,3,0.002377666905532765,2019-03-27 17:30:00,2019-03-27 17:45:00
196,1,1,0,0.0030513868690641125,2019-03-27 17:30:00,2019-03-27 17:45:00
201,3,1,2,0.0036811527635124968,2019-03-27 17:30:00,2019-03-27 17:45:00
202,2,1,1,0.006582495343862266,2019-03-27 17:30:00,2019-03-27 17:45:00
203,2,1,1,0.004398826796126807,2019-03-27 17:30:00,2019-03-27 17:45:00
1,2,1,1,0.004513159998842537,2019-03-27 17:45:00,2019-03-27 18:00:00
2,4,1,3,0.0038304803370612806,2019-03-27 17:45:00,2019-03-27 18:00:00
5,8,6,2,0.015961203116853537,2019-03-27 17:45:00,2019-03-27 18:00:00
10,1,1,0,0.006490710781817273,2019-03-27 17:45:00,2019-03-27 18:00:00
11,1,1,0,0.003984626219525359,2019-03-27 17:45:00,2019-03-27 18:00:00
15,3,2,1,0.004440753279878858,2019-03-27 17:45:00,2019-03-27 18:00:00
16,3,1,2,0.005078589941531009,2019-03-27 17:45:00,2019-03-27 18:00:00
18,4,2,2,0.0066623257524653,2019-03-27 17:45:00,2019-03-27 18:00:00
19,10,2,8,0.008629544236804803,2019-03-27 17:45:00,2019-03-27 18:00:00
21,3,1,2,0.00477442880886262,2019-03-27 17:45:00,2019-03-27 18:00:00
22,1,1,0,0.005078589941531009,2019-03-27 17:45:00,2019-03-27 18:00:00
23,4,4,0,0.012377582531691494,2019-03-27 17:45:00,2019-03-27 18:00:00
26,1,0,1,0.0027450644176972554,2019-03-27 17:45:00,2019-03-27 18:00:00
27,3,3,0,0.008799077186248618,2019-03-27 17:45:00,2019-03-27 18:00:00
28,3,3,0,0.013584107564526124,2019-03-27 17:45:00,2019-03-27 18:00:00
30,2,2,0,0.005552270650140538,2019-03-27 17:45:00,2019-03-27 18:00:00
35,1,1,0,0.006913660071585443,2019-03-27 17:45:00,2019-03-27 18:00:00
37,2,1,1,0.01827038224988665,2019-03-27 17:45:00,2019-03-27 18:00:00
40,4,1,3,0.005078589941531009,2019-03-27 17:45:00,2019-03-27 18:00:00
41,8,4,4,0.014014280298332056,2019-03-27 17:45:00,2019-03-27 18:00:00
46,9,5,4,0.014583419381895911,2019-03-27 17:45:00,2019-03-27 18:00:00
57,3,1,2,0.005576909833101275,2019-03-27 17:45:00,2019-03-27 18:00:00
58,2,2,0,0.004369433363381164,2019-03-27 17:45:00,2019-03-27 18:00:00
61,2,1,1,0.0036620689647655254,2019-03-27 17:45:00,2019-03-27 18:00:00
62,2,2,0,0.01023635714593729,2019-03-27 17:45:00,2019-03-27 18:00:00
64,3,1,2,0.00477442880886262,2019-03-27 17:45:00,2019-03-27 18:00:00
67,6,4,2,0.010433343997787729,2019-03-27 17:45:00,2019-03-27 18:00:00
68,3,1,2,0.006520120093934026,2019-03-27 17:45:00,2019-03-27 18:00:00
69,2,1,1,0.006432075880039186,2019-03-27 17:45:00,2019-03-27 18:00:00
70,1,1,0,0.0071797600857762415,2019-03-27 17:45:00,2019-03-27 18:00:00
86,2,2,0,0.004579073511833795,2019-03-27 17:45:00,2019-03-27 18:00:00
88,1,1,0,0.005918787274705621,2019-03-27 17:45:00,2019-03-27 18:00:00
90,1,1,0,0.004151529501713172,2019-03-27 17:45:00,2019-03-27 18:00:00
99,1,1,0,0.0049036913208717345,2019-03-27 17:45:00,2019-03-27 18:00:00
101,3,1,2,0.00477442880886262,2019-03-27 17:45:00,2019-03-27 18:00:00
104,3,1,2,0.005844536654162421,2019-03-27 17:45:00,2019-03-27 18:00:00
106,1,0,1,0.0027450644176972554,2019-03-27 17:45:00,2019-03-27 18:00:00
109,6,2,4,0.004650393428331489,2019-03-27 17:45:00,2019-03-27 18:00:00
110,1,1,0,0.004151529501713172,2019-03-27 17:45:00,2019-03-27 18:00:00
111,4,3,1,0.007062318224046214,2019-03-27 17:45:00,2019-03-27 18:00:00
112,4,2,2,0.008674168494473177,2019-03-27 17:45:00,2019-03-27 18:00:00
113,2,0,2,0.0027450644176972554,2019-03-27 17:45:00,2019-03-27 18:00:00
114,2,1,1,0.005516443715715559,2019-03-27 17:45:00,2019-03-27 18:00:00
115,3,0,3,0.0027450644176972554,2019-03-27 17:45:00,2019-03-27 18:00:00
116,1,1,0,0.004513159998842537,2019-03-27 17:45:00,2019-03-27 18:00:00
119,5,1,4,0.003328445798655694,2019-03-27 17:45:00,2019-03-27 18:00:00
120,4,0,4,0.0027450644176972554,2019-03-27 17:45:00,2019-03-27 18:00:00
122,3,2,1,0.03262893732015916,2019-03-27 17:45:00,2019-03-27 18:00:00
126,4,2,2,0.004159793214928533,2019-03-27 17:45:00,2019-03-27 18:00:00
127,2,1,1,0.003984626219525359,2019-03-27 17:45:00,2019-03-27 18:00:00
129,1,0,1,0.0027450644176972554,2019-03-27 17:45:00,2019-03-27 18:00:00
135,2,2,0,0.004300748100253091,2019-03-27 17:45:00,2019-03-27 18:00:00
137,6,1,5,0.008272018588425354,2019-03-27 17:45:00,2019-03-27 18:00:00
138,9,6,3,0.01950390659026936,2019-03-27 17:45:00,2019-03-27 18:00:00
140,1,0,1,0.0027450644176972554,2019-03-27 17:45:00,2019-03-27 18:00:00
141,7,5,2,0.04314045338051422,2019-03-27 17:45:00,2019-03-27 18:00:00
147,1,0,1,0.0027450644176972554,2019-03-27 17:45:00,2019-03-27 18:00:00
153,7,1,6,0.008748730201639876,2019-03-27 17:45:00,2019-03-27 18:00:00
154,1,1,0,0.006132383591767694,2019-03-27 17:45:00,2019-03-27 18:00:00
157,2,1,1,0.01827038224988665,2019-03-27 17:45:00,2019-03-27 18:00:00
158,1,1,0,0.004769345385151676,2019-03-27 17:45:00,2019-03-27 18:00:00
159,1,0,1,0.0027450644176972554,2019-03-27 17:45:00,2019-03-27 18:00:00
161,2,1,1,0.01827038224988665,2019-03-27 17:45:00,2019-03-27 18:00:00
162,7,4,3,0.013217864797401198,2019-03-27 17:45:00,2019-03-27 18:00:00
164,2,1,1,0.0037333888812632193,2019-03-27 17:45:00,2019-03-27 18:00:00
170,4,2,2,0.004762468060803276,2019-03-27 17:45:00,2019-03-27 18:00:00
171,3,1,2,0.005078589941531009,2019-03-27 17:45:00,2019-03-27 18:00:00
172,1,0,1,0.0027450644176972554,2019-03-27 17:45:00,2019-03-27 18:00:00
173,3,1,2,0.00477442880886262,2019-03-27 17:45:00,2019-03-27 18:00:00
189,2,0,2,0.0027450644176972554,2019-03-27 17:45:00,2019-03-27 18:00:00
190,1,0,1,0.0027450644176972554,2019-03-27 17:45:00,2019-03-27 18:00:00
191,2,1,1,0.005115548715972113,2019-03-27 17:45:00,2019-03-27 18:00:00
195,3,0,3,0.0027450644176972554,2019-03-27 17:45:00,2019-03-27 18:00:00
196,1,1,0,0.003522906258975173,2019-03-27 17:45:00,2019-03-27 18:00:00
197,3,2,1,0.06334280956015319,2019-03-27 17:45:00,2019-03-27 18:00:00
199,1,1,0,0.003984626219525359,2019-03-27 17:45:00,2019-03-27 18:00:00
201,2,1,1,0.0049036913208717345,2019-03-27 17:45:00,2019-03-27 18:00:00
202,1,1,0,0.004151529501713172,2019-03-27 17:45:00,2019-03-27 18:00:00
203,3,2,1,0.033795700082076045,2019-03-27 17:45:00,2019-03-27 18:00:00
1,2,0,2,0.0023550333408833644,2019-03-27 18:00:00,2019-03-27 18:15:00
2,7,2,5,0.0035684058644114922,2019-03-27 18:00:00,2019-03-27 18:15:00
5,4,3,1,0.012527458740785521,2019-03-27 18:00:00,2019-03-27 18:15:00
11,3,2,1,0.036187422438592916,2019-03-27 18:00:00,2019-03-27 18:15:00
15,3,1,2,0.004096015650503683,2019-03-27 18:00:00,2019-03-27 18:15:00
16,3,3,0,0.00684132588771373,2019-03-27 18:00:00,2019-03-27 18:15:00
18,7,4,3,0.013917510391612025,2019-03-27 18:00:00,2019-03-27 18:15:00
19,5,1,4,0.005317714852967094,2019-03-27 18:00:00,2019-03-27 18:15:00
21,2,1,1,0.004356976314585152,2019-03-27 18:00:00,2019-03-27 18:15:00
22,3,1,2,0.004096015650503683,2019-03-27 18:00:00,2019-03-27 18:15:00
23,8,5,3,0.02186573009838015,2019-03-27 18:00:00,2019-03-27 18:15:00
26,3,2,1,0.027134516469225572,2019-03-27 18:00:00,2019-03-27 18:15:00
27,1,1,0,0.0029617196026474283,2019-03-27 18:00:00,2019-03-27 18:15:00
28,4,2,2,0.02917161755550318,2019-03-27 18:00:00,2019-03-27 18:15:00
30,3,2,1,0.006824288805111241,2019-03-27 18:00:00,2019-03-27 18:15:00
35,4,2,2,0.008159187072035019,2019-03-27 18:00:00,2019-03-27 18:15:00
37,2,1,1,0.015682145790766662,2019-03-27 18:00:00,2019-03-27 18:15:00
40,7,1,6,0.0027437670091970253,2019-03-27 18:00:00,2019-03-27 18:15:00
41,8,4,4,0.017709377501065847,2019-03-27 18:00:00,2019-03-27 18:15:00
46,10,4,6,0.010021057373531279,2019-03-27 18:00:00,2019-03-27 18:15:00
57,5,2,3,0.004522168386718833,2019-03-27 18:00:00,2019-03-27 18:15:00
58,1,1,0,0.004276856721940954,2019-03-27 18:00:00,2019-03-27 18:15:00
61,2,1,1,0.0034851660492719776,2019-03-27 18:00:00,2019-03-27 18:15:00
62,2,1,1,0.00694216129105978,2019-03-27 18:00:00,2019-03-27 18:15:00
64,2,1,1,0.015682145790766662,2019-03-27 18:00:00,2019-03-27 18:15:00
66,2,1,1,0.0034386008638010988,2019-03-27 18:00:00,2019-03-27 18:15:00
67,3,2,1,0.005207889513731438,2019-03-27 18:00:00,2019-03-27 18:15:00
68,6,3,3,0.005766242923794721,2019-03-27 18:00:00,2019-03-27 18:15:00
69,2,0,2,0.0023550333408833644,2019-03-27 18:00:00,2019-03-27 18:15:00
75,2,2,0,0.004935260904922261,2019-03-27 18:00:00,2019-03-27 18:15:00
85,1,1,0,0.0027437670091970253,2019-03-27 18:00:00,2019-03-27 18:15:00
86,2,2,0,0.004615298757660591,2019-03-27 18:00:00,2019-03-27 18:15:00
88,3,3,0,0.010292572782488225,2019-03-27 18:00:00,2019-03-27 18:15:00
89,3,1,2,0.003356004827734258,2019-03-27 18:00:00,2019-03-27 18:15:00
90,3,2,1,0.005207889513731438,2019-03-27 18:00:00,2019-03-27 18:15:00
99,1,1,0,0.004206918026880544,2019-03-27 18:00:00,2019-03-27 18:15:00
101,3,1,2,0.004096015650503683,2019-03-27 18:00:00,2019-03-27 18:15:00
104,2,2,0,0.004775892714618681,2019-03-27 18:00:00,2019-03-27 18:15:00
109,5,3,2,0.018893322253380786,2019-03-27 18:00:00,2019-03-27 18:15:00
111,5,3,2,0.003521234345824348,2019-03-27 18:00:00,2019-03-27 18:15:00
112,3,1,2,0.00694216129105978,2019-03-27 18:00:00,2019-03-27 18:15:00
113,2,0,2,0.0023550333408833644,2019-03-27 18:00:00,2019-03-27 18:15:00
114,5,3,2,0.010791542814914267,2019-03-27 18:00:00,2019-03-27 18:15:00
115,3,1,2,0.006418204762414701,2019-03-27 18:00:00,2019-03-27 18:15:00
118,3,2,1,0.005408894129067762,2019-03-27 18:00:00,2019-03-27 18:15:00
119,4,1,3,0.00678217183837615,2019-03-27 18:00:00,2019-03-27 18:15:00
120,3,2,1,0.006559738840177701,2019-03-27 18:00:00,2019-03-27 18:15:00
122,4,1,3,0.003286211595055674,2019-03-27 18:00:00,2019-03-27 18:15:00
126,4,3,1,0.012395375883118296,2019-03-27 18:00:00,2019-03-27 18:15:00
127,1,1,0,0.003356004827734258,2019-03-27 18:00:00,2019-03-27 18:15:00
129,2,0,2,0.0023550333408833644,2019-03-27 18:00:00,2019-03-27 18:15:00
135,3,3,0,0.008287856099187807,2019-03-27 18:00:00,2019-03-27 18:15:00
137,10,3,7,0.008921660172216858,2019-03-27 18:00:00,2019-03-27 18:15:00
138,12,6,6,0.028675164188946098,2019-03-27 18:00:00,2019-03-27 18:15:00
140,1,0,1,0.0023550333408833644,2019-03-27 18:00:00,2019-03-27 18:15:00
141,5,4,1,0.055996497906956114,2019-03-27 18:00:00,2019-03-27 18:15:00
147,1,0,1,0.0023550333408833644,2019-03-27 18:00:00,2019-03-27 18:15:00
151,1,1,0,0.008551729121003116,2019-03-27 18:00:00,2019-03-27 18:15:00
153,6,3,3,0.010887270871119218,2019-03-27 18:00:00,2019-03-27 18:15:00
154,1,0,1,0.0023550333408833644,2019-03-27 18:00:00,2019-03-27 18:15:00
157,2,1,1,0.015682145790766662,2019-03-27 18:00:00,2019-03-27 18:15:00
159,1,0,1,0.0023550333408833644,2019-03-27 18:00:00,2019-03-27 18:15:00
161,2,1,1,0.015682145790766662,2019-03-27 18:00:00,2019-03-27 18:15:00
162,3,3,0,0.005906025423007294,2019-03-27 18:00:00,2019-03-27 18:15:00
164,2,0,2,0.0023550333408833644,2019-03-27 18:00:00,2019-03-27 18:15:00
170,6,1,5,0.002837439940310156,2019-03-27 18:00:00,2019-03-27 18:15:00
171,3,1,2,0.004356976314585152,2019-03-27 18:00:00,2019-03-27 18:15:00
172,4,2,2,0.009552700607854011,2019-03-27 18:00:00,2019-03-27 18:15:00
173,3,1,2,0.004096015650503683,2019-03-27 18:00:00,2019-03-27 18:15:00
177,1,1,0,0.008256801776020777,2019-03-27 18:00:00,2019-03-27 18:15:00
189,2,0,2,0.0023550333408833644,2019-03-27 18:00:00,2019-03-27 18:15:00
190,1,0,1,0.0023550333408833644,2019-03-27 18:00:00,2019-03-27 18:15:00
191,2,1,1,0.0036365269458607415,2019-03-27 18:00:00,2019-03-27 18:15:00
195,3,0,3,0.0023550333408833644,2019-03-27 18:00:00,2019-03-27 18:15:00
196,3,3,0,0.00398716086430421,2019-03-27 18:00:00,2019-03-27 18:15:00
197,5,2,3,0.018151329678937407,2019-03-27 18:00:00,2019-03-27 18:15:00
199,1,1,0,0.005440299290142115,2019-03-27 18:00:00,2019-03-27 18:15:00
202,3,3,0,0.005300957372145717,2019-03-27 18:00:00,2019-03-27 18:15:00
203,5,4,1,0.03971072777437667,2019-03-27 18:00:00,2019-03-27 18:15:00
1,3,1,2,0.0038717525066063307,2019-03-27 18:15:00,2019-03-27 18:30:00
2,6,2,4,0.004920025422029575,2019-03-27 18:15:00,2019-03-27 18:30:00
5,6,4,2,0.013421673638547377,2019-03-27 18:15:00,2019-03-27 18:30:00
10,1,1,0,0.008533930882488692,2019-03-27 18:15:00,2019-03-27 18:30:00
15,1,0,1,0.002828770024555646,2019-03-27 18:15:00,2019-03-27 18:30:00
16,5,4,1,0.010825420201593935,2019-03-27 18:15:00,2019-03-27 18:30:00
18,9,4,5,0.009179061458523817,2019-03-27 18:15:00,2019-03-27 18:30:00
19,4,0,4,0.002828770024555646,2019-03-27 18:15:00,2019-03-27 18:30:00
20,1,1,0,0.0038717525066063307,2019-03-27 18:15:00,2019-03-27 18:30:00
21,1,1,0,0.0052334592166020525,2019-03-27 18:15:00,2019-03-27 18:30:00
22,1,0,1,0.002828770024555646,2019-03-27 18:15:00,2019-03-27 18:30:00
23,7,3,4,0.009781116704801217,2019-03-27 18:15:00,2019-03-27 18:30:00
26,3,2,1,0.008294240809630295,2019-03-27 18:15:00,2019-03-27 18:30:00
27,1,1,0,0.0038743977232926106,2019-03-27 18:15:00,2019-03-27 18:30:00
28,4,2,2,0.006429132842868937,2019-03-27 18:15:00,2019-03-27 18:30:00
30,2,1,1,0.0052334592166020525,2019-03-27 18:15:00,2019-03-27 18:30:00
35,5,2,3,0.006540647268029669,2019-03-27 18:15:00,2019-03-27 18:30:00
37,2,2,0,0.006378970754435941,2019-03-27 18:15:00,2019-03-27 18:30:00
40,3,1,2,0.006490382268658541,2019-03-27 18:15:00,2019-03-27 18:30:00
41,6,2,4,0.004920025422029575,2019-03-27 18:15:00,2019-03-27 18:30:00
46,4,1,3,0.004920025422029575,2019-03-27 18:15:00,2019-03-27 18:30:00
57,6,2,4,0.007078222985290748,2019-03-27 18:15:00,2019-03-27 18:30:00
58,2,1,1,0.0034299423225672477,2019-03-27 18:15:00,2019-03-27 18:30:00
62,3,1,2,0.006397586906509184,2019-03-27 18:15:00,2019-03-27 18:30:00
66,2,1,1,0.004953496504923197,2019-03-27 18:15:00,2019-03-27 18:30:00
67,3,1,2,0.004031114620578849,2019-03-27 18:15:00,2019-03-27 18:30:00
68,5,3,2,0.009496589737490914,2019-03-27 18:15:00,2019-03-27 18:30:00
69,4,1,3,0.009015538819999044,2019-03-27 18:15:00,2019-03-27 18:30:00
75,4,4,0,0.007047269095493311,2019-03-27 18:15:00,2019-03-27 18:30:00
85,4,3,1,0.06381307404117356,2019-03-27 18:15:00,2019-03-27 18:30:00
86,2,2,0,0.004031114620578849,2019-03-27 18:15:00,2019-03-27 18:30:00
88,5,3,2,0.008614369560713458,2019-03-27 18:15:00,2019-03-27 18:30:00
89,2,2,0,0.005283359188383939,2019-03-27 18:15:00,2019-03-27 18:30:00
90,2,1,1,0.0034299423225672477,2019-03-27 18:15:00,2019-03-27 18:30:00
99,2,1,1,0.007277689220469278,2019-03-27 18:15:00,2019-03-27 18:30:00
101,3,1,2,0.004920025422029575,2019-03-27 18:15:00,2019-03-27 18:30:00
104,2,2,0,0.005868620659029512,2019-03-27 18:15:00,2019-03-27 18:30:00
106,4,1,3,0.003947288078059008,2019-03-27 18:15:00,2019-03-27 18:30:00
109,4,3,1,0.059493583577004135,2019-03-27 18:15:00,2019-03-27 18:30:00
110,4,2,2,0.007971711639381162,2019-03-27 18:15:00,2019-03-27 18:30:00
111,6,1,5,0.004389441704223576,2019-03-27 18:15:00,2019-03-27 18:30:00
112,5,2,3,0.0077047749579368,2019-03-27 18:15:00,2019-03-27 18:30:00
113,2,0,2,0.002828770024555646,2019-03-27 18:15:00,2019-03-27 18:30:00
114,4,2,2,0.008396207273972639,2019-03-27 18:15:00,2019-03-27 18:30:00
115,1,0,1,0.002828770024555646,2019-03-27 18:15:00,2019-03-27 18:30:00
118,2,2,0,0.009048690387683352,2019-03-27 18:15:00,2019-03-27 18:30:00
119,3,2,1,0.0064908168638481145,2019-03-27 18:15:00,2019-03-27 18:30:00
120,2,2,0,0.008544128273743717,2019-03-27 18:15:00,2019-03-27 18:30:00
122,5,1,4,0.0055875626610562175,2019-03-27 18:15:00,2019-03-27 18:30:00
126,5,1,4,0.004907535829080077,2019-03-27 18:15:00,2019-03-27 18:30:00
127,1,1,0,0.004474450394046893,2019-03-27 18:15:00,2019-03-27 18:30:00
129,1,0,1,0.002828770024555646,2019-03-27 18:15:00,2019-03-27 18:30:00
135,2,2,0,0.004431896152586583,2019-03-27 18:15:00,2019-03-27 18:30:00
137,11,6,5,0.0124966179041935,2019-03-27 18:15:00,2019-03-27 18:30:00
138,16,7,9,0.013838560207788467,2019-03-27 18:15:00,2019-03-27 18:30:00
140,1,0,1,0.002828770024555646,2019-03-27 18:15:00,2019-03-27 18:30:00
141,5,3,2,0.009467569688733031,2019-03-27 18:15:00,2019-03-27 18:30:00
147,1,0,1,0.002828770024555646,2019-03-27 18:15:00,2019-03-27 18:30:00
151,1,1,0,0.004907535829080077,2019-03-27 18:15:00,2019-03-27 18:30:00
153,1,1,0,0.004389441704223576,2019-03-27 18:15:00,2019-03-27 18:30:00
154,2,1,1,0.004333107908943935,2019-03-27 18:15:00,2019-03-27 18:30:00
157,3,2,1,0.030212074810006342,2019-03-27 18:15:00,2019-03-27 18:30:00
158,1,1,0,0.012031616191963392,2019-03-27 18:15:00,2019-03-27 18:30:00
159,1,0,1,0.002828770024555646,2019-03-27 18:15:00,2019-03-27 18:30:00
160,1,1,0,0.009879845967315032,2019-03-27 18:15:00,2019-03-27 18:30:00
161,2,1,1,0.0188198997865341,2019-03-27 18:15:00,2019-03-27 18:30:00
162,5,5,0,0.012817477433275791,2019-03-27 18:15:00,2019-03-27 18:30:00
164,4,1,3,0.003947288078059008,2019-03-27 18:15:00,2019-03-27 18:30:00
168,4,2,2,0.0041762424688465034,2019-03-27 18:15:00,2019-03-27 18:30:00
170,4,0,4,0.002828770024555646,2019-03-27 18:15:00,2019-03-27 18:30:00
171,2,1,1,0.0052334592166020525,2019-03-27 18:15:00,2019-03-27 18:30:00
172,2,2,0,0.0061098804251032805,2019-03-27 18:15:00,2019-03-27 18:30:00
173,2,1,1,0.0188198997865341,2019-03-27 18:15:00,2019-03-27 18:30:00
189,4,0,4,0.002828770024555646,2019-03-27 18:15:00,2019-03-27 18:30:00
190,1,1,0,0.0038717525066063307,2019-03-27 18:15:00,2019-03-27 18:30:00
191,2,2,0,0.007248854601957148,2019-03-27 18:15:00,2019-03-27 18:30:00
195,3,0,3,0.002828770024555646,2019-03-27 18:15:00,2019-03-27 18:30:00
196,3,3,0,0.0048326776845943175,2019-03-27 18:15:00,2019-03-27 18:30:00
197,2,0,2,0.002828770024555646,2019-03-27 18:15:00,2019-03-27 18:30:00
202,3,3,0,0.00595009943438052,2019-03-27 18:15:00,2019-03-27 18:30:00
203,2,2,0,0.006279086915339017,2019-03-27 18:15:00,2019-03-27 18:30:00
1,3,2,1,0.01067675947725518,2019-03-27 18:30:00,2019-03-27 18:45:00
2,4,1,3,0.003723769337987775,2019-03-27 18:30:00,2019-03-27 18:45:00
5,1,0,1,0.002668598505765512,2019-03-27 18:30:00,2019-03-27 18:45:00
10,3,2,1,0.006452036838736552,2019-03-27 18:30:00,2019-03-27 18:45:00
15,2,1,1,0.0032152402196431477,2019-03-27 18:30:00,2019-03-27 18:45:00
16,6,4,2,0.008040348781029279,2019-03-27 18:30:00,2019-03-27 18:45:00
18,11,5,6,0.008751200687514005,2019-03-27 18:30:00,2019-03-27 18:45:00
19,4,3,1,0.009633315663262811,2019-03-27 18:30:00,2019-03-27 18:45:00
20,2,2,0,0.00700673073960731,2019-03-27 18:30:00,2019-03-27 18:45:00
23,6,1,5,0.01294055956823024,2019-03-27 18:30:00,2019-03-27 18:45:00
26,1,0,1,0.002668598505765512,2019-03-27 18:30:00,2019-03-27 18:45:00
27,1,1,0,0.003723769337987775,2019-03-27 18:30:00,2019-03-27 18:45:00
28,4,2,2,0.009419757854998548,2019-03-27 18:30:00,2019-03-27 18:45:00
30,1,1,0,0.004937108588296197,2019-03-27 18:30:00,2019-03-27 18:45:00
35,5,0,5,0.002668598505765512,2019-03-27 18:30:00,2019-03-27 18:45:00
37,7,4,3,0.005346244421950136,2019-03-27 18:30:00,2019-03-27 18:45:00
40,3,1,2,0.006086169573516767,2019-03-27 18:30:00,2019-03-27 18:45:00
41,1,0,1,0.002668598505765512,2019-03-27 18:30:00,2019-03-27 18:45:00
46,4,2,2,0.008203846457130806,2019-03-27 18:30:00,2019-03-27 18:45:00
57,6,4,2,0.012358298821078613,2019-03-27 18:30:00,2019-03-27 18:45:00
58,2,2,0,0.004230890429792945,2019-03-27 18:30:00,2019-03-27 18:45:00
62,3,1,2,0.003235726026398183,2019-03-27 18:30:00,2019-03-27 18:45:00
64,1,1,0,0.0032152402196431477,2019-03-27 18:30:00,2019-03-27 18:45:00
66,1,1,0,0.0042669083041088395,2019-03-27 18:30:00,2019-03-27 18:45:00
67,2,0,2,0.002668598505765512,2019-03-27 18:30:00,2019-03-27 18:45:00
68,2,2,0,0.0038325092662549057,2019-03-27 18:30:00,2019-03-27 18:45:00
69,5,2,3,0.01257154578338398,2019-03-27 18:30:00,2019-03-27 18:45:00
70,1,0,1,0.002668598505765512,2019-03-27 18:30:00,2019-03-27 18:45:00
75,3,3,0,0.005276900567115627,2019-03-27 18:30:00,2019-03-27 18:45:00
85,5,3,2,0.024164863651775358,2019-03-27 18:30:00,2019-03-27 18:45:00
86,4,2,2,0.017758943443527794,2019-03-27 18:30:00,2019-03-27 18:45:00
87,6,1,5,0.0032152402196431477,2019-03-27 18:30:00,2019-03-27 18:45:00
88,12,8,4,0.015002838876871764,2019-03-27 18:30:00,2019-03-27 18:45:00
89,3,3,0,0.014500305820273568,2019-03-27 18:30:00,2019-03-27 18:45:00
90,1,1,0,0.0030966353885276024,2019-03-27 18:30:00,2019-03-27 18:45:00
99,2,1,1,0.009214589461337639,2019-03-27 18:30:00,2019-03-27 18:45:00
101,3,1,2,0.00464140653561723,2019-03-27 18:30:00,2019-03-27 18:45:00
104,1,1,0,0.006155705100288783,2019-03-27 18:30:00,2019-03-27 18:45:00
106,2,0,2,0.002668598505765512,2019-03-27 18:30:00,2019-03-27 18:45:00
108,1,1,0,0.0042669083041088395,2019-03-27 18:30:00,2019-03-27 18:45:00
109,5,4,1,0.0626230913014223,2019-03-27 18:30:00,2019-03-27 18:45:00
110,8,6,2,0.013203243616630245,2019-03-27 18:30:00,2019-03-27 18:45:00
111,12,3,9,0.006161176094765828,2019-03-27 18:30:00,2019-03-27 18:45:00
112,7,4,3,0.0065223513335424445,2019-03-27 18:30:00,2019-03-27 18:45:00
114,4,0,4,0.002668598505765512,2019-03-27 18:30:00,2019-03-27 18:45:00
115,1,0,1,0.002668598505765512,2019-03-27 18:30:00,2019-03-27 18:45:00
118,3,3,0,0.007499262416427,2019-03-27 18:30:00,2019-03-27 18:45:00
119,2,1,1,0.003250553886010209,2019-03-27 18:30:00,2019-03-27 18:45:00
120,2,2,0,0.004646247844325473,2019-03-27 18:30:00,2019-03-27 18:45:00
122,5,1,4,0.0052555416175889,2019-03-27 18:30:00,2019-03-27 18:45:00
126,3,1,2,0.004868928738401364,2019-03-27 18:30:00,2019-03-27 18:45:00
127,1,1,0,0.011745470060505895,2019-03-27 18:30:00,2019-03-27 18:45:00
135,2,2,0,0.004180938560785968,2019-03-27 18:30:00,2019-03-27 18:45:00
137,18,9,9,0.016920627250696305,2019-03-27 18:30:00,2019-03-27 18:45:00
138,8,2,6,0.005414756448921782,2019-03-27 18:30:00,2019-03-27 18:45:00
140,1,0,1,0.002668598505765512,2019-03-27 18:30:00,2019-03-27 18:45:00
141,11,4,7,0.006074959504835515,2019-03-27 18:30:00,2019-03-27 18:45:00
147,2,1,1,0.003250553886010209,2019-03-27 18:30:00,2019-03-27 18:45:00
151,1,1,0,0.004868928738401364,2019-03-27 18:30:00,2019-03-27 18:45:00
154,3,3,0,0.011894887793780137,2019-03-27 18:30:00,2019-03-27 18:45:00
157,4,3,1,0.04956638169837833,2019-03-27 18:30:00,2019-03-27 18:45:00
158,2,0,2,0.002668598505765512,2019-03-27 18:30:00,2019-03-27 18:45:00
160,1,1,0,0.004937108588296197,2019-03-27 18:30:00,2019-03-27 18:45:00
161,2,1,1,0.017758943443527794,2019-03-27 18:30:00,2019-03-27 18:45:00
162,6,5,1,0.06482248123972986,2019-03-27 18:30:00,2019-03-27 18:45:00
164,2,1,1,0.003122300522271649,2019-03-27 18:30:00,2019-03-27 18:45:00
168,7,3,4,0.0042252324826499345,2019-03-27 18:30:00,2019-03-27 18:45:00
170,3,1,2,0.003406353336740358,2019-03-27 18:30:00,2019-03-27 18:45:00
171,3,2,1,0.007700350086869525,2019-03-27 18:30:00,2019-03-27 18:45:00
173,3,1,2,0.00464140653561723,2019-03-27 18:30:00,2019-03-27 18:45:00
189,9,2,7,0.003524672271289693,2019-03-27 18:30:00,2019-03-27 18:45:00
190,2,0,2,0.002668598505765512,2019-03-27 18:30:00,2019-03-27 18:45:00
195,3,0,3,0.002668598505765512,2019-03-27 18:30:00,2019-03-27 18:45:00
196,3,3,0,0.006320454835033086,2019-03-27 18:30:00,2019-03-27 18:45:00
197,5,3,2,0.008587022595320667,2019-03-27 18:30:00,2019-03-27 18:45:00
199,1,0,1,0.002668598505765512,2019-03-27 18:30:00,2019-03-27 18:45:00
202,2,2,0,0.004902471685629867,2019-03-27 18:30:00,2019-03-27 18:45:00
1,3,2,1,0.016690283716740723,2019-03-27 18:45:00,2019-03-27 19:00:00
2,6,2,4,0.00479027998410368,2019-03-27 18:45:00,2019-03-27 19:00:00
5,1,1,0,0.003208828421841544,2019-03-27 18:45:00,2019-03-27 19:00:00
10,2,1,1,0.004198058732128109,2019-03-27 18:45:00,2019-03-27 19:00:00
15,2,1,1,0.006167513073201991,2019-03-27 18:45:00,2019-03-27 19:00:00
16,8,4,4,0.0107359654012518,2019-03-27 18:45:00,2019-03-27 19:00:00
18,14,8,6,0.014375771030027157,2019-03-27 18:45:00,2019-03-27 19:00:00
19,4,4,0,0.0136571914976754,2019-03-27 18:45:00,2019-03-27 19:00:00
20,4,3,1,0.006207618028258705,2019-03-27 18:45:00,2019-03-27 19:00:00
23,7,1,6,0.003208828421841544,2019-03-27 18:45:00,2019-03-27 19:00:00
26,1,0,1,0.0027542039743848864,2019-03-27 18:45:00,2019-03-27 19:00:00
27,1,1,0,0.003772241979244283,2019-03-27 18:45:00,2019-03-27 19:00:00
28,6,4,2,0.01639326532594796,2019-03-27 18:45:00,2019-03-27 19:00:00
30,1,1,0,0.00509547826724392,2019-03-27 18:45:00,2019-03-27 19:00:00
35,2,1,1,0.0038663437353996704,2019-03-27 18:45:00,2019-03-27 19:00:00
37,4,1,3,0.00509547826724392,2019-03-27 18:45:00,2019-03-27 19:00:00
40,3,2,1,0.020438233583340088,2019-03-27 18:45:00,2019-03-27 19:00:00
41,2,0,2,0.0027542039743848864,2019-03-27 18:45:00,2019-03-27 19:00:00
46,3,2,1,0.006549275817945418,2019-03-27 18:45:00,2019-03-27 19:00:00
57,9,7,2,0.03130276135991274,2019-03-27 18:45:00,2019-03-27 19:00:00
58,5,1,4,0.003497487758740934,2019-03-27 18:45:00,2019-03-27 19:00:00
62,1,1,0,0.005311081655884312,2019-03-27 18:45:00,2019-03-27 19:00:00
64,1,1,0,0.006167513073201991,2019-03-27 18:45:00,2019-03-27 19:00:00
66,1,1,0,0.004759497301838513,2019-03-27 18:45:00,2019-03-27 19:00:00
67,5,2,3,0.009022954964334258,2019-03-27 18:45:00,2019-03-27 19:00:00
68,3,3,0,0.00497384281162139,2019-03-27 18:45:00,2019-03-27 19:00:00
69,5,2,3,0.006207618028258704,2019-03-27 18:45:00,2019-03-27 19:00:00
85,3,1,2,0.004501930640210786,2019-03-27 18:45:00,2019-03-27 19:00:00
86,4,2,2,0.018315813489667147,2019-03-27 18:45:00,2019-03-27 19:00:00
87,5,1,4,0.0160599204702008,2019-03-27 18:45:00,2019-03-27 19:00:00
88,14,8,6,0.01739420430011731,2019-03-27 18:45:00,2019-03-27 19:00:00
89,2,1,1,0.005218760634509621,2019-03-27 18:45:00,2019-03-27 19:00:00
90,1,0,1,0.0027542039743848864,2019-03-27 18:45:00,2019-03-27 19:00:00
99,1,0,1,0.0027542039743848864,2019-03-27 18:45:00,2019-03-27 19:00:00
101,3,1,2,0.00479027998410368,2019-03-27 18:45:00,2019-03-27 19:00:00
104,2,1,1,0.00832167820805014,2019-03-27 18:45:00,2019-03-27 19:00:00
106,2,0,2,0.0027542039743848864,2019-03-27 18:45:00,2019-03-27 19:00:00
108,1,1,0,0.004759497301838513,2019-03-27 18:45:00,2019-03-27 19:00:00
109,6,4,2,0.015245169403129467,2019-03-27 18:45:00,2019-03-27 19:00:00
110,5,3,2,0.03626252506375271,2019-03-27 18:45:00,2019-03-27 19:00:00
111,11,4,7,0.007266888629435377,2019-03-27 18:45:00,2019-03-27 19:00:00
112,5,2,3,0.007279652834216775,2019-03-27 18:45:00,2019-03-27 19:00:00
114,4,1,3,0.003924841120814404,2019-03-27 18:45:00,2019-03-27 19:00:00
115,1,0,1,0.0027542039743848864,2019-03-27 18:45:00,2019-03-27 19:00:00
118,4,2,2,0.0073739493978087255,2019-03-27 18:45:00,2019-03-27 19:00:00
119,2,2,0,0.007072712652555634,2019-03-27 18:45:00,2019-03-27 19:00:00
120,3,2,1,0.0055335035769440615,2019-03-27 18:45:00,2019-03-27 19:00:00
122,2,0,2,0.0027542039743848864,2019-03-27 18:45:00,2019-03-27 19:00:00
126,4,1,3,0.003924841120814404,2019-03-27 18:45:00,2019-03-27 19:00:00
127,1,1,0,0.016943003402041943,2019-03-27 18:45:00,2019-03-27 19:00:00
135,2,2,0,0.004315053502957576,2019-03-27 18:45:00,2019-03-27 19:00:00
137,11,6,5,0.011794485624711755,2019-03-27 18:45:00,2019-03-27 19:00:00
138,4,2,2,0.0065647983821352,2019-03-27 18:45:00,2019-03-27 19:00:00
140,1,0,1,0.0027542039743848864,2019-03-27 18:45:00,2019-03-27 19:00:00
141,9,2,7,0.006113544796432419,2019-03-27 18:45:00,2019-03-27 19:00:00
147,2,1,1,0.0036367111692748094,2019-03-27 18:45:00,2019-03-27 19:00:00
151,1,1,0,0.004817071716309301,2019-03-27 18:45:00,2019-03-27 19:00:00
153,2,0,2,0.0027542039743848864,2019-03-27 18:45:00,2019-03-27 19:00:00
154,3,3,0,0.012071047287632693,2019-03-27 18:45:00,2019-03-27 19:00:00
157,5,4,1,0.051725644385233964,2019-03-27 18:45:00,2019-03-27 19:00:00
158,4,1,3,0.009234479744455577,2019-03-27 18:45:00,2019-03-27 19:00:00
161,2,1,1,0.018315813489667147,2019-03-27 18:45:00,2019-03-27 19:00:00
162,2,2,0,0.007303629925185704,2019-03-27 18:45:00,2019-03-27 19:00:00
164,2,2,0,0.008657774372912878,2019-03-27 18:45:00,2019-03-27 19:00:00
168,4,1,3,0.006167513073201991,2019-03-27 18:45:00,2019-03-27 19:00:00
170,3,1,2,0.0034966719190590075,2019-03-27 18:45:00,2019-03-27 19:00:00
171,1,1,0,0.005845711582812098,2019-03-27 18:45:00,2019-03-27 19:00:00
173,2,1,1,0.018315813489667147,2019-03-27 18:45:00,2019-03-27 19:00:00
189,2,1,1,0.008031191475910101,2019-03-27 18:45:00,2019-03-27 19:00:00
191,3,3,0,0.0044467290716247426,2019-03-27 18:45:00,2019-03-27 19:00:00
195,3,0,3,0.0027542039743848864,2019-03-27 18:45:00,2019-03-27 19:00:00
196,3,3,0,0.0065071128610640905,2019-03-27 18:45:00,2019-03-27 19:00:00
197,6,1,5,0.0033183790067981716,2019-03-27 18:45:00,2019-03-27 19:00:00
199,2,0,2,0.0027542039743848864,2019-03-27 18:45:00,2019-03-27 19:00:00
202,3,2,1,0.00509547826724392,2019-03-27 18:45:00,2019-03-27 19:00:00
1,1,0,1,0.00266251695940115,2019-03-27 19:00:00,2019-03-27 19:15:00
2,3,1,2,0.004630821630153886,2019-03-27 19:00:00,2019-03-27 19:15:00
5,1,1,0,0.003095818176356698,2019-03-27 19:00:00,2019-03-27 19:15:00
10,2,1,1,0.005214946113808782,2019-03-27 19:00:00,2019-03-27 19:15:00
16,6,3,3,0.009800072368442651,2019-03-27 19:00:00,2019-03-27 19:15:00
18,8,5,3,0.020247945357484774,2019-03-27 19:00:00,2019-03-27 19:15:00
19,3,1,2,0.007070154478030487,2019-03-27 19:00:00,2019-03-27 19:15:00
20,5,3,2,0.014042620499181688,2019-03-27 19:00:00,2019-03-27 19:15:00
23,12,2,10,0.005097129167456865,2019-03-27 19:00:00,2019-03-27 19:15:00
26,1,0,1,0.00266251695940115,2019-03-27 19:00:00,2019-03-27 19:15:00
27,1,1,0,0.004630821630153886,2019-03-27 19:00:00,2019-03-27 19:15:00
28,2,2,0,0.0114977560915733,2019-03-27 19:00:00,2019-03-27 19:15:00
30,1,1,0,0.004925853167560069,2019-03-27 19:00:00,2019-03-27 19:15:00
35,2,1,1,0.00624335402306159,2019-03-27 19:00:00,2019-03-27 19:15:00
37,6,3,3,0.009007279923544834,2019-03-27 19:00:00,2019-03-27 19:15:00
40,3,1,2,0.016384027418015614,2019-03-27 19:00:00,2019-03-27 19:15:00
41,2,2,0,0.011636775531426079,2019-03-27 19:00:00,2019-03-27 19:15:00
46,2,1,1,0.004630821630153886,2019-03-27 19:00:00,2019-03-27 19:15:00
57,4,2,2,0.009532310501640908,2019-03-27 19:00:00,2019-03-27 19:15:00
58,4,1,3,0.0037152802072422525,2019-03-27 19:00:00,2019-03-27 19:15:00
62,1,1,0,0.004058309328228261,2019-03-27 19:00:00,2019-03-27 19:15:00
64,1,1,0,0.00379418506348061,2019-03-27 19:00:00,2019-03-27 19:15:00
66,2,1,1,0.007970039527066949,2019-03-27 19:00:00,2019-03-27 19:15:00
67,5,2,3,0.004925853167560069,2019-03-27 19:00:00,2019-03-27 19:15:00
68,3,3,0,0.007927189715301968,2019-03-27 19:00:00,2019-03-27 19:15:00
69,1,1,0,0.004925853167560069,2019-03-27 19:00:00,2019-03-27 19:15:00
70,1,1,0,0.00657690028454026,2019-03-27 19:00:00,2019-03-27 19:15:00
74,2,2,0,0.005454101697055373,2019-03-27 19:00:00,2019-03-27 19:15:00
79,1,0,1,0.00266251695940115,2019-03-27 19:00:00,2019-03-27 19:15:00
85,2,1,1,0.004925853167560069,2019-03-27 19:00:00,2019-03-27 19:15:00
86,5,3,2,0.03277577826497454,2019-03-27 19:00:00,2019-03-27 19:15:00
87,2,0,2,0.00266251695940115,2019-03-27 19:00:00,2019-03-27 19:15:00
88,7,4,3,0.009871922096682605,2019-03-27 19:00:00,2019-03-27 19:15:00
89,2,1,1,0.004170574486700549,2019-03-27 19:00:00,2019-03-27 19:15:00
90,2,0,2,0.00266251695940115,2019-03-27 19:00:00,2019-03-27 19:15:00
99,1,0,1,0.00266251695940115,2019-03-27 19:00:00,2019-03-27 19:15:00
101,3,1,2,0.004630821630153886,2019-03-27 19:00:00,2019-03-27 19:15:00
104,3,2,1,0.007730794404986082,2019-03-27 19:00:00,2019-03-27 19:15:00
106,2,0,2,0.00266251695940115,2019-03-27 19:00:00,2019-03-27 19:15:00
108,1,1,0,0.006397920786465399,2019-03-27 19:00:00,2019-03-27 19:15:00
109,8,4,4,0.01728217651101656,2019-03-27 19:00:00,2019-03-27 19:15:00
110,4,3,1,0.016139697250706516,2019-03-27 19:00:00,2019-03-27 19:15:00
111,7,3,4,0.011366035710345666,2019-03-27 19:00:00,2019-03-27 19:15:00
112,3,1,2,0.00379418506348061,2019-03-27 19:00:00,2019-03-27 19:15:00
114,2,0,2,0.00266251695940115,2019-03-27 19:00:00,2019-03-27 19:15:00
115,1,0,1,0.00266251695940115,2019-03-27 19:00:00,2019-03-27 19:15:00
118,2,0,2,0.00266251695940115,2019-03-27 19:00:00,2019-03-27 19:15:00
120,4,2,2,0.010368947068314184,2019-03-27 19:00:00,2019-03-27 19:15:00
126,5,3,2,0.0084244269571468,2019-03-27 19:00:00,2019-03-27 19:15:00
127,3,2,1,0.004932867260373569,2019-03-27 19:00:00,2019-03-27 19:15:00
135,4,3,1,0.004604708981795978,2019-03-27 19:00:00,2019-03-27 19:15:00
137,11,6,5,0.021969500327229746,2019-03-27 19:00:00,2019-03-27 19:15:00
138,4,2,2,0.004708496505016761,2019-03-27 19:00:00,2019-03-27 19:15:00
140,2,1,1,0.00379418506348061,2019-03-27 19:00:00,2019-03-27 19:15:00
141,4,2,2,0.017719147612187847,2019-03-27 19:00:00,2019-03-27 19:15:00
147,2,1,1,0.017719147612187847,2019-03-27 19:00:00,2019-03-27 19:15:00
151,1,1,0,0.004275195288061214,2019-03-27 19:00:00,2019-03-27 19:15:00
153,7,2,5,0.006676655240017138,2019-03-27 19:00:00,2019-03-27 19:15:00
154,3,1,2,0.004630821630153886,2019-03-27 19:00:00,2019-03-27 19:15:00
157,5,4,1,0.09429601805922413,2019-03-27 19:00:00,2019-03-27 19:15:00
158,2,1,1,0.006335739757592124,2019-03-27 19:00:00,2019-03-27 19:15:00
161,2,1,1,0.017719147612187847,2019-03-27 19:00:00,2019-03-27 19:15:00
162,1,1,0,0.004663827950501317,2019-03-27 19:00:00,2019-03-27 19:15:00
164,3,3,0,0.01225734080505336,2019-03-27 19:00:00,2019-03-27 19:15:00
168,1,0,1,0.00266251695940115,2019-03-27 19:00:00,2019-03-27 19:15:00
170,5,1,4,0.00709579997715479,2019-03-27 19:00:00,2019-03-27 19:15:00
173,2,1,1,0.017719147612187847,2019-03-27 19:00:00,2019-03-27 19:15:00
189,1,1,0,0.00863142620460821,2019-03-27 19:00:00,2019-03-27 19:15:00
190,1,1,0,0.003095818176356698,2019-03-27 19:00:00,2019-03-27 19:15:00
191,4,3,1,0.004925853167560069,2019-03-27 19:00:00,2019-03-27 19:15:00
195,3,0,3,0.00266251695940115,2019-03-27 19:00:00,2019-03-27 19:15:00
196,4,4,0,0.00898550657112722,2019-03-27 19:00:00,2019-03-27 19:15:00
197,3,0,3,0.00266251695940115,2019-03-27 19:00:00,2019-03-27 19:15:00
199,2,1,1,0.004925853167560069,2019-03-27 19:00:00,2019-03-27 19:15:00
2,4,2,2,0.006961710216231883,2019-03-27 19:15:00,2019-03-27 19:30:00
5,3,2,1,0.02232852574064462,2019-03-27 19:15:00,2019-03-27 19:30:00
10,2,1,1,0.004143973584301822,2019-03-27 19:15:00,2019-03-27 19:30:00
15,2,2,0,0.004087591232677455,2019-03-27 19:15:00,2019-03-27 19:30:00
16,3,1,2,0.004988964693686199,2019-03-27 19:15:00,2019-03-27 19:30:00
18,6,4,2,0.008876666307310597,2019-03-27 19:15:00,2019-03-27 19:30:00
19,1,0,1,0.0028684001771638007,2019-03-27 19:15:00,2019-03-27 19:30:00
20,2,1,1,0.005306782288191109,2019-03-27 19:15:00,2019-03-27 19:30:00
22,1,0,1,0.0028684001771638007,2019-03-27 19:15:00,2019-03-27 19:30:00
23,8,1,7,0.00400941480950689,2019-03-27 19:15:00,2019-03-27 19:30:00
26,1,1,0,0.006343221636213968,2019-03-27 19:15:00,2019-03-27 19:30:00
27,4,2,2,0.010338779268055355,2019-03-27 19:15:00,2019-03-27 19:30:00
30,1,1,0,0.008587851984362098,2019-03-27 19:15:00,2019-03-27 19:30:00
35,1,0,1,0.0028684001771638007,2019-03-27 19:15:00,2019-03-27 19:30:00
37,4,1,3,0.00450152098216957,2019-03-27 19:15:00,2019-03-27 19:30:00
40,4,0,4,0.0028684001771638007,2019-03-27 19:15:00,2019-03-27 19:30:00
46,4,2,2,0.008677391590119474,2019-03-27 19:15:00,2019-03-27 19:30:00
57,4,2,2,0.009079864816562873,2019-03-27 19:15:00,2019-03-27 19:30:00
58,3,0,3,0.0028684001771638007,2019-03-27 19:15:00,2019-03-27 19:30:00
61,1,1,0,0.003355310794063153,2019-03-27 19:15:00,2019-03-27 19:30:00
62,1,1,0,0.00548896773647521,2019-03-27 19:15:00,2019-03-27 19:30:00
66,2,1,1,0.005306782288191109,2019-03-27 19:15:00,2019-03-27 19:30:00
67,7,3,4,0.012330388935674725,2019-03-27 19:15:00,2019-03-27 19:30:00
68,3,2,1,0.005306782288191109,2019-03-27 19:15:00,2019-03-27 19:30:00
69,3,3,0,0.007173279171945013,2019-03-27 19:15:00,2019-03-27 19:30:00
70,6,1,5,0.00548896773647521,2019-03-27 19:15:00,2019-03-27 19:30:00
74,3,3,0,0.010547917406813928,2019-03-27 19:15:00,2019-03-27 19:30:00
79,2,1,1,0.019089982591607508,2019-03-27 19:15:00,2019-03-27 19:30:00
80,2,0,2,0.0028684001771638007,2019-03-27 19:15:00,2019-03-27 19:30:00
85,1,1,0,0.009309633575930877,2019-03-27 19:15:00,2019-03-27 19:30:00
86,2,1,1,0.019089982591607508,2019-03-27 19:15:00,2019-03-27 19:30:00
87,1,0,1,0.0028684001771638007,2019-03-27 19:15:00,2019-03-27 19:30:00
88,4,2,2,0.0038422214109625056,2019-03-27 19:15:00,2019-03-27 19:30:00
90,1,1,0,0.004372153779521477,2019-03-27 19:15:00,2019-03-27 19:30:00
99,1,0,1,0.0028684001771638007,2019-03-27 19:15:00,2019-03-27 19:30:00
101,3,1,2,0.004988964693686199,2019-03-27 19:15:00,2019-03-27 19:30:00
104,4,4,0,0.016565153561992466,2019-03-27 19:15:00,2019-03-27 19:30:00
106,4,1,3,0.004002591932413357,2019-03-27 19:15:00,2019-03-27 19:30:00
109,6,3,3,0.015683411950549158,2019-03-27 19:15:00,2019-03-27 19:30:00
110,4,3,1,0.006874133628581048,2019-03-27 19:15:00,2019-03-27 19:30:00
111,2,0,2,0.0028684001771638007,2019-03-27 19:15:00,2019-03-27 19:30:00
112,4,1,3,0.004087591232677455,2019-03-27 19:15:00,2019-03-27 19:30:00
114,2,0,2,0.0028684001771638007,2019-03-27 19:15:00,2019-03-27 19:30:00
115,2,1,1,0.006727852651204136,2019-03-27 19:15:00,2019-03-27 19:30:00
118,5,3,2,0.009696208623603608,2019-03-27 19:15:00,2019-03-27 19:30:00
119,4,1,3,0.005306782288191109,2019-03-27 19:15:00,2019-03-27 19:30:00
120,1,1,0,0.004002591932413357,2019-03-27 19:15:00,2019-03-27 19:30:00
122,1,1,0,0.004372153779521477,2019-03-27 19:15:00,2019-03-27 19:30:00
126,2,1,1,0.004087591232677455,2019-03-27 19:15:00,2019-03-27 19:30:00
127,2,0,2,0.0028684001771638007,2019-03-27 19:15:00,2019-03-27 19:30:00
135,3,3,0,0.004980898868081359,2019-03-27 19:15:00,2019-03-27 19:30:00
137,7,7,0,0.015023774071182164,2019-03-27 19:15:00,2019-03-27 19:30:00
138,4,1,3,0.00402667399684719,2019-03-27 19:15:00,2019-03-27 19:30:00
140,3,1,2,0.004988964693686199,2019-03-27 19:15:00,2019-03-27 19:30:00
141,5,2,3,0.006620623952536904,2019-03-27 19:15:00,2019-03-27 19:30:00
147,4,3,1,0.05153314742049492,2019-03-27 19:15:00,2019-03-27 19:30:00
153,2,1,1,0.003355310794063153,2019-03-27 19:15:00,2019-03-27 19:30:00
154,4,1,3,0.004002591932413357,2019-03-27 19:15:00,2019-03-27 19:30:00
157,4,3,1,0.07815873612737195,2019-03-27 19:15:00,2019-03-27 19:30:00
158,2,1,1,0.005306782288191109,2019-03-27 19:15:00,2019-03-27 19:30:00
161,2,1,1,0.019089982591607508,2019-03-27 19:15:00,2019-03-27 19:30:00
162,1,1,0,0.00400941480950689,2019-03-27 19:15:00,2019-03-27 19:30:00
164,3,3,0,0.007794975111903265,2019-03-27 19:15:00,2019-03-27 19:30:00
168,4,2,2,0.015153369172062808,2019-03-27 19:15:00,2019-03-27 19:30:00
170,3,1,2,0.00639116917726681,2019-03-27 19:15:00,2019-03-27 19:30:00
171,1,0,1,0.0028684001771638007,2019-03-27 19:15:00,2019-03-27 19:30:00
172,2,1,1,0.019089982591607508,2019-03-27 19:15:00,2019-03-27 19:30:00
189,1,0,1,0.0028684001771638007,2019-03-27 19:15:00,2019-03-27 19:30:00
190,1,1,0,0.003355310794063153,2019-03-27 19:15:00,2019-03-27 19:30:00
191,1,0,1,0.0028684001771638007,2019-03-27 19:15:00,2019-03-27 19:30:00
195,3,0,3,0.0028684001771638007,2019-03-27 19:15:00,2019-03-27 19:30:00
196,5,5,0,0.01120270819196039,2019-03-27 19:15:00,2019-03-27 19:30:00
197,2,2,0,0.005306782288191109,2019-03-27 19:15:00,2019-03-27 19:30:00
199,1,0,1,0.0028684001771638007,2019-03-27 19:15:00,2019-03-27 19:30:00
201,1,1,0,0.004988964693686199,2019-03-27 19:15:00,2019-03-27 19:30:00
203,1,1,0,0.004372153779521477,2019-03-27 19:15:00,2019-03-27 19:30:00
1,2,2,0,0.006412127884029971,2019-03-27 19:30:00,2019-03-27 19:45:00
2,2,1,1,0.003586866985955505,2019-03-27 19:30:00,2019-03-27 19:45:00
5,2,1,1,0.018598969399318505,2019-03-27 19:30:00,2019-03-27 19:45:00
15,2,2,0,0.0051707931831848995,2019-03-27 19:30:00,2019-03-27 19:45:00
16,4,2,2,0.008702586741208397,2019-03-27 19:30:00,2019-03-27 19:45:00
18,6,3,3,0.005557702979716212,2019-03-27 19:30:00,2019-03-27 19:45:00
19,1,1,0,0.003982848535262854,2019-03-27 19:30:00,2019-03-27 19:45:00
20,1,0,1,0.0027949038873408077,2019-03-27 19:30:00,2019-03-27 19:45:00
23,2,0,2,0.0027949038873408077,2019-03-27 19:30:00,2019-03-27 19:45:00
26,4,1,3,0.006382635127448119,2019-03-27 19:30:00,2019-03-27 19:45:00
27,5,3,2,0.008695105862788486,2019-03-27 19:30:00,2019-03-27 19:45:00
28,5,0,5,0.0027949038873408077,2019-03-27 19:30:00,2019-03-27 19:45:00
30,1,1,0,0.007190529756956932,2019-03-27 19:30:00,2019-03-27 19:45:00
40,2,0,2,0.0027949038873408077,2019-03-27 19:30:00,2019-03-27 19:45:00
41,1,1,0,0.003982848535262854,2019-03-27 19:30:00,2019-03-27 19:45:00
46,4,2,2,0.008454935513352397,2019-03-27 19:30:00,2019-03-27 19:45:00
50,2,2,0,0.010794257875900886,2019-03-27 19:30:00,2019-03-27 19:45:00
57,1,1,0,0.004369758331794166,2019-03-27 19:30:00,2019-03-27 19:45:00
58,4,0,4,0.0027949038873408077,2019-03-27 19:30:00,2019-03-27 19:45:00
61,1,1,0,0.003982848535262854,2019-03-27 19:30:00,2019-03-27 19:45:00
62,1,1,0,0.013143506600837067,2019-03-27 19:30:00,2019-03-27 19:45:00
67,4,3,1,0.012172751399458073,2019-03-27 19:30:00,2019-03-27 19:45:00
68,1,0,1,0.0027949038873408077,2019-03-27 19:30:00,2019-03-27 19:45:00
69,3,3,0,0.007996153718875333,2019-03-27 19:30:00,2019-03-27 19:45:00
70,4,0,4,0.0027949038873408077,2019-03-27 19:30:00,2019-03-27 19:45:00
74,1,1,0,0.003982848535262854,2019-03-27 19:30:00,2019-03-27 19:45:00
79,1,1,0,0.0051707931831848995,2019-03-27 19:30:00,2019-03-27 19:45:00
80,2,0,2,0.0027949038873408077,2019-03-27 19:30:00,2019-03-27 19:45:00
85,2,1,1,0.010751286679450385,2019-03-27 19:30:00,2019-03-27 19:45:00
86,1,0,1,0.0027949038873408077,2019-03-27 19:30:00,2019-03-27 19:45:00
88,2,1,1,0.0051707931831848995,2019-03-27 19:30:00,2019-03-27 19:45:00
90,1,1,0,0.00499271682214887,2019-03-27 19:30:00,2019-03-27 19:45:00
99,1,0,1,0.0027949038873408077,2019-03-27 19:30:00,2019-03-27 19:45:00
101,3,1,2,0.004861104383292818,2019-03-27 19:30:00,2019-03-27 19:45:00
104,4,4,0,0.014968328382030343,2019-03-27 19:30:00,2019-03-27 19:45:00
106,4,1,3,0.0039000235242909694,2019-03-27 19:30:00,2019-03-27 19:45:00
109,2,1,1,0.018598969399318505,2019-03-27 19:30:00,2019-03-27 19:45:00
110,4,0,4,0.0027949038873408077,2019-03-27 19:30:00,2019-03-27 19:45:00
111,1,0,1,0.0027949038873408077,2019-03-27 19:30:00,2019-03-27 19:45:00
112,7,2,5,0.013123227046148355,2019-03-27 19:30:00,2019-03-27 19:45:00
114,2,0,2,0.0027949038873408077,2019-03-27 19:30:00,2019-03-27 19:45:00
115,3,2,1,0.0051707931831848995,2019-03-27 19:30:00,2019-03-27 19:45:00
116,2,0,2,0.0027949038873408077,2019-03-27 19:30:00,2019-03-27 19:45:00
118,5,3,2,0.009633569606643723,2019-03-27 19:30:00,2019-03-27 19:45:00
119,3,1,2,0.0051707931831848995,2019-03-27 19:30:00,2019-03-27 19:45:00
120,1,0,1,0.0027949038873408077,2019-03-27 19:30:00,2019-03-27 19:45:00
126,4,3,1,0.004220437464847263,2019-03-27 19:30:00,2019-03-27 19:45:00
127,2,0,2,0.0027949038873408077,2019-03-27 19:30:00,2019-03-27 19:45:00
133,4,2,2,0.018598969399318505,2019-03-27 19:30:00,2019-03-27 19:45:00
135,2,2,0,0.004378830084570202,2019-03-27 19:30:00,2019-03-27 19:45:00
137,10,9,1,0.012726783372734429,2019-03-27 19:30:00,2019-03-27 19:45:00
138,3,2,1,0.006214236746992265,2019-03-27 19:30:00,2019-03-27 19:45:00
140,4,2,2,0.01019323676649948,2019-03-27 19:30:00,2019-03-27 19:45:00
141,4,2,2,0.018598969399318505,2019-03-27 19:30:00,2019-03-27 19:45:00
147,2,1,1,0.018598969399318505,2019-03-27 19:30:00,2019-03-27 19:45:00
153,1,1,0,0.0033888762113018305,2019-03-27 19:30:00,2019-03-27 19:45:00
154,3,0,3,0.0027949038873408077,2019-03-27 19:30:00,2019-03-27 19:45:00
157,3,2,1,0.03440303491129621,2019-03-27 19:30:00,2019-03-27 19:45:00
158,1,0,1,0.0027949038873408077,2019-03-27 19:30:00,2019-03-27 19:45:00
159,2,1,1,0.018598969399318505,2019-03-27 19:30:00,2019-03-27 19:45:00
161,2,1,1,0.018598969399318505,2019-03-27 19:30:00,2019-03-27 19:45:00
162,1,1,0,0.0051707931831848995,2019-03-27 19:30:00,2019-03-27 19:45:00
164,4,2,2,0.008671772291321485,2019-03-27 19:30:00,2019-03-27 19:45:00
168,6,4,2,0.018717373294967598,2019-03-27 19:30:00,2019-03-27 19:45:00
169,1,0,1,0.0027949038873408077,2019-03-27 19:30:00,2019-03-27 19:45:00
170,4,2,2,0.005818255197684917,2019-03-27 19:30:00,2019-03-27 19:45:00
172,2,1,1,0.018598969399318505,2019-03-27 19:30:00,2019-03-27 19:45:00
173,3,2,1,0.00697940518152948,2019-03-27 19:30:00,2019-03-27 19:45:00
177,1,0,1,0.0027949038873408077,2019-03-27 19:30:00,2019-03-27 19:45:00
189,1,0,1,0.0027949038873408077,2019-03-27 19:30:00,2019-03-27 19:45:00
190,3,1,2,0.004861104383292818,2019-03-27 19:30:00,2019-03-27 19:45:00
191,2,0,2,0.0027949038873408077,2019-03-27 19:30:00,2019-03-27 19:45:00
195,3,0,3,0.0027949038873408077,2019-03-27 19:30:00,2019-03-27 19:45:00
196,6,6,0,0.01039425358542436,2019-03-27 19:30:00,2019-03-27 19:45:00
197,2,2,0,0.0051707931831848995,2019-03-27 19:30:00,2019-03-27 19:45:00
199,1,0,1,0.0027949038873408077,2019-03-27 19:30:00,2019-03-27 19:45:00
201,1,1,0,0.007127732296755038,2019-03-27 19:30:00,2019-03-27 19:45:00
202,1,1,0,0.013613876277956799,2019-03-27 19:30:00,2019-03-27 19:45:00
203,4,3,1,0.06244733199148547,2019-03-27 19:30:00,2019-03-27 19:45:00
1,4,2,2,0.018141803862336096,2019-03-27 19:45:00,2019-03-27 20:00:00
2,2,1,1,0.005041475057695233,2019-03-27 19:45:00,2019-03-27 20:00:00
5,2,1,1,0.018141803862336096,2019-03-27 19:45:00,2019-03-27 20:00:00
15,1,0,1,0.0027249869955856686,2019-03-27 19:45:00,2019-03-27 20:00:00
16,4,2,2,0.007336102588222828,2019-03-27 19:45:00,2019-03-27 20:00:00
18,6,3,3,0.007507015905622797,2019-03-27 19:45:00,2019-03-27 20:00:00
19,3,3,0,0.00700069213056973,2019-03-27 19:45:00,2019-03-27 20:00:00
20,1,0,1,0.0027249869955856686,2019-03-27 19:45:00,2019-03-27 20:00:00
23,1,1,0,0.012194049004937117,2019-03-27 19:45:00,2019-03-27 20:00:00
26,4,2,2,0.018141803862336096,2019-03-27 19:45:00,2019-03-27 20:00:00
27,2,2,0,0.009327243792084196,2019-03-27 19:45:00,2019-03-27 20:00:00
28,5,0,5,0.0027249869955856686,2019-03-27 19:45:00,2019-03-27 20:00:00
30,1,1,0,0.004085607972502595,2019-03-27 19:45:00,2019-03-27 20:00:00
35,3,1,2,0.0058433343198662745,2019-03-27 19:45:00,2019-03-27 20:00:00
40,7,3,4,0.007519774979055706,2019-03-27 19:45:00,2019-03-27 20:00:00
41,2,2,0,0.013065835794513,2019-03-27 19:45:00,2019-03-27 20:00:00
46,4,2,2,0.005202869818689728,2019-03-27 19:45:00,2019-03-27 20:00:00
50,2,2,0,0.007357963119804798,2019-03-27 19:45:00,2019-03-27 20:00:00
57,2,0,2,0.0027249869955856686,2019-03-27 19:45:00,2019-03-27 20:00:00
58,4,1,3,0.0046842040684601655,2019-03-27 19:45:00,2019-03-27 20:00:00
67,1,1,0,0.006026115393834932,2019-03-27 19:45:00,2019-03-27 20:00:00
68,2,1,1,0.004507373135107686,2019-03-27 19:45:00,2019-03-27 20:00:00
69,2,2,0,0.005746272874534927,2019-03-27 19:45:00,2019-03-27 20:00:00
70,4,1,3,0.0033041090111130596,2019-03-27 19:45:00,2019-03-27 20:00:00
74,2,1,1,0.003883231026640451,2019-03-27 19:45:00,2019-03-27 20:00:00
79,2,1,1,0.005041475057695233,2019-03-27 19:45:00,2019-03-27 20:00:00
80,2,0,2,0.0027249869955856686,2019-03-27 19:45:00,2019-03-27 20:00:00
85,1,0,1,0.0027249869955856686,2019-03-27 19:45:00,2019-03-27 20:00:00
86,1,0,1,0.0027249869955856686,2019-03-27 19:45:00,2019-03-27 20:00:00
88,3,1,2,0.004570808883651173,2019-03-27 19:45:00,2019-03-27 20:00:00
89,1,0,1,0.0027249869955856686,2019-03-27 19:45:00,2019-03-27 20:00:00
101,3,1,2,0.004739572206267815,2019-03-27 19:45:00,2019-03-27 20:00:00
104,1,1,0,0.0049365002734957555,2019-03-27 19:45:00,2019-03-27 20:00:00
106,2,1,1,0.018141803862336096,2019-03-27 19:45:00,2019-03-27 20:00:00
108,1,1,0,0.004416210362208593,2019-03-27 19:45:00,2019-03-27 20:00:00
109,6,5,1,0.06188181671068266,2019-03-27 19:45:00,2019-03-27 20:00:00
110,2,2,0,0.006984342865769894,2019-03-27 19:45:00,2019-03-27 20:00:00
112,5,2,3,0.007357963119804798,2019-03-27 19:45:00,2019-03-27 20:00:00
114,1,0,1,0.0027249869955856686,2019-03-27 19:45:00,2019-03-27 20:00:00
115,7,3,4,0.00640209603461216,2019-03-27 19:45:00,2019-03-27 20:00:00
116,2,0,2,0.0027249869955856686,2019-03-27 19:45:00,2019-03-27 20:00:00
118,5,2,3,0.0062897592746297025,2019-03-27 19:45:00,2019-03-27 20:00:00
119,1,1,0,0.004570808883651173,2019-03-27 19:45:00,2019-03-27 20:00:00
122,1,0,1,0.0027249869955856686,2019-03-27 19:45:00,2019-03-27 20:00:00
126,8,4,4,0.005225421142123682,2019-03-27 19:45:00,2019-03-27 20:00:00
129,1,0,1,0.0027249869955856686,2019-03-27 19:45:00,2019-03-27 20:00:00
133,3,2,1,0.04362827917727089,2019-03-27 19:45:00,2019-03-27 20:00:00
135,2,2,0,0.005522712090914502,2019-03-27 19:45:00,2019-03-27 20:00:00
137,6,3,3,0.0069140138778148435,2019-03-27 19:45:00,2019-03-27 20:00:00
138,5,4,1,0.011138245241129888,2019-03-27 19:45:00,2019-03-27 20:00:00
140,3,1,2,0.0058433343198662745,2019-03-27 19:45:00,2019-03-27 20:00:00
141,2,1,1,0.018141803862336096,2019-03-27 19:45:00,2019-03-27 20:00:00
153,3,2,1,0.010801070728810383,2019-03-27 19:45:00,2019-03-27 20:00:00
154,2,0,2,0.0027249869955856686,2019-03-27 19:45:00,2019-03-27 20:00:00
157,3,2,1,0.03229016142715643,2019-03-27 19:45:00,2019-03-27 20:00:00
158,1,1,0,0.0043232496567423475,2019-03-27 19:45:00,2019-03-27 20:00:00
159,2,1,1,0.018141803862336096,2019-03-27 19:45:00,2019-03-27 20:00:00
160,1,1,0,0.0070107557299746315,2019-03-27 19:45:00,2019-03-27 20:00:00
161,10,5,5,0.018141803862336096,2019-03-27 19:45:00,2019-03-27 20:00:00
162,1,1,0,0.005041475057695233,2019-03-27 19:45:00,2019-03-27 20:00:00
164,4,0,4,0.0027249869955856686,2019-03-27 19:45:00,2019-03-27 20:00:00
168,2,2,0,0.003883231026640451,2019-03-27 19:45:00,2019-03-27 20:00:00
169,1,0,1,0.0027249869955856686,2019-03-27 19:45:00,2019-03-27 20:00:00
170,5,2,3,0.005968247495529905,2019-03-27 19:45:00,2019-03-27 20:00:00
172,5,4,1,0.04030827670259876,2019-03-27 19:45:00,2019-03-27 20:00:00
173,1,0,1,0.0027249869955856686,2019-03-27 19:45:00,2019-03-27 20:00:00
177,1,0,1,0.0027249869955856686,2019-03-27 19:45:00,2019-03-27 20:00:00
190,1,0,1,0.0027249869955856686,2019-03-27 19:45:00,2019-03-27 20:00:00
191,2,0,2,0.0027249869955856686,2019-03-27 19:45:00,2019-03-27 20:00:00
195,4,1,3,0.0049365002734957555,2019-03-27 19:45:00,2019-03-27 20:00:00
196,8,6,2,0.0158765597945629,2019-03-27 19:45:00,2019-03-27 20:00:00
197,2,2,0,0.005041475057695233,2019-03-27 19:45:00,2019-03-27 20:00:00
201,1,1,0,0.005208797395454589,2019-03-27 19:45:00,2019-03-27 20:00:00
202,1,1,0,0.0046842040684601655,2019-03-27 19:45:00,2019-03-27 20:00:00
203,5,2,3,0.006513676691725834,2019-03-27 19:45:00,2019-03-27 20:00:00
1,3,1,2,0.004562500192613925,2019-03-27 20:00:00,2019-03-27 20:15:00
2,3,2,1,0.007460353758682314,2019-03-27 20:00:00,2019-03-27 20:15:00
5,2,1,1,0.02128706691611419,2019-03-27 20:00:00,2019-03-27 20:15:00
10,1,1,0,0.007258341102374536,2019-03-27 20:00:00,2019-03-27 20:15:00
15,8,2,6,0.004467622239692304,2019-03-27 20:00:00,2019-03-27 20:15:00
18,7,3,4,0.005793822089108596,2019-03-27 20:00:00,2019-03-27 20:15:00
19,5,5,0,0.008828649300169857,2019-03-27 20:00:00,2019-03-27 20:15:00
23,6,4,2,0.011872760778307734,2019-03-27 20:00:00,2019-03-27 20:15:00
26,6,2,4,0.007080187045215654,2019-03-27 20:00:00,2019-03-27 20:15:00
27,3,1,2,0.009543800716064407,2019-03-27 20:00:00,2019-03-27 20:15:00
28,6,5,1,0.013277176288153583,2019-03-27 20:00:00,2019-03-27 20:15:00
30,1,1,0,0.003730153424980073,2019-03-27 20:00:00,2019-03-27 20:15:00
40,5,1,4,0.004065715301157394,2019-03-27 20:00:00,2019-03-27 20:15:00
41,3,2,1,0.005664305700171134,2019-03-27 20:00:00,2019-03-27 20:15:00
46,4,2,2,0.016855723175082146,2019-03-27 20:00:00,2019-03-27 20:15:00
57,2,0,2,0.0032016619071817934,2019-03-27 20:00:00,2019-03-27 20:15:00
58,4,0,4,0.0032016619071817934,2019-03-27 20:00:00,2019-03-27 20:15:00
62,1,1,0,0.005923338478046058,2019-03-27 20:00:00,2019-03-27 20:15:00
67,1,1,0,0.005923338478046058,2019-03-27 20:00:00,2019-03-27 20:15:00
68,5,1,4,0.004065715301157394,2019-03-27 20:00:00,2019-03-27 20:15:00
69,1,1,0,0.009464234847640465,2019-03-27 20:00:00,2019-03-27 20:15:00
70,3,3,0,0.004939064085494419,2019-03-27 20:00:00,2019-03-27 20:15:00
74,1,0,1,0.0032016619071817934,2019-03-27 20:00:00,2019-03-27 20:15:00
88,4,1,3,0.007514355496152614,2019-03-27 20:00:00,2019-03-27 20:15:00
89,1,0,1,0.0032016619071817934,2019-03-27 20:00:00,2019-03-27 20:15:00
90,2,2,0,0.00922343933249512,2019-03-27 20:00:00,2019-03-27 20:15:00
101,3,1,2,0.0055685812395128076,2019-03-27 20:00:00,2019-03-27 20:15:00
104,1,1,0,0.010366411267504351,2019-03-27 20:00:00,2019-03-27 20:15:00
106,2,1,1,0.02128706691611419,2019-03-27 20:00:00,2019-03-27 20:15:00
108,1,1,0,0.00488011980891628,2019-03-27 20:00:00,2019-03-27 20:15:00
109,7,4,3,0.009886249131552059,2019-03-27 20:00:00,2019-03-27 20:15:00
112,2,1,1,0.008304906931940947,2019-03-27 20:00:00,2019-03-27 20:15:00
114,2,1,1,0.006003100876634259,2019-03-27 20:00:00,2019-03-27 20:15:00
115,7,1,6,0.003730153424980073,2019-03-27 20:00:00,2019-03-27 20:15:00
118,1,1,0,0.004065715301157394,2019-03-27 20:00:00,2019-03-27 20:15:00
119,3,3,0,0.008780315828663125,2019-03-27 20:00:00,2019-03-27 20:15:00
120,1,0,1,0.0032016619071817934,2019-03-27 20:00:00,2019-03-27 20:15:00
122,1,0,1,0.0032016619071817934,2019-03-27 20:00:00,2019-03-27 20:15:00
126,3,0,3,0.0032016619071817934,2019-03-27 20:00:00,2019-03-27 20:15:00
129,1,1,0,0.003834642073437049,2019-03-27 20:00:00,2019-03-27 20:15:00
133,5,3,2,0.02702751745443312,2019-03-27 20:00:00,2019-03-27 20:15:00
135,2,2,0,0.00907687076074761,2019-03-27 20:00:00,2019-03-27 20:15:00
137,2,1,1,0.003882081049897859,2019-03-27 20:00:00,2019-03-27 20:15:00
138,7,4,3,0.022099508867508614,2019-03-27 20:00:00,2019-03-27 20:15:00
141,2,1,1,0.02128706691611419,2019-03-27 20:00:00,2019-03-27 20:15:00
157,3,2,1,0.02946571602660479,2019-03-27 20:00:00,2019-03-27 20:15:00
158,2,2,0,0.00686715427060986,2019-03-27 20:00:00,2019-03-27 20:15:00
159,2,1,1,0.02128706691611419,2019-03-27 20:00:00,2019-03-27 20:15:00
161,10,5,5,0.02128706691611419,2019-03-27 20:00:00,2019-03-27 20:15:00
162,1,0,1,0.0032016619071817934,2019-03-27 20:00:00,2019-03-27 20:15:00
164,4,0,4,0.0032016619071817934,2019-03-27 20:00:00,2019-03-27 20:15:00
168,2,2,0,0.004562500192613925,2019-03-27 20:00:00,2019-03-27 20:15:00
170,4,1,3,0.005923338478046058,2019-03-27 20:00:00,2019-03-27 20:15:00
172,3,3,0,0.005923338478046058,2019-03-27 20:00:00,2019-03-27 20:15:00
175,4,2,2,0.02128706691611419,2019-03-27 20:00:00,2019-03-27 20:15:00
191,2,0,2,0.0032016619071817934,2019-03-27 20:00:00,2019-03-27 20:15:00
195,4,1,3,0.010366411267504351,2019-03-27 20:00:00,2019-03-27 20:15:00
196,3,3,0,0.009496182137433673,2019-03-27 20:00:00,2019-03-27 20:15:00
197,1,1,0,0.008248381591898508,2019-03-27 20:00:00,2019-03-27 20:15:00
203,4,2,2,0.01014620929968596,2019-03-27 20:00:00,2019-03-27 20:15:00
2,4,2,2,0.029734623814521122,2019-03-27 20:15:00,2019-03-27 20:30:00
5,2,1,1,0.0197145471058682,2019-03-27 20:15:00,2019-03-27 20:30:00
10,1,1,0,0.005478783259886745,2019-03-27 20:15:00,2019-03-27 20:30:00
15,2,0,2,0.0029613508226087122,2019-03-27 20:15:00,2019-03-27 20:30:00
16,1,1,0,0.004448367351476738,2019-03-27 20:15:00,2019-03-27 20:30:00
18,8,4,4,0.006560773515373588,2019-03-27 20:15:00,2019-03-27 20:30:00
19,3,2,1,0.008418122226653231,2019-03-27 20:15:00,2019-03-27 20:30:00
20,1,0,1,0.0029613508226087122,2019-03-27 20:15:00,2019-03-27 20:30:00
23,6,4,2,0.010291124253946776,2019-03-27 20:15:00,2019-03-27 20:30:00
26,4,0,4,0.0029613508226087122,2019-03-27 20:15:00,2019-03-27 20:30:00
27,1,0,1,0.0029613508226087122,2019-03-27 20:15:00,2019-03-27 20:30:00
28,4,4,0,0.005478783259886745,2019-03-27 20:15:00,2019-03-27 20:30:00
30,1,1,0,0.0038004949683680565,2019-03-27 20:15:00,2019-03-27 20:30:00
40,6,1,5,0.0035679796558919503,2019-03-27 20:15:00,2019-03-27 20:30:00
41,5,3,2,0.007237083963101347,2019-03-27 20:15:00,2019-03-27 20:30:00
46,7,3,4,0.008958887920836586,2019-03-27 20:15:00,2019-03-27 20:30:00
57,1,0,1,0.0029613508226087122,2019-03-27 20:15:00,2019-03-27 20:30:00
58,5,1,4,0.003760568599443379,2019-03-27 20:15:00,2019-03-27 20:30:00
61,1,1,0,0.010117770451149869,2019-03-27 20:15:00,2019-03-27 20:30:00
62,1,1,0,0.0051507058416495645,2019-03-27 20:15:00,2019-03-27 20:30:00
66,1,0,1,0.0029613508226087122,2019-03-27 20:15:00,2019-03-27 20:30:00
67,1,1,0,0.00359070893192822,2019-03-27 20:15:00,2019-03-27 20:30:00
68,3,2,1,0.005478783259886745,2019-03-27 20:15:00,2019-03-27 20:30:00
69,1,1,0,0.004703372719721899,2019-03-27 20:15:00,2019-03-27 20:30:00
70,3,3,0,0.00654373015372091,2019-03-27 20:15:00,2019-03-27 20:30:00
88,6,3,3,0.028834041890124555,2019-03-27 20:15:00,2019-03-27 20:30:00
89,4,3,1,0.03225205625179915,2019-03-27 20:15:00,2019-03-27 20:30:00
90,7,5,2,0.043789817509616656,2019-03-27 20:15:00,2019-03-27 20:30:00
101,3,1,2,0.0051507058416495645,2019-03-27 20:15:00,2019-03-27 20:30:00
104,2,2,0,0.006259800168014527,2019-03-27 20:15:00,2019-03-27 20:30:00
106,2,1,1,0.0197145471058682,2019-03-27 20:15:00,2019-03-27 20:30:00
109,5,1,4,0.003760568599443379,2019-03-27 20:15:00,2019-03-27 20:30:00
111,1,0,1,0.0029613508226087122,2019-03-27 20:15:00,2019-03-27 20:30:00
112,2,1,1,0.0061582219299473814,2019-03-27 20:15:00,2019-03-27 20:30:00
114,2,1,1,0.003760568599443379,2019-03-27 20:15:00,2019-03-27 20:30:00
115,3,0,3,0.0029613508226087122,2019-03-27 20:15:00,2019-03-27 20:30:00
116,1,1,0,0.005478783259886745,2019-03-27 20:15:00,2019-03-27 20:30:00
118,1,0,1,0.0029613508226087122,2019-03-27 20:15:00,2019-03-27 20:30:00
119,1,1,0,0.008094055474164273,2019-03-27 20:15:00,2019-03-27 20:30:00
120,1,1,0,0.003760568599443379,2019-03-27 20:15:00,2019-03-27 20:30:00
133,2,1,1,0.0197145471058682,2019-03-27 20:15:00,2019-03-27 20:30:00
135,2,2,0,0.004220067041247728,2019-03-27 20:15:00,2019-03-27 20:30:00
137,5,1,4,0.003760568599443379,2019-03-27 20:15:00,2019-03-27 20:30:00
138,5,1,4,0.008196537940129287,2019-03-27 20:15:00,2019-03-27 20:30:00
140,1,1,0,0.005478783259886745,2019-03-27 20:15:00,2019-03-27 20:30:00
141,5,3,2,0.02372779258413229,2019-03-27 20:15:00,2019-03-27 20:30:00
151,1,1,0,0.005478783259886745,2019-03-27 20:15:00,2019-03-27 20:30:00
153,1,0,1,0.0029613508226087122,2019-03-27 20:15:00,2019-03-27 20:30:00
154,2,1,1,0.0197145471058682,2019-03-27 20:15:00,2019-03-27 20:30:00
157,2,1,1,0.0197145471058682,2019-03-27 20:15:00,2019-03-27 20:30:00
158,3,2,1,0.0062780010367214124,2019-03-27 20:15:00,2019-03-27 20:30:00
161,6,3,3,0.0197145471058682,2019-03-27 20:15:00,2019-03-27 20:30:00
162,3,1,2,0.0051507058416495645,2019-03-27 20:15:00,2019-03-27 20:30:00
164,5,2,3,0.005247585128311406,2019-03-27 20:15:00,2019-03-27 20:30:00
168,1,1,0,0.005478783259886745,2019-03-27 20:15:00,2019-03-27 20:30:00
169,1,0,1,0.0029613508226087122,2019-03-27 20:15:00,2019-03-27 20:30:00
170,2,0,2,0.0029613508226087122,2019-03-27 20:15:00,2019-03-27 20:30:00
171,1,1,0,0.004703372719721899,2019-03-27 20:15:00,2019-03-27 20:30:00
172,1,1,0,0.006037567997592187,2019-03-27 20:15:00,2019-03-27 20:30:00
175,4,2,2,0.0197145471058682,2019-03-27 20:15:00,2019-03-27 20:30:00
177,2,1,1,0.0197145471058682,2019-03-27 20:15:00,2019-03-27 20:30:00
195,4,0,4,0.0029613508226087122,2019-03-27 20:15:00,2019-03-27 20:30:00
196,3,3,0,0.006108141369206253,2019-03-27 20:15:00,2019-03-27 20:30:00
197,1,1,0,0.007335844690267112,2019-03-27 20:15:00,2019-03-27 20:30:00
201,1,1,0,0.0082983431198792,2019-03-27 20:15:00,2019-03-27 20:30:00
203,2,1,1,0.006037567997592187,2019-03-27 20:15:00,2019-03-27 20:30:00
1,2,2,0,0.01676073312875436,2019-03-27 20:30:00,2019-03-27 20:45:00
2,5,3,2,0.011192971003716395,2019-03-27 20:30:00,2019-03-27 20:45:00
5,2,1,1,0.020116100476247702,2019-03-27 20:30:00,2019-03-27 20:45:00
15,3,0,3,0.003023494596339039,2019-03-27 20:30:00,2019-03-27 20:45:00
16,7,6,1,0.04788730117755607,2019-03-27 20:30:00,2019-03-27 20:45:00
18,8,4,4,0.011743327427919137,2019-03-27 20:30:00,2019-03-27 20:45:00
19,8,1,7,0.0034414250340491876,2019-03-27 20:30:00,2019-03-27 20:45:00
20,1,0,1,0.003023494596339039,2019-03-27 20:30:00,2019-03-27 20:45:00
23,7,3,4,0.010927159960892868,2019-03-27 20:30:00,2019-03-27 20:45:00
28,2,1,1,0.020116100476247702,2019-03-27 20:30:00,2019-03-27 20:45:00
30,1,1,0,0.0038802370157051663,2019-03-27 20:30:00,2019-03-27 20:45:00
40,1,0,1,0.003023494596339039,2019-03-27 20:30:00,2019-03-27 20:45:00
41,6,5,1,0.011421127167307789,2019-03-27 20:30:00,2019-03-27 20:45:00
46,9,5,4,0.01212865878516605,2019-03-27 20:30:00,2019-03-27 20:45:00
57,1,1,0,0.005258717885468816,2019-03-27 20:30:00,2019-03-27 20:45:00
58,4,2,2,0.004298167453415314,2019-03-27 20:30:00,2019-03-27 20:45:00
61,1,1,0,0.0034414250340491876,2019-03-27 20:30:00,2019-03-27 20:45:00
62,1,0,1,0.003023494596339039,2019-03-27 20:30:00,2019-03-27 20:45:00
66,1,0,1,0.003023494596339039,2019-03-27 20:30:00,2019-03-27 20:45:00
67,1,0,1,0.003023494596339039,2019-03-27 20:30:00,2019-03-27 20:45:00
68,2,2,0,0.004736979435071293,2019-03-27 20:30:00,2019-03-27 20:45:00
69,1,1,0,0.0055937218544374195,2019-03-27 20:30:00,2019-03-27 20:45:00
70,5,3,2,0.007314661353014876,2019-03-27 20:30:00,2019-03-27 20:45:00
88,5,3,2,0.015109392092851523,2019-03-27 20:30:00,2019-03-27 20:45:00
89,3,3,0,0.01244626083103335,2019-03-27 20:30:00,2019-03-27 20:45:00
90,7,1,6,0.006282319789464991,2019-03-27 20:30:00,2019-03-27 20:45:00
101,3,1,2,0.005258717885468816,2019-03-27 20:30:00,2019-03-27 20:45:00
104,4,4,0,0.008932809608427955,2019-03-27 20:30:00,2019-03-27 20:45:00
106,2,1,1,0.020116100476247702,2019-03-27 20:30:00,2019-03-27 20:45:00
109,6,1,5,0.003642842764735502,2019-03-27 20:30:00,2019-03-27 20:45:00
110,1,0,1,0.003023494596339039,2019-03-27 20:30:00,2019-03-27 20:45:00
112,3,2,1,0.007916141940151358,2019-03-27 20:30:00,2019-03-27 20:45:00
114,1,0,1,0.003023494596339039,2019-03-27 20:30:00,2019-03-27 20:45:00
115,3,0,3,0.003023494596339039,2019-03-27 20:30:00,2019-03-27 20:45:00
116,2,2,0,0.0081639491125358,2019-03-27 20:30:00,2019-03-27 20:45:00
118,1,0,1,0.003023494596339039,2019-03-27 20:30:00,2019-03-27 20:45:00
119,1,1,0,0.013847891971103556,2019-03-27 20:30:00,2019-03-27 20:45:00
122,4,1,3,0.004219012736110378,2019-03-27 20:30:00,2019-03-27 20:45:00
126,3,2,1,0.0065998193715993145,2019-03-27 20:30:00,2019-03-27 20:45:00
129,2,1,1,0.020116100476247702,2019-03-27 20:30:00,2019-03-27 20:45:00
135,3,3,0,0.00784610636134587,2019-03-27 20:30:00,2019-03-27 20:45:00
137,3,0,3,0.003023494596339039,2019-03-27 20:30:00,2019-03-27 20:45:00
138,6,3,3,0.011500020203183716,2019-03-27 20:30:00,2019-03-27 20:45:00
140,1,1,0,0.0055937218544374195,2019-03-27 20:30:00,2019-03-27 20:45:00
141,2,1,1,0.020116100476247702,2019-03-27 20:30:00,2019-03-27 20:45:00
151,1,1,0,0.0055937218544374195,2019-03-27 20:30:00,2019-03-27 20:45:00
153,3,1,2,0.005601176514282623,2019-03-27 20:30:00,2019-03-27 20:45:00
154,3,1,2,0.005258717885468816,2019-03-27 20:30:00,2019-03-27 20:45:00
157,2,1,1,0.020116100476247702,2019-03-27 20:30:00,2019-03-27 20:45:00
158,2,1,1,0.006282319789464991,2019-03-27 20:30:00,2019-03-27 20:45:00
161,2,1,1,0.020116100476247702,2019-03-27 20:30:00,2019-03-27 20:45:00
162,6,3,3,0.020116100476247702,2019-03-27 20:30:00,2019-03-27 20:45:00
164,1,0,1,0.003023494596339039,2019-03-27 20:30:00,2019-03-27 20:45:00
168,1,1,0,0.0038802370157051663,2019-03-27 20:30:00,2019-03-27 20:45:00
170,2,0,2,0.003023494596339039,2019-03-27 20:30:00,2019-03-27 20:45:00
173,3,1,2,0.003642842764735502,2019-03-27 20:30:00,2019-03-27 20:45:00
175,4,2,2,0.020116100476247702,2019-03-27 20:30:00,2019-03-27 20:45:00
190,1,1,0,0.003642842764735502,2019-03-27 20:30:00,2019-03-27 20:45:00
195,3,0,3,0.003023494596339039,2019-03-27 20:30:00,2019-03-27 20:45:00
196,5,4,1,0.009559591200078125,2019-03-27 20:30:00,2019-03-27 20:45:00
197,1,1,0,0.005345914682052978,2019-03-27 20:30:00,2019-03-27 20:45:00
201,1,1,0,0.008364229939552936,2019-03-27 20:30:00,2019-03-27 20:45:00
203,2,1,1,0.012732724035389237,2019-03-27 20:30:00,2019-03-27 20:45:00
1,2,2,0,0.011633614187707104,2019-03-27 20:45:00,2019-03-27 21:00:00
2,3,1,2,0.0036706329450831186,2019-03-27 20:45:00,2019-03-27 21:00:00
10,1,1,0,0.004489692417682151,2019-03-27 20:45:00,2019-03-27 21:00:00
15,4,3,1,0.012016650192589445,2019-03-27 20:45:00,2019-03-27 21:00:00
16,5,3,2,0.005876161874480267,2019-03-27 20:45:00,2019-03-27 21:00:00
18,4,3,1,0.038748331410914605,2019-03-27 20:45:00,2019-03-27 21:00:00
19,6,1,5,0.005828804899451318,2019-03-27 20:45:00,2019-03-27 21:00:00
20,2,0,2,0.0031505799359129835,2019-03-27 20:45:00,2019-03-27 21:00:00
23,4,1,3,0.01551666078847771,2019-03-27 20:45:00,2019-03-27 21:00:00
28,2,1,1,0.02094945567341379,2019-03-27 20:45:00,2019-03-27 21:00:00
30,1,1,0,0.005828804899451318,2019-03-27 20:45:00,2019-03-27 21:00:00
41,3,3,0,0.006471674405039213,2019-03-27 20:45:00,2019-03-27 21:00:00
46,5,3,2,0.0061031171723990064,2019-03-27 20:45:00,2019-03-27 21:00:00
57,1,1,0,0.005828804899451318,2019-03-27 20:45:00,2019-03-27 21:00:00
58,2,0,2,0.0031505799359129835,2019-03-27 20:45:00,2019-03-27 21:00:00
61,1,1,0,0.0041415709295915155,2019-03-27 20:45:00,2019-03-27 21:00:00
62,1,0,1,0.0031505799359129835,2019-03-27 20:45:00,2019-03-27 21:00:00
67,2,0,2,0.0031505799359129835,2019-03-27 20:45:00,2019-03-27 21:00:00
69,1,1,0,0.005828804899451318,2019-03-27 20:45:00,2019-03-27 21:00:00
70,2,0,2,0.0031505799359129835,2019-03-27 20:45:00,2019-03-27 21:00:00
88,4,4,0,0.009469175963642265,2019-03-27 20:45:00,2019-03-27 21:00:00
89,4,2,2,0.00981776225113413,2019-03-27 20:45:00,2019-03-27 21:00:00
90,4,1,3,0.0036706329450831186,2019-03-27 20:45:00,2019-03-27 21:00:00
104,5,5,0,0.00934006234333887,2019-03-27 20:45:00,2019-03-27 21:00:00
106,2,1,1,0.02094945567341379,2019-03-27 20:45:00,2019-03-27 21:00:00
109,6,1,5,0.0037959498377997257,2019-03-27 20:45:00,2019-03-27 21:00:00
110,1,0,1,0.0031505799359129835,2019-03-27 20:45:00,2019-03-27 21:00:00
112,2,1,1,0.017273073105040206,2019-03-27 20:45:00,2019-03-27 21:00:00
114,4,3,1,0.016611565097168622,2019-03-27 20:45:00,2019-03-27 21:00:00
115,1,0,1,0.0031505799359129835,2019-03-27 20:45:00,2019-03-27 21:00:00
116,2,2,0,0.005828804899451318,2019-03-27 20:45:00,2019-03-27 21:00:00
118,1,1,0,0.01551666078847771,2019-03-27 20:45:00,2019-03-27 21:00:00
119,1,1,0,0.004489692417682151,2019-03-27 20:45:00,2019-03-27 21:00:00
120,1,1,0,0.005828804899451318,2019-03-27 20:45:00,2019-03-27 21:00:00
122,2,0,2,0.0031505799359129835,2019-03-27 20:45:00,2019-03-27 21:00:00
126,2,1,1,0.004489692417682151,2019-03-27 20:45:00,2019-03-27 21:00:00
127,3,3,0,0.012543072248990112,2019-03-27 20:45:00,2019-03-27 21:00:00
129,1,0,1,0.0031505799359129835,2019-03-27 20:45:00,2019-03-27 21:00:00
135,4,3,1,0.012110580609492359,2019-03-27 20:45:00,2019-03-27 21:00:00
137,7,1,6,0.0036706329450831186,2019-03-27 20:45:00,2019-03-27 21:00:00
138,5,3,2,0.029091192456185067,2019-03-27 20:45:00,2019-03-27 21:00:00
140,1,1,0,0.005479685054079837,2019-03-27 20:45:00,2019-03-27 21:00:00
141,2,1,1,0.02094945567341379,2019-03-27 20:45:00,2019-03-27 21:00:00
153,3,2,1,0.0070837680830341185,2019-03-27 20:45:00,2019-03-27 21:00:00
154,1,0,1,0.0031505799359129835,2019-03-27 20:45:00,2019-03-27 21:00:00
157,2,1,1,0.02094945567341379,2019-03-27 20:45:00,2019-03-27 21:00:00
161,2,1,1,0.02094945567341379,2019-03-27 20:45:00,2019-03-27 21:00:00
164,2,0,2,0.0031505799359129835,2019-03-27 20:45:00,2019-03-27 21:00:00
168,1,1,0,0.0036706329450831186,2019-03-27 20:45:00,2019-03-27 21:00:00
170,2,0,2,0.0031505799359129835,2019-03-27 20:45:00,2019-03-27 21:00:00
171,1,0,1,0.0031505799359129835,2019-03-27 20:45:00,2019-03-27 21:00:00
172,2,1,1,0.02094945567341379,2019-03-27 20:45:00,2019-03-27 21:00:00
173,5,1,4,0.0037959498377997257,2019-03-27 20:45:00,2019-03-27 21:00:00
175,4,2,2,0.02094945567341379,2019-03-27 20:45:00,2019-03-27 21:00:00
190,1,1,0,0.0037959498377997257,2019-03-27 20:45:00,2019-03-27 21:00:00
195,4,1,3,0.013446307103553334,2019-03-27 20:45:00,2019-03-27 21:00:00
196,6,4,2,0.010978361477125588,2019-03-27 20:45:00,2019-03-27 21:00:00
201,3,1,2,0.005479685054079837,2019-03-27 20:45:00,2019-03-27 21:00:00
2,3,1,2,0.004992307476320698,2019-03-27 21:00:00,2019-03-27 21:15:00
10,1,1,0,0.006059504626811464,2019-03-27 21:00:00,2019-03-27 21:15:00
15,1,1,0,0.004992307476320698,2019-03-27 21:00:00,2019-03-27 21:15:00
16,2,0,2,0.003275254242888805,2019-03-27 21:00:00,2019-03-27 21:15:00
18,5,2,3,0.008455536789447975,2019-03-27 21:00:00,2019-03-27 21:15:00
19,3,2,1,0.010653557241630373,2019-03-27 21:00:00,2019-03-27 21:15:00
20,1,0,1,0.003275254242888805,2019-03-27 21:00:00,2019-03-27 21:15:00
23,4,1,3,0.009261432049669043,2019-03-27 21:00:00,2019-03-27 21:15:00
28,3,1,2,0.005696610887962197,2019-03-27 21:00:00,2019-03-27 21:15:00
30,1,1,0,0.006059504626811464,2019-03-27 21:00:00,2019-03-27 21:15:00
37,1,0,1,0.003275254242888805,2019-03-27 21:00:00,2019-03-27 21:15:00
46,2,1,1,0.004667379434850134,2019-03-27 21:00:00,2019-03-27 21:15:00
57,6,4,2,0.0182433783808769,2019-03-27 21:00:00,2019-03-27 21:15:00
58,1,0,1,0.003275254242888805,2019-03-27 21:00:00,2019-03-27 21:15:00
61,1,1,0,0.005696610887962197,2019-03-27 21:00:00,2019-03-27 21:15:00
62,1,0,1,0.003275254242888805,2019-03-27 21:00:00,2019-03-27 21:15:00
67,2,0,2,0.003275254242888805,2019-03-27 21:00:00,2019-03-27 21:15:00
69,2,1,1,0.006059504626811464,2019-03-27 21:00:00,2019-03-27 21:15:00
70,1,1,0,0.008426413943184484,2019-03-27 21:00:00,2019-03-27 21:15:00
75,1,1,0,0.006059504626811464,2019-03-27 21:00:00,2019-03-27 21:15:00
87,1,0,1,0.003275254242888805,2019-03-27 21:00:00,2019-03-27 21:15:00
88,2,2,0,0.007519201765336443,2019-03-27 21:00:00,2019-03-27 21:15:00
89,1,0,1,0.003275254242888805,2019-03-27 21:00:00,2019-03-27 21:15:00
90,1,1,0,0.006059504626811464,2019-03-27 21:00:00,2019-03-27 21:15:00
104,1,1,0,0.007242959284997975,2019-03-27 21:00:00,2019-03-27 21:15:00
106,2,1,1,0.021790619969976666,2019-03-27 21:00:00,2019-03-27 21:15:00
109,3,1,2,0.005696610887962197,2019-03-27 21:00:00,2019-03-27 21:15:00
110,4,4,0,0.013445085776856741,2019-03-27 21:00:00,2019-03-27 21:15:00
112,2,1,1,0.012711885104013509,2019-03-27 21:00:00,2019-03-27 21:15:00
114,4,3,1,0.011099991834144757,2019-03-27 21:00:00,2019-03-27 21:15:00
115,1,0,1,0.003275254242888805,2019-03-27 21:00:00,2019-03-27 21:15:00
116,2,2,0,0.007291958305404189,2019-03-27 21:00:00,2019-03-27 21:15:00
119,2,0,2,0.003275254242888805,2019-03-27 21:00:00,2019-03-27 21:15:00
122,1,0,1,0.003275254242888805,2019-03-27 21:00:00,2019-03-27 21:15:00
126,1,1,0,0.006059504626811464,2019-03-27 21:00:00,2019-03-27 21:15:00
127,2,2,0,0.006059504626811464,2019-03-27 21:00:00,2019-03-27 21:15:00
135,3,2,1,0.021790619969976666,2019-03-27 21:00:00,2019-03-27 21:15:00
137,5,2,3,0.006059504626811464,2019-03-27 21:00:00,2019-03-27 21:15:00
138,3,1,2,0.014082344776868084,2019-03-27 21:00:00,2019-03-27 21:15:00
140,3,2,1,0.008843755010734124,2019-03-27 21:00:00,2019-03-27 21:15:00
141,5,1,4,0.004159175081988551,2019-03-27 21:00:00,2019-03-27 21:15:00
153,2,2,0,0.007242959284997974,2019-03-27 21:00:00,2019-03-27 21:15:00
154,1,1,0,0.01233244551273748,2019-03-27 21:00:00,2019-03-27 21:15:00
157,2,1,1,0.021790619969976666,2019-03-27 21:00:00,2019-03-27 21:15:00
161,2,1,1,0.021790619969976666,2019-03-27 21:00:00,2019-03-27 21:15:00
164,3,2,1,0.07328231954870747,2019-03-27 21:00:00,2019-03-27 21:15:00
168,1,1,0,0.004992307476320698,2019-03-27 21:00:00,2019-03-27 21:15:00
170,2,0,2,0.003275254242888805,2019-03-27 21:00:00,2019-03-27 21:15:00
171,2,0,2,0.003275254242888805,2019-03-27 21:00:00,2019-03-27 21:15:00
175,4,2,2,0.021790619969976666,2019-03-27 21:00:00,2019-03-27 21:15:00
195,3,1,2,0.021790619969976666,2019-03-27 21:00:00,2019-03-27 21:15:00
196,4,2,2,0.006059504626811464,2019-03-27 21:00:00,2019-03-27 21:15:00
201,1,0,1,0.003275254242888805,2019-03-27 21:00:00,2019-03-27 21:15:00
1,2,0,2,0.003385368714656615,2019-03-27 21:15:00,2019-03-27 21:30:00
2,4,0,4,0.003385368714656615,2019-03-27 21:15:00,2019-03-27 21:30:00
5,1,0,1,0.003385368714656615,2019-03-27 21:15:00,2019-03-27 21:30:00
15,2,1,1,0.006263214855235262,2019-03-27 21:15:00,2019-03-27 21:30:00
18,2,0,2,0.003385368714656615,2019-03-27 21:15:00,2019-03-27 21:30:00
19,2,1,1,0.010117173632963545,2019-03-27 21:15:00,2019-03-27 21:30:00
23,4,1,3,0.010117173632963545,2019-03-27 21:15:00,2019-03-27 21:30:00
30,3,3,0,0.00914106099581391,2019-03-27 21:15:00,2019-03-27 21:30:00
37,1,0,1,0.003385368714656615,2019-03-27 21:15:00,2019-03-27 21:30:00
46,3,0,3,0.003385368714656615,2019-03-27 21:15:00,2019-03-27 21:30:00
57,4,3,1,0.007222496902094811,2019-03-27 21:15:00,2019-03-27 21:30:00
62,2,1,1,0.004344650761516164,2019-03-27 21:15:00,2019-03-27 21:30:00
67,3,0,3,0.003385368714656615,2019-03-27 21:15:00,2019-03-27 21:30:00
69,2,1,1,0.00707870199547163,2019-03-27 21:15:00,2019-03-27 21:30:00
70,2,1,1,0.009402940974420832,2019-03-27 21:15:00,2019-03-27 21:30:00
75,1,1,0,0.006263214855235262,2019-03-27 21:15:00,2019-03-27 21:30:00
86,1,1,0,0.004344650761516164,2019-03-27 21:15:00,2019-03-27 21:30:00
87,1,0,1,0.003385368714656615,2019-03-27 21:15:00,2019-03-27 21:30:00
88,2,2,0,0.004824291784945939,2019-03-27 21:15:00,2019-03-27 21:30:00
89,1,0,1,0.003385368714656615,2019-03-27 21:15:00,2019-03-27 21:30:00
90,1,1,0,0.006263214855235262,2019-03-27 21:15:00,2019-03-27 21:30:00
104,1,1,0,0.004344650761516164,2019-03-27 21:15:00,2019-03-27 21:30:00
106,2,1,1,0.022511981415527384,2019-03-27 21:15:00,2019-03-27 21:30:00
109,3,0,3,0.003385368714656615,2019-03-27 21:15:00,2019-03-27 21:30:00
112,2,1,1,0.014645443787014661,2019-03-27 21:15:00,2019-03-27 21:30:00
114,4,3,1,0.013244776592082534,2019-03-27 21:15:00,2019-03-27 21:30:00
115,1,0,1,0.003385368714656615,2019-03-27 21:15:00,2019-03-27 21:30:00
116,3,3,0,0.010089592877577913,2019-03-27 21:15:00,2019-03-27 21:30:00
119,1,0,1,0.003385368714656615,2019-03-27 21:15:00,2019-03-27 21:30:00
120,1,1,0,0.008709676275944368,2019-03-27 21:15:00,2019-03-27 21:30:00
126,3,3,0,0.014422830236403561,2019-03-27 21:15:00,2019-03-27 21:30:00
127,1,0,1,0.003385368714656615,2019-03-27 21:15:00,2019-03-27 21:30:00
129,2,2,0,0.004824291784945939,2019-03-27 21:15:00,2019-03-27 21:30:00
135,4,3,1,0.05120839158584055,2019-03-27 21:15:00,2019-03-27 21:30:00
137,1,1,0,0.00743405189225342,2019-03-27 21:15:00,2019-03-27 21:30:00
138,3,1,2,0.01583634315310444,2019-03-27 21:15:00,2019-03-27 21:30:00
140,1,1,0,0.006263214855235262,2019-03-27 21:15:00,2019-03-27 21:30:00
141,1,1,0,0.004723970900202101,2019-03-27 21:15:00,2019-03-27 21:30:00
153,3,2,1,0.00846986668797588,2019-03-27 21:15:00,2019-03-27 21:30:00
154,1,1,0,0.011986656641105918,2019-03-27 21:15:00,2019-03-27 21:30:00
157,2,1,1,0.022511981415527384,2019-03-27 21:15:00,2019-03-27 21:30:00
158,1,0,1,0.003385368714656615,2019-03-27 21:15:00,2019-03-27 21:30:00
161,3,2,1,0.031405986673190014,2019-03-27 21:15:00,2019-03-27 21:30:00
164,3,1,2,0.009525163416180735,2019-03-27 21:15:00,2019-03-27 21:30:00
170,3,1,2,0.00743405189225342,2019-03-27 21:15:00,2019-03-27 21:30:00
173,2,2,0,0.005303932808375713,2019-03-27 21:15:00,2019-03-27 21:30:00
195,3,1,2,0.046900759327344665,2019-03-27 21:15:00,2019-03-27 21:30:00
196,4,2,2,0.00970510048058111,2019-03-27 21:15:00,2019-03-27 21:30:00
199,1,1,0,0.006263214855235262,2019-03-27 21:15:00,2019-03-27 21:30:00
203,4,1,3,0.004723970900202101,2019-03-27 21:15:00,2019-03-27 21:30:00
2,2,0,2,0.0033389937138685443,2019-03-27 21:30:00,2019-03-27 21:45:00
5,1,0,1,0.0033389937138685443,2019-03-27 21:30:00,2019-03-27 21:45:00
10,1,1,0,0.00717101471705581,2019-03-27 21:30:00,2019-03-27 21:45:00
15,1,1,0,0.006177359764023591,2019-03-27 21:30:00,2019-03-27 21:45:00
18,2,1,1,0.006177359764023591,2019-03-27 21:30:00,2019-03-27 21:45:00
19,1,0,1,0.0033389937138685443,2019-03-27 21:30:00,2019-03-27 21:45:00
20,1,1,0,0.006177359764023591,2019-03-27 21:30:00,2019-03-27 21:45:00
23,3,1,2,0.026138728279649658,2019-03-27 21:30:00,2019-03-27 21:45:00
41,1,1,0,0.01064134162418442,2019-03-27 21:30:00,2019-03-27 21:45:00
46,3,0,3,0.0033389937138685443,2019-03-27 21:30:00,2019-03-27 21:45:00
50,1,0,1,0.0033389937138685443,2019-03-27 21:30:00,2019-03-27 21:45:00
57,1,0,1,0.0033389937138685443,2019-03-27 21:30:00,2019-03-27 21:45:00
62,3,2,1,0.008590197742133333,2019-03-27 21:30:00,2019-03-27 21:45:00
70,1,0,1,0.0033389937138685443,2019-03-27 21:30:00,2019-03-27 21:45:00
75,1,1,0,0.006177359764023591,2019-03-27 21:30:00,2019-03-27 21:45:00
87,1,0,1,0.0033389937138685443,2019-03-27 21:30:00,2019-03-27 21:45:00
88,1,1,0,0.004758176738946068,2019-03-27 21:30:00,2019-03-27 21:45:00
89,1,0,1,0.0033389937138685443,2019-03-27 21:30:00,2019-03-27 21:45:00
90,1,1,0,0.004758176738946068,2019-03-27 21:30:00,2019-03-27 21:45:00
104,2,1,1,0.004285115730586894,2019-03-27 21:30:00,2019-03-27 21:45:00
106,2,1,1,0.022145454277000882,2019-03-27 21:30:00,2019-03-27 21:45:00
109,2,0,2,0.0033389937138685443,2019-03-27 21:30:00,2019-03-27 21:45:00
110,9,4,5,0.015127432020456619,2019-03-27 21:30:00,2019-03-27 21:45:00
112,7,3,4,0.037081518512025055,2019-03-27 21:30:00,2019-03-27 21:45:00
114,5,4,1,0.03746409402461527,2019-03-27 21:30:00,2019-03-27 21:45:00
118,2,2,0,0.01910203176046974,2019-03-27 21:30:00,2019-03-27 21:45:00
119,2,0,2,0.0033389937138685443,2019-03-27 21:30:00,2019-03-27 21:45:00
122,1,1,0,0.006177359764023591,2019-03-27 21:30:00,2019-03-27 21:45:00
126,5,3,2,0.009015725814178638,2019-03-27 21:30:00,2019-03-27 21:45:00
129,4,3,1,0.007596542789101116,2019-03-27 21:30:00,2019-03-27 21:45:00
133,1,0,1,0.0033389937138685443,2019-03-27 21:30:00,2019-03-27 21:45:00
135,3,3,0,0.009015725814178638,2019-03-27 21:30:00,2019-03-27 21:45:00
137,3,1,2,0.007502953639539253,2019-03-27 21:30:00,2019-03-27 21:45:00
138,6,5,1,0.02681783894127268,2019-03-27 21:30:00,2019-03-27 21:45:00
140,2,0,2,0.0033389937138685443,2019-03-27 21:30:00,2019-03-27 21:45:00
141,2,2,0,0.009562103395960796,2019-03-27 21:30:00,2019-03-27 21:45:00
153,1,0,1,0.0033389937138685443,2019-03-27 21:30:00,2019-03-27 21:45:00
154,1,1,0,0.006177359764023591,2019-03-27 21:30:00,2019-03-27 21:45:00
157,3,1,2,0.0058073387952129775,2019-03-27 21:30:00,2019-03-27 21:45:00
158,1,0,1,0.0033389937138685443,2019-03-27 21:30:00,2019-03-27 21:45:00
161,3,2,1,0.04631036008248945,2019-03-27 21:30:00,2019-03-27 21:45:00
164,3,1,2,0.009796616731188205,2019-03-27 21:30:00,2019-03-27 21:45:00
170,3,1,2,0.007502953639539253,2019-03-27 21:30:00,2019-03-27 21:45:00
191,2,1,1,0.022145454277000882,2019-03-27 21:30:00,2019-03-27 21:45:00
195,2,0,2,0.0033389937138685443,2019-03-27 21:30:00,2019-03-27 21:45:00
196,3,2,1,0.009717130243367258,2019-03-27 21:30:00,2019-03-27 21:45:00
197,1,1,0,0.0058073387952129775,2019-03-27 21:30:00,2019-03-27 21:45:00
199,1,1,0,0.006177359764023591,2019-03-27 21:30:00,2019-03-27 21:45:00
203,3,1,2,0.008590197742133335,2019-03-27 21:30:00,2019-03-27 21:45:00
2,2,2,0,0.009017890710238338,2019-03-27 21:45:00,2019-03-27 22:00:00
5,1,0,1,0.0034204571551296335,2019-03-27 21:45:00,2019-03-27 22:00:00
10,3,1,2,0.0075640508603209405,2019-03-27 21:45:00,2019-03-27 22:00:00
11,1,1,0,0.008477830558887775,2019-03-27 21:45:00,2019-03-27 22:00:00
16,2,1,1,0.004874297005047032,2019-03-27 21:45:00,2019-03-27 22:00:00
18,1,0,1,0.0034204571551296335,2019-03-27 21:45:00,2019-03-27 22:00:00
19,1,0,1,0.0034204571551296335,2019-03-27 21:45:00,2019-03-27 22:00:00
20,2,2,0,0.009543231587812232,2019-03-27 21:45:00,2019-03-27 22:00:00
23,3,1,2,0.009624391097406539,2019-03-27 21:45:00,2019-03-27 22:00:00
41,1,1,0,0.006328136854964429,2019-03-27 21:45:00,2019-03-27 22:00:00
46,2,0,2,0.0034204571551296335,2019-03-27 21:45:00,2019-03-27 22:00:00
50,1,0,1,0.0034204571551296335,2019-03-27 21:45:00,2019-03-27 22:00:00
58,2,0,2,0.0034204571551296335,2019-03-27 21:45:00,2019-03-27 22:00:00
62,1,0,1,0.0034204571551296335,2019-03-27 21:45:00,2019-03-27 22:00:00
88,1,1,0,0.004874297005047032,2019-03-27 21:45:00,2019-03-27 22:00:00
89,1,0,1,0.0034204571551296335,2019-03-27 21:45:00,2019-03-27 22:00:00
90,2,2,0,0.010666743173696511,2019-03-27 21:45:00,2019-03-27 22:00:00
104,2,1,1,0.004874297005047032,2019-03-27 21:45:00,2019-03-27 22:00:00
110,4,0,4,0.0034204571551296335,2019-03-27 21:45:00,2019-03-27 22:00:00
112,7,1,6,0.01197355347510802,2019-03-27 21:45:00,2019-03-27 22:00:00
114,7,4,3,0.030182198345864282,2019-03-27 21:45:00,2019-03-27 22:00:00
118,2,2,0,0.0068135675977821905,2019-03-27 21:45:00,2019-03-27 22:00:00
119,2,0,2,0.0034204571551296335,2019-03-27 21:45:00,2019-03-27 22:00:00
126,2,1,1,0.004874297005047032,2019-03-27 21:45:00,2019-03-27 22:00:00
127,1,1,0,0.0075640508603209405,2019-03-27 21:45:00,2019-03-27 22:00:00
129,2,1,1,0.004874297005047032,2019-03-27 21:45:00,2019-03-27 22:00:00
135,2,2,0,0.006328136854964429,2019-03-27 21:45:00,2019-03-27 22:00:00
137,3,2,1,0.0068135675977821905,2019-03-27 21:45:00,2019-03-27 22:00:00
138,5,4,1,0.007297772151332009,2019-03-27 21:45:00,2019-03-27 22:00:00
140,2,0,2,0.0034204571551296335,2019-03-27 21:45:00,2019-03-27 22:00:00
141,6,4,2,0.05364505397742738,2019-03-27 21:45:00,2019-03-27 22:00:00
153,1,1,0,0.006635551887977437,2019-03-27 21:45:00,2019-03-27 22:00:00
154,3,2,1,0.04206211280758966,2019-03-27 21:45:00,2019-03-27 22:00:00
157,3,1,2,0.005949143857008704,2019-03-27 21:45:00,2019-03-27 22:00:00
158,1,1,0,0.004874297005047032,2019-03-27 21:45:00,2019-03-27 22:00:00
161,3,2,1,0.04881484702086987,2019-03-27 21:45:00,2019-03-27 22:00:00
164,2,1,1,0.0075640508603209405,2019-03-27 21:45:00,2019-03-27 22:00:00
170,3,1,2,0.009850646620825241,2019-03-27 21:45:00,2019-03-27 22:00:00
173,1,1,0,0.005117012376455912,2019-03-27 21:45:00,2019-03-27 22:00:00
190,1,1,0,0.006328136854964429,2019-03-27 21:45:00,2019-03-27 22:00:00
191,2,1,1,0.022741284981359647,2019-03-27 21:45:00,2019-03-27 22:00:00
195,2,0,2,0.0034204571551296335,2019-03-27 21:45:00,2019-03-27 22:00:00
196,3,2,1,0.011794567584355509,2019-03-27 21:45:00,2019-03-27 22:00:00
197,2,1,1,0.005949143857008704,2019-03-27 21:45:00,2019-03-27 22:00:00
199,1,1,0,0.01197355347510802,2019-03-27 21:45:00,2019-03-27 22:00:00
203,4,2,2,0.009235816554799225,2019-03-27 21:45:00,2019-03-27 22:00:00
1,1,0,1,0.0037550593513749255,2019-03-27 22:00:00,2019-03-27 22:15:00
2,3,3,0,0.015805819627304787,2019-03-27 22:00:00,2019-03-27 22:15:00
5,2,0,2,0.0037550593513749255,2019-03-27 22:00:00,2019-03-27 22:15:00
10,2,0,2,0.0037550593513749255,2019-03-27 22:00:00,2019-03-27 22:15:00
11,1,1,0,0.00694718229884447,2019-03-27 22:00:00,2019-03-27 22:15:00
15,1,1,0,0.00694718229884447,2019-03-27 22:00:00,2019-03-27 22:15:00
16,3,2,1,0.008543243772579243,2019-03-27 22:00:00,2019-03-27 22:15:00
20,3,3,0,0.011735366720048787,2019-03-27 22:00:00,2019-03-27 22:15:00
21,1,0,1,0.0037550593513749255,2019-03-27 22:00:00,2019-03-27 22:15:00
23,1,1,0,0.013321129736022761,2019-03-27 22:00:00,2019-03-27 22:15:00
26,1,0,1,0.0037550593513749255,2019-03-27 22:00:00,2019-03-27 22:15:00
41,1,0,1,0.0037550593513749255,2019-03-27 22:00:00,2019-03-27 22:15:00
46,1,0,1,0.0037550593513749255,2019-03-27 22:00:00,2019-03-27 22:15:00
50,1,0,1,0.0037550593513749255,2019-03-27 22:00:00,2019-03-27 22:15:00
57,1,0,1,0.0037550593513749255,2019-03-27 22:00:00,2019-03-27 22:15:00
58,2,0,2,0.0037550593513749255,2019-03-27 22:00:00,2019-03-27 22:15:00
70,2,1,1,0.024949860595620703,2019-03-27 22:00:00,2019-03-27 22:15:00
74,1,0,1,0.0037550593513749255,2019-03-27 22:00:00,2019-03-27 22:15:00
88,3,2,1,0.041232630923914666,2019-03-27 22:00:00,2019-03-27 22:15:00
89,2,0,2,0.0037550593513749255,2019-03-27 22:00:00,2019-03-27 22:15:00
90,1,1,0,0.00694718229884447,2019-03-27 22:00:00,2019-03-27 22:15:00
99,1,1,0,0.00694718229884447,2019-03-27 22:00:00,2019-03-27 22:15:00
101,1,0,1,0.0037550593513749255,2019-03-27 22:00:00,2019-03-27 22:15:00
104,1,1,0,0.00694718229884447,2019-03-27 22:00:00,2019-03-27 22:15:00
109,1,1,0,0.008891099228227773,2019-03-27 22:00:00,2019-03-27 22:15:00
110,1,0,1,0.0037550593513749255,2019-03-27 22:00:00,2019-03-27 22:15:00
112,5,1,4,0.0052398456201626815,2019-03-27 22:00:00,2019-03-27 22:15:00
114,4,1,3,0.0052398456201626815,2019-03-27 22:00:00,2019-03-27 22:15:00
118,1,0,1,0.0037550593513749255,2019-03-27 22:00:00,2019-03-27 22:15:00
122,1,0,1,0.0037550593513749255,2019-03-27 22:00:00,2019-03-27 22:15:00
129,1,1,0,0.005351120825109698,2019-03-27 22:00:00,2019-03-27 22:15:00
135,2,2,0,0.00694718229884447,2019-03-27 22:00:00,2019-03-27 22:15:00
137,2,2,0,0.005982238754556559,2019-03-27 22:00:00,2019-03-27 22:15:00
138,4,3,1,0.011252894947904832,2019-03-27 22:00:00,2019-03-27 22:15:00
140,1,0,1,0.0037550593513749255,2019-03-27 22:00:00,2019-03-27 22:15:00
141,5,2,3,0.008667090267326726,2019-03-27 22:00:00,2019-03-27 22:15:00
153,1,1,0,0.005351120825109698,2019-03-27 22:00:00,2019-03-27 22:15:00
154,4,2,2,0.012083222175697317,2019-03-27 22:00:00,2019-03-27 22:15:00
157,2,1,1,0.024949860595620703,2019-03-27 22:00:00,2019-03-27 22:15:00
158,1,1,0,0.005351120825109698,2019-03-27 22:00:00,2019-03-27 22:15:00
161,2,1,1,0.024949860595620703,2019-03-27 22:00:00,2019-03-27 22:15:00
164,1,0,1,0.0037550593513749255,2019-03-27 22:00:00,2019-03-27 22:15:00
170,2,0,2,0.0037550593513749255,2019-03-27 22:00:00,2019-03-27 22:15:00
171,1,1,0,0.00694718229884447,2019-03-27 22:00:00,2019-03-27 22:15:00
172,2,1,1,0.024949860595620703,2019-03-27 22:00:00,2019-03-27 22:15:00
173,1,1,0,0.004868649052965742,2019-03-27 22:00:00,2019-03-27 22:15:00
190,1,1,0,0.005351120825109698,2019-03-27 22:00:00,2019-03-27 22:15:00
191,1,1,0,0.00694718229884447,2019-03-27 22:00:00,2019-03-27 22:15:00
195,2,0,2,0.0037550593513749255,2019-03-27 22:00:00,2019-03-27 22:15:00
196,2,2,0,0.00694718229884447,2019-03-27 22:00:00,2019-03-27 22:15:00
197,1,0,1,0.0037550593513749255,2019-03-27 22:00:00,2019-03-27 22:15:00
199,1,1,0,0.0052398456201626815,2019-03-27 22:00:00,2019-03-27 22:15:00
203,2,2,0,0.008543243772579243,2019-03-27 22:00:00,2019-03-27 22:15:00
2,1,1,0,0.006543500630745512,2019-03-27 22:15:00,2019-03-27 22:30:00
5,1,0,1,0.0035368586463816634,2019-03-27 22:15:00,2019-03-27 22:30:00
10,1,0,1,0.0035368586463816634,2019-03-27 22:15:00,2019-03-27 22:30:00
16,2,2,0,0.01049189969648674,2019-03-27 22:15:00,2019-03-27 22:30:00
19,1,0,1,0.0035368586463816634,2019-03-27 22:15:00,2019-03-27 22:30:00
20,4,3,1,0.013609431561069606,2019-03-27 22:15:00,2019-03-27 22:30:00
23,2,2,0,0.01049189969648674,2019-03-27 22:15:00,2019-03-27 22:30:00
28,1,0,1,0.0035368586463816634,2019-03-27 22:15:00,2019-03-27 22:30:00
41,5,2,3,0.015220773140754068,2019-03-27 22:15:00,2019-03-27 22:30:00
50,1,0,1,0.0035368586463816634,2019-03-27 22:15:00,2019-03-27 22:30:00
57,2,1,1,0.006543500630745512,2019-03-27 22:15:00,2019-03-27 22:30:00
58,3,2,1,0.06779137676072529,2019-03-27 22:15:00,2019-03-27 22:30:00
74,2,0,2,0.0035368586463816634,2019-03-27 22:15:00,2019-03-27 22:30:00
79,1,1,0,0.006151619577229503,2019-03-27 22:15:00,2019-03-27 22:30:00
86,1,1,0,0.005040179638563588,2019-03-27 22:15:00,2019-03-27 22:30:00
89,1,1,0,0.006543500630745512,2019-03-27 22:15:00,2019-03-27 22:30:00
90,2,1,1,0.023514930649042913,2019-03-27 22:15:00,2019-03-27 22:30:00
101,1,0,1,0.0035368586463816634,2019-03-27 22:15:00,2019-03-27 22:30:00
109,1,1,0,0.006543500630745512,2019-03-27 22:15:00,2019-03-27 22:30:00
110,1,0,1,0.0035368586463816634,2019-03-27 22:15:00,2019-03-27 22:30:00
112,2,1,1,0.00990035500599605,2019-03-27 22:15:00,2019-03-27 22:30:00
114,2,1,1,0.007485257712122892,2019-03-27 22:15:00,2019-03-27 22:30:00
116,1,1,0,0.007850086314883134,2019-03-27 22:15:00,2019-03-27 22:30:00
118,2,0,2,0.0035368586463816634,2019-03-27 22:15:00,2019-03-27 22:30:00
122,1,1,0,0.009099468584523833,2019-03-27 22:15:00,2019-03-27 22:30:00
135,2,2,0,0.006543500630745512,2019-03-27 22:15:00,2019-03-27 22:30:00
137,1,0,1,0.0035368586463816634,2019-03-27 22:15:00,2019-03-27 22:30:00
138,10,5,5,0.023221801792789796,2019-03-27 22:15:00,2019-03-27 22:30:00
140,2,1,1,0.006543500630745512,2019-03-27 22:15:00,2019-03-27 22:30:00
151,3,1,2,0.006151619577229503,2019-03-27 22:15:00,2019-03-27 22:30:00
153,2,1,1,0.007850086314883134,2019-03-27 22:15:00,2019-03-27 22:30:00
154,1,0,1,0.0035368586463816634,2019-03-27 22:15:00,2019-03-27 22:30:00
157,2,1,1,0.023514930649042913,2019-03-27 22:15:00,2019-03-27 22:30:00
161,2,1,1,0.023514930649042913,2019-03-27 22:15:00,2019-03-27 22:30:00
170,2,0,2,0.0035368586463816634,2019-03-27 22:15:00,2019-03-27 22:30:00
172,2,1,1,0.023514930649042913,2019-03-27 22:15:00,2019-03-27 22:30:00
173,1,1,0,0.006543500630745512,2019-03-27 22:15:00,2019-03-27 22:30:00
191,2,1,1,0.009099468584523833,2019-03-27 22:15:00,2019-03-27 22:30:00
195,2,0,2,0.0035368586463816634,2019-03-27 22:15:00,2019-03-27 22:30:00
196,3,2,1,0.006543500630745512,2019-03-27 22:15:00,2019-03-27 22:30:00
197,1,1,0,0.015106326005680322,2019-03-27 22:15:00,2019-03-27 22:30:00
202,1,0,1,0.0035368586463816634,2019-03-27 22:15:00,2019-03-27 22:30:00
203,1,1,0,0.006543500630745512,2019-03-27 22:15:00,2019-03-27 22:30:00
2,1,1,0,0.006964394882235846,2019-03-27 22:30:00,2019-03-27 22:45:00
5,3,2,1,0.017493050941298334,2019-03-27 22:30:00,2019-03-27 22:45:00
10,1,0,1,0.00376436518446518,2019-03-27 22:30:00,2019-03-27 22:45:00
16,3,2,1,0.0218355174618618,2019-03-27 22:30:00,2019-03-27 22:45:00
18,2,0,2,0.00376436518446518,2019-03-27 22:30:00,2019-03-27 22:45:00
20,1,0,1,0.00376436518446518,2019-03-27 22:30:00,2019-03-27 22:45:00
23,3,3,0,0.009047619545798708,2019-03-27 22:30:00,2019-03-27 22:45:00
28,5,2,3,0.014640133009576799,2019-03-27 22:30:00,2019-03-27 22:45:00
35,2,1,1,0.024905202732313385,2019-03-27 22:30:00,2019-03-27 22:45:00
41,4,2,2,0.008806014638459942,2019-03-27 22:30:00,2019-03-27 22:45:00
58,4,3,1,0.013346413519622964,2019-03-27 22:30:00,2019-03-27 22:45:00
61,1,1,0,0.007913056956163452,2019-03-27 22:30:00,2019-03-27 22:45:00
62,1,1,0,0.006964394882235846,2019-03-27 22:30:00,2019-03-27 22:45:00
74,1,0,1,0.00376436518446518,2019-03-27 22:30:00,2019-03-27 22:45:00
79,1,1,0,0.006964394882235846,2019-03-27 22:30:00,2019-03-27 22:45:00
86,1,1,0,0.006964394882235846,2019-03-27 22:30:00,2019-03-27 22:45:00
89,1,1,0,0.006964394882235846,2019-03-27 22:30:00,2019-03-27 22:45:00
109,1,1,0,0.022745572637818113,2019-03-27 22:30:00,2019-03-27 22:45:00
110,1,0,1,0.00376436518446518,2019-03-27 22:30:00,2019-03-27 22:45:00
112,2,1,1,0.006147185789349929,2019-03-27 22:30:00,2019-03-27 22:45:00
114,3,1,2,0.005605984940689278,2019-03-27 22:30:00,2019-03-27 22:45:00
116,1,1,0,0.007507359865525534,2019-03-27 22:30:00,2019-03-27 22:45:00
122,1,1,0,0.011044917110762663,2019-03-27 22:30:00,2019-03-27 22:45:00
126,1,0,1,0.00376436518446518,2019-03-27 22:30:00,2019-03-27 22:45:00
127,1,0,1,0.00376436518446518,2019-03-27 22:30:00,2019-03-27 22:45:00
135,2,2,0,0.006964394882235846,2019-03-27 22:30:00,2019-03-27 22:45:00
137,2,0,2,0.00376436518446518,2019-03-27 22:30:00,2019-03-27 22:45:00
138,7,2,5,0.01083169232089433,2019-03-27 22:30:00,2019-03-27 22:45:00
140,3,2,1,0.008564409731121178,2019-03-27 22:30:00,2019-03-27 22:45:00
151,1,0,1,0.00376436518446518,2019-03-27 22:30:00,2019-03-27 22:45:00
153,2,1,1,0.007507359865525534,2019-03-27 22:30:00,2019-03-27 22:45:00
154,2,1,1,0.022327249804206334,2019-03-27 22:30:00,2019-03-27 22:45:00
157,2,1,1,0.024905202732313385,2019-03-27 22:30:00,2019-03-27 22:45:00
161,2,1,1,0.024905202732313385,2019-03-27 22:30:00,2019-03-27 22:45:00
170,2,0,2,0.00376436518446518,2019-03-27 22:30:00,2019-03-27 22:45:00
173,2,1,1,0.007913056956163452,2019-03-27 22:30:00,2019-03-27 22:45:00
191,1,0,1,0.00376436518446518,2019-03-27 22:30:00,2019-03-27 22:45:00
195,2,0,2,0.00376436518446518,2019-03-27 22:30:00,2019-03-27 22:45:00
196,2,2,0,0.006964394882235846,2019-03-27 22:30:00,2019-03-27 22:45:00
197,1,1,0,0.006964394882235846,2019-03-27 22:30:00,2019-03-27 22:45:00
202,1,0,1,0.00376436518446518,2019-03-27 22:30:00,2019-03-27 22:45:00
2,1,1,0,0.007669607703337697,2019-03-27 22:45:00,2019-03-27 23:00:00
5,2,2,0,0.009431644866122926,2019-03-27 22:45:00,2019-03-27 23:00:00
11,2,1,1,0.02750196204620498,2019-03-27 22:45:00,2019-03-27 23:00:00
15,1,1,0,0.007669607703337697,2019-03-27 22:45:00,2019-03-27 23:00:00
16,2,1,1,0.005907570540552468,2019-03-27 22:45:00,2019-03-27 23:00:00
19,1,0,1,0.004145533377767238,2019-03-27 22:45:00,2019-03-27 23:00:00
23,2,2,0,0.0077385055690306764,2019-03-27 22:45:00,2019-03-27 23:00:00
35,2,1,1,0.02750196204620498,2019-03-27 22:45:00,2019-03-27 23:00:00
41,1,1,0,0.005942019473398958,2019-03-27 22:45:00,2019-03-27 23:00:00
58,1,0,1,0.004145533377767238,2019-03-27 22:45:00,2019-03-27 23:00:00
62,1,1,0,0.007669607703337697,2019-03-27 22:45:00,2019-03-27 23:00:00
68,1,0,1,0.004145533377767238,2019-03-27 22:45:00,2019-03-27 23:00:00
104,1,0,1,0.004145533377767238,2019-03-27 22:45:00,2019-03-27 23:00:00
109,1,1,0,0.011938873367633069,2019-03-27 22:45:00,2019-03-27 23:00:00
110,1,0,1,0.004145533377767238,2019-03-27 22:45:00,2019-03-27 23:00:00
112,3,1,2,0.005907570540552468,2019-03-27 22:45:00,2019-03-27 23:00:00
114,2,0,2,0.004145533377767238,2019-03-27 22:45:00,2019-03-27 23:00:00
122,3,3,0,0.008066160503353377,2019-03-27 22:45:00,2019-03-27 23:00:00
126,1,0,1,0.004145533377767238,2019-03-27 22:45:00,2019-03-27 23:00:00
127,2,0,2,0.004145533377767238,2019-03-27 22:45:00,2019-03-27 23:00:00
135,1,1,0,0.005907570540552468,2019-03-27 22:45:00,2019-03-27 23:00:00
137,1,1,0,0.0048503482428813305,2019-03-27 22:45:00,2019-03-27 23:00:00
138,6,2,4,0.008453016868756913,2019-03-27 22:45:00,2019-03-27 23:00:00
154,2,1,1,0.009167528168483149,2019-03-27 22:45:00,2019-03-27 23:00:00
157,2,1,1,0.02750196204620498,2019-03-27 22:45:00,2019-03-27 23:00:00
161,2,1,1,0.02750196204620498,2019-03-27 22:45:00,2019-03-27 23:00:00
170,5,0,5,0.004145533377767238,2019-03-27 22:45:00,2019-03-27 23:00:00
172,1,1,0,0.007669607703337697,2019-03-27 22:45:00,2019-03-27 23:00:00
173,1,1,0,0.007669607703337697,2019-03-27 22:45:00,2019-03-27 23:00:00
196,2,2,0,0.005555163107995422,2019-03-27 22:45:00,2019-03-27 23:00:00
2,1,0,1,0.004172525031089555,2019-03-27 23:00:00,2019-03-27 23:15:00
15,1,1,0,0.005946029024458267,2019-03-27 23:00:00,2019-03-27 23:15:00
16,2,0,2,0.004172525031089555,2019-03-27 23:00:00,2019-03-27 23:15:00
19,1,0,1,0.004172525031089555,2019-03-27 23:00:00,2019-03-27 23:15:00
23,1,1,0,0.008433893118362002,2019-03-27 23:00:00,2019-03-27 23:15:00
28,2,0,2,0.004172525031089555,2019-03-27 23:00:00,2019-03-27 23:15:00
57,1,1,0,0.005946029024458267,2019-03-27 23:00:00,2019-03-27 23:15:00
61,2,1,1,0.005946029024458267,2019-03-27 23:00:00,2019-03-27 23:15:00
67,2,2,0,0.00771953301782698,2019-03-27 23:00:00,2019-03-27 23:15:00
68,1,1,0,0.010734856340701414,2019-03-27 23:00:00,2019-03-27 23:15:00
90,4,2,2,0.027636017083101913,2019-03-27 23:00:00,2019-03-27 23:15:00
109,2,2,0,0.011266541004564406,2019-03-27 23:00:00,2019-03-27 23:15:00
110,2,1,1,0.00771953301782698,2019-03-27 23:00:00,2019-03-27 23:15:00
112,2,1,1,0.00771953301782698,2019-03-27 23:00:00,2019-03-27 23:15:00
114,1,0,1,0.004172525031089555,2019-03-27 23:00:00,2019-03-27 23:15:00
122,1,1,0,0.00771953301782698,2019-03-27 23:00:00,2019-03-27 23:15:00
126,1,0,1,0.004172525031089555,2019-03-27 23:00:00,2019-03-27 23:15:00
127,1,0,1,0.004172525031089555,2019-03-27 23:00:00,2019-03-27 23:15:00
135,1,1,0,0.00771953301782698,2019-03-27 23:00:00,2019-03-27 23:15:00
138,7,3,4,0.0200508940761485,2019-03-27 23:00:00,2019-03-27 23:15:00
140,1,1,0,0.005946029024458267,2019-03-27 23:00:00,2019-03-27 23:15:00
154,1,0,1,0.004172525031089555,2019-03-27 23:00:00,2019-03-27 23:15:00
157,2,1,1,0.027636017083101913,2019-03-27 23:00:00,2019-03-27 23:15:00
158,1,0,1,0.004172525031089555,2019-03-27 23:00:00,2019-03-27 23:15:00
161,2,1,1,0.027636017083101913,2019-03-27 23:00:00,2019-03-27 23:15:00
170,2,0,2,0.004172525031089555,2019-03-27 23:00:00,2019-03-27 23:15:00
172,1,1,0,0.00771953301782698,2019-03-27 23:00:00,2019-03-27 23:15:00
196,4,4,0,0.016242269192371872,2019-03-27 23:00:00,2019-03-27 23:15:00
203,2,0,2,0.004172525031089555,2019-03-27 23:00:00,2019-03-27 23:15:00
2,1,0,1,0.0039555856812039615,2019-03-27 23:15:00,2019-03-27 23:30:00
23,1,1,0,0.015251174207019293,2019-03-27 23:15:00,2019-03-27 23:30:00
28,2,0,2,0.0039555856812039615,2019-03-27 23:15:00,2019-03-27 23:30:00
57,4,4,0,0.008158819508163495,2019-03-27 23:15:00,2019-03-27 23:30:00
61,2,1,1,0.005636879211987775,2019-03-27 23:15:00,2019-03-27 23:30:00
67,2,2,0,0.007318172742771588,2019-03-27 23:15:00,2019-03-27 23:30:00
68,1,1,0,0.010176719410412167,2019-03-27 23:15:00,2019-03-27 23:30:00
69,1,1,0,0.007318172742771588,2019-03-27 23:15:00,2019-03-27 23:30:00
86,1,0,1,0.0039555856812039615,2019-03-27 23:15:00,2019-03-27 23:30:00
90,6,2,4,0.006879884454731639,2019-03-27 23:15:00,2019-03-27 23:30:00
108,2,1,1,0.026279593743316114,2019-03-27 23:15:00,2019-03-27 23:30:00
109,4,4,0,0.011083118281691172,2019-03-27 23:15:00,2019-03-27 23:30:00
110,2,1,1,0.007318172742771588,2019-03-27 23:15:00,2019-03-27 23:30:00
111,2,1,1,0.026279593743316114,2019-03-27 23:15:00,2019-03-27 23:30:00
112,4,2,2,0.010680759804339215,2019-03-27 23:15:00,2019-03-27 23:30:00
114,1,0,1,0.0039555856812039615,2019-03-27 23:15:00,2019-03-27 23:30:00
120,1,1,0,0.007318172742771588,2019-03-27 23:15:00,2019-03-27 23:30:00
122,1,1,0,0.007318172742771588,2019-03-27 23:15:00,2019-03-27 23:30:00
126,1,0,1,0.0039555856812039615,2019-03-27 23:15:00,2019-03-27 23:30:00
137,1,0,1,0.0039555856812039615,2019-03-27 23:15:00,2019-03-27 23:30:00
138,3,2,1,0.013287286275016269,2019-03-27 23:15:00,2019-03-27 23:30:00
141,1,0,1,0.0039555856812039615,2019-03-27 23:15:00,2019-03-27 23:30:00
154,1,0,1,0.0039555856812039615,2019-03-27 23:15:00,2019-03-27 23:30:00
157,2,1,1,0.026279593743316114,2019-03-27 23:15:00,2019-03-27 23:30:00
158,4,0,4,0.0039555856812039615,2019-03-27 23:15:00,2019-03-27 23:30:00
161,3,2,1,0.056403018774916706,2019-03-27 23:15:00,2019-03-27 23:30:00
170,2,0,2,0.0039555856812039615,2019-03-27 23:15:00,2019-03-27 23:30:00
196,2,2,0,0.007318172742771588,2019-03-27 23:15:00,2019-03-27 23:30:00
203,2,0,2,0.0039555856812039615,2019-03-27 23:15:00,2019-03-27 23:30:00
1,2,1,1,0.024619518800975782,2019-03-27 23:30:00,2019-03-27 23:45:00
2,1,0,1,0.003702588481987025,2019-03-27 23:30:00,2019-03-27 23:45:00
15,1,0,1,0.003702588481987025,2019-03-27 23:30:00,2019-03-27 23:45:00
20,2,2,0,0.010104338989807992,2019-03-27 23:30:00,2019-03-27 23:45:00
23,1,1,0,0.006649805251232559,2019-03-27 23:30:00,2019-03-27 23:45:00
26,2,1,1,0.024619518800975782,2019-03-27 23:30:00,2019-03-27 23:45:00
57,3,3,0,0.006850128750893393,2019-03-27 23:30:00,2019-03-27 23:45:00
67,2,2,0,0.006850128750893393,2019-03-27 23:30:00,2019-03-27 23:45:00
69,1,1,0,0.006850128750893393,2019-03-27 23:30:00,2019-03-27 23:45:00
86,1,0,1,0.003702588481987025,2019-03-27 23:30:00,2019-03-27 23:45:00
90,3,1,2,0.005166644034090066,2019-03-27 23:30:00,2019-03-27 23:45:00
108,2,1,1,0.024619518800975782,2019-03-27 23:30:00,2019-03-27 23:45:00
109,6,3,3,0.011295630392206631,2019-03-27 23:30:00,2019-03-27 23:45:00
110,1,1,0,0.006850128750893393,2019-03-27 23:30:00,2019-03-27 23:45:00
112,4,2,2,0.016978901128010704,2019-03-27 23:30:00,2019-03-27 23:45:00
114,2,1,1,0.006850128750893393,2019-03-27 23:30:00,2019-03-27 23:45:00
116,1,1,0,0.006529181857361956,2019-03-27 23:30:00,2019-03-27 23:45:00
120,1,1,0,0.005166644034090066,2019-03-27 23:30:00,2019-03-27 23:45:00
122,1,1,0,0.006850128750893393,2019-03-27 23:30:00,2019-03-27 23:45:00
126,1,0,1,0.003702588481987025,2019-03-27 23:30:00,2019-03-27 23:45:00
137,4,1,3,0.005166644034090066,2019-03-27 23:30:00,2019-03-27 23:45:00
138,6,2,4,0.013866926864891544,2019-03-27 23:30:00,2019-03-27 23:45:00
141,2,1,1,0.00876697467054568,2019-03-27 23:30:00,2019-03-27 23:45:00
154,3,1,2,0.006649805251232559,2019-03-27 23:30:00,2019-03-27 23:45:00
157,2,1,1,0.024619518800975782,2019-03-27 23:30:00,2019-03-27 23:45:00
158,3,0,3,0.003702588481987025,2019-03-27 23:30:00,2019-03-27 23:45:00
161,3,2,1,0.0725202269774652,2019-03-27 23:30:00,2019-03-27 23:45:00
170,2,0,2,0.003702588481987025,2019-03-27 23:30:00,2019-03-27 23:45:00
173,1,1,0,0.006649805251232559,2019-03-27 23:30:00,2019-03-27 23:45:00
195,1,1,0,0.006529181857361956,2019-03-27 23:30:00,2019-03-27 23:45:00
196,5,3,2,0.011914514939452048,2019-03-27 23:30:00,2019-03-27 23:45:00
203,2,0,2,0.003702588481987025,2019-03-27 23:30:00,2019-03-27 23:45:00
2,1,0,1,0.0041864152948954845,2019-03-27 23:45:00,2019-03-28 00:00:00
16,1,0,1,0.0041864152948954845,2019-03-27 23:45:00,2019-03-28 00:00:00
20,2,2,0,0.006558954873195039,2019-03-27 23:45:00,2019-03-28 00:00:00
23,1,1,0,0.0059946035900181206,2019-03-27 23:45:00,2019-03-28 00:00:00
58,1,1,0,0.007745224662344818,2019-03-27 23:45:00,2019-03-28 00:00:00
61,1,1,0,0.009282388067832199,2019-03-27 23:45:00,2019-03-28 00:00:00
62,1,0,1,0.0041864152948954845,2019-03-27 23:45:00,2019-03-28 00:00:00
67,2,2,0,0.007745224662344818,2019-03-27 23:45:00,2019-03-28 00:00:00
90,1,1,0,0.0063811351917843874,2019-03-27 23:45:00,2019-03-28 00:00:00
109,3,0,3,0.0041864152948954845,2019-03-27 23:45:00,2019-03-28 00:00:00
110,5,1,4,0.007745224662344818,2019-03-27 23:45:00,2019-03-28 00:00:00
112,4,1,3,0.007745224662344818,2019-03-27 23:45:00,2019-03-28 00:00:00
114,1,0,1,0.0041864152948954845,2019-03-27 23:45:00,2019-03-28 00:00:00
116,1,1,0,0.005885072885874389,2019-03-27 23:45:00,2019-03-28 00:00:00
120,1,1,0,0.005885072885874389,2019-03-27 23:45:00,2019-03-28 00:00:00
126,1,1,0,0.005372685084045262,2019-03-27 23:45:00,2019-03-28 00:00:00
137,2,1,1,0.027768188244708183,2019-03-27 23:45:00,2019-03-28 00:00:00
138,4,1,3,0.0063811351917843874,2019-03-27 23:45:00,2019-03-28 00:00:00
141,5,5,0,0.014329384353011527,2019-03-27 23:45:00,2019-03-28 00:00:00
151,1,1,0,0.00918927332665956,2019-03-27 23:45:00,2019-03-28 00:00:00
154,4,1,3,0.0059946035900181206,2019-03-27 23:45:00,2019-03-28 00:00:00
157,2,1,1,0.027768188244708183,2019-03-27 23:45:00,2019-03-28 00:00:00
161,3,2,1,0.04230310042210021,2019-03-27 23:45:00,2019-03-28 00:00:00
162,1,1,0,0.007745224662344818,2019-03-27 23:45:00,2019-03-28 00:00:00
173,2,1,1,0.0059946035900181206,2019-03-27 23:45:00,2019-03-28 00:00:00
195,2,1,1,0.005885072885874389,2019-03-27 23:45:00,2019-03-28 00:00:00
196,1,0,1,0.0041864152948954845,2019-03-27 23:45:00,2019-03-28 00:00:00
203,2,0,2,0.0041864152948954845,2019-03-27 23:45:00,2019-03-28 00:00:00
15,2,2,0,0.007772778868362537,2019-03-28 00:00:00,2019-03-28 00:15:00
16,2,1,1,0.007772778868362537,2019-03-28 00:00:00,2019-03-28 00:15:00
23,1,1,0,0.009560132149608852,2019-03-28 00:00:00,2019-03-28 00:15:00
35,1,0,1,0.00420131897147352,2019-03-28 00:00:00,2019-03-28 00:15:00
41,1,1,0,0.007772778868362537,2019-03-28 00:00:00,2019-03-28 00:15:00
57,2,1,1,0.009892708369347641,2019-03-28 00:00:00,2019-03-28 00:15:00
62,1,0,1,0.00420131897147352,2019-03-28 00:00:00,2019-03-28 00:15:00
67,2,2,0,0.007772778868362537,2019-03-28 00:00:00,2019-03-28 00:15:00
90,1,1,0,0.00630377878710062,2019-03-28 00:00:00,2019-03-28 00:15:00
104,2,1,1,0.01080886266855529,2019-03-28 00:00:00,2019-03-28 00:15:00
109,2,0,2,0.00420131897147352,2019-03-28 00:00:00,2019-03-28 00:15:00
110,5,1,4,0.00630377878710062,2019-03-28 00:00:00,2019-03-28 00:15:00
111,1,1,0,0.005987048919918029,2019-03-28 00:00:00,2019-03-28 00:15:00
112,5,1,4,0.009892708369347641,2019-03-28 00:00:00,2019-03-28 00:15:00
114,3,1,2,0.013389880953282043,2019-03-28 00:00:00,2019-03-28 00:15:00
126,1,1,0,0.005987048919918029,2019-03-28 00:00:00,2019-03-28 00:15:00
137,2,0,2,0.00420131897147352,2019-03-28 00:00:00,2019-03-28 00:15:00
138,2,1,1,0.00630377878710062,2019-03-28 00:00:00,2019-03-28 00:15:00
140,1,1,0,0.007772778868362537,2019-03-28 00:00:00,2019-03-28 00:15:00
141,4,4,0,0.009560132149608852,2019-03-28 00:00:00,2019-03-28 00:15:00
153,1,0,1,0.00420131897147352,2019-03-28 00:00:00,2019-03-28 00:15:00
157,2,1,1,0.02782293899905438,2019-03-28 00:00:00,2019-03-28 00:15:00
161,3,2,1,0.04169536097329908,2019-03-28 00:00:00,2019-03-28 00:15:00
162,1,1,0,0.007772778868362537,2019-03-28 00:00:00,2019-03-28 00:15:00
164,1,0,1,0.00420131897147352,2019-03-28 00:00:00,2019-03-28 00:15:00
168,1,1,0,0.012611158233981925,2019-03-28 00:00:00,2019-03-28 00:15:00
203,2,0,2,0.00420131897147352,2019-03-28 00:00:00,2019-03-28 00:15:00
2,1,1,0,0.00925870126401225,2019-03-28 00:15:00,2019-03-28 00:30:00
5,1,0,1,0.004311022169234649,2019-03-28 00:15:00,2019-03-28 00:30:00
15,2,2,0,0.007975722154440732,2019-03-28 00:15:00,2019-03-28 00:30:00
16,4,2,2,0.011640422139646814,2019-03-28 00:15:00,2019-03-28 00:30:00
23,2,1,1,0.010195478418450334,2019-03-28 00:15:00,2019-03-28 00:30:00
35,2,2,0,0.0057769021633170825,2019-03-28 00:15:00,2019-03-28 00:30:00
41,1,1,0,0.007975722154440732,2019-03-28 00:15:00,2019-03-28 00:30:00
57,2,1,1,0.00614337216183769,2019-03-28 00:15:00,2019-03-28 00:30:00
67,6,6,0,0.02030749764432381,2019-03-28 00:15:00,2019-03-28 00:30:00
68,1,1,0,0.005043962166275865,2019-03-28 00:15:00,2019-03-28 00:30:00
90,2,2,0,0.0057769021633170825,2019-03-28 00:15:00,2019-03-28 00:30:00
104,1,1,0,0.00925870126401225,2019-03-28 00:15:00,2019-03-28 00:30:00
110,1,1,0,0.00692220443738133,2019-03-28 00:15:00,2019-03-28 00:30:00
112,3,1,2,0.00614337216183769,2019-03-28 00:15:00,2019-03-28 00:30:00
114,2,0,2,0.004311022169234649,2019-03-28 00:15:00,2019-03-28 00:30:00
118,3,0,3,0.004311022169234649,2019-03-28 00:15:00,2019-03-28 00:30:00
137,2,0,2,0.004311022169234649,2019-03-28 00:15:00,2019-03-28 00:30:00
138,2,1,1,0.00692220443738133,2019-03-28 00:15:00,2019-03-28 00:30:00
140,1,0,1,0.004311022169234649,2019-03-28 00:15:00,2019-03-28 00:30:00
153,1,0,1,0.004311022169234649,2019-03-28 00:15:00,2019-03-28 00:30:00
154,5,0,5,0.004311022169234649,2019-03-28 00:15:00,2019-03-28 00:30:00
157,2,1,1,0.028494290381242526,2019-03-28 00:15:00,2019-03-28 00:30:00
161,2,1,1,0.028494290381242526,2019-03-28 00:15:00,2019-03-28 00:30:00
164,1,0,1,0.004311022169234649,2019-03-28 00:15:00,2019-03-28 00:30:00
168,2,2,0,0.013198086690734093,2019-03-28 00:15:00,2019-03-28 00:30:00
203,2,0,2,0.004311022169234649,2019-03-28 00:15:00,2019-03-28 00:30:00
5,1,0,1,0.004094466039923379,2019-03-28 00:30:00,2019-03-28 00:45:00
16,1,1,0,0.007575157778872885,2019-03-28 00:30:00,2019-03-28 00:45:00
23,2,1,1,0.00940000711833083,2019-03-28 00:30:00,2019-03-28 00:45:00
35,4,2,2,0.007717944524669941,2019-03-28 00:30:00,2019-03-28 00:45:00
46,2,0,2,0.004094466039923379,2019-03-28 00:30:00,2019-03-28 00:45:00
62,2,0,2,0.004094466039923379,2019-03-28 00:30:00,2019-03-28 00:45:00
67,6,6,0,0.019046933340738675,2019-03-28 00:30:00,2019-03-28 00:45:00
68,1,1,0,0.0059062052822966594,2019-03-28 00:30:00,2019-03-28 00:45:00
70,2,2,0,0.00798137317290206,2019-03-28 00:30:00,2019-03-28 00:45:00
90,2,2,0,0.007717944524669941,2019-03-28 00:30:00,2019-03-28 00:45:00
110,3,2,1,0.041398838741286026,2019-03-28 00:30:00,2019-03-28 00:45:00
112,4,1,3,0.007575157778872885,2019-03-28 00:30:00,2019-03-28 00:45:00
114,1,0,1,0.004094466039923379,2019-03-28 00:30:00,2019-03-28 00:45:00
118,3,0,3,0.004094466039923379,2019-03-28 00:30:00,2019-03-28 00:45:00
138,2,1,1,0.006241027303427308,2019-03-28 00:30:00,2019-03-28 00:45:00
147,1,1,0,0.005834811909398132,2019-03-28 00:30:00,2019-03-28 00:45:00
153,2,2,0,0.007575157778872885,2019-03-28 00:30:00,2019-03-28 00:45:00
154,7,2,5,0.010655675174550804,2019-03-28 00:30:00,2019-03-28 00:45:00
157,2,1,1,0.027173228008530864,2019-03-28 00:30:00,2019-03-28 00:45:00
161,2,1,1,0.027173228008530864,2019-03-28 00:30:00,2019-03-28 00:45:00
190,2,1,1,0.027173228008530864,2019-03-28 00:30:00,2019-03-28 00:45:00
203,2,0,2,0.004094466039923379,2019-03-28 00:30:00,2019-03-28 00:45:00
5,1,0,1,0.004305897263066955,2019-03-28 00:45:00,2019-03-28 01:00:00
16,2,2,0,0.011626582174779155,2019-03-28 00:45:00,2019-03-28 01:00:00
23,1,1,0,0.013723079510898463,2019-03-28 00:45:00,2019-03-28 01:00:00
26,1,1,0,0.013723079510898463,2019-03-28 00:45:00,2019-03-28 01:00:00
35,2,0,2,0.004305897263066955,2019-03-28 00:45:00,2019-03-28 01:00:00
41,1,0,1,0.004305897263066955,2019-03-28 00:45:00,2019-03-28 01:00:00
46,2,0,2,0.004305897263066955,2019-03-28 00:45:00,2019-03-28 01:00:00
62,2,0,2,0.004305897263066955,2019-03-28 00:45:00,2019-03-28 01:00:00
67,2,2,0,0.007966239718923055,2019-03-28 00:45:00,2019-03-28 01:00:00
70,1,1,0,0.006136068490995005,2019-03-28 00:45:00,2019-03-28 01:00:00
112,2,1,1,0.007966239718923055,2019-03-28 00:45:00,2019-03-28 01:00:00
114,1,0,1,0.004305897263066955,2019-03-28 00:45:00,2019-03-28 01:00:00
116,1,1,0,0.007966239718923055,2019-03-28 00:45:00,2019-03-28 01:00:00
118,2,0,2,0.004305897263066955,2019-03-28 00:45:00,2019-03-28 01:00:00
127,1,0,1,0.004305897263066955,2019-03-28 00:45:00,2019-03-28 01:00:00
138,2,1,1,0.011077863543004454,2019-03-28 00:45:00,2019-03-28 01:00:00
147,1,1,0,0.006136068490995005,2019-03-28 00:45:00,2019-03-28 01:00:00
153,2,2,0,0.007966239718923055,2019-03-28 00:45:00,2019-03-28 01:00:00
154,2,2,0,0.007966239718923055,2019-03-28 00:45:00,2019-03-28 01:00:00
157,2,1,1,0.028460566991655945,2019-03-28 00:45:00,2019-03-28 01:00:00
161,2,1,1,0.028460566991655945,2019-03-28 00:45:00,2019-03-28 01:00:00
164,2,2,0,0.007966239718923055,2019-03-28 00:45:00,2019-03-28 01:00:00
171,1,0,1,0.004305897263066955,2019-03-28 00:45:00,2019-03-28 01:00:00
190,2,1,1,0.011077863543004454,2019-03-28 00:45:00,2019-03-28 01:00:00
196,2,1,1,0.007966239718923055,2019-03-28 00:45:00,2019-03-28 01:00:00
203,2,0,2,0.004305897263066955,2019-03-28 00:45:00,2019-03-28 01:00:00
16,1,1,0,0.008101856513902704,2019-03-28 01:00:00,2019-03-28 01:15:00
18,1,0,1,0.00437919628308433,2019-03-28 01:00:00,2019-03-28 01:15:00
23,1,1,0,0.013956730536479202,2019-03-28 01:00:00,2019-03-28 01:15:00
26,1,1,0,0.011266464248009367,2019-03-28 01:00:00,2019-03-28 01:15:00
41,1,0,1,0.00437919628308433,2019-03-28 01:00:00,2019-03-28 01:15:00
50,1,1,0,0.008101856513902704,2019-03-28 01:00:00,2019-03-28 01:15:00
58,1,1,0,0.008101856513902704,2019-03-28 01:00:00,2019-03-28 01:15:00
62,2,0,2,0.00437919628308433,2019-03-28 01:00:00,2019-03-28 01:15:00
67,2,2,0,0.008101856513902704,2019-03-28 01:00:00,2019-03-28 01:15:00
70,1,1,0,0.006240526398493517,2019-03-28 01:00:00,2019-03-28 01:15:00
109,1,0,1,0.00437919628308433,2019-03-28 01:00:00,2019-03-28 01:15:00
112,2,1,1,0.008101856513902704,2019-03-28 01:00:00,2019-03-28 01:15:00
114,1,0,1,0.00437919628308433,2019-03-28 01:00:00,2019-03-28 01:15:00
116,1,1,0,0.008101856513902704,2019-03-28 01:00:00,2019-03-28 01:15:00
138,2,1,1,0.011266464248009367,2019-03-28 01:00:00,2019-03-28 01:15:00
147,1,1,0,0.006240526398493517,2019-03-28 01:00:00,2019-03-28 01:15:00
157,2,1,1,0.02894490125204747,2019-03-28 01:00:00,2019-03-28 01:15:00
161,2,1,1,0.02894490125204747,2019-03-28 01:00:00,2019-03-28 01:15:00
171,1,0,1,0.00437919628308433,2019-03-28 01:00:00,2019-03-28 01:15:00
190,2,1,1,0.008101856513902704,2019-03-28 01:00:00,2019-03-28 01:15:00
196,1,0,1,0.00437919628308433,2019-03-28 01:00:00,2019-03-28 01:15:00
203,2,0,2,0.00437919628308433,2019-03-28 01:00:00,2019-03-28 01:15:00
23,1,1,0,0.014213394749871999,2019-03-28 01:15:00,2019-03-28 01:30:00
50,1,1,0,0.008250831934390045,2019-03-28 01:15:00,2019-03-28 01:30:00
67,2,2,0,0.008250831934390045,2019-03-28 01:15:00,2019-03-28 01:30:00
90,1,1,0,0.008250831934390045,2019-03-28 01:15:00,2019-03-28 01:30:00
109,1,0,1,0.004459715759195106,2019-03-28 01:15:00,2019-03-28 01:30:00
112,2,1,1,0.008250831934390045,2019-03-28 01:15:00,2019-03-28 01:30:00
114,1,0,1,0.004459715759195106,2019-03-28 01:15:00,2019-03-28 01:30:00
138,2,1,1,0.01147364182054263,2019-03-28 01:15:00,2019-03-28 01:30:00
140,1,1,0,0.008250831934390045,2019-03-28 01:15:00,2019-03-28 01:30:00
141,1,0,1,0.004459715759195106,2019-03-28 01:15:00,2019-03-28 01:30:00
157,2,1,1,0.029477257477699245,2019-03-28 01:15:00,2019-03-28 01:30:00
158,1,0,1,0.004459715759195106,2019-03-28 01:15:00,2019-03-28 01:30:00
161,2,1,1,0.029477257477699245,2019-03-28 01:15:00,2019-03-28 01:30:00
203,2,0,2,0.004459715759195106,2019-03-28 01:15:00,2019-03-28 01:30:00
18,1,0,1,0.004409566237143664,2019-03-28 01:30:00,2019-03-28 01:45:00
23,1,1,0,0.014053539275702192,2019-03-28 01:30:00,2019-03-28 01:45:00
67,2,2,0,0.008158046602978792,2019-03-28 01:30:00,2019-03-28 01:45:00
69,1,1,0,0.008158046602978792,2019-03-28 01:30:00,2019-03-28 01:45:00
89,1,1,0,0.008158046602978792,2019-03-28 01:30:00,2019-03-28 01:45:00
90,1,1,0,0.008158046602978792,2019-03-28 01:30:00,2019-03-28 01:45:00
110,1,1,0,0.008158046602978792,2019-03-28 01:30:00,2019-03-28 01:45:00
112,2,1,1,0.008158046602978792,2019-03-28 01:30:00,2019-03-28 01:45:00
114,1,0,1,0.004409566237143664,2019-03-28 01:30:00,2019-03-28 01:45:00
115,2,0,2,0.004409566237143664,2019-03-28 01:30:00,2019-03-28 01:45:00
122,1,1,0,0.008158046602978792,2019-03-28 01:30:00,2019-03-28 01:45:00
138,2,1,1,0.011344607207919882,2019-03-28 01:30:00,2019-03-28 01:45:00
140,1,0,1,0.004409566237143664,2019-03-28 01:30:00,2019-03-28 01:45:00
153,1,0,1,0.004409566237143664,2019-03-28 01:30:00,2019-03-28 01:45:00
157,2,1,1,0.029145598461911178,2019-03-28 01:30:00,2019-03-28 01:45:00
158,1,0,1,0.004409566237143664,2019-03-28 01:30:00,2019-03-28 01:45:00
161,2,1,1,0.029145598461911178,2019-03-28 01:30:00,2019-03-28 01:45:00
164,1,0,1,0.004409566237143664,2019-03-28 01:30:00,2019-03-28 01:45:00
168,2,2,0,0.008158046602978792,2019-03-28 01:30:00,2019-03-28 01:45:00
203,2,0,2,0.004409566237143664,2019-03-28 01:30:00,2019-03-28 01:45:00
23,1,1,0,0.014001050256082184,2019-03-28 01:45:00,2019-03-28 02:00:00
26,1,1,0,0.008127580202919909,2019-03-28 01:45:00,2019-03-28 02:00:00
28,1,0,1,0.004393099444820354,2019-03-28 01:45:00,2019-03-28 02:00:00
46,1,0,1,0.004393099444820354,2019-03-28 01:45:00,2019-03-28 02:00:00
64,1,1,0,0.005326719634345244,2019-03-28 01:45:00,2019-03-28 02:00:00
67,2,2,0,0.008127580202919909,2019-03-28 01:45:00,2019-03-28 02:00:00
69,2,2,0,0.011862060961019464,2019-03-28 01:45:00,2019-03-28 02:00:00
89,2,2,0,0.009994820581969686,2019-03-28 01:45:00,2019-03-28 02:00:00
109,1,0,1,0.004393099444820354,2019-03-28 01:45:00,2019-03-28 02:00:00
110,1,1,0,0.006260339823870132,2019-03-28 01:45:00,2019-03-28 02:00:00
112,2,1,1,0.008127580202919909,2019-03-28 01:45:00,2019-03-28 02:00:00
114,1,0,1,0.004393099444820354,2019-03-28 01:45:00,2019-03-28 02:00:00
115,4,0,4,0.004393099444820354,2019-03-28 01:45:00,2019-03-28 02:00:00
138,2,1,1,0.011302238265924608,2019-03-28 01:45:00,2019-03-28 02:00:00
140,1,0,1,0.004393099444820354,2019-03-28 01:45:00,2019-03-28 02:00:00
153,1,0,1,0.004393099444820354,2019-03-28 01:45:00,2019-03-28 02:00:00
157,2,1,1,0.0290366981231011,2019-03-28 01:45:00,2019-03-28 02:00:00
161,2,1,1,0.0290366981231011,2019-03-28 01:45:00,2019-03-28 02:00:00
164,2,0,2,0.004393099444820354,2019-03-28 01:45:00,2019-03-28 02:00:00
168,3,3,0,0.0071939600133950204,2019-03-28 01:45:00,2019-03-28 02:00:00
201,1,1,0,0.008127580202919909,2019-03-28 01:45:00,2019-03-28 02:00:00
203,2,0,2,0.004393099444820354,2019-03-28 01:45:00,2019-03-28 02:00:00
16,1,1,0,0.006197838603839232,2019-03-28 02:00:00,2019-03-28 02:15:00
23,1,1,0,0.01386124675853451,2019-03-28 02:00:00,2019-03-28 02:15:00
26,1,1,0,0.008046435329411974,2019-03-28 02:00:00,2019-03-28 02:15:00
28,1,0,1,0.004349241878266489,2019-03-28 02:00:00,2019-03-28 02:15:00
46,1,0,1,0.004349241878266489,2019-03-28 02:00:00,2019-03-28 02:15:00
64,1,1,0,0.006197838603839232,2019-03-28 02:00:00,2019-03-28 02:15:00
67,2,2,0,0.006814037512363479,2019-03-28 02:00:00,2019-03-28 02:15:00
69,3,2,1,0.01174362878055746,2019-03-28 02:00:00,2019-03-28 02:15:00
108,1,1,0,0.01433234604256526,2019-03-28 02:00:00,2019-03-28 02:15:00
109,1,0,1,0.004349241878266489,2019-03-28 02:00:00,2019-03-28 02:15:00
110,1,1,0,0.008046435329411974,2019-03-28 02:00:00,2019-03-28 02:15:00
112,2,1,1,0.008046435329411974,2019-03-28 02:00:00,2019-03-28 02:15:00
114,1,0,1,0.004349241878266489,2019-03-28 02:00:00,2019-03-28 02:15:00
115,2,0,2,0.004349241878266489,2019-03-28 02:00:00,2019-03-28 02:15:00
116,1,1,0,0.006197838603839232,2019-03-28 02:00:00,2019-03-28 02:15:00
138,2,1,1,0.011189390685988617,2019-03-28 02:00:00,2019-03-28 02:15:00
153,1,0,1,0.004349241878266489,2019-03-28 02:00:00,2019-03-28 02:15:00
154,2,0,2,0.004349241878266489,2019-03-28 02:00:00,2019-03-28 02:15:00
157,2,1,1,0.028746949899650695,2019-03-28 02:00:00,2019-03-28 02:15:00
160,1,1,0,0.005581639695314984,2019-03-28 02:00:00,2019-03-28 02:15:00
161,2,1,1,0.028746949899650695,2019-03-28 02:00:00,2019-03-28 02:15:00
164,1,0,1,0.004349241878266489,2019-03-28 02:00:00,2019-03-28 02:15:00
168,1,1,0,0.006197838603839232,2019-03-28 02:00:00,2019-03-28 02:15:00
201,1,1,0,0.008046435329411974,2019-03-28 02:00:00,2019-03-28 02:15:00
203,3,0,3,0.004349241878266489,2019-03-28 02:00:00,2019-03-28 02:15:00
16,1,1,0,0.006652783561234015,2019-03-28 02:15:00,2019-03-28 02:30:00
23,1,1,0,0.014884384270987119,2019-03-28 02:15:00,2019-03-28 02:30:00
41,4,1,3,0.0065119032783235815,2019-03-28 02:15:00,2019-03-28 02:30:00
64,1,1,0,0.006652783561234015,2019-03-28 02:15:00,2019-03-28 02:30:00
67,2,2,0,0.0073141628050310305,2019-03-28 02:15:00,2019-03-28 02:30:00
112,2,1,1,0.008636921292625062,2019-03-28 02:15:00,2019-03-28 02:30:00
114,1,0,1,0.004668645829842969,2019-03-28 02:15:00,2019-03-28 02:30:00
115,2,0,2,0.004668645829842969,2019-03-28 02:15:00,2019-03-28 02:30:00
116,1,1,0,0.006652783561234015,2019-03-28 02:15:00,2019-03-28 02:30:00
138,2,1,1,0.012009362611538867,2019-03-28 02:15:00,2019-03-28 02:30:00
154,2,0,2,0.004668645829842969,2019-03-28 02:15:00,2019-03-28 02:30:00
160,1,1,0,0.005991404317437,2019-03-28 02:15:00,2019-03-28 02:30:00
168,2,2,0,0.010621059024016107,2019-03-28 02:15:00,2019-03-28 02:30:00
191,2,2,0,0.008355160726804194,2019-03-28 02:15:00,2019-03-28 02:30:00
196,1,0,1,0.004668645829842969,2019-03-28 02:15:00,2019-03-28 02:30:00
203,3,0,3,0.004668645829842969,2019-03-28 02:15:00,2019-03-28 02:30:00
23,1,1,0,0.008841134476694983,2019-03-28 02:30:00,2019-03-28 02:45:00
64,1,1,0,0.008841134476694983,2019-03-28 02:30:00,2019-03-28 02:45:00
67,2,2,0,0.007487080197157539,2019-03-28 02:30:00,2019-03-28 02:45:00
112,1,1,0,0.008841134476694983,2019-03-28 02:30:00,2019-03-28 02:45:00
114,1,0,1,0.004778971638082649,2019-03-28 02:30:00,2019-03-28 02:45:00
115,1,0,1,0.004778971638082649,2019-03-28 02:30:00,2019-03-28 02:45:00
138,1,0,1,0.004778971638082649,2019-03-28 02:30:00,2019-03-28 02:45:00
160,1,1,0,0.006133025917620094,2019-03-28 02:30:00,2019-03-28 02:45:00
168,1,1,0,0.008841134476694983,2019-03-28 02:30:00,2019-03-28 02:45:00
196,1,0,1,0.004778971638082649,2019-03-28 02:30:00,2019-03-28 02:45:00
203,3,0,3,0.004778971638082649,2019-03-28 02:30:00,2019-03-28 02:45:00
1,1,0,1,0.0047433302497723135,2019-03-28 02:45:00,2019-03-28 03:00:00
15,1,1,0,0.008775135004045599,2019-03-28 02:45:00,2019-03-28 03:00:00
23,1,1,0,0.008775135004045599,2019-03-28 02:45:00,2019-03-28 03:00:00
64,1,1,0,0.008775135004045599,2019-03-28 02:45:00,2019-03-28 03:00:00
67,2,2,0,0.007431200085954504,2019-03-28 02:45:00,2019-03-28 03:00:00
112,2,1,1,0.008775135004045599,2019-03-28 02:45:00,2019-03-28 03:00:00
114,1,0,1,0.0047433302497723135,2019-03-28 02:45:00,2019-03-28 03:00:00
115,1,0,1,0.0047433302497723135,2019-03-28 02:45:00,2019-03-28 03:00:00
138,1,0,1,0.0047433302497723135,2019-03-28 02:45:00,2019-03-28 03:00:00
160,1,1,0,0.006087265167863409,2019-03-28 02:45:00,2019-03-28 03:00:00
195,1,1,0,0.012201605275080553,2019-03-28 02:45:00,2019-03-28 03:00:00
203,3,0,3,0.0047433302497723135,2019-03-28 02:45:00,2019-03-28 03:00:00
1,1,0,1,0.004710466058664215,2019-03-28 03:00:00,2019-03-28 03:15:00
15,1,1,0,0.008714557744616857,2019-03-28 03:00:00,2019-03-28 03:15:00
23,1,1,0,0.008714557744616857,2019-03-28 03:00:00,2019-03-28 03:15:00
26,3,1,2,0.008173482403293408,2019-03-28 03:00:00,2019-03-28 03:15:00
28,1,1,0,0.008173482403293408,2019-03-28 03:00:00,2019-03-28 03:15:00
64,1,1,0,0.008714557744616857,2019-03-28 03:00:00,2019-03-28 03:15:00
67,2,2,0,0.008714557744616857,2019-03-28 03:00:00,2019-03-28 03:15:00
112,2,1,1,0.008714557744616857,2019-03-28 03:00:00,2019-03-28 03:15:00
114,1,0,1,0.004710466058664215,2019-03-28 03:00:00,2019-03-28 03:15:00
115,1,0,1,0.004710466058664215,2019-03-28 03:00:00,2019-03-28 03:15:00
138,1,0,1,0.004710466058664215,2019-03-28 03:00:00,2019-03-28 03:15:00
195,1,1,0,0.012118432913481242,2019-03-28 03:00:00,2019-03-28 03:15:00
203,2,0,2,0.004710466058664215,2019-03-28 03:00:00,2019-03-28 03:15:00
1,1,0,1,0.004743330249772313,2019-03-28 03:15:00,2019-03-28 03:30:00
15,1,1,0,0.008775135004045597,2019-03-28 03:15:00,2019-03-28 03:30:00
23,1,1,0,0.008775135004045597,2019-03-28 03:15:00,2019-03-28 03:30:00
64,1,1,0,0.008775135004045597,2019-03-28 03:15:00,2019-03-28 03:30:00
67,2,2,0,0.008775135004045597,2019-03-28 03:15:00,2019-03-28 03:30:00
112,2,1,1,0.008775135004045597,2019-03-28 03:15:00,2019-03-28 03:30:00
114,1,0,1,0.004743330249772313,2019-03-28 03:15:00,2019-03-28 03:30:00
115,1,0,1,0.004743330249772313,2019-03-28 03:15:00,2019-03-28 03:30:00
138,1,0,1,0.004743330249772313,2019-03-28 03:15:00,2019-03-28 03:30:00
153,1,1,0,0.012201605275080553,2019-03-28 03:15:00,2019-03-28 03:30:00
203,2,0,2,0.004743330249772313,2019-03-28 03:15:00,2019-03-28 03:30:00
23,1,1,0,0.008775135004045597,2019-03-28 03:30:00,2019-03-28 03:45:00
46,1,0,1,0.004743330249772313,2019-03-28 03:30:00,2019-03-28 03:45:00
64,1,1,0,0.008775135004045597,2019-03-28 03:30:00,2019-03-28 03:45:00
67,2,2,0,0.008775135004045597,2019-03-28 03:30:00,2019-03-28 03:45:00
112,2,1,1,0.008775135004045597,2019-03-28 03:30:00,2019-03-28 03:45:00
114,1,0,1,0.004743330249772313,2019-03-28 03:30:00,2019-03-28 03:45:00
115,1,0,1,0.004743330249772313,2019-03-28 03:30:00,2019-03-28 03:45:00
138,1,0,1,0.004743330249772313,2019-03-28 03:30:00,2019-03-28 03:45:00
153,1,1,0,0.012201605275080553,2019-03-28 03:30:00,2019-03-28 03:45:00
171,1,1,0,0.008775135004045597,2019-03-28 03:30:00,2019-03-28 03:45:00
203,2,0,2,0.004743330249772313,2019-03-28 03:30:00,2019-03-28 03:45:00
23,1,1,0,0.008877177553798802,2019-03-28 03:45:00,2019-03-28 04:00:00
64,1,1,0,0.008877177553798802,2019-03-28 03:45:00,2019-03-28 04:00:00
67,2,2,0,0.008877177553798802,2019-03-28 03:45:00,2019-03-28 04:00:00
112,1,1,0,0.008877177553798802,2019-03-28 03:45:00,2019-03-28 04:00:00
114,1,0,1,0.004798464128282619,2019-03-28 03:45:00,2019-03-28 04:00:00
115,1,0,1,0.004798464128282619,2019-03-28 03:45:00,2019-03-28 04:00:00
138,1,0,1,0.004798464128282619,2019-03-28 03:45:00,2019-03-28 04:00:00
203,2,0,2,0.004798464128282619,2019-03-28 03:45:00,2019-03-28 04:00:00
5,3,1,2,0.008267379881953996,2019-03-28 04:00:00,2019-03-28 04:15:00
18,1,1,0,0.008267379881953996,2019-03-28 04:00:00,2019-03-28 04:15:00
23,1,1,0,0.008815177167202395,2019-03-28 04:00:00,2019-03-28 04:15:00
64,1,1,0,0.008815177167202395,2019-03-28 04:00:00,2019-03-28 04:15:00
67,2,2,0,0.008815177167202395,2019-03-28 04:00:00,2019-03-28 04:15:00
112,1,1,0,0.008815177167202395,2019-03-28 04:00:00,2019-03-28 04:15:00
114,1,0,1,0.004764846892297899,2019-03-28 04:00:00,2019-03-28 04:15:00
115,1,0,1,0.004764846892297899,2019-03-28 04:00:00,2019-03-28 04:15:00
138,1,0,1,0.004764846892297899,2019-03-28 04:00:00,2019-03-28 04:15:00
203,2,0,2,0.004764846892297899,2019-03-28 04:00:00,2019-03-28 04:15:00
1,1,1,0,0.008841134476694983,2019-03-28 04:15:00,2019-03-28 04:30:00
23,1,1,0,0.008841134476694983,2019-03-28 04:15:00,2019-03-28 04:30:00
64,1,1,0,0.008841134476694983,2019-03-28 04:15:00,2019-03-28 04:30:00
67,2,2,0,0.008841134476694983,2019-03-28 04:15:00,2019-03-28 04:30:00
112,1,1,0,0.008841134476694983,2019-03-28 04:15:00,2019-03-28 04:30:00
114,1,0,1,0.004778971638082649,2019-03-28 04:15:00,2019-03-28 04:30:00
115,1,0,1,0.004778971638082649,2019-03-28 04:15:00,2019-03-28 04:30:00
126,1,0,1,0.004778971638082649,2019-03-28 04:15:00,2019-03-28 04:30:00
138,1,0,1,0.004778971638082649,2019-03-28 04:15:00,2019-03-28 04:30:00
203,2,0,2,0.004778971638082649,2019-03-28 04:15:00,2019-03-28 04:30:00
19,1,1,0,0.008841134476694983,2019-03-28 04:30:00,2019-03-28 04:45:00
23,1,1,0,0.008841134476694983,2019-03-28 04:30:00,2019-03-28 04:45:00
57,1,0,1,0.004778971638082649,2019-03-28 04:30:00,2019-03-28 04:45:00
64,1,1,0,0.008841134476694983,2019-03-28 04:30:00,2019-03-28 04:45:00
67,2,2,0,0.008841134476694983,2019-03-28 04:30:00,2019-03-28 04:45:00
112,1,1,0,0.008841134476694983,2019-03-28 04:30:00,2019-03-28 04:45:00
114,1,0,1,0.004778971638082649,2019-03-28 04:30:00,2019-03-28 04:45:00
115,1,0,1,0.004778971638082649,2019-03-28 04:30:00,2019-03-28 04:45:00
138,1,0,1,0.004778971638082649,2019-03-28 04:30:00,2019-03-28 04:45:00
203,2,0,2,0.004778971638082649,2019-03-28 04:30:00,2019-03-28 04:45:00
19,1,1,0,0.008841134476694983,2019-03-28 04:45:00,2019-03-28 05:00:00
23,1,1,0,0.008841134476694983,2019-03-28 04:45:00,2019-03-28 05:00:00
57,1,0,1,0.004778971638082649,2019-03-28 04:45:00,2019-03-28 05:00:00
64,1,1,0,0.008841134476694983,2019-03-28 04:45:00,2019-03-28 05:00:00
67,2,2,0,0.008841134476694983,2019-03-28 04:45:00,2019-03-28 05:00:00
112,1,1,0,0.008841134476694983,2019-03-28 04:45:00,2019-03-28 05:00:00
114,1,0,1,0.004778971638082649,2019-03-28 04:45:00,2019-03-28 05:00:00
115,1,0,1,0.004778971638082649,2019-03-28 04:45:00,2019-03-28 05:00:00
138,1,0,1,0.004778971638082649,2019-03-28 04:45:00,2019-03-28 05:00:00
203,2,0,2,0.004778971638082649,2019-03-28 04:45:00,2019-03-28 05:00:00
23,1,1,0,0.006837820841040711,2019-03-28 05:00:00,2019-03-28 05:15:00
64,1,1,0,0.008877177553798802,2019-03-28 05:00:00,2019-03-28 05:15:00
67,2,2,0,0.008877177553798802,2019-03-28 05:00:00,2019-03-28 05:15:00
112,1,1,0,0.008877177553798802,2019-03-28 05:00:00,2019-03-28 05:15:00
114,1,0,1,0.0047984641282826195,2019-03-28 05:00:00,2019-03-28 05:15:00
115,1,0,1,0.0047984641282826195,2019-03-28 05:00:00,2019-03-28 05:15:00
138,2,0,2,0.0047984641282826195,2019-03-28 05:00:00,2019-03-28 05:15:00
158,1,1,0,0.006837820841040711,2019-03-28 05:00:00,2019-03-28 05:15:00
203,2,0,2,0.0047984641282826195,2019-03-28 05:00:00,2019-03-28 05:15:00
15,1,0,1,0.004619070617153597,2019-03-28 05:15:00,2019-03-28 05:30:00
23,1,1,0,0.00658237838861692,2019-03-28 05:15:00,2019-03-28 05:30:00
41,1,1,0,0.008545686160080241,2019-03-28 05:15:00,2019-03-28 05:30:00
64,1,1,0,0.008545686160080241,2019-03-28 05:15:00,2019-03-28 05:30:00
67,2,2,0,0.008545686160080241,2019-03-28 05:15:00,2019-03-28 05:30:00
68,1,1,0,0.008545686160080241,2019-03-28 05:15:00,2019-03-28 05:30:00
109,1,0,1,0.004619070617153597,2019-03-28 05:15:00,2019-03-28 05:30:00
112,1,1,0,0.008545686160080241,2019-03-28 05:15:00,2019-03-28 05:30:00
114,1,0,1,0.004619070617153597,2019-03-28 05:15:00,2019-03-28 05:30:00
115,1,0,1,0.004619070617153597,2019-03-28 05:15:00,2019-03-28 05:30:00
138,2,0,2,0.004619070617153597,2019-03-28 05:15:00,2019-03-28 05:30:00
151,2,1,1,0.030223285300177725,2019-03-28 05:15:00,2019-03-28 05:30:00
158,1,1,0,0.00658237838861692,2019-03-28 05:15:00,2019-03-28 05:30:00
170,1,1,0,0.008545686160080241,2019-03-28 05:15:00,2019-03-28 05:30:00
172,1,0,1,0.004619070617153597,2019-03-28 05:15:00,2019-03-28 05:30:00
203,2,0,2,0.004619070617153597,2019-03-28 05:15:00,2019-03-28 05:30:00
15,1,0,1,0.0047596364442711045,2019-03-28 05:30:00,2019-03-28 05:45:00
19,1,1,0,0.008805391265007892,2019-03-28 05:30:00,2019-03-28 05:45:00
23,1,1,0,0.008805391265007892,2019-03-28 05:30:00,2019-03-28 05:45:00
41,1,1,0,0.008805391265007892,2019-03-28 05:30:00,2019-03-28 05:45:00
67,2,2,0,0.008805391265007892,2019-03-28 05:30:00,2019-03-28 05:45:00
68,1,1,0,0.008805391265007892,2019-03-28 05:30:00,2019-03-28 05:45:00
112,1,1,0,0.008805391265007892,2019-03-28 05:30:00,2019-03-28 05:45:00
114,1,0,1,0.0047596364442711045,2019-03-28 05:30:00,2019-03-28 05:45:00
138,1,0,1,0.0047596364442711045,2019-03-28 05:30:00,2019-03-28 05:45:00
157,1,0,1,0.0047596364442711045,2019-03-28 05:30:00,2019-03-28 05:45:00
172,1,0,1,0.0047596364442711045,2019-03-28 05:30:00,2019-03-28 05:45:00
203,2,0,2,0.0047596364442711045,2019-03-28 05:30:00,2019-03-28 05:45:00
10,1,1,0,0.0067700801328538975,2019-03-28 05:45:00,2019-03-28 06:00:00
19,1,1,0,0.008243859509595766,2019-03-28 05:45:00,2019-03-28 06:00:00
23,1,1,0,0.0067700801328538975,2019-03-28 05:45:00,2019-03-28 06:00:00
26,1,0,1,0.0047507901598179084,2019-03-28 05:45:00,2019-03-28 06:00:00
50,1,1,0,0.008789370105889887,2019-03-28 05:45:00,2019-03-28 06:00:00
67,2,2,0,0.008789370105889887,2019-03-28 05:45:00,2019-03-28 06:00:00
112,1,1,0,0.008243859509595766,2019-03-28 05:45:00,2019-03-28 06:00:00
114,3,1,2,0.008243859509595766,2019-03-28 05:45:00,2019-03-28 06:00:00
138,2,0,2,0.0047507901598179084,2019-03-28 05:45:00,2019-03-28 06:00:00
191,3,1,2,0.008243859509595766,2019-03-28 05:45:00,2019-03-28 06:00:00
203,2,0,2,0.0047507901598179084,2019-03-28 05:45:00,2019-03-28 06:00:00
10,1,1,0,0.006586278661121661,2019-03-28 06:00:00,2019-03-28 06:15:00
16,2,1,1,0.011441187919179755,2019-03-28 06:00:00,2019-03-28 06:15:00
19,1,1,0,0.008550706272288584,2019-03-28 06:00:00,2019-03-28 06:15:00
23,2,1,1,0.006586278661121661,2019-03-28 06:00:00,2019-03-28 06:15:00
26,1,0,1,0.004621851049954738,2019-03-28 06:00:00,2019-03-28 06:15:00
46,1,1,0,0.010220762220662382,2019-03-28 06:00:00,2019-03-28 06:15:00
50,1,1,0,0.008550706272288584,2019-03-28 06:00:00,2019-03-28 06:15:00
67,2,2,0,0.008550706272288584,2019-03-28 06:00:00,2019-03-28 06:15:00
88,2,0,2,0.004621851049954738,2019-03-28 06:00:00,2019-03-28 06:15:00
89,1,1,0,0.014331669566070926,2019-03-28 06:00:00,2019-03-28 06:15:00
112,2,1,1,0.008031519484567247,2019-03-28 06:00:00,2019-03-28 06:15:00
114,3,1,2,0.008031519484567247,2019-03-28 06:00:00,2019-03-28 06:15:00
137,2,2,0,0.008550706272288584,2019-03-28 06:00:00,2019-03-28 06:15:00
138,2,0,2,0.004621851049954738,2019-03-28 06:00:00,2019-03-28 06:15:00
157,1,1,0,0.008550706272288584,2019-03-28 06:00:00,2019-03-28 06:15:00
191,1,0,1,0.004621851049954738,2019-03-28 06:00:00,2019-03-28 06:15:00
196,1,0,1,0.004621851049954738,2019-03-28 06:00:00,2019-03-28 06:15:00
203,2,0,2,0.004621851049954738,2019-03-28 06:00:00,2019-03-28 06:15:00
10,1,1,0,0.006582378388616919,2019-03-28 06:15:00,2019-03-28 06:30:00
11,2,1,1,0.030223285300177725,2019-03-28 06:15:00,2019-03-28 06:30:00
16,2,0,2,0.004619070617153597,2019-03-28 06:15:00,2019-03-28 06:30:00
23,1,1,0,0.006582378388616919,2019-03-28 06:15:00,2019-03-28 06:30:00
67,2,2,0,0.008545686160080241,2019-03-28 06:15:00,2019-03-28 06:30:00
68,1,1,0,0.006582378388616919,2019-03-28 06:15:00,2019-03-28 06:30:00
70,1,1,0,0.008545686160080241,2019-03-28 06:15:00,2019-03-28 06:30:00
88,2,0,2,0.004619070617153597,2019-03-28 06:15:00,2019-03-28 06:30:00
89,1,1,0,0.006582378388616919,2019-03-28 06:15:00,2019-03-28 06:30:00
112,1,1,0,0.008545686160080241,2019-03-28 06:15:00,2019-03-28 06:30:00
114,1,0,1,0.004619070617153597,2019-03-28 06:15:00,2019-03-28 06:30:00
137,2,2,0,0.008545686160080241,2019-03-28 06:15:00,2019-03-28 06:30:00
138,2,0,2,0.004619070617153597,2019-03-28 06:15:00,2019-03-28 06:30:00
157,1,1,0,0.008545686160080241,2019-03-28 06:15:00,2019-03-28 06:30:00
171,1,0,1,0.004619070617153597,2019-03-28 06:15:00,2019-03-28 06:30:00
196,1,0,1,0.004619070617153597,2019-03-28 06:15:00,2019-03-28 06:30:00
203,2,0,2,0.004619070617153597,2019-03-28 06:15:00,2019-03-28 06:30:00
5,1,1,0,0.007707276372848529,2019-03-28 06:30:00,2019-03-28 06:45:00
11,5,2,3,0.010736027939726896,2019-03-28 06:30:00,2019-03-28 06:45:00
16,1,0,1,0.004678524805970161,2019-03-28 06:30:00,2019-03-28 06:45:00
22,1,1,0,0.008655544815405234,2019-03-28 06:30:00,2019-03-28 06:45:00
23,1,1,0,0.008655544815405234,2019-03-28 06:30:00,2019-03-28 06:45:00
35,1,1,0,0.008655544815405234,2019-03-28 06:30:00,2019-03-28 06:45:00
61,1,0,1,0.004678524805970161,2019-03-28 06:30:00,2019-03-28 06:45:00
67,2,2,0,0.008655544815405234,2019-03-28 06:30:00,2019-03-28 06:45:00
68,1,1,0,0.008655544815405234,2019-03-28 06:30:00,2019-03-28 06:45:00
89,1,0,1,0.004678524805970161,2019-03-28 06:30:00,2019-03-28 06:45:00
104,1,1,0,0.008655544815405234,2019-03-28 06:30:00,2019-03-28 06:45:00
112,1,1,0,0.008655544815405234,2019-03-28 06:30:00,2019-03-28 06:45:00
114,1,0,1,0.004678524805970161,2019-03-28 06:30:00,2019-03-28 06:45:00
138,1,0,1,0.004678524805970161,2019-03-28 06:30:00,2019-03-28 06:45:00
147,1,0,1,0.004678524805970161,2019-03-28 06:30:00,2019-03-28 06:45:00
157,1,1,0,0.008655544815405234,2019-03-28 06:30:00,2019-03-28 06:45:00
196,1,0,1,0.004678524805970161,2019-03-28 06:30:00,2019-03-28 06:45:00
203,2,0,2,0.004678524805970161,2019-03-28 06:30:00,2019-03-28 06:45:00
5,1,1,0,0.005985640186075253,2019-03-28 06:45:00,2019-03-28 07:00:00
11,4,1,3,0.005985640186075253,2019-03-28 06:45:00,2019-03-28 07:00:00
15,1,0,1,0.004289513743808797,2019-03-28 06:45:00,2019-03-28 07:00:00
18,1,0,1,0.004289513743808797,2019-03-28 06:45:00,2019-03-28 07:00:00
19,1,0,1,0.004289513743808797,2019-03-28 06:45:00,2019-03-28 07:00:00
21,1,1,0,0.00793598879887622,2019-03-28 06:45:00,2019-03-28 07:00:00
22,1,1,0,0.00793598879887622,2019-03-28 06:45:00,2019-03-28 07:00:00
23,1,1,0,0.013671191051566237,2019-03-28 06:45:00,2019-03-28 07:00:00
26,1,1,0,0.01103588443218638,2019-03-28 06:45:00,2019-03-28 07:00:00
35,1,1,0,0.00793598879887622,2019-03-28 06:45:00,2019-03-28 07:00:00
41,3,2,1,0.009632115241142675,2019-03-28 06:45:00,2019-03-28 07:00:00
57,1,0,1,0.004289513743808797,2019-03-28 06:45:00,2019-03-28 07:00:00
66,2,0,2,0.004289513743808797,2019-03-28 06:45:00,2019-03-28 07:00:00
67,2,2,0,0.00793598879887622,2019-03-28 06:45:00,2019-03-28 07:00:00
89,1,0,1,0.004289513743808797,2019-03-28 06:45:00,2019-03-28 07:00:00
112,2,1,1,0.01987432699675718,2019-03-28 06:45:00,2019-03-28 07:00:00
114,4,2,2,0.036738559487959406,2019-03-28 06:45:00,2019-03-28 07:00:00
115,1,1,0,0.00793598879887622,2019-03-28 06:45:00,2019-03-28 07:00:00
116,1,1,0,0.00793598879887622,2019-03-28 06:45:00,2019-03-28 07:00:00
138,2,1,1,0.01103588443218638,2019-03-28 06:45:00,2019-03-28 07:00:00
141,1,0,1,0.004289513743808797,2019-03-28 06:45:00,2019-03-28 07:00:00
147,1,0,1,0.004289513743808797,2019-03-28 06:45:00,2019-03-28 07:00:00
151,1,0,1,0.004289513743808797,2019-03-28 06:45:00,2019-03-28 07:00:00
153,1,1,0,0.01247778870391833,2019-03-28 06:45:00,2019-03-28 07:00:00
154,1,1,0,0.00793598879887622,2019-03-28 06:45:00,2019-03-28 07:00:00
158,2,1,1,0.00793598879887622,2019-03-28 06:45:00,2019-03-28 07:00:00
164,3,2,1,0.00793598879887622,2019-03-28 06:45:00,2019-03-28 07:00:00
203,2,0,2,0.004289513743808797,2019-03-28 06:45:00,2019-03-28 07:00:00
2,1,1,0,0.0077476996696847576,2019-03-28 07:00:00,2019-03-28 07:15:00
11,1,0,1,0.004187836849517383,2019-03-28 07:00:00,2019-03-28 07:15:00
18,3,1,2,0.012110587009174795,2019-03-28 07:00:00,2019-03-28 07:15:00
19,2,0,2,0.004187836849517383,2019-03-28 07:00:00,2019-03-28 07:15:00
21,1,1,0,0.0077476996696847576,2019-03-28 07:00:00,2019-03-28 07:15:00
23,2,2,0,0.02341470696544492,2019-03-28 07:00:00,2019-03-28 07:15:00
26,1,1,0,0.00596776825960107,2019-03-28 07:00:00,2019-03-28 07:15:00
37,1,1,0,0.0077476996696847576,2019-03-28 07:00:00,2019-03-28 07:15:00
41,1,1,0,0.0077476996696847576,2019-03-28 07:00:00,2019-03-28 07:15:00
46,1,0,1,0.004187836849517383,2019-03-28 07:00:00,2019-03-28 07:15:00
58,4,3,1,0.014600605902701218,2019-03-28 07:00:00,2019-03-28 07:15:00
61,1,0,1,0.004187836849517383,2019-03-28 07:00:00,2019-03-28 07:15:00
62,3,2,1,0.007499530052043456,2019-03-28 07:00:00,2019-03-28 07:15:00
66,2,0,2,0.004187836849517383,2019-03-28 07:00:00,2019-03-28 07:15:00
67,2,2,0,0.0077476996696847576,2019-03-28 07:00:00,2019-03-28 07:15:00
74,1,0,1,0.004187836849517383,2019-03-28 07:00:00,2019-03-28 07:15:00
85,1,0,1,0.004187836849517383,2019-03-28 07:00:00,2019-03-28 07:15:00
87,3,3,0,0.013087493899935819,2019-03-28 07:00:00,2019-03-28 07:15:00
88,1,0,1,0.004187836849517383,2019-03-28 07:00:00,2019-03-28 07:15:00
90,1,0,1,0.004187836849517383,2019-03-28 07:00:00,2019-03-28 07:15:00
104,4,1,3,0.00584368345078042,2019-03-28 07:00:00,2019-03-28 07:15:00
109,2,2,0,0.009527631079768445,2019-03-28 07:00:00,2019-03-28 07:15:00
111,1,1,0,0.010773923675215555,2019-03-28 07:00:00,2019-03-28 07:15:00
115,2,1,1,0.00596776825960107,2019-03-28 07:00:00,2019-03-28 07:15:00
116,1,1,0,0.00596776825960107,2019-03-28 07:00:00,2019-03-28 07:15:00
118,1,1,0,0.0077476996696847576,2019-03-28 07:00:00,2019-03-28 07:15:00
119,1,0,1,0.004187836849517383,2019-03-28 07:00:00,2019-03-28 07:15:00
127,1,1,0,0.01659961665329555,2019-03-28 07:00:00,2019-03-28 07:15:00
137,1,1,0,0.0077476996696847576,2019-03-28 07:00:00,2019-03-28 07:15:00
138,2,1,1,0.015136811014705594,2019-03-28 07:00:00,2019-03-28 07:15:00
141,2,0,2,0.004187836849517383,2019-03-28 07:00:00,2019-03-28 07:15:00
151,1,0,1,0.004187836849517383,2019-03-28 07:00:00,2019-03-28 07:15:00
157,1,0,1,0.004187836849517383,2019-03-28 07:00:00,2019-03-28 07:15:00
158,2,0,2,0.004187836849517383,2019-03-28 07:00:00,2019-03-28 07:15:00
164,4,3,1,0.012887169364159304,2019-03-28 07:00:00,2019-03-28 07:15:00
168,1,0,1,0.004187836849517383,2019-03-28 07:00:00,2019-03-28 07:15:00
170,2,1,1,0.009327306543991928,2019-03-28 07:00:00,2019-03-28 07:15:00
173,2,1,1,0.0077476996696847576,2019-03-28 07:00:00,2019-03-28 07:15:00
189,1,1,0,0.0077476996696847576,2019-03-28 07:00:00,2019-03-28 07:15:00
191,1,0,1,0.004187836849517383,2019-03-28 07:00:00,2019-03-28 07:15:00
197,1,1,0,0.0077476996696847576,2019-03-28 07:00:00,2019-03-28 07:15:00
201,1,0,1,0.004187836849517383,2019-03-28 07:00:00,2019-03-28 07:15:00
203,2,0,2,0.004187836849517383,2019-03-28 07:00:00,2019-03-28 07:15:00
2,2,1,1,0.007359785338066329,2019-03-28 07:15:00,2019-03-28 07:30:00
5,2,1,1,0.007359785338066329,2019-03-28 07:15:00,2019-03-28 07:30:00
10,1,0,1,0.003978315264668608,2019-03-28 07:15:00,2019-03-28 07:30:00
16,2,0,2,0.003978315264668608,2019-03-28 07:15:00,2019-03-28 07:30:00
18,6,1,5,0.006110464277718513,2019-03-28 07:15:00,2019-03-28 07:30:00
19,2,0,2,0.003978315264668608,2019-03-28 07:15:00,2019-03-28 07:30:00
23,3,2,1,0.016486926964633705,2019-03-28 07:15:00,2019-03-28 07:30:00
26,1,1,0,0.007359785338066329,2019-03-28 07:15:00,2019-03-28 07:30:00
37,5,5,0,0.019413343424300584,2019-03-28 07:15:00,2019-03-28 07:30:00
40,1,1,0,0.010232621114651157,2019-03-28 07:15:00,2019-03-28 07:30:00
46,2,1,1,0.007359785338066329,2019-03-28 07:15:00,2019-03-28 07:30:00
58,5,2,3,0.01074125541146405,2019-03-28 07:15:00,2019-03-28 07:30:00
61,1,0,1,0.003978315264668608,2019-03-28 07:15:00,2019-03-28 07:30:00
62,4,3,1,0.01074125541146405,2019-03-28 07:15:00,2019-03-28 07:30:00
67,2,2,0,0.007359785338066329,2019-03-28 07:15:00,2019-03-28 07:30:00
68,2,1,1,0.0056690503013674684,2019-03-28 07:15:00,2019-03-28 07:30:00
85,3,1,2,0.0056690503013674684,2019-03-28 07:15:00,2019-03-28 07:30:00
86,1,0,1,0.003978315264668608,2019-03-28 07:15:00,2019-03-28 07:30:00
87,5,5,0,0.013868408336455328,2019-03-28 07:15:00,2019-03-28 07:30:00
88,2,0,2,0.003978315264668608,2019-03-28 07:15:00,2019-03-28 07:30:00
90,1,0,1,0.003978315264668608,2019-03-28 07:15:00,2019-03-28 07:30:00
104,2,0,2,0.003978315264668608,2019-03-28 07:15:00,2019-03-28 07:30:00
109,2,2,0,0.018205183103294227,2019-03-28 07:15:00,2019-03-28 07:30:00
110,2,1,1,0.007020695806857734,2019-03-28 07:15:00,2019-03-28 07:30:00
111,2,2,0,0.014796191927934847,2019-03-28 07:15:00,2019-03-28 07:30:00
115,1,0,1,0.003978315264668608,2019-03-28 07:15:00,2019-03-28 07:30:00
119,2,1,1,0.005016930820070667,2019-03-28 07:15:00,2019-03-28 07:30:00
122,1,0,1,0.003978315264668608,2019-03-28 07:15:00,2019-03-28 07:30:00
127,1,1,0,0.007020695806857734,2019-03-28 07:15:00,2019-03-28 07:30:00
137,1,1,0,0.007359785338066329,2019-03-28 07:15:00,2019-03-28 07:30:00
138,1,0,1,0.003978315264668608,2019-03-28 07:15:00,2019-03-28 07:30:00
141,3,1,2,0.018746711987569404,2019-03-28 07:15:00,2019-03-28 07:30:00
147,1,1,0,0.008796203226358743,2019-03-28 07:15:00,2019-03-28 07:30:00
153,2,2,0,0.013614091188048879,2019-03-28 07:15:00,2019-03-28 07:30:00
157,1,0,1,0.003978315264668608,2019-03-28 07:15:00,2019-03-28 07:30:00
158,1,0,1,0.003978315264668608,2019-03-28 07:15:00,2019-03-28 07:30:00
164,1,1,0,0.005016930820070667,2019-03-28 07:15:00,2019-03-28 07:30:00
168,2,0,2,0.003978315264668608,2019-03-28 07:15:00,2019-03-28 07:30:00
170,3,1,2,0.005016930820070667,2019-03-28 07:15:00,2019-03-28 07:30:00
172,1,0,1,0.003978315264668608,2019-03-28 07:15:00,2019-03-28 07:30:00
173,3,2,1,0.01074125541146405,2019-03-28 07:15:00,2019-03-28 07:30:00
177,1,0,1,0.003978315264668608,2019-03-28 07:15:00,2019-03-28 07:30:00
189,5,4,1,0.017381435568261404,2019-03-28 07:15:00,2019-03-28 07:30:00
191,1,0,1,0.003978315264668608,2019-03-28 07:15:00,2019-03-28 07:30:00
195,1,1,0,0.01799238402158106,2019-03-28 07:15:00,2019-03-28 07:30:00
197,1,1,0,0.007359785338066329,2019-03-28 07:15:00,2019-03-28 07:30:00
201,1,0,1,0.003978315264668608,2019-03-28 07:15:00,2019-03-28 07:30:00
203,2,0,2,0.003978315264668608,2019-03-28 07:15:00,2019-03-28 07:30:00
2,1,0,1,0.004131283688971997,2019-03-28 07:30:00,2019-03-28 07:45:00
5,2,1,1,0.005887232623554915,2019-03-28 07:30:00,2019-03-28 07:45:00
10,2,0,2,0.004131283688971997,2019-03-28 07:30:00,2019-03-28 07:45:00
16,2,1,1,0.027042074611892702,2019-03-28 07:30:00,2019-03-28 07:45:00
18,3,0,3,0.004131283688971997,2019-03-28 07:30:00,2019-03-28 07:45:00
19,3,2,1,0.009399130492720753,2019-03-28 07:30:00,2019-03-28 07:45:00
21,1,1,0,0.007643181558137834,2019-03-28 07:30:00,2019-03-28 07:45:00
23,2,1,1,0.008638321950559153,2019-03-28 07:30:00,2019-03-28 07:45:00
26,1,0,1,0.004131283688971997,2019-03-28 07:30:00,2019-03-28 07:45:00
28,1,0,1,0.004131283688971997,2019-03-28 07:30:00,2019-03-28 07:45:00
37,2,2,0,0.01089184108135273,2019-03-28 07:30:00,2019-03-28 07:45:00
40,1,1,0,0.007643181558137834,2019-03-28 07:30:00,2019-03-28 07:45:00
41,1,0,1,0.004131283688971997,2019-03-28 07:30:00,2019-03-28 07:45:00
46,1,1,0,0.015935467138006428,2019-03-28 07:30:00,2019-03-28 07:45:00
50,1,0,1,0.004131283688971997,2019-03-28 07:30:00,2019-03-28 07:45:00
57,2,1,1,0.005301916312027276,2019-03-28 07:30:00,2019-03-28 07:45:00
58,3,1,2,0.007643181558137834,2019-03-28 07:30:00,2019-03-28 07:45:00
61,1,0,1,0.004131283688971997,2019-03-28 07:30:00,2019-03-28 07:45:00
62,4,4,0,0.01174039573883131,2019-03-28 07:30:00,2019-03-28 07:45:00
66,1,0,1,0.004131283688971997,2019-03-28 07:30:00,2019-03-28 07:45:00
67,3,3,0,0.009399130492720752,2019-03-28 07:30:00,2019-03-28 07:45:00
68,2,1,1,0.012121313324033762,2019-03-28 07:30:00,2019-03-28 07:45:00
86,2,0,2,0.004131283688971997,2019-03-28 07:30:00,2019-03-28 07:45:00
104,3,0,3,0.004131283688971997,2019-03-28 07:30:00,2019-03-28 07:45:00
110,2,1,1,0.007379943212186891,2019-03-28 07:30:00,2019-03-28 07:45:00
111,1,0,1,0.004131283688971997,2019-03-28 07:30:00,2019-03-28 07:45:00
112,1,1,0,0.005301916312027276,2019-03-28 07:30:00,2019-03-28 07:45:00
122,2,1,1,0.013885700043146527,2019-03-28 07:30:00,2019-03-28 07:45:00
126,1,1,0,0.005887232623554915,2019-03-28 07:30:00,2019-03-28 07:45:00
135,1,1,0,0.007643181558137834,2019-03-28 07:30:00,2019-03-28 07:45:00
138,2,1,1,0.005301916312027276,2019-03-28 07:30:00,2019-03-28 07:45:00
141,1,0,1,0.004131283688971997,2019-03-28 07:30:00,2019-03-28 07:45:00
147,3,3,0,0.021459274347555134,2019-03-28 07:30:00,2019-03-28 07:45:00
153,2,2,0,0.01089184108135273,2019-03-28 07:30:00,2019-03-28 07:45:00
172,2,0,2,0.004131283688971997,2019-03-28 07:30:00,2019-03-28 07:45:00
177,1,0,1,0.004131283688971997,2019-03-28 07:30:00,2019-03-28 07:45:00
189,4,4,0,0.019594419525185307,2019-03-28 07:30:00,2019-03-28 07:45:00
195,2,1,1,0.011474575151806603,2019-03-28 07:30:00,2019-03-28 07:45:00
203,2,0,2,0.004131283688971997,2019-03-28 07:30:00,2019-03-28 07:45:00
1,1,1,0,0.017641313512887523,2019-03-28 07:45:00,2019-03-28 08:00:00
5,1,0,1,0.004093104940566307,2019-03-28 07:45:00,2019-03-28 08:00:00
10,1,0,1,0.004093104940566307,2019-03-28 07:45:00,2019-03-28 08:00:00
16,6,2,4,0.009616573025020135,2019-03-28 07:45:00,2019-03-28 08:00:00
18,4,1,3,0.005711794833738741,2019-03-28 07:45:00,2019-03-28 08:00:00
19,3,2,1,0.01105173645099821,2019-03-28 07:45:00,2019-03-28 08:00:00
21,1,1,0,0.007572420695782259,2019-03-28 07:45:00,2019-03-28 08:00:00
23,1,1,0,0.006697521801551427,2019-03-28 07:45:00,2019-03-28 08:00:00
26,1,0,1,0.004093104940566307,2019-03-28 07:45:00,2019-03-28 08:00:00
28,1,0,1,0.004093104940566307,2019-03-28 07:45:00,2019-03-28 08:00:00
40,2,2,0,0.01105173645099821,2019-03-28 07:45:00,2019-03-28 08:00:00
50,1,0,1,0.004093104940566307,2019-03-28 07:45:00,2019-03-28 08:00:00
57,3,1,2,0.007116315392884212,2019-03-28 07:45:00,2019-03-28 08:00:00
58,1,0,1,0.004093104940566307,2019-03-28 07:45:00,2019-03-28 08:00:00
61,1,0,1,0.004093104940566307,2019-03-28 07:45:00,2019-03-28 08:00:00
62,1,1,0,0.007572420695782259,2019-03-28 07:45:00,2019-03-28 08:00:00
66,2,1,1,0.013965706747776882,2019-03-28 07:45:00,2019-03-28 08:00:00
67,2,2,0,0.007572420695782259,2019-03-28 07:45:00,2019-03-28 08:00:00
68,1,0,1,0.004093104940566307,2019-03-28 07:45:00,2019-03-28 08:00:00
69,1,0,1,0.004093104940566307,2019-03-28 07:45:00,2019-03-28 08:00:00
86,1,0,1,0.004093104940566307,2019-03-28 07:45:00,2019-03-28 08:00:00
104,3,1,2,0.007116315392884212,2019-03-28 07:45:00,2019-03-28 08:00:00
110,1,0,1,0.004093104940566307,2019-03-28 07:45:00,2019-03-28 08:00:00
112,2,2,0,0.009191110588954693,2019-03-28 07:45:00,2019-03-28 08:00:00
113,1,0,1,0.004093104940566307,2019-03-28 07:45:00,2019-03-28 08:00:00
119,2,2,0,0.008741674130789304,2019-03-28 07:45:00,2019-03-28 08:00:00
120,1,0,1,0.004093104940566307,2019-03-28 07:45:00,2019-03-28 08:00:00
122,2,1,1,0.011618116296921145,2019-03-28 07:45:00,2019-03-28 08:00:00
126,1,1,0,0.012014719822662442,2019-03-28 07:45:00,2019-03-28 08:00:00
127,1,1,0,0.007572420695782259,2019-03-28 07:45:00,2019-03-28 08:00:00
135,2,1,1,0.015959594548301856,2019-03-28 07:45:00,2019-03-28 08:00:00
138,5,2,3,0.009191110588954693,2019-03-28 07:45:00,2019-03-28 08:00:00
147,3,3,0,0.014531052206214161,2019-03-28 07:45:00,2019-03-28 08:00:00
153,1,1,0,0.007572420695782259,2019-03-28 07:45:00,2019-03-28 08:00:00
154,2,2,0,0.015226440380266352,2019-03-28 07:45:00,2019-03-28 08:00:00
164,1,0,1,0.004093104940566307,2019-03-28 07:45:00,2019-03-28 08:00:00
170,2,1,1,0.006137257269804184,2019-03-28 07:45:00,2019-03-28 08:00:00
171,2,0,2,0.004093104940566307,2019-03-28 07:45:00,2019-03-28 08:00:00
172,2,1,1,0.009312533354079756,2019-03-28 07:45:00,2019-03-28 08:00:00
189,3,3,0,0.01263978347733804,2019-03-28 07:45:00,2019-03-28 08:00:00
190,1,1,0,0.0058327628181742835,2019-03-28 07:45:00,2019-03-28 08:00:00
191,1,0,1,0.004093104940566307,2019-03-28 07:45:00,2019-03-28 08:00:00
195,3,2,1,0.008855973270492187,2019-03-28 07:45:00,2019-03-28 08:00:00
196,2,2,0,0.008437179679159404,2019-03-28 07:45:00,2019-03-28 08:00:00
199,2,0,2,0.004093104940566307,2019-03-28 07:45:00,2019-03-28 08:00:00
203,2,0,2,0.004093104940566307,2019-03-28 07:45:00,2019-03-28 08:00:00
1,1,1,0,0.00767842219388827,2019-03-28 08:00:00,2019-03-28 08:15:00
5,2,0,2,0.0041503292052466854,2019-03-28 08:00:00,2019-03-28 08:15:00
15,1,0,1,0.0041503292052466854,2019-03-28 08:00:00,2019-03-28 08:15:00
16,2,0,2,0.0041503292052466854,2019-03-28 08:00:00,2019-03-28 08:15:00
18,3,1,2,0.007218510725725736,2019-03-28 08:00:00,2019-03-28 08:15:00
19,5,3,2,0.01192263471058118,2019-03-28 08:00:00,2019-03-28 08:15:00
21,1,1,0,0.00767842219388827,2019-03-28 08:00:00,2019-03-28 08:15:00
23,2,2,0,0.014852840189739301,2019-03-28 08:00:00,2019-03-28 08:15:00
35,2,2,0,0.012004411369405152,2019-03-28 08:00:00,2019-03-28 08:15:00
40,2,2,0,0.014205708682348443,2019-03-28 08:00:00,2019-03-28 08:15:00
41,1,0,1,0.0041503292052466854,2019-03-28 08:00:00,2019-03-28 08:15:00
50,1,0,1,0.0041503292052466854,2019-03-28 08:00:00,2019-03-28 08:15:00
57,3,0,3,0.0041503292052466854,2019-03-28 08:00:00,2019-03-28 08:15:00
58,1,0,1,0.0041503292052466854,2019-03-28 08:00:00,2019-03-28 08:15:00
61,1,0,1,0.0041503292052466854,2019-03-28 08:00:00,2019-03-28 08:15:00
66,1,1,0,0.00767842219388827,2019-03-28 08:00:00,2019-03-28 08:15:00
67,2,2,0,0.00767842219388827,2019-03-28 08:00:00,2019-03-28 08:15:00
68,1,0,1,0.0041503292052466854,2019-03-28 08:00:00,2019-03-28 08:15:00
69,1,0,1,0.0041503292052466854,2019-03-28 08:00:00,2019-03-28 08:15:00
74,1,1,0,0.00767842219388827,2019-03-28 08:00:00,2019-03-28 08:15:00
85,1,0,1,0.0041503292052466854,2019-03-28 08:00:00,2019-03-28 08:15:00
99,2,1,1,0.027164055777260065,2019-03-28 08:00:00,2019-03-28 08:15:00
104,1,1,0,0.005326360201460547,2019-03-28 08:00:00,2019-03-28 08:15:00
106,1,0,1,0.0041503292052466854,2019-03-28 08:00:00,2019-03-28 08:15:00
109,2,2,0,0.008982557220046528,2019-03-28 08:00:00,2019-03-28 08:15:00
110,2,1,1,0.00767842219388827,2019-03-28 08:00:00,2019-03-28 08:15:00
113,1,1,0,0.00767842219388827,2019-03-28 08:00:00,2019-03-28 08:15:00
114,2,1,1,0.007164039657825222,2019-03-28 08:00:00,2019-03-28 08:15:00
120,2,0,2,0.0041503292052466854,2019-03-28 08:00:00,2019-03-28 08:15:00
122,1,0,1,0.0041503292052466854,2019-03-28 08:00:00,2019-03-28 08:15:00
126,3,0,3,0.0041503292052466854,2019-03-28 08:00:00,2019-03-28 08:15:00
127,1,1,0,0.005914375699567478,2019-03-28 08:00:00,2019-03-28 08:15:00
135,1,0,1,0.0041503292052466854,2019-03-28 08:00:00,2019-03-28 08:15:00
137,1,1,0,0.005914375699567478,2019-03-28 08:00:00,2019-03-28 08:15:00
138,3,2,1,0.011206515182529854,2019-03-28 08:00:00,2019-03-28 08:15:00
147,1,1,0,0.00767842219388827,2019-03-28 08:00:00,2019-03-28 08:15:00
153,1,1,0,0.005326360201460547,2019-03-28 08:00:00,2019-03-28 08:15:00
154,4,4,0,0.01957775639559194,2019-03-28 08:00:00,2019-03-28 08:15:00
164,1,0,1,0.0041503292052466854,2019-03-28 08:00:00,2019-03-28 08:15:00
170,2,1,1,0.005914375699567478,2019-03-28 08:00:00,2019-03-28 08:15:00
171,2,0,2,0.0041503292052466854,2019-03-28 08:00:00,2019-03-28 08:15:00
172,1,1,0,0.009178018943797562,2019-03-28 08:00:00,2019-03-28 08:15:00
173,1,1,0,0.007164039657825222,2019-03-28 08:00:00,2019-03-28 08:15:00
189,1,1,0,0.005914375699567478,2019-03-28 08:00:00,2019-03-28 08:15:00
190,2,2,0,0.007090406695781339,2019-03-28 08:00:00,2019-03-28 08:15:00
191,3,1,2,0.007218510725725736,2019-03-28 08:00:00,2019-03-28 08:15:00
195,1,1,0,0.005914375699567478,2019-03-28 08:00:00,2019-03-28 08:15:00
196,4,2,2,0.007090406695781339,2019-03-28 08:00:00,2019-03-28 08:15:00
199,2,0,2,0.0041503292052466854,2019-03-28 08:00:00,2019-03-28 08:15:00
203,2,0,2,0.0041503292052466854,2019-03-28 08:00:00,2019-03-28 08:15:00
1,1,0,1,0.004046477067966492,2019-03-28 08:15:00,2019-03-28 08:30:00
5,2,1,1,0.012896480943163941,2019-03-28 08:15:00,2019-03-28 08:30:00
10,1,1,0,0.007486327555757815,2019-03-28 08:15:00,2019-03-28 08:30:00
15,2,1,1,0.005766402311862154,2019-03-28 08:15:00,2019-03-28 08:30:00
16,2,0,2,0.004046477067966492,2019-03-28 08:15:00,2019-03-28 08:30:00
18,2,1,1,0.007486327555757815,2019-03-28 08:15:00,2019-03-28 08:30:00
19,1,0,1,0.004046477067966492,2019-03-28 08:15:00,2019-03-28 08:30:00
21,1,1,0,0.005766402311862154,2019-03-28 08:15:00,2019-03-28 08:30:00
23,3,3,0,0.021746484818361392,2019-03-28 08:15:00,2019-03-28 08:30:00
26,1,1,0,0.007486327555757815,2019-03-28 08:15:00,2019-03-28 08:30:00
28,1,0,1,0.004046477067966492,2019-03-28 08:15:00,2019-03-28 08:30:00
35,2,2,0,0.01066836243485255,2019-03-28 08:15:00,2019-03-28 08:30:00
41,3,1,2,0.007486327555757815,2019-03-28 08:15:00,2019-03-28 08:30:00
46,1,0,1,0.004046477067966492,2019-03-28 08:15:00,2019-03-28 08:30:00
57,1,0,1,0.004046477067966492,2019-03-28 08:15:00,2019-03-28 08:30:00
61,2,0,2,0.004046477067966492,2019-03-28 08:15:00,2019-03-28 08:30:00
62,1,1,0,0.007486327555757815,2019-03-28 08:15:00,2019-03-28 08:30:00
66,1,0,1,0.004046477067966492,2019-03-28 08:15:00,2019-03-28 08:30:00
67,2,2,0,0.007486327555757815,2019-03-28 08:15:00,2019-03-28 08:30:00
74,2,2,0,0.009206252799653477,2019-03-28 08:15:00,2019-03-28 08:30:00
79,1,0,1,0.004046477067966492,2019-03-28 08:15:00,2019-03-28 08:30:00
85,1,0,1,0.004046477067966492,2019-03-28 08:15:00,2019-03-28 08:30:00
87,1,1,0,0.007228511947061229,2019-03-28 08:15:00,2019-03-28 08:30:00
99,4,2,2,0.026399744973444075,2019-03-28 08:15:00,2019-03-28 08:30:00
104,3,2,1,0.009206252799653477,2019-03-28 08:15:00,2019-03-28 08:30:00
109,3,3,0,0.02309386906908867,2019-03-28 08:15:00,2019-03-28 08:30:00
110,2,1,1,0.007486327555757815,2019-03-28 08:15:00,2019-03-28 08:30:00
111,2,1,1,0.010410546826155966,2019-03-28 08:15:00,2019-03-28 08:30:00
112,3,1,2,0.0070379537786122316,2019-03-28 08:15:00,2019-03-28 08:30:00
113,1,1,0,0.005766402311862154,2019-03-28 08:15:00,2019-03-28 08:30:00
114,2,1,1,0.005766402311862154,2019-03-28 08:15:00,2019-03-28 08:30:00
120,1,0,1,0.004046477067966492,2019-03-28 08:15:00,2019-03-28 08:30:00
126,2,0,2,0.004046477067966492,2019-03-28 08:15:00,2019-03-28 08:30:00
127,1,0,1,0.004046477067966492,2019-03-28 08:15:00,2019-03-28 08:30:00
137,1,1,0,0.007486327555757815,2019-03-28 08:15:00,2019-03-28 08:30:00
138,3,2,1,0.01677461658434544,2019-03-28 08:15:00,2019-03-28 08:30:00
151,2,0,2,0.004046477067966492,2019-03-28 08:15:00,2019-03-28 08:30:00
154,3,3,0,0.014108212922643873,2019-03-28 08:15:00,2019-03-28 08:30:00
159,1,1,0,0.005766402311862154,2019-03-28 08:15:00,2019-03-28 08:30:00
162,1,0,1,0.004046477067966492,2019-03-28 08:15:00,2019-03-28 08:30:00
164,2,1,1,0.0070379537786122316,2019-03-28 08:15:00,2019-03-28 08:30:00
170,3,3,0,0.015189206220944954,2019-03-28 08:15:00,2019-03-28 08:30:00
191,1,0,1,0.004046477067966492,2019-03-28 08:15:00,2019-03-28 08:30:00
199,2,0,2,0.004046477067966492,2019-03-28 08:15:00,2019-03-28 08:30:00
202,2,0,2,0.004046477067966492,2019-03-28 08:15:00,2019-03-28 08:30:00
203,2,0,2,0.004046477067966492,2019-03-28 08:15:00,2019-03-28 08:30:00
1,1,0,1,0.003955451180876763,2019-03-28 08:30:00,2019-03-28 08:45:00
2,1,0,1,0.003955451180876763,2019-03-28 08:30:00,2019-03-28 08:45:00
5,4,1,3,0.01957322778105381,2019-03-28 08:30:00,2019-03-28 08:45:00
10,1,1,0,0.007317856207631788,2019-03-28 08:30:00,2019-03-28 08:45:00
16,3,3,0,0.01687968713023804,2019-03-28 08:30:00,2019-03-28 08:45:00
18,3,2,1,0.009133185000360351,2019-03-28 08:30:00,2019-03-28 08:45:00
19,1,0,1,0.003955451180876763,2019-03-28 08:30:00,2019-03-28 08:45:00
21,1,1,0,0.007317856207631788,2019-03-28 08:30:00,2019-03-28 08:45:00
23,3,2,1,0.0118360795901055,2019-03-28 08:30:00,2019-03-28 08:45:00
26,1,1,0,0.007317856207631788,2019-03-28 08:30:00,2019-03-28 08:45:00
27,1,0,1,0.003955451180876763,2019-03-28 08:30:00,2019-03-28 08:45:00
28,1,0,1,0.003955451180876763,2019-03-28 08:30:00,2019-03-28 08:45:00
37,1,1,0,0.007317856207631788,2019-03-28 08:30:00,2019-03-28 08:45:00
41,3,0,3,0.003955451180876763,2019-03-28 08:30:00,2019-03-28 08:45:00
46,4,4,0,0.013044159348536331,2019-03-28 08:30:00,2019-03-28 08:45:00
57,5,1,4,0.00502292816521136,2019-03-28 08:30:00,2019-03-28 08:45:00
58,7,2,5,0.010676595194034588,2019-03-28 08:30:00,2019-03-28 08:45:00
61,1,0,1,0.003955451180876763,2019-03-28 08:30:00,2019-03-28 08:45:00
62,1,1,0,0.007317856207631788,2019-03-28 08:30:00,2019-03-28 08:45:00
66,1,0,1,0.003955451180876763,2019-03-28 08:30:00,2019-03-28 08:45:00
74,3,2,1,0.0089990587210093,2019-03-28 08:30:00,2019-03-28 08:45:00
79,1,0,1,0.003955451180876763,2019-03-28 08:30:00,2019-03-28 08:45:00
85,1,1,0,0.00502292816521136,2019-03-28 08:30:00,2019-03-28 08:45:00
87,1,1,0,0.005076252856461771,2019-03-28 08:30:00,2019-03-28 08:45:00
88,1,0,1,0.003955451180876763,2019-03-28 08:30:00,2019-03-28 08:45:00
89,1,0,1,0.003955451180876763,2019-03-28 08:30:00,2019-03-28 08:45:00
90,1,0,1,0.003955451180876763,2019-03-28 08:30:00,2019-03-28 08:45:00
104,2,0,2,0.003955451180876763,2019-03-28 08:30:00,2019-03-28 08:45:00
109,1,1,0,0.00948631263322764,2019-03-28 08:30:00,2019-03-28 08:45:00
110,1,0,1,0.003955451180876763,2019-03-28 08:30:00,2019-03-28 08:45:00
111,4,3,1,0.018379579112333545,2019-03-28 08:30:00,2019-03-28 08:45:00
113,2,1,1,0.005770779973605327,2019-03-28 08:30:00,2019-03-28 08:45:00
114,3,3,0,0.014042666261141836,2019-03-28 08:30:00,2019-03-28 08:45:00
116,1,0,1,0.003955451180876763,2019-03-28 08:30:00,2019-03-28 08:45:00
119,1,1,0,0.011719724404584402,2019-03-28 08:30:00,2019-03-28 08:45:00
122,1,0,1,0.003955451180876763,2019-03-28 08:30:00,2019-03-28 08:45:00
126,4,1,3,0.0055194684349640566,2019-03-28 08:30:00,2019-03-28 08:45:00
127,1,0,1,0.003955451180876763,2019-03-28 08:30:00,2019-03-28 08:45:00
129,1,1,0,0.007317856207631788,2019-03-28 08:30:00,2019-03-28 08:45:00
137,1,0,1,0.003955451180876763,2019-03-28 08:30:00,2019-03-28 08:45:00
138,6,3,3,0.021892441153770224,2019-03-28 08:30:00,2019-03-28 08:45:00
147,1,1,0,0.011605543212549356,2019-03-28 08:30:00,2019-03-28 08:45:00
151,2,0,2,0.003955451180876763,2019-03-28 08:30:00,2019-03-28 08:45:00
153,2,2,0,0.0089990587210093,2019-03-28 08:30:00,2019-03-28 08:45:00
156,1,0,1,0.003955451180876763,2019-03-28 08:30:00,2019-03-28 08:45:00
157,1,1,0,0.005076252856461771,2019-03-28 08:30:00,2019-03-28 08:45:00
158,1,1,0,0.005770779973605327,2019-03-28 08:30:00,2019-03-28 08:45:00
159,1,1,0,0.005636653694254275,2019-03-28 08:30:00,2019-03-28 08:45:00
162,1,0,1,0.003955451180876763,2019-03-28 08:30:00,2019-03-28 08:45:00
164,1,0,1,0.003955451180876763,2019-03-28 08:30:00,2019-03-28 08:45:00
170,5,5,0,0.017422012307957695,2019-03-28 08:30:00,2019-03-28 08:45:00
172,1,0,1,0.003955451180876763,2019-03-28 08:30:00,2019-03-28 08:45:00
189,1,1,0,0.007317856207631788,2019-03-28 08:30:00,2019-03-28 08:45:00
191,2,2,0,0.006090405149545957,2019-03-28 08:30:00,2019-03-28 08:45:00
196,1,1,0,0.007317856207631788,2019-03-28 08:30:00,2019-03-28 08:45:00
197,1,1,0,0.0055194684349640566,2019-03-28 08:30:00,2019-03-28 08:45:00
199,2,0,2,0.003955451180876763,2019-03-28 08:30:00,2019-03-28 08:45:00
201,3,1,2,0.006879750132818787,2019-03-28 08:30:00,2019-03-28 08:45:00
202,1,0,1,0.003955451180876763,2019-03-28 08:30:00,2019-03-28 08:45:00
2,1,0,1,0.0033970887438511304,2019-03-28 08:45:00,2019-03-28 09:00:00
5,3,1,2,0.0468612561850515,2019-03-28 08:45:00,2019-03-28 09:00:00
18,2,1,1,0.005027329897327402,2019-03-28 08:45:00,2019-03-28 09:00:00
19,4,1,3,0.004359691858111864,2019-03-28 08:45:00,2019-03-28 09:00:00
20,1,0,1,0.0033970887438511304,2019-03-28 08:45:00,2019-03-28 09:00:00
21,1,1,0,0.006284898086633331,2019-03-28 08:45:00,2019-03-28 09:00:00
23,1,1,0,0.016780170728965624,2019-03-28 08:45:00,2019-03-28 09:00:00
28,2,0,2,0.0033970887438511304,2019-03-28 08:45:00,2019-03-28 09:00:00
35,1,0,1,0.0033970887438511304,2019-03-28 08:45:00,2019-03-28 09:00:00
37,2,1,1,0.008739827574485767,2019-03-28 08:45:00,2019-03-28 09:00:00
41,2,0,2,0.0033970887438511304,2019-03-28 08:45:00,2019-03-28 09:00:00
46,4,4,0,0.010616612100806633,2019-03-28 08:45:00,2019-03-28 09:00:00
57,4,1,3,0.017266334704749788,2019-03-28 08:45:00,2019-03-28 09:00:00
58,5,1,4,0.007670803690840607,2019-03-28 08:45:00,2019-03-28 09:00:00
61,1,1,0,0.008385293179094214,2019-03-28 08:45:00,2019-03-28 09:00:00
62,2,1,1,0.004840993415242231,2019-03-28 08:45:00,2019-03-28 09:00:00
68,1,1,0,0.00751236283055955,2019-03-28 08:45:00,2019-03-28 09:00:00
69,1,0,1,0.0033970887438511304,2019-03-28 08:45:00,2019-03-28 09:00:00
74,2,1,1,0.006284898086633331,2019-03-28 08:45:00,2019-03-28 09:00:00
85,3,2,1,0.01571964573958891,2019-03-28 08:45:00,2019-03-28 09:00:00
87,4,3,1,0.01631467746041594,2019-03-28 08:45:00,2019-03-28 09:00:00
88,1,0,1,0.0033970887438511304,2019-03-28 08:45:00,2019-03-28 09:00:00
90,3,0,3,0.0033970887438511304,2019-03-28 08:45:00,2019-03-28 09:00:00
104,2,0,2,0.0033970887438511304,2019-03-28 08:45:00,2019-03-28 09:00:00
109,1,1,0,0.004359691858111864,2019-03-28 08:45:00,2019-03-28 09:00:00
111,5,4,1,0.051156594577609564,2019-03-28 08:45:00,2019-03-28 09:00:00
112,1,1,0,0.004840993415242231,2019-03-28 08:45:00,2019-03-28 09:00:00
113,2,1,1,0.005027329897327402,2019-03-28 08:45:00,2019-03-28 09:00:00
114,3,2,1,0.04175668154730138,2019-03-28 08:45:00,2019-03-28 09:00:00
115,1,1,0,0.005027329897327402,2019-03-28 08:45:00,2019-03-28 09:00:00
116,1,0,1,0.0033970887438511304,2019-03-28 08:45:00,2019-03-28 09:00:00
119,2,1,1,0.007670803690840607,2019-03-28 08:45:00,2019-03-28 09:00:00
120,2,0,2,0.0033970887438511304,2019-03-28 08:45:00,2019-03-28 09:00:00
122,2,1,1,0.006284898086633331,2019-03-28 08:45:00,2019-03-28 09:00:00
126,2,0,2,0.0033970887438511304,2019-03-28 08:45:00,2019-03-28 09:00:00
127,1,1,0,0.004840993415242231,2019-03-28 08:45:00,2019-03-28 09:00:00
129,1,0,1,0.0033970887438511304,2019-03-28 08:45:00,2019-03-28 09:00:00
137,5,4,1,0.011579215215067367,2019-03-28 08:45:00,2019-03-28 09:00:00
138,4,3,1,0.015742911003976387,2019-03-28 08:45:00,2019-03-28 09:00:00
147,2,2,0,0.011627636917267967,2019-03-28 08:45:00,2019-03-28 09:00:00
153,3,2,1,0.005867834858562028,2019-03-28 08:45:00,2019-03-28 09:00:00
156,1,0,1,0.0033970887438511304,2019-03-28 08:45:00,2019-03-28 09:00:00
157,2,2,0,0.0060763664725976795,2019-03-28 08:45:00,2019-03-28 09:00:00
162,1,0,1,0.0033970887438511304,2019-03-28 08:45:00,2019-03-28 09:00:00
168,1,0,1,0.0033970887438511304,2019-03-28 08:45:00,2019-03-28 09:00:00
170,3,2,1,0.007728802758024432,2019-03-28 08:45:00,2019-03-28 09:00:00
171,1,0,1,0.0033970887438511304,2019-03-28 08:45:00,2019-03-28 09:00:00
172,1,0,1,0.0033970887438511304,2019-03-28 08:45:00,2019-03-28 09:00:00
189,3,3,0,0.02253630798091756,2019-03-28 08:45:00,2019-03-28 09:00:00
191,2,2,0,0.013182746169024095,2019-03-28 08:45:00,2019-03-28 09:00:00
196,1,1,0,0.006284898086633331,2019-03-28 08:45:00,2019-03-28 09:00:00
197,1,1,0,0.004840993415242231,2019-03-28 08:45:00,2019-03-28 09:00:00
201,2,0,2,0.0033970887438511304,2019-03-28 08:45:00,2019-03-28 09:00:00
202,1,0,1,0.0033970887438511304,2019-03-28 08:45:00,2019-03-28 09:00:00
203,1,0,1,0.0033970887438511304,2019-03-28 08:45:00,2019-03-28 09:00:00
2,2,1,1,0.02447380211993295,2019-03-28 09:00:00,2019-03-28 09:15:00
5,2,0,2,0.003689634012059159,2019-03-28 09:00:00,2019-03-28 09:15:00
15,3,2,1,0.04525797022780674,2019-03-28 09:00:00,2019-03-28 09:15:00
16,2,1,1,0.004137702182689971,2019-03-28 09:00:00,2019-03-28 09:15:00
19,3,1,2,0.0047351264101977205,2019-03-28 09:00:00,2019-03-28 09:15:00
20,1,0,1,0.003689634012059159,2019-03-28 09:00:00,2019-03-28 09:15:00
22,1,1,0,0.006826111206474843,2019-03-28 09:00:00,2019-03-28 09:15:00
23,1,1,0,0.014089927660450072,2019-03-28 09:00:00,2019-03-28 09:15:00
26,1,1,0,0.006826111206474843,2019-03-28 09:00:00,2019-03-28 09:15:00
28,1,0,1,0.003689634012059159,2019-03-28 09:00:00,2019-03-28 09:15:00
35,4,1,3,0.004137702182689971,2019-03-28 09:00:00,2019-03-28 09:15:00
37,3,3,0,0.009889402629509172,2019-03-28 09:00:00,2019-03-28 09:15:00
40,1,1,0,0.004137702182689971,2019-03-28 09:00:00,2019-03-28 09:15:00
41,1,1,0,0.009492409582791484,2019-03-28 09:00:00,2019-03-28 09:15:00
57,1,1,0,0.008540160162678397,2019-03-28 09:00:00,2019-03-28 09:15:00
58,7,0,7,0.003689634012059159,2019-03-28 09:00:00,2019-03-28 09:15:00
61,2,1,1,0.009870184737350542,2019-03-28 09:00:00,2019-03-28 09:15:00
62,1,0,1,0.003689634012059159,2019-03-28 09:00:00,2019-03-28 09:15:00
67,1,0,1,0.003689634012059159,2019-03-28 09:00:00,2019-03-28 09:15:00
68,1,1,0,0.006826111206474843,2019-03-28 09:00:00,2019-03-28 09:15:00
69,1,0,1,0.003689634012059159,2019-03-28 09:00:00,2019-03-28 09:15:00
70,1,0,1,0.003689634012059159,2019-03-28 09:00:00,2019-03-28 09:15:00
74,1,1,0,0.006826111206474843,2019-03-28 09:00:00,2019-03-28 09:15:00
85,2,0,2,0.003689634012059159,2019-03-28 09:00:00,2019-03-28 09:15:00
87,3,2,1,0.005705940779897813,2019-03-28 09:00:00,2019-03-28 09:15:00
88,2,2,0,0.021920000260907412,2019-03-28 09:00:00,2019-03-28 09:15:00
90,3,0,3,0.003689634012059159,2019-03-28 09:00:00,2019-03-28 09:15:00
99,1,0,1,0.003689634012059159,2019-03-28 09:00:00,2019-03-28 09:15:00
104,1,0,1,0.003689634012059159,2019-03-28 09:00:00,2019-03-28 09:15:00
109,2,2,0,0.0100300356235364,2019-03-28 09:00:00,2019-03-28 09:15:00
110,1,1,0,0.0047351264101977205,2019-03-28 09:00:00,2019-03-28 09:15:00
111,6,5,1,0.01960025349618505,2019-03-28 09:00:00,2019-03-28 09:15:00
112,2,1,1,0.006826111206474843,2019-03-28 09:00:00,2019-03-28 09:15:00
113,2,1,1,0.02447380211993295,2019-03-28 09:00:00,2019-03-28 09:15:00
115,1,1,0,0.004137702182689971,2019-03-28 09:00:00,2019-03-28 09:15:00
119,1,0,1,0.003689634012059159,2019-03-28 09:00:00,2019-03-28 09:15:00
120,2,0,2,0.003689634012059159,2019-03-28 09:00:00,2019-03-28 09:15:00
126,1,1,0,0.006417264076046172,2019-03-28 09:00:00,2019-03-28 09:15:00
127,2,1,1,0.006826111206474843,2019-03-28 09:00:00,2019-03-28 09:15:00
129,1,0,1,0.003689634012059159,2019-03-28 09:00:00,2019-03-28 09:15:00
137,4,4,0,0.013573021280121254,2019-03-28 09:00:00,2019-03-28 09:15:00
138,5,4,1,0.012234320604483116,2019-03-28 09:00:00,2019-03-28 09:15:00
140,1,1,0,0.005257872609267001,2019-03-28 09:00:00,2019-03-28 09:15:00
141,2,0,2,0.003689634012059159,2019-03-28 09:00:00,2019-03-28 09:15:00
153,3,2,1,0.007270494269194282,2019-03-28 09:00:00,2019-03-28 09:15:00
154,1,0,1,0.003689634012059159,2019-03-28 09:00:00,2019-03-28 09:15:00
157,1,1,0,0.00570225567198644,2019-03-28 09:00:00,2019-03-28 09:15:00
158,1,1,0,0.012080219712272862,2019-03-28 09:00:00,2019-03-28 09:15:00
162,2,1,1,0.006826111206474843,2019-03-28 09:00:00,2019-03-28 09:15:00
164,2,1,1,0.009492409582791484,2019-03-28 09:00:00,2019-03-28 09:15:00
168,3,0,3,0.003689634012059159,2019-03-28 09:00:00,2019-03-28 09:15:00
170,3,1,2,0.007207010974520077,2019-03-28 09:00:00,2019-03-28 09:15:00
177,3,1,2,0.006417264076046172,2019-03-28 09:00:00,2019-03-28 09:15:00
189,4,3,1,0.006228686978967093,2019-03-28 09:00:00,2019-03-28 09:15:00
195,1,1,0,0.009492409582791484,2019-03-28 09:00:00,2019-03-28 09:15:00
196,1,1,0,0.004137702182689971,2019-03-28 09:00:00,2019-03-28 09:15:00
201,2,0,2,0.003689634012059159,2019-03-28 09:00:00,2019-03-28 09:15:00
203,2,1,1,0.004862092999546132,2019-03-28 09:00:00,2019-03-28 09:15:00
2,2,1,1,0.02594418261308081,2019-03-28 09:15:00,2019-03-28 09:30:00
5,1,0,1,0.003931519277099335,2019-03-28 09:15:00,2019-03-28 09:30:00
15,2,1,1,0.007273628717509792,2019-03-28 09:15:00,2019-03-28 09:30:00
16,1,1,0,0.0059925936289217455,2019-03-28 09:15:00,2019-03-28 09:30:00
18,2,1,1,0.02594418261308081,2019-03-28 09:15:00,2019-03-28 09:30:00
19,1,1,0,0.007273628717509792,2019-03-28 09:15:00,2019-03-28 09:30:00
20,1,1,0,0.007273628717509792,2019-03-28 09:15:00,2019-03-28 09:30:00
21,1,0,1,0.003931519277099335,2019-03-28 09:15:00,2019-03-28 09:30:00
23,3,3,0,0.019427152880696574,2019-03-28 09:15:00,2019-03-28 09:30:00
26,1,1,0,0.007273628717509792,2019-03-28 09:15:00,2019-03-28 09:30:00
35,2,1,1,0.0059925936289217455,2019-03-28 09:15:00,2019-03-28 09:30:00
37,1,1,0,0.007273628717509792,2019-03-28 09:15:00,2019-03-28 09:30:00
41,1,0,1,0.003931519277099335,2019-03-28 09:15:00,2019-03-28 09:30:00
46,1,1,0,0.007273628717509792,2019-03-28 09:15:00,2019-03-28 09:30:00
57,1,0,1,0.003931519277099335,2019-03-28 09:15:00,2019-03-28 09:30:00
58,4,1,3,0.007273628717509792,2019-03-28 09:15:00,2019-03-28 09:30:00
61,1,0,1,0.003931519277099335,2019-03-28 09:15:00,2019-03-28 09:30:00
62,1,0,1,0.003931519277099335,2019-03-28 09:15:00,2019-03-28 09:30:00
67,1,0,1,0.003931519277099335,2019-03-28 09:15:00,2019-03-28 09:30:00
68,3,1,2,0.007273628717509792,2019-03-28 09:15:00,2019-03-28 09:30:00
69,1,0,1,0.003931519277099335,2019-03-28 09:15:00,2019-03-28 09:30:00
70,1,1,0,0.007273628717509792,2019-03-28 09:15:00,2019-03-28 09:30:00
74,1,0,1,0.003931519277099335,2019-03-28 09:15:00,2019-03-28 09:30:00
88,1,0,1,0.003931519277099335,2019-03-28 09:15:00,2019-03-28 09:30:00
90,1,0,1,0.003931519277099335,2019-03-28 09:15:00,2019-03-28 09:30:00
99,1,0,1,0.003931519277099335,2019-03-28 09:15:00,2019-03-28 09:30:00
104,1,0,1,0.003931519277099335,2019-03-28 09:15:00,2019-03-28 09:30:00
109,1,0,1,0.003931519277099335,2019-03-28 09:15:00,2019-03-28 09:30:00
110,1,1,0,0.007273628717509792,2019-03-28 09:15:00,2019-03-28 09:30:00
111,3,2,1,0.010615738157920248,2019-03-28 09:15:00,2019-03-28 09:30:00
112,1,1,0,0.007273628717509792,2019-03-28 09:15:00,2019-03-28 09:30:00
113,3,1,2,0.006837982413862262,2019-03-28 09:15:00,2019-03-28 09:30:00
114,3,1,2,0.006837982413862262,2019-03-28 09:15:00,2019-03-28 09:30:00
118,1,1,0,0.006837982413862262,2019-03-28 09:15:00,2019-03-28 09:30:00
119,2,2,0,0.015862319084386265,2019-03-28 09:15:00,2019-03-28 09:30:00
120,1,0,1,0.003931519277099335,2019-03-28 09:15:00,2019-03-28 09:30:00
126,1,1,0,0.007273628717509792,2019-03-28 09:15:00,2019-03-28 09:30:00
129,1,0,1,0.003931519277099335,2019-03-28 09:15:00,2019-03-28 09:30:00
137,2,2,0,0.017787490289499556,2019-03-28 09:15:00,2019-03-28 09:30:00
138,3,2,1,0.010365240245243407,2019-03-28 09:15:00,2019-03-28 09:30:00
140,1,0,1,0.003931519277099335,2019-03-28 09:15:00,2019-03-28 09:30:00
141,3,2,1,0.007273628717509792,2019-03-28 09:15:00,2019-03-28 09:30:00
153,1,1,0,0.010114742332566566,2019-03-28 09:15:00,2019-03-28 09:30:00
154,1,0,1,0.003931519277099335,2019-03-28 09:15:00,2019-03-28 09:30:00
156,1,1,0,0.007023130804832951,2019-03-28 09:15:00,2019-03-28 09:30:00
158,1,1,0,0.007273628717509792,2019-03-28 09:15:00,2019-03-28 09:30:00
162,2,1,1,0.007273628717509792,2019-03-28 09:15:00,2019-03-28 09:30:00
164,1,0,1,0.003931519277099335,2019-03-28 09:15:00,2019-03-28 09:30:00
168,1,0,1,0.003931519277099335,2019-03-28 09:15:00,2019-03-28 09:30:00
170,1,0,1,0.003931519277099335,2019-03-28 09:15:00,2019-03-28 09:30:00
173,1,1,0,0.007273628717509792,2019-03-28 09:15:00,2019-03-28 09:30:00
177,1,0,1,0.003931519277099335,2019-03-28 09:15:00,2019-03-28 09:30:00
189,2,0,2,0.003931519277099335,2019-03-28 09:15:00,2019-03-28 09:30:00
191,1,1,0,0.0059925936289217455,2019-03-28 09:15:00,2019-03-28 09:30:00
195,2,2,0,0.013456851772977022,2019-03-28 09:15:00,2019-03-28 09:30:00
201,1,1,0,0.007273628717509792,2019-03-28 09:15:00,2019-03-28 09:30:00
203,2,1,1,0.009025756495715857,2019-03-28 09:15:00,2019-03-28 09:30:00
2,2,1,1,0.027836691016462967,2019-03-28 09:30:00,2019-03-28 09:45:00
15,1,0,1,0.004253375465246765,2019-03-28 09:30:00,2019-03-28 09:45:00
16,1,0,1,0.004253375465246765,2019-03-28 09:30:00,2019-03-28 09:45:00
22,1,1,0,0.005157300799394939,2019-03-28 09:30:00,2019-03-28 09:45:00
23,2,2,0,0.015326877818833896,2019-03-28 09:30:00,2019-03-28 09:45:00
37,1,1,0,0.007869076801839462,2019-03-28 09:30:00,2019-03-28 09:45:00
41,1,1,0,0.007869076801839462,2019-03-28 09:30:00,2019-03-28 09:45:00
46,5,2,3,0.010980572669421856,2019-03-28 09:30:00,2019-03-28 09:45:00
58,2,0,2,0.004253375465246765,2019-03-28 09:30:00,2019-03-28 09:45:00
66,1,1,0,0.007869076801839462,2019-03-28 09:30:00,2019-03-28 09:45:00
67,1,0,1,0.004253375465246765,2019-03-28 09:30:00,2019-03-28 09:45:00
68,4,0,4,0.004253375465246765,2019-03-28 09:30:00,2019-03-28 09:45:00
69,1,0,1,0.004253375465246765,2019-03-28 09:30:00,2019-03-28 09:45:00
70,1,1,0,0.007869076801839462,2019-03-28 09:30:00,2019-03-28 09:45:00
74,1,0,1,0.004253375465246765,2019-03-28 09:30:00,2019-03-28 09:45:00
104,1,0,1,0.004253375465246765,2019-03-28 09:30:00,2019-03-28 09:45:00
110,1,0,1,0.004253375465246765,2019-03-28 09:30:00,2019-03-28 09:45:00
112,3,2,1,0.01148477813843216,2019-03-28 09:30:00,2019-03-28 09:45:00
114,1,0,1,0.004253375465246765,2019-03-28 09:30:00,2019-03-28 09:45:00
118,1,1,0,0.007869076801839462,2019-03-28 09:30:00,2019-03-28 09:45:00
119,4,4,0,0.028465648978721805,2019-03-28 09:30:00,2019-03-28 09:45:00
120,1,0,1,0.004253375465246765,2019-03-28 09:30:00,2019-03-28 09:45:00
122,2,2,0,0.009405916674000155,2019-03-28 09:30:00,2019-03-28 09:45:00
129,3,1,2,0.0060612261335431135,2019-03-28 09:30:00,2019-03-28 09:45:00
133,1,1,0,0.0060612261335431135,2019-03-28 09:30:00,2019-03-28 09:45:00
137,3,2,1,0.00967692747013581,2019-03-28 09:30:00,2019-03-28 09:45:00
138,3,2,1,0.008773002135987636,2019-03-28 09:30:00,2019-03-28 09:45:00
140,1,0,1,0.004253375465246765,2019-03-28 09:30:00,2019-03-28 09:45:00
141,1,1,0,0.007869076801839462,2019-03-28 09:30:00,2019-03-28 09:45:00
147,1,0,1,0.004253375465246765,2019-03-28 09:30:00,2019-03-28 09:45:00
154,1,0,1,0.004253375465246765,2019-03-28 09:30:00,2019-03-28 09:45:00
156,1,1,0,0.005157300799394939,2019-03-28 09:30:00,2019-03-28 09:45:00
157,2,0,2,0.004253375465246765,2019-03-28 09:30:00,2019-03-28 09:45:00
162,2,1,1,0.007869076801839462,2019-03-28 09:30:00,2019-03-28 09:45:00
164,1,0,1,0.004253375465246765,2019-03-28 09:30:00,2019-03-28 09:45:00
191,1,1,0,0.0060612261335431135,2019-03-28 09:30:00,2019-03-28 09:45:00
195,2,2,0,0.011846681880309023,2019-03-28 09:30:00,2019-03-28 09:45:00
1,1,0,1,0.003915500452371771,2019-03-28 09:45:00,2019-03-28 10:00:00
2,2,1,1,0.025932280420774237,2019-03-28 09:45:00,2019-03-28 10:00:00
16,1,0,1,0.003915500452371771,2019-03-28 09:45:00,2019-03-28 10:00:00
21,1,1,0,0.00879858136541782,2019-03-28 09:45:00,2019-03-28 10:00:00
22,1,1,0,0.005579745174153226,2019-03-28 09:45:00,2019-03-28 10:00:00
23,5,4,1,0.01501046526424814,2019-03-28 09:45:00,2019-03-28 10:00:00
30,1,0,1,0.003915500452371771,2019-03-28 09:45:00,2019-03-28 10:00:00
40,2,2,0,0.009768253342203593,2019-03-28 09:45:00,2019-03-28 10:00:00
41,2,1,1,0.01007352382609723,2019-03-28 09:45:00,2019-03-28 10:00:00
46,2,1,1,0.007243989895934682,2019-03-28 09:45:00,2019-03-28 10:00:00
57,1,0,1,0.003915500452371771,2019-03-28 09:45:00,2019-03-28 10:00:00
58,1,0,1,0.003915500452371771,2019-03-28 09:45:00,2019-03-28 10:00:00
62,1,0,1,0.003915500452371771,2019-03-28 09:45:00,2019-03-28 10:00:00
66,2,2,0,0.010323001582797411,2019-03-28 09:45:00,2019-03-28 10:00:00
68,2,0,2,0.003915500452371771,2019-03-28 09:45:00,2019-03-28 10:00:00
69,1,0,1,0.003915500452371771,2019-03-28 09:45:00,2019-03-28 10:00:00
74,3,1,2,0.011488290791178505,2019-03-28 09:45:00,2019-03-28 10:00:00
85,1,0,1,0.003915500452371771,2019-03-28 09:45:00,2019-03-28 10:00:00
109,3,2,1,0.047949060389176706,2019-03-28 09:45:00,2019-03-28 10:00:00
110,2,0,2,0.003915500452371771,2019-03-28 09:45:00,2019-03-28 10:00:00
111,2,1,1,0.005579745174153226,2019-03-28 09:45:00,2019-03-28 10:00:00
112,3,0,3,0.003915500452371771,2019-03-28 09:45:00,2019-03-28 10:00:00
114,2,1,1,0.01007352382609723,2019-03-28 09:45:00,2019-03-28 10:00:00
118,1,1,0,0.012478949461008327,2019-03-28 09:45:00,2019-03-28 10:00:00
119,4,4,0,0.011183020307284866,2019-03-28 09:45:00,2019-03-28 10:00:00
122,2,2,0,0.01007352382609723,2019-03-28 09:45:00,2019-03-28 10:00:00
129,3,1,2,0.007243989895934682,2019-03-28 09:45:00,2019-03-28 10:00:00
133,1,1,0,0.005579745174153226,2019-03-28 09:45:00,2019-03-28 10:00:00
137,5,2,3,0.008908234617716136,2019-03-28 09:45:00,2019-03-28 10:00:00
138,1,0,1,0.003915500452371771,2019-03-28 09:45:00,2019-03-28 10:00:00
140,1,0,1,0.003915500452371771,2019-03-28 09:45:00,2019-03-28 10:00:00
153,1,1,0,0.007243989895934682,2019-03-28 09:45:00,2019-03-28 10:00:00
154,1,1,0,0.01667576966314318,2019-03-28 09:45:00,2019-03-28 10:00:00
157,2,0,2,0.003915500452371771,2019-03-28 09:45:00,2019-03-28 10:00:00
158,1,0,1,0.003915500452371771,2019-03-28 09:45:00,2019-03-28 10:00:00
162,1,0,1,0.003915500452371771,2019-03-28 09:45:00,2019-03-28 10:00:00
164,2,1,1,0.007243989895934682,2019-03-28 09:45:00,2019-03-28 10:00:00
168,1,1,0,0.007243989895934682,2019-03-28 09:45:00,2019-03-28 10:00:00
173,1,0,1,0.003915500452371771,2019-03-28 09:45:00,2019-03-28 10:00:00
177,1,1,0,0.007243989895934682,2019-03-28 09:45:00,2019-03-28 10:00:00
189,1,1,0,0.00879858136541782,2019-03-28 09:45:00,2019-03-28 10:00:00
191,1,1,0,0.012478949461008327,2019-03-28 09:45:00,2019-03-28 10:00:00
195,3,2,1,0.008908234617716136,2019-03-28 09:45:00,2019-03-28 10:00:00
1,3,1,2,0.007697321490613466,2019-03-28 10:00:00,2019-03-28 10:15:00
5,1,1,0,0.014553661594565295,2019-03-28 10:00:00,2019-03-28 10:15:00
16,1,0,1,0.004160547969168407,2019-03-28 10:00:00,2019-03-28 10:15:00
19,2,1,1,0.027236441431342462,2019-03-28 10:00:00,2019-03-28 10:15:00
21,1,1,0,0.00743221798109002,2019-03-28 10:00:00,2019-03-28 10:15:00
23,3,2,1,0.006813128110252201,2019-03-28 10:00:00,2019-03-28 10:15:00
30,1,0,1,0.004160547969168407,2019-03-28 10:00:00,2019-03-28 10:15:00
37,1,1,0,0.005928934729890936,2019-03-28 10:00:00,2019-03-28 10:15:00
40,2,2,0,0.009803322381998086,2019-03-28 10:00:00,2019-03-28 10:15:00
46,4,3,1,0.016218760618037592,2019-03-28 10:00:00,2019-03-28 10:15:00
57,2,0,2,0.004160547969168407,2019-03-28 10:00:00,2019-03-28 10:15:00
61,1,1,0,0.017948097081970378,2019-03-28 10:00:00,2019-03-28 10:15:00
62,1,0,1,0.004160547969168407,2019-03-28 10:00:00,2019-03-28 10:15:00
66,1,1,0,0.010703887993011633,2019-03-28 10:00:00,2019-03-28 10:15:00
74,3,1,2,0.007697321490613466,2019-03-28 10:00:00,2019-03-28 10:15:00
86,1,1,0,0.007697321490613466,2019-03-28 10:00:00,2019-03-28 10:15:00
104,1,0,1,0.004160547969168407,2019-03-28 10:00:00,2019-03-28 10:15:00
109,3,1,2,0.0072362730125662715,2019-03-28 10:00:00,2019-03-28 10:15:00
110,2,1,1,0.0062665488605530275,2019-03-28 10:00:00,2019-03-28 10:15:00
111,2,1,1,0.007697321490613466,2019-03-28 10:00:00,2019-03-28 10:15:00
112,2,0,2,0.004160547969168407,2019-03-28 10:00:00,2019-03-28 10:15:00
115,1,0,1,0.004160547969168407,2019-03-28 10:00:00,2019-03-28 10:15:00
119,7,4,3,0.015503931983147206,2019-03-28 10:00:00,2019-03-28 10:15:00
137,4,1,3,0.00743221798109002,2019-03-28 10:00:00,2019-03-28 10:15:00
138,4,0,4,0.004160547969168407,2019-03-28 10:00:00,2019-03-28 10:15:00
153,1,1,0,0.007697321490613466,2019-03-28 10:00:00,2019-03-28 10:15:00
154,1,1,0,0.009952246367412092,2019-03-28 10:00:00,2019-03-28 10:15:00
158,2,1,1,0.009487628888715956,2019-03-28 10:00:00,2019-03-28 10:15:00
159,1,0,1,0.004160547969168407,2019-03-28 10:00:00,2019-03-28 10:15:00
164,1,1,0,0.005928934729890936,2019-03-28 10:00:00,2019-03-28 10:15:00
169,3,3,0,0.006813128110252201,2019-03-28 10:00:00,2019-03-28 10:15:00
177,1,1,0,0.007697321490613466,2019-03-28 10:00:00,2019-03-28 10:15:00
189,1,1,0,0.00743221798109002,2019-03-28 10:00:00,2019-03-28 10:15:00
191,2,1,1,0.012225856769127928,2019-03-28 10:00:00,2019-03-28 10:15:00
195,1,0,1,0.004160547969168407,2019-03-28 10:00:00,2019-03-28 10:15:00
1,2,0,2,0.0036756269020174555,2019-03-28 10:15:00,2019-03-28 10:30:00
2,1,1,0,0.007315291683841048,2019-03-28 10:15:00,2019-03-28 10:30:00
5,1,1,0,0.008174984989844513,2019-03-28 10:15:00,2019-03-28 10:30:00
18,2,2,0,0.00931386992433537,2019-03-28 10:15:00,2019-03-28 10:30:00
19,4,3,1,0.08353607116470436,2019-03-28 10:15:00,2019-03-28 10:30:00
20,1,1,0,0.006189287699001672,2019-03-28 10:15:00,2019-03-28 10:30:00
23,1,1,0,0.004456772458350879,2019-03-28 10:15:00,2019-03-28 10:30:00
35,1,0,1,0.0036756269020174555,2019-03-28 10:15:00,2019-03-28 10:30:00
41,1,0,1,0.0036756269020174555,2019-03-28 10:15:00,2019-03-28 10:30:00
46,5,4,1,0.015641829803665186,2019-03-28 10:15:00,2019-03-28 10:30:00
57,1,1,0,0.011714495974377487,2019-03-28 10:15:00,2019-03-28 10:30:00
58,1,1,0,0.0052379180146843035,2019-03-28 10:15:00,2019-03-28 10:30:00
61,1,1,0,0.01697296663817336,2019-03-28 10:15:00,2019-03-28 10:30:00
70,1,0,1,0.0036756269020174555,2019-03-28 10:15:00,2019-03-28 10:30:00
74,1,0,1,0.0036756269020174555,2019-03-28 10:15:00,2019-03-28 10:30:00
85,1,1,0,0.010784511392024536,2019-03-28 10:15:00,2019-03-28 10:30:00
86,3,2,1,0.04516814014602776,2019-03-28 10:15:00,2019-03-28 10:30:00
87,2,1,1,0.006800209127351152,2019-03-28 10:15:00,2019-03-28 10:30:00
88,1,0,1,0.0036756269020174555,2019-03-28 10:15:00,2019-03-28 10:30:00
90,1,1,0,0.006800209127351152,2019-03-28 10:15:00,2019-03-28 10:30:00
104,7,3,4,0.011827530721319587,2019-03-28 10:15:00,2019-03-28 10:30:00
109,4,2,2,0.014218885364370947,2019-03-28 10:15:00,2019-03-28 10:30:00
111,2,1,1,0.0052379180146843035,2019-03-28 10:15:00,2019-03-28 10:30:00
114,1,0,1,0.0036756269020174555,2019-03-28 10:15:00,2019-03-28 10:30:00
115,2,0,2,0.0036756269020174555,2019-03-28 10:15:00,2019-03-28 10:30:00
119,5,2,3,0.012844109501877584,2019-03-28 10:15:00,2019-03-28 10:30:00
137,3,2,1,0.008362500240018,2019-03-28 10:15:00,2019-03-28 10:30:00
138,4,0,4,0.0036756269020174555,2019-03-28 10:15:00,2019-03-28 10:30:00
140,1,0,1,0.0036756269020174555,2019-03-28 10:15:00,2019-03-28 10:30:00
151,1,0,1,0.0036756269020174555,2019-03-28 10:15:00,2019-03-28 10:30:00
153,2,1,1,0.006800209127351152,2019-03-28 10:15:00,2019-03-28 10:30:00
154,1,0,1,0.0036756269020174555,2019-03-28 10:15:00,2019-03-28 10:30:00
158,2,1,1,0.00812830988224228,2019-03-28 10:15:00,2019-03-28 10:30:00
159,1,0,1,0.0036756269020174555,2019-03-28 10:15:00,2019-03-28 10:30:00
168,2,1,1,0.009456410637133409,2019-03-28 10:15:00,2019-03-28 10:30:00
169,3,3,0,0.006019063571017728,2019-03-28 10:15:00,2019-03-28 10:30:00
171,1,0,1,0.0036756269020174555,2019-03-28 10:15:00,2019-03-28 10:30:00
189,1,1,0,0.006800209127351152,2019-03-28 10:15:00,2019-03-28 10:30:00
191,3,1,2,0.010585453305755447,2019-03-28 10:15:00,2019-03-28 10:30:00
2,1,1,0,0.014639606178950071,2019-03-28 10:30:00,2019-03-28 10:45:00
18,2,2,0,0.009871841328026156,2019-03-28 10:30:00,2019-03-28 10:45:00
19,2,1,1,0.024888478825023395,2019-03-28 10:30:00,2019-03-28 10:45:00
20,1,1,0,0.006688814038061729,2019-03-28 10:30:00,2019-03-28 10:45:00
23,1,1,0,0.006041834710377483,2019-03-28 10:30:00,2019-03-28 10:45:00
35,1,0,1,0.003744339052142673,2019-03-28 10:30:00,2019-03-28 10:45:00
40,2,1,1,0.006439689829911977,2019-03-28 10:30:00,2019-03-28 10:45:00
41,2,0,2,0.003744339052142673,2019-03-28 10:30:00,2019-03-28 10:45:00
46,1,0,1,0.003744339052142673,2019-03-28 10:30:00,2019-03-28 10:45:00
57,2,1,1,0.0069273663421071,2019-03-28 10:30:00,2019-03-28 10:45:00
67,1,1,0,0.006439689829911977,2019-03-28 10:30:00,2019-03-28 10:45:00
70,1,0,1,0.003744339052142673,2019-03-28 10:30:00,2019-03-28 10:45:00
74,1,0,1,0.003744339052142673,2019-03-28 10:30:00,2019-03-28 10:45:00
86,3,2,1,0.046032618597904126,2019-03-28 10:30:00,2019-03-28 10:45:00
87,2,0,2,0.003744339052142673,2019-03-28 10:30:00,2019-03-28 10:45:00
88,1,1,0,0.005335852697124887,2019-03-28 10:30:00,2019-03-28 10:45:00
89,1,0,1,0.003744339052142673,2019-03-28 10:30:00,2019-03-28 10:45:00
104,3,1,2,0.0069273663421071,2019-03-28 10:30:00,2019-03-28 10:45:00
109,6,3,3,0.00951176382435499,2019-03-28 10:30:00,2019-03-28 10:45:00
111,2,0,2,0.003744339052142673,2019-03-28 10:30:00,2019-03-28 10:45:00
113,1,1,0,0.009633289023980784,2019-03-28 10:30:00,2019-03-28 10:45:00
114,1,0,1,0.003744339052142673,2019-03-28 10:30:00,2019-03-28 10:45:00
119,3,2,1,0.012816316313945211,2019-03-28 10:30:00,2019-03-28 10:45:00
126,1,1,0,0.005335852697124887,2019-03-28 10:30:00,2019-03-28 10:45:00
137,2,1,1,0.0069273663421071,2019-03-28 10:30:00,2019-03-28 10:45:00
138,6,2,4,0.010810289931077983,2019-03-28 10:30:00,2019-03-28 10:45:00
140,1,0,1,0.003744339052142673,2019-03-28 10:30:00,2019-03-28 10:45:00
151,1,0,1,0.003744339052142673,2019-03-28 10:30:00,2019-03-28 10:45:00
153,1,1,0,0.0069273663421071,2019-03-28 10:30:00,2019-03-28 10:45:00
154,1,0,1,0.003744339052142673,2019-03-28 10:30:00,2019-03-28 10:45:00
158,1,1,0,0.005335852697124887,2019-03-28 10:30:00,2019-03-28 10:45:00
159,1,0,1,0.003744339052142673,2019-03-28 10:30:00,2019-03-28 10:45:00
168,1,1,0,0.005335852697124887,2019-03-28 10:30:00,2019-03-28 10:45:00
169,3,3,0,0.010636826026847103,2019-03-28 10:30:00,2019-03-28 10:45:00
189,5,4,1,0.08832089814366559,2019-03-28 10:30:00,2019-03-28 10:45:00
191,4,1,3,0.0052248994016034726,2019-03-28 10:30:00,2019-03-28 10:45:00
199,1,1,0,0.0052248994016034726,2019-03-28 10:30:00,2019-03-28 10:45:00
1,2,0,2,0.003814903947727604,2019-03-28 10:45:00,2019-03-28 11:00:00
2,1,1,0,0.007609247498145535,2019-03-28 10:45:00,2019-03-28 11:00:00
10,5,2,3,0.008805071125369275,2019-03-28 10:45:00,2019-03-28 11:00:00
16,1,1,0,0.004463499072069674,2019-03-28 10:45:00,2019-03-28 11:00:00
19,3,2,1,0.03670818783246758,2019-03-28 10:45:00,2019-03-28 11:00:00
23,1,1,0,0.007839972893650859,2019-03-28 10:45:00,2019-03-28 11:00:00
26,3,2,1,0.007057879569437956,2019-03-28 10:45:00,2019-03-28 11:00:00
37,2,0,2,0.003814903947727604,2019-03-28 10:45:00,2019-03-28 11:00:00
40,2,1,1,0.0052820632091851874,2019-03-28 10:45:00,2019-03-28 11:00:00
41,3,2,1,0.007931475347403615,2019-03-28 10:45:00,2019-03-28 11:00:00
46,4,3,1,0.016005117350159928,2019-03-28 10:45:00,2019-03-28 11:00:00
57,3,2,1,0.019731547062011186,2019-03-28 10:45:00,2019-03-28 11:00:00
58,1,1,0,0.005556159606970801,2019-03-28 10:45:00,2019-03-28 11:00:00
62,1,1,0,0.007057879569437956,2019-03-28 10:45:00,2019-03-28 11:00:00
66,2,1,1,0.007057879569437956,2019-03-28 10:45:00,2019-03-28 11:00:00
67,1,1,0,0.0052820632091851874,2019-03-28 10:45:00,2019-03-28 11:00:00
85,3,1,2,0.00543639175858278,2019-03-28 10:45:00,2019-03-28 11:00:00
86,3,1,2,0.00663515538581278,2019-03-28 10:45:00,2019-03-28 11:00:00
87,5,1,4,0.008193231402120672,2019-03-28 10:45:00,2019-03-28 11:00:00
88,4,3,1,0.010463314337317918,2019-03-28 10:45:00,2019-03-28 11:00:00
89,1,0,1,0.003814903947727604,2019-03-28 10:45:00,2019-03-28 11:00:00
109,6,2,4,0.006903551020040363,2019-03-28 10:45:00,2019-03-28 11:00:00
110,2,1,1,0.025229432965429652,2019-03-28 10:45:00,2019-03-28 11:00:00
111,2,0,2,0.003814903947727604,2019-03-28 10:45:00,2019-03-28 11:00:00
112,1,1,0,0.009814719212975848,2019-03-28 10:45:00,2019-03-28 11:00:00
113,1,1,0,0.02058887152189925,2019-03-28 10:45:00,2019-03-28 11:00:00
114,1,0,1,0.003814903947727604,2019-03-28 10:45:00,2019-03-28 11:00:00
115,1,1,0,0.012709714335176913,2019-03-28 10:45:00,2019-03-28 11:00:00
119,2,1,1,0.004463499072069674,2019-03-28 10:45:00,2019-03-28 11:00:00
120,2,2,0,0.007706474693780026,2019-03-28 10:45:00,2019-03-28 11:00:00
137,5,0,5,0.003814903947727604,2019-03-28 10:45:00,2019-03-28 11:00:00
138,8,4,4,0.018939224933696788,2019-03-28 10:45:00,2019-03-28 11:00:00
140,1,0,1,0.003814903947727604,2019-03-28 10:45:00,2019-03-28 11:00:00
141,1,1,0,0.005556159606970801,2019-03-28 10:45:00,2019-03-28 11:00:00
158,2,1,1,0.005556159606970801,2019-03-28 10:45:00,2019-03-28 11:00:00
168,1,1,0,0.006125601669467253,2019-03-28 10:45:00,2019-03-28 11:00:00
169,3,3,0,0.015890110785497367,2019-03-28 10:45:00,2019-03-28 11:00:00
170,1,0,1,0.003814903947727604,2019-03-28 10:45:00,2019-03-28 11:00:00
171,1,1,0,0.00543639175858278,2019-03-28 10:45:00,2019-03-28 11:00:00
172,1,0,1,0.003814903947727604,2019-03-28 10:45:00,2019-03-28 11:00:00
189,4,2,2,0.010300855191148308,2019-03-28 10:45:00,2019-03-28 11:00:00
190,1,0,1,0.003814903947727604,2019-03-28 10:45:00,2019-03-28 11:00:00
191,2,0,2,0.003814903947727604,2019-03-28 10:45:00,2019-03-28 11:00:00
195,1,1,0,0.00663515538581278,2019-03-28 10:45:00,2019-03-28 11:00:00
196,1,1,0,0.007057879569437956,2019-03-28 10:45:00,2019-03-28 11:00:00
199,1,1,0,0.00543639175858278,2019-03-28 10:45:00,2019-03-28 11:00:00
203,1,0,1,0.003814903947727604,2019-03-28 10:45:00,2019-03-28 11:00:00
2,1,1,0,0.004485101667140139,2019-03-28 11:00:00,2019-03-28 11:15:00
5,1,1,0,0.006436360719893687,2019-03-28 11:00:00,2019-03-28 11:15:00
16,2,2,0,0.010013717871223727,2019-03-28 11:00:00,2019-03-28 11:15:00
18,3,3,0,0.008469254961691342,2019-03-28 11:00:00,2019-03-28 11:15:00
19,5,4,1,0.06896600154740044,2019-03-28 11:00:00,2019-03-28 11:15:00
23,2,2,0,0.013911287361174359,2019-03-28 11:00:00,2019-03-28 11:15:00
26,2,1,1,0.011884116913051588,2019-03-28 11:00:00,2019-03-28 11:15:00
28,2,0,2,0.0037225637793639288,2019-03-28 11:00:00,2019-03-28 11:15:00
37,5,1,4,0.004727184777616963,2019-03-28 11:00:00,2019-03-28 11:15:00
41,4,1,3,0.0095771011729453,2019-03-28 11:00:00,2019-03-28 11:15:00
46,1,1,0,0.0095771011729453,2019-03-28 11:00:00,2019-03-28 11:15:00
57,2,1,1,0.0078104013988070115,2019-03-28 11:00:00,2019-03-28 11:15:00
58,2,1,1,0.004777384042103354,2019-03-28 11:00:00,2019-03-28 11:15:00
62,3,2,1,0.009600821508111961,2019-03-28 11:00:00,2019-03-28 11:15:00
66,2,1,1,0.006887024567582204,2019-03-28 11:00:00,2019-03-28 11:15:00
67,1,1,0,0.01046358639772698,2019-03-28 11:00:00,2019-03-28 11:15:00
85,4,2,2,0.009617375008874407,2019-03-28 11:00:00,2019-03-28 11:15:00
86,1,0,1,0.0037225637793639288,2019-03-28 11:00:00,2019-03-28 11:15:00
87,3,0,3,0.0037225637793639288,2019-03-28 11:00:00,2019-03-28 11:15:00
88,2,0,2,0.0037225637793639288,2019-03-28 11:00:00,2019-03-28 11:15:00
109,3,1,2,0.015858998307540343,2019-03-28 11:00:00,2019-03-28 11:15:00
110,3,1,2,0.006474519573483851,2019-03-28 11:00:00,2019-03-28 11:15:00
111,6,3,3,0.010401518249478338,2019-03-28 11:00:00,2019-03-28 11:15:00
112,3,3,0,0.02339660169309921,2019-03-28 11:00:00,2019-03-28 11:15:00
114,1,0,1,0.0037225637793639288,2019-03-28 11:00:00,2019-03-28 11:15:00
116,1,1,0,0.006436360719893687,2019-03-28 11:00:00,2019-03-28 11:15:00
119,6,1,5,0.004485101667140139,2019-03-28 11:00:00,2019-03-28 11:15:00
120,4,4,0,0.012215029077650439,2019-03-28 11:00:00,2019-03-28 11:15:00
127,1,0,1,0.0037225637793639288,2019-03-28 11:00:00,2019-03-28 11:15:00
133,1,0,1,0.0037225637793639288,2019-03-28 11:00:00,2019-03-28 11:15:00
137,5,1,4,0.006474519573483851,2019-03-28 11:00:00,2019-03-28 11:15:00
138,3,2,1,0.008263002464642165,2019-03-28 11:00:00,2019-03-28 11:15:00
140,1,0,1,0.0037225637793639288,2019-03-28 11:00:00,2019-03-28 11:15:00
141,3,2,1,0.005782005040356388,2019-03-28 11:00:00,2019-03-28 11:15:00
153,2,1,1,0.004485101667140139,2019-03-28 11:00:00,2019-03-28 11:15:00
154,1,1,0,0.006887024567582204,2019-03-28 11:00:00,2019-03-28 11:15:00
158,2,1,1,0.010362145199615083,2019-03-28 11:00:00,2019-03-28 11:15:00
168,1,1,0,0.0078104013988070115,2019-03-28 11:00:00,2019-03-28 11:15:00
170,1,0,1,0.0037225637793639288,2019-03-28 11:00:00,2019-03-28 11:15:00
171,1,1,0,0.004727184777616963,2019-03-28 11:00:00,2019-03-28 11:15:00
189,3,1,2,0.006474519573483851,2019-03-28 11:00:00,2019-03-28 11:15:00
190,1,0,1,0.0037225637793639288,2019-03-28 11:00:00,2019-03-28 11:15:00
191,2,1,1,0.006887024567582204,2019-03-28 11:00:00,2019-03-28 11:15:00
195,1,1,0,0.006887024567582204,2019-03-28 11:00:00,2019-03-28 11:15:00
196,3,2,1,0.014276275836608034,2019-03-28 11:00:00,2019-03-28 11:15:00
197,1,0,1,0.0037225637793639288,2019-03-28 11:00:00,2019-03-28 11:15:00
201,1,1,0,0.00509854167642389,2019-03-28 11:00:00,2019-03-28 11:15:00
203,1,0,1,0.0037225637793639288,2019-03-28 11:00:00,2019-03-28 11:15:00
5,1,1,0,0.004568519405919442,2019-03-28 11:15:00,2019-03-28 11:30:00
18,4,4,0,0.01291722314978791,2019-03-28 11:15:00,2019-03-28 11:30:00
19,2,2,0,0.009891086603655761,2019-03-28 11:15:00,2019-03-28 11:30:00
20,1,0,1,0.0035598072238753925,2019-03-28 11:15:00,2019-03-28 11:30:00
23,2,2,0,0.014573557879725214,2019-03-28 11:15:00,2019-03-28 11:30:00
26,2,1,1,0.007443452033055696,2019-03-28 11:15:00,2019-03-28 11:30:00
28,2,0,2,0.0035598072238753925,2019-03-28 11:15:00,2019-03-28 11:30:00
37,2,0,2,0.0035598072238753925,2019-03-28 11:15:00,2019-03-28 11:30:00
41,3,0,3,0.0035598072238753925,2019-03-28 11:15:00,2019-03-28 11:30:00
46,1,1,0,0.007229074967293657,2019-03-28 11:15:00,2019-03-28 11:30:00
57,5,3,2,0.02060977694716233,2019-03-28 11:15:00,2019-03-28 11:30:00
58,1,0,1,0.0035598072238753925,2019-03-28 11:15:00,2019-03-28 11:30:00
62,2,1,1,0.004568519405919442,2019-03-28 11:15:00,2019-03-28 11:30:00
66,2,1,1,0.00431634136040843,2019-03-28 11:15:00,2019-03-28 11:30:00
85,1,0,1,0.0035598072238753925,2019-03-28 11:15:00,2019-03-28 11:30:00
88,4,1,3,0.011663404633824707,2019-03-28 11:15:00,2019-03-28 11:30:00
109,4,2,2,0.011454904782230548,2019-03-28 11:15:00,2019-03-28 11:30:00
110,4,3,1,0.09750028906954267,2019-03-28 11:15:00,2019-03-28 11:30:00
111,6,3,3,0.010698370645697512,2019-03-28 11:15:00,2019-03-28 11:30:00
112,2,2,0,0.012913592887011164,2019-03-28 11:15:00,2019-03-28 11:30:00
116,1,1,0,0.004568519405919442,2019-03-28 11:15:00,2019-03-28 11:30:00
119,4,0,4,0.0035598072238753925,2019-03-28 11:15:00,2019-03-28 11:30:00
120,4,3,1,0.011130608985460248,2019-03-28 11:15:00,2019-03-28 11:30:00
127,1,0,1,0.0035598072238753925,2019-03-28 11:15:00,2019-03-28 11:30:00
129,2,1,1,0.023659729633222007,2019-03-28 11:15:00,2019-03-28 11:30:00
137,8,5,3,0.028596693564375254,2019-03-28 11:15:00,2019-03-28 11:30:00
138,1,0,1,0.0035598072238753925,2019-03-28 11:15:00,2019-03-28 11:30:00
140,2,1,1,0.009395840864784765,2019-03-28 11:15:00,2019-03-28 11:30:00
141,1,0,1,0.0035598072238753925,2019-03-28 11:15:00,2019-03-28 11:30:00
147,1,0,1,0.0035598072238753925,2019-03-28 11:15:00,2019-03-28 11:30:00
153,2,1,1,0.00431634136040843,2019-03-28 11:15:00,2019-03-28 11:30:00
154,1,1,0,0.006585943770007542,2019-03-28 11:15:00,2019-03-28 11:30:00
157,1,0,1,0.0035598072238753925,2019-03-28 11:15:00,2019-03-28 11:30:00
158,1,0,1,0.0035598072238753925,2019-03-28 11:15:00,2019-03-28 11:30:00
168,2,1,1,0.0068649500575236125,2019-03-28 11:15:00,2019-03-28 11:30:00
169,1,1,0,0.005072875496941467,2019-03-28 11:15:00,2019-03-28 11:30:00
171,2,2,0,0.008099012043073617,2019-03-28 11:15:00,2019-03-28 11:30:00
189,2,0,2,0.0035598072238753925,2019-03-28 11:15:00,2019-03-28 11:30:00
191,2,1,1,0.006191506409993778,2019-03-28 11:15:00,2019-03-28 11:30:00
196,1,1,0,0.007229074967293657,2019-03-28 11:15:00,2019-03-28 11:30:00
197,3,1,2,0.006191506409993778,2019-03-28 11:15:00,2019-03-28 11:30:00
201,1,1,0,0.011663404633824707,2019-03-28 11:15:00,2019-03-28 11:30:00
203,1,0,1,0.0035598072238753925,2019-03-28 11:15:00,2019-03-28 11:30:00
2,1,1,0,0.007438156583270874,2019-03-28 11:30:00,2019-03-28 11:45:00
16,2,1,1,0.008141390204698477,2019-03-28 11:30:00,2019-03-28 11:45:00
18,2,1,1,0.00731317914050115,2019-03-28 11:30:00,2019-03-28 11:45:00
19,2,2,0,0.008033883813363169,2019-03-28 11:30:00,2019-03-28 11:45:00
20,1,0,1,0.0033911963852894292,2019-03-28 11:30:00,2019-03-28 11:45:00
23,2,2,0,0.00951078138690508,2019-03-28 11:30:00,2019-03-28 11:45:00
26,1,0,1,0.0033911963852894292,2019-03-28 11:30:00,2019-03-28 11:45:00
30,3,1,2,0.005898279501305265,2019-03-28 11:30:00,2019-03-28 11:45:00
35,1,0,1,0.0033911963852894292,2019-03-28 11:30:00,2019-03-28 11:45:00
50,1,0,1,0.0033911963852894292,2019-03-28 11:30:00,2019-03-28 11:45:00
57,3,2,1,0.009156833768185579,2019-03-28 11:30:00,2019-03-28 11:45:00
58,2,1,1,0.005898279501305265,2019-03-28 11:30:00,2019-03-28 11:45:00
62,1,1,0,0.006274015076737504,2019-03-28 11:30:00,2019-03-28 11:45:00
66,2,0,2,0.0033911963852894292,2019-03-28 11:30:00,2019-03-28 11:45:00
67,1,1,0,0.006057960586185201,2019-03-28 11:30:00,2019-03-28 11:45:00
88,4,1,3,0.01383965970395413,2019-03-28 11:30:00,2019-03-28 11:45:00
90,2,1,1,0.004760587567496033,2019-03-28 11:30:00,2019-03-28 11:45:00
109,4,1,3,0.004832605731013467,2019-03-28 11:30:00,2019-03-28 11:45:00
110,8,5,3,0.11879071025816101,2019-03-28 11:30:00,2019-03-28 11:45:00
111,2,1,1,0.004760587567496033,2019-03-28 11:30:00,2019-03-28 11:45:00
112,2,0,2,0.0033911963852894292,2019-03-28 11:30:00,2019-03-28 11:45:00
113,1,0,1,0.0033911963852894292,2019-03-28 11:30:00,2019-03-28 11:45:00
114,4,0,4,0.0033911963852894292,2019-03-28 11:30:00,2019-03-28 11:45:00
116,1,0,1,0.0033911963852894292,2019-03-28 11:30:00,2019-03-28 11:45:00
119,2,0,2,0.0033911963852894292,2019-03-28 11:30:00,2019-03-28 11:45:00
126,3,2,1,0.009156833768185579,2019-03-28 11:30:00,2019-03-28 11:45:00
127,1,1,0,0.0084053626173211,2019-03-28 11:30:00,2019-03-28 11:45:00
129,2,1,1,0.022557619141992905,2019-03-28 11:30:00,2019-03-28 11:45:00
137,12,9,3,0.03687035927458192,2019-03-28 11:30:00,2019-03-28 11:45:00
138,3,1,2,0.011175434497424443,2019-03-28 11:30:00,2019-03-28 11:45:00
141,4,2,2,0.015281069049678167,2019-03-28 11:30:00,2019-03-28 11:45:00
147,1,0,1,0.0033911963852894292,2019-03-28 11:30:00,2019-03-28 11:45:00
154,2,2,0,0.006274015076737504,2019-03-28 11:30:00,2019-03-28 11:45:00
156,1,1,0,0.006274015076737504,2019-03-28 11:30:00,2019-03-28 11:45:00
158,2,2,0,0.007715424422461542,2019-03-28 11:30:00,2019-03-28 11:45:00
168,2,1,1,0.00731317914050115,2019-03-28 11:30:00,2019-03-28 11:45:00
170,1,1,0,0.010312339327352468,2019-03-28 11:30:00,2019-03-28 11:45:00
171,3,1,2,0.006274015076737504,2019-03-28 11:30:00,2019-03-28 11:45:00
189,1,0,1,0.0033911963852894292,2019-03-28 11:30:00,2019-03-28 11:45:00
191,1,0,1,0.0033911963852894292,2019-03-28 11:30:00,2019-03-28 11:45:00
195,1,1,0,0.006057960586185201,2019-03-28 11:30:00,2019-03-28 11:45:00
196,1,1,0,0.009608475985881836,2019-03-28 11:30:00,2019-03-28 11:45:00
197,2,1,1,0.022557619141992905,2019-03-28 11:30:00,2019-03-28 11:45:00
5,1,1,0,0.02035551299909749,2019-03-28 11:45:00,2019-03-28 12:00:00
15,1,1,0,0.005828548895604985,2019-03-28 11:45:00,2019-03-28 12:00:00
16,2,1,1,0.010885086704192855,2019-03-28 11:45:00,2019-03-28 12:00:00
18,1,0,1,0.003823911431220051,2019-03-28 11:45:00,2019-03-28 12:00:00
20,1,1,0,0.007074520195790947,2019-03-28 11:45:00,2019-03-28 12:00:00
23,5,3,2,0.0161649998802343,2019-03-28 11:45:00,2019-03-28 12:00:00
26,1,0,1,0.003823911431220051,2019-03-28 11:45:00,2019-03-28 12:00:00
28,1,1,0,0.007074520195790947,2019-03-28 11:45:00,2019-03-28 12:00:00
30,1,0,1,0.003823911431220051,2019-03-28 11:45:00,2019-03-28 12:00:00
35,1,0,1,0.003823911431220051,2019-03-28 11:45:00,2019-03-28 12:00:00
37,1,0,1,0.003823911431220051,2019-03-28 11:45:00,2019-03-28 12:00:00
46,1,0,1,0.003823911431220051,2019-03-28 11:45:00,2019-03-28 12:00:00
50,4,1,3,0.005335889288590558,2019-03-28 11:45:00,2019-03-28 12:00:00
58,3,2,1,0.009575435008571238,2019-03-28 11:45:00,2019-03-28 12:00:00
61,1,0,1,0.003823911431220051,2019-03-28 11:45:00,2019-03-28 12:00:00
62,1,1,0,0.007074520195790947,2019-03-28 11:45:00,2019-03-28 12:00:00
66,1,1,0,0.007074520195790947,2019-03-28 11:45:00,2019-03-28 12:00:00
67,1,1,0,0.005449215813505499,2019-03-28 11:45:00,2019-03-28 12:00:00
79,1,1,0,0.007074520195790947,2019-03-28 11:45:00,2019-03-28 12:00:00
88,2,1,1,0.007074520195790947,2019-03-28 11:45:00,2019-03-28 12:00:00
89,2,2,0,0.007608846268054599,2019-03-28 11:45:00,2019-03-28 12:00:00
90,1,1,0,0.006096868410684093,2019-03-28 11:45:00,2019-03-28 12:00:00
104,1,0,1,0.003823911431220051,2019-03-28 11:45:00,2019-03-28 12:00:00
109,5,1,4,0.010694904717322302,2019-03-28 11:45:00,2019-03-28 12:00:00
111,1,1,0,0.006096868410684093,2019-03-28 11:45:00,2019-03-28 12:00:00
112,1,0,1,0.003823911431220051,2019-03-28 11:45:00,2019-03-28 12:00:00
113,1,0,1,0.003823911431220051,2019-03-28 11:45:00,2019-03-28 12:00:00
114,3,0,3,0.003823911431220051,2019-03-28 11:45:00,2019-03-28 12:00:00
115,1,0,1,0.003823911431220051,2019-03-28 11:45:00,2019-03-28 12:00:00
116,2,0,2,0.003823911431220051,2019-03-28 11:45:00,2019-03-28 12:00:00
119,3,1,2,0.007074520195790947,2019-03-28 11:45:00,2019-03-28 12:00:00
126,3,2,1,0.006961193670876005,2019-03-28 11:45:00,2019-03-28 12:00:00
127,1,1,0,0.011963891661259843,2019-03-28 11:45:00,2019-03-28 12:00:00
137,7,6,1,0.01944680392865076,2019-03-28 11:45:00,2019-03-28 12:00:00
138,4,2,2,0.016612490103725775,2019-03-28 11:45:00,2019-03-28 12:00:00
141,4,1,3,0.007074520195790947,2019-03-28 11:45:00,2019-03-28 12:00:00
153,1,1,0,0.009837823824374852,2019-03-28 11:45:00,2019-03-28 12:00:00
154,2,1,1,0.025240044699010346,2019-03-28 11:45:00,2019-03-28 12:00:00
156,1,1,0,0.007074520195790947,2019-03-28 11:45:00,2019-03-28 12:00:00
158,2,2,0,0.010081476392368349,2019-03-28 11:45:00,2019-03-28 12:00:00
159,1,1,0,0.007074520195790947,2019-03-28 11:45:00,2019-03-28 12:00:00
160,1,0,1,0.003823911431220051,2019-03-28 11:45:00,2019-03-28 12:00:00
168,2,1,1,0.009837823824374852,2019-03-28 11:45:00,2019-03-28 12:00:00
170,1,1,0,0.013077392654908558,2019-03-28 11:45:00,2019-03-28 12:00:00
171,2,0,2,0.003823911431220051,2019-03-28 11:45:00,2019-03-28 12:00:00
172,1,1,0,0.005449215813505499,2019-03-28 11:45:00,2019-03-28 12:00:00
189,1,0,1,0.003823911431220051,2019-03-28 11:45:00,2019-03-28 12:00:00
191,5,2,3,0.008825741056780634,2019-03-28 11:45:00,2019-03-28 12:00:00
195,1,1,0,0.005449215813505499,2019-03-28 11:45:00,2019-03-28 12:00:00
196,2,1,1,0.007074520195790947,2019-03-28 11:45:00,2019-03-28 12:00:00
197,2,1,1,0.025240044699010346,2019-03-28 11:45:00,2019-03-28 12:00:00
1,1,1,0,0.007804745273369592,2019-03-28 12:00:00,2019-03-28 12:15:00
2,1,0,1,0.0035292881168207313,2019-03-28 12:00:00,2019-03-28 12:15:00
5,1,1,0,0.004598152405957946,2019-03-28 12:00:00,2019-03-28 12:15:00
15,1,1,0,0.005029391876847658,2019-03-28 12:00:00,2019-03-28 12:15:00
16,2,2,0,0.00722975931218331,2019-03-28 12:00:00,2019-03-28 12:15:00
18,1,1,0,0.006529495636874584,2019-03-28 12:00:00,2019-03-28 12:15:00
20,4,1,3,0.006529495636874584,2019-03-28 12:00:00,2019-03-28 12:15:00
23,4,2,2,0.018541359554991917,2019-03-28 12:00:00,2019-03-28 12:15:00
26,2,1,1,0.005029391876847658,2019-03-28 12:00:00,2019-03-28 12:15:00
27,1,1,0,0.006529495636874584,2019-03-28 12:00:00,2019-03-28 12:15:00
28,1,1,0,0.005029391876847658,2019-03-28 12:00:00,2019-03-28 12:15:00
30,2,0,2,0.0035292881168207313,2019-03-28 12:00:00,2019-03-28 12:15:00
41,1,0,1,0.0035292881168207313,2019-03-28 12:00:00,2019-03-28 12:15:00
46,2,2,0,0.01652452270633401,2019-03-28 12:00:00,2019-03-28 12:15:00
50,1,0,1,0.0035292881168207313,2019-03-28 12:00:00,2019-03-28 12:15:00
57,1,1,0,0.004598152405957946,2019-03-28 12:00:00,2019-03-28 12:15:00
58,2,2,0,0.00802959939690151,2019-03-28 12:00:00,2019-03-28 12:15:00
61,1,0,1,0.0035292881168207313,2019-03-28 12:00:00,2019-03-28 12:15:00
62,1,1,0,0.007379662061204589,2019-03-28 12:00:00,2019-03-28 12:15:00
67,2,2,0,0.006529495636874584,2019-03-28 12:00:00,2019-03-28 12:15:00
68,1,0,1,0.0035292881168207313,2019-03-28 12:00:00,2019-03-28 12:15:00
70,2,0,2,0.0035292881168207313,2019-03-28 12:00:00,2019-03-28 12:15:00
79,1,1,0,0.006529495636874584,2019-03-28 12:00:00,2019-03-28 12:15:00
87,1,0,1,0.0035292881168207313,2019-03-28 12:00:00,2019-03-28 12:15:00
88,6,5,1,0.04550010119390764,2019-03-28 12:00:00,2019-03-28 12:15:00
89,1,1,0,0.006529495636874584,2019-03-28 12:00:00,2019-03-28 12:15:00
104,2,0,2,0.0035292881168207313,2019-03-28 12:00:00,2019-03-28 12:15:00
109,1,0,1,0.0035292881168207313,2019-03-28 12:00:00,2019-03-28 12:15:00
110,2,2,0,0.006138454515809215,2019-03-28 12:00:00,2019-03-28 12:15:00
112,2,1,1,0.007804745273369592,2019-03-28 12:00:00,2019-03-28 12:15:00
113,2,1,1,0.004529357290172015,2019-03-28 12:00:00,2019-03-28 12:15:00
114,1,0,1,0.0035292881168207313,2019-03-28 12:00:00,2019-03-28 12:15:00
115,1,0,1,0.0035292881168207313,2019-03-28 12:00:00,2019-03-28 12:15:00
119,3,2,1,0.011643268429648267,2019-03-28 12:00:00,2019-03-28 12:15:00
122,6,2,4,0.006138454515809215,2019-03-28 12:00:00,2019-03-28 12:15:00
133,1,1,0,0.006529495636874584,2019-03-28 12:00:00,2019-03-28 12:15:00
135,1,1,0,0.006529495636874584,2019-03-28 12:00:00,2019-03-28 12:15:00
137,5,1,4,0.005029391876847658,2019-03-28 12:00:00,2019-03-28 12:15:00
138,5,2,3,0.018045585636664765,2019-03-28 12:00:00,2019-03-28 12:15:00
141,2,0,2,0.0035292881168207313,2019-03-28 12:00:00,2019-03-28 12:15:00
151,1,0,1,0.0035292881168207313,2019-03-28 12:00:00,2019-03-28 12:15:00
153,5,3,2,0.0351253401338624,2019-03-28 12:00:00,2019-03-28 12:15:00
164,2,0,2,0.0035292881168207313,2019-03-28 12:00:00,2019-03-28 12:15:00
168,2,1,1,0.042212920274322864,2019-03-28 12:00:00,2019-03-28 12:15:00
170,2,2,0,0.006529495636874584,2019-03-28 12:00:00,2019-03-28 12:15:00
189,3,0,3,0.0035292881168207313,2019-03-28 12:00:00,2019-03-28 12:15:00
191,5,3,2,0.03575554429636842,2019-03-28 12:00:00,2019-03-28 12:15:00
195,1,0,1,0.0035292881168207313,2019-03-28 12:00:00,2019-03-28 12:15:00
196,2,1,1,0.018450091593837623,2019-03-28 12:00:00,2019-03-28 12:15:00
199,2,1,1,0.005029391876847658,2019-03-28 12:00:00,2019-03-28 12:15:00
202,1,1,0,0.006529495636874584,2019-03-28 12:00:00,2019-03-28 12:15:00
1,1,1,0,0.008788793054008887,2019-03-28 12:15:00,2019-03-28 12:30:00
2,1,0,1,0.00341618648679257,2019-03-28 12:15:00,2019-03-28 12:30:00
5,1,1,0,0.008792419992299249,2019-03-28 12:15:00,2019-03-28 12:30:00
10,4,1,3,0.004766931880767768,2019-03-28 12:15:00,2019-03-28 12:30:00
15,1,1,0,0.005883119111446676,2019-03-28 12:15:00,2019-03-28 12:30:00
16,5,3,2,0.022137137451885527,2019-03-28 12:15:00,2019-03-28 12:30:00
18,1,1,0,0.005782342000390775,2019-03-28 12:15:00,2019-03-28 12:30:00
20,6,3,3,0.01984997230984828,2019-03-28 12:15:00,2019-03-28 12:30:00
21,1,0,1,0.00341618648679257,2019-03-28 12:15:00,2019-03-28 12:30:00
23,3,3,0,0.01761829323066689,2019-03-28 12:15:00,2019-03-28 12:30:00
26,3,1,2,0.006320173669650888,2019-03-28 12:15:00,2019-03-28 12:30:00
27,1,1,0,0.008543029742696547,2019-03-28 12:15:00,2019-03-28 12:30:00
30,1,0,1,0.00341618648679257,2019-03-28 12:15:00,2019-03-28 12:30:00
37,7,2,5,0.01450936954653904,2019-03-28 12:15:00,2019-03-28 12:30:00
41,3,2,1,0.009111145924944998,2019-03-28 12:15:00,2019-03-28 12:30:00
46,2,2,0,0.007453235164375927,2019-03-28 12:15:00,2019-03-28 12:30:00
50,1,0,1,0.00341618648679257,2019-03-28 12:15:00,2019-03-28 12:30:00
57,2,2,0,0.011158575505897455,2019-03-28 12:15:00,2019-03-28 12:30:00
62,1,1,0,0.007554483361829888,2019-03-28 12:15:00,2019-03-28 12:30:00
67,3,2,1,0.01017162538571467,2019-03-28 12:15:00,2019-03-28 12:30:00
68,2,1,1,0.005782342000390775,2019-03-28 12:15:00,2019-03-28 12:30:00
70,5,2,3,0.011920749192157597,2019-03-28 12:15:00,2019-03-28 12:30:00
88,4,2,2,0.014887949360751291,2019-03-28 12:15:00,2019-03-28 12:30:00
89,2,1,1,0.006320173669650888,2019-03-28 12:15:00,2019-03-28 12:30:00
90,1,1,0,0.012825677093094394,2019-03-28 12:15:00,2019-03-28 12:30:00
99,1,1,0,0.006320173669650888,2019-03-28 12:15:00,2019-03-28 12:30:00
104,1,0,1,0.00341618648679257,2019-03-28 12:15:00,2019-03-28 12:30:00
109,5,2,3,0.008350051736100782,2019-03-28 12:15:00,2019-03-28 12:30:00
110,4,3,1,0.019692071234512804,2019-03-28 12:15:00,2019-03-28 12:30:00
112,2,1,1,0.0061024897704007285,2019-03-28 12:15:00,2019-03-28 12:30:00
113,2,1,1,0.004868180078221729,2019-03-28 12:15:00,2019-03-28 12:30:00
115,1,0,1,0.00341618648679257,2019-03-28 12:15:00,2019-03-28 12:30:00
116,5,1,4,0.004338111591520282,2019-03-28 12:15:00,2019-03-28 12:30:00
118,1,1,0,0.006320173669650888,2019-03-28 12:15:00,2019-03-28 12:30:00
119,1,0,1,0.00341618648679257,2019-03-28 12:15:00,2019-03-28 12:30:00
120,2,1,1,0.022265333629942638,2019-03-28 12:15:00,2019-03-28 12:30:00
122,3,1,2,0.012825677093094394,2019-03-28 12:15:00,2019-03-28 12:30:00
135,2,1,1,0.006320173669650888,2019-03-28 12:15:00,2019-03-28 12:30:00
137,4,2,2,0.012648401146248243,2019-03-28 12:15:00,2019-03-28 12:30:00
138,3,1,2,0.006320173669650888,2019-03-28 12:15:00,2019-03-28 12:30:00
141,1,0,1,0.00341618648679257,2019-03-28 12:15:00,2019-03-28 12:30:00
151,1,0,1,0.00341618648679257,2019-03-28 12:15:00,2019-03-28 12:30:00
153,2,2,0,0.005790105182949441,2019-03-28 12:15:00,2019-03-28 12:30:00
154,2,1,1,0.008788793054008887,2019-03-28 12:15:00,2019-03-28 12:30:00
157,1,1,0,0.005883119111446676,2019-03-28 12:15:00,2019-03-28 12:30:00
158,3,1,2,0.005941593855438638,2019-03-28 12:15:00,2019-03-28 12:30:00
164,3,1,2,0.005883119111446676,2019-03-28 12:15:00,2019-03-28 12:30:00
168,3,1,2,0.020156613368904175,2019-03-28 12:15:00,2019-03-28 12:30:00
170,2,2,0,0.008417413348619037,2019-03-28 12:15:00,2019-03-28 12:30:00
173,1,1,0,0.006320173669650888,2019-03-28 12:15:00,2019-03-28 12:30:00
189,2,0,2,0.00341618648679257,2019-03-28 12:15:00,2019-03-28 12:30:00
191,10,6,4,0.020440854482986288,2019-03-28 12:15:00,2019-03-28 12:30:00
195,3,1,2,0.012062525809328994,2019-03-28 12:15:00,2019-03-28 12:30:00
196,1,0,1,0.00341618648679257,2019-03-28 12:15:00,2019-03-28 12:30:00
197,3,1,2,0.005941593855438638,2019-03-28 12:15:00,2019-03-28 12:30:00
199,2,1,1,0.006320173669650888,2019-03-28 12:15:00,2019-03-28 12:30:00
202,1,1,0,0.008331720472458103,2019-03-28 12:15:00,2019-03-28 12:30:00
1,2,2,0,0.004634593560833116,2019-03-28 12:30:00,2019-03-28 12:45:00
2,1,0,1,0.0032522432000390692,2019-03-28 12:30:00,2019-03-28 12:45:00
5,3,2,1,0.03907933882720675,2019-03-28 12:30:00,2019-03-28 12:45:00
10,2,0,2,0.0032522432000390692,2019-03-28 12:30:00,2019-03-28 12:45:00
15,1,1,0,0.004765710442478794,2019-03-28 12:30:00,2019-03-28 12:45:00
16,3,1,2,0.008367246047532714,2019-03-28 12:30:00,2019-03-28 12:45:00
18,2,2,0,0.008781644643215259,2019-03-28 12:30:00,2019-03-28 12:45:00
20,3,2,1,0.03917338257664872,2019-03-28 12:30:00,2019-03-28 12:45:00
21,1,0,1,0.0032522432000390692,2019-03-28 12:30:00,2019-03-28 12:45:00
23,3,3,0,0.009034367597115914,2019-03-28 12:30:00,2019-03-28 12:45:00
26,4,0,4,0.0032522432000390692,2019-03-28 12:30:00,2019-03-28 12:45:00
27,1,0,1,0.0032522432000390692,2019-03-28 12:30:00,2019-03-28 12:45:00
30,2,1,1,0.005810831373007494,2019-03-28 12:30:00,2019-03-28 12:45:00
37,8,3,5,0.008901511814958914,2019-03-28 12:30:00,2019-03-28 12:45:00
40,6,4,2,0.061418834204870265,2019-03-28 12:30:00,2019-03-28 12:45:00
41,2,1,1,0.004634593560833116,2019-03-28 12:30:00,2019-03-28 12:45:00
46,2,2,0,0.005472445388028186,2019-03-28 12:30:00,2019-03-28 12:45:00
57,3,1,2,0.00719209498457994,2019-03-28 12:30:00,2019-03-28 12:45:00
58,1,0,1,0.0032522432000390692,2019-03-28 12:30:00,2019-03-28 12:45:00
62,2,2,0,0.009445786947288521,2019-03-28 12:30:00,2019-03-28 12:45:00
67,5,0,5,0.0032522432000390692,2019-03-28 12:30:00,2019-03-28 12:45:00
68,3,2,1,0.009448471808545172,2019-03-28 12:30:00,2019-03-28 12:45:00
70,1,1,0,0.006487004346808274,2019-03-28 12:30:00,2019-03-28 12:45:00
74,4,4,0,0.005464003777309545,2019-03-28 12:30:00,2019-03-28 12:45:00
85,2,0,2,0.0032522432000390692,2019-03-28 12:30:00,2019-03-28 12:45:00
86,2,1,1,0.021635561415374465,2019-03-28 12:30:00,2019-03-28 12:45:00
87,1,0,1,0.0032522432000390692,2019-03-28 12:30:00,2019-03-28 12:45:00
88,5,2,3,0.007691614075349281,2019-03-28 12:30:00,2019-03-28 12:45:00
89,1,0,1,0.0032522432000390692,2019-03-28 12:30:00,2019-03-28 12:45:00
90,2,2,0,0.01036532241061008,2019-03-28 12:30:00,2019-03-28 12:45:00
99,1,1,0,0.006016943921627164,2019-03-28 12:30:00,2019-03-28 12:45:00
104,1,0,1,0.0032522432000390692,2019-03-28 12:30:00,2019-03-28 12:45:00
109,7,4,3,0.01210089892102278,2019-03-28 12:30:00,2019-03-28 12:45:00
110,1,1,0,0.006016943921627164,2019-03-28 12:30:00,2019-03-28 12:45:00
111,1,1,0,0.004634593560833116,2019-03-28 12:30:00,2019-03-28 12:45:00
112,1,1,0,0.003943418380436093,2019-03-28 12:30:00,2019-03-28 12:45:00
113,4,2,2,0.008060975126507193,2019-03-28 12:30:00,2019-03-28 12:45:00
114,1,0,1,0.0032522432000390692,2019-03-28 12:30:00,2019-03-28 12:45:00
115,1,0,1,0.0032522432000390692,2019-03-28 12:30:00,2019-03-28 12:45:00
116,3,1,2,0.006019405381614443,2019-03-28 12:30:00,2019-03-28 12:45:00
118,1,1,0,0.006016943921627164,2019-03-28 12:30:00,2019-03-28 12:45:00
120,5,2,3,0.007506659621360018,2019-03-28 12:30:00,2019-03-28 12:45:00
122,1,0,1,0.0032522432000390692,2019-03-28 12:30:00,2019-03-28 12:45:00
126,2,2,0,0.007399294282421211,2019-03-28 12:30:00,2019-03-28 12:45:00
129,1,1,0,0.005379451410699544,2019-03-28 12:30:00,2019-03-28 12:45:00
135,1,0,1,0.0032522432000390692,2019-03-28 12:30:00,2019-03-28 12:45:00
137,4,2,2,0.006016943921627164,2019-03-28 12:30:00,2019-03-28 12:45:00
138,1,0,1,0.0032522432000390692,2019-03-28 12:30:00,2019-03-28 12:45:00
153,7,4,3,0.009765142021857517,2019-03-28 12:30:00,2019-03-28 12:45:00
154,2,1,1,0.006016943921627164,2019-03-28 12:30:00,2019-03-28 12:45:00
157,1,1,0,0.004765710442478794,2019-03-28 12:30:00,2019-03-28 12:45:00
158,7,2,5,0.004927946854429209,2019-03-28 12:30:00,2019-03-28 12:45:00
164,3,3,0,0.00970998301236057,2019-03-28 12:30:00,2019-03-28 12:45:00
168,2,0,2,0.0032522432000390692,2019-03-28 12:30:00,2019-03-28 12:45:00
169,1,1,0,0.005431815048332749,2019-03-28 12:30:00,2019-03-28 12:45:00
189,2,0,2,0.0032522432000390692,2019-03-28 12:30:00,2019-03-28 12:45:00
190,2,0,2,0.0032522432000390692,2019-03-28 12:30:00,2019-03-28 12:45:00
191,5,3,2,0.04225269595972583,2019-03-28 12:30:00,2019-03-28 12:45:00
195,2,1,1,0.0038051833443566883,2019-03-28 12:30:00,2019-03-28 12:45:00
196,4,1,3,0.004538223344067057,2019-03-28 12:30:00,2019-03-28 12:45:00
197,2,1,1,0.006016943921627164,2019-03-28 12:30:00,2019-03-28 12:45:00
199,2,2,0,0.010956799982408772,2019-03-28 12:30:00,2019-03-28 12:45:00
202,1,1,0,0.011284624766440047,2019-03-28 12:30:00,2019-03-28 12:45:00
1,2,2,0,0.005369529157638784,2019-03-28 12:45:00,2019-03-28 13:00:00
2,1,0,1,0.003427234540010432,2019-03-28 12:45:00,2019-03-28 13:00:00
5,3,2,1,0.013062135088605868,2019-03-28 12:45:00,2019-03-28 13:00:00
10,1,0,1,0.003427234540010432,2019-03-28 12:45:00,2019-03-28 13:00:00
15,1,1,0,0.014983663495599984,2019-03-28 12:45:00,2019-03-28 13:00:00
18,1,1,0,0.0063406764664529595,2019-03-28 12:45:00,2019-03-28 13:00:00
20,2,1,1,0.010648012532908794,2019-03-28 12:45:00,2019-03-28 13:00:00
21,1,0,1,0.003427234540010432,2019-03-28 12:45:00,2019-03-28 13:00:00
23,3,2,1,0.01269975696476254,2019-03-28 12:45:00,2019-03-28 13:00:00
26,3,0,3,0.003427234540010432,2019-03-28 12:45:00,2019-03-28 13:00:00
27,1,0,1,0.003427234540010432,2019-03-28 12:45:00,2019-03-28 13:00:00
28,2,1,1,0.022716329734978793,2019-03-28 12:45:00,2019-03-28 13:00:00
37,3,2,1,0.013594102927273182,2019-03-28 12:45:00,2019-03-28 13:00:00
40,3,2,1,0.029146028133301576,2019-03-28 12:45:00,2019-03-28 13:00:00
41,1,0,1,0.003427234540010432,2019-03-28 12:45:00,2019-03-28 13:00:00
46,1,1,0,0.0063406764664529595,2019-03-28 12:45:00,2019-03-28 13:00:00
57,4,1,3,0.0063406764664529595,2019-03-28 12:45:00,2019-03-28 13:00:00
58,1,1,0,0.01730879019280865,2019-03-28 12:45:00,2019-03-28 13:00:00
62,3,2,1,0.007103310293911882,2019-03-28 12:45:00,2019-03-28 13:00:00
67,5,0,5,0.003427234540010432,2019-03-28 12:45:00,2019-03-28 13:00:00
68,5,2,3,0.00802106954104911,2019-03-28 12:45:00,2019-03-28 13:00:00
74,4,4,0,0.005757988081164454,2019-03-28 12:45:00,2019-03-28 13:00:00
75,1,1,0,0.0048839555032316965,2019-03-28 12:45:00,2019-03-28 13:00:00
80,4,2,2,0.022716329734978793,2019-03-28 12:45:00,2019-03-28 13:00:00
85,1,1,0,0.0063406764664529595,2019-03-28 12:45:00,2019-03-28 13:00:00
86,2,1,1,0.022716329734978793,2019-03-28 12:45:00,2019-03-28 13:00:00
87,1,0,1,0.003427234540010432,2019-03-28 12:45:00,2019-03-28 13:00:00
88,4,2,2,0.006571497140299397,2019-03-28 12:45:00,2019-03-28 13:00:00
90,1,0,1,0.003427234540010432,2019-03-28 12:45:00,2019-03-28 13:00:00
99,1,1,0,0.0063406764664529595,2019-03-28 12:45:00,2019-03-28 13:00:00
104,1,0,1,0.003427234540010432,2019-03-28 12:45:00,2019-03-28 13:00:00
109,2,2,0,0.01602010443415422,2019-03-28 12:45:00,2019-03-28 13:00:00
110,1,0,1,0.003427234540010432,2019-03-28 12:45:00,2019-03-28 13:00:00
111,2,2,0,0.009410061584885162,2019-03-28 12:45:00,2019-03-28 13:00:00
112,4,4,0,0.012826575965131865,2019-03-28 12:45:00,2019-03-28 13:00:00
113,4,1,3,0.004782393367469889,2019-03-28 12:45:00,2019-03-28 13:00:00
114,1,0,1,0.003427234540010432,2019-03-28 12:45:00,2019-03-28 13:00:00
115,1,0,1,0.003427234540010432,2019-03-28 12:45:00,2019-03-28 13:00:00
116,1,1,0,0.005748151466452425,2019-03-28 12:45:00,2019-03-28 13:00:00
119,4,3,1,0.008532455141054251,2019-03-28 12:45:00,2019-03-28 13:00:00
120,6,2,4,0.005960924345569815,2019-03-28 12:45:00,2019-03-28 13:00:00
126,8,5,3,0.025481241914526866,2019-03-28 12:45:00,2019-03-28 13:00:00
129,1,1,0,0.0046940794427901235,2019-03-28 12:45:00,2019-03-28 13:00:00
133,2,0,2,0.003427234540010432,2019-03-28 12:45:00,2019-03-28 13:00:00
137,3,0,3,0.003427234540010432,2019-03-28 12:45:00,2019-03-28 13:00:00
138,2,1,1,0.0063406764664529595,2019-03-28 12:45:00,2019-03-28 13:00:00
140,1,1,0,0.004398381848824608,2019-03-28 12:45:00,2019-03-28 13:00:00
141,1,1,0,0.0063406764664529595,2019-03-28 12:45:00,2019-03-28 13:00:00
151,1,1,0,0.0063406764664529595,2019-03-28 12:45:00,2019-03-28 13:00:00
153,6,3,3,0.008190544010096163,2019-03-28 12:45:00,2019-03-28 13:00:00
154,1,1,0,0.004398381848824608,2019-03-28 12:45:00,2019-03-28 13:00:00
158,1,0,1,0.003427234540010432,2019-03-28 12:45:00,2019-03-28 13:00:00
160,1,0,1,0.003427234540010432,2019-03-28 12:45:00,2019-03-28 13:00:00
164,4,2,2,0.009133883503293052,2019-03-28 12:45:00,2019-03-28 13:00:00
168,1,0,1,0.003427234540010432,2019-03-28 12:45:00,2019-03-28 13:00:00
169,4,4,0,0.010263064920079194,2019-03-28 12:45:00,2019-03-28 13:00:00
170,5,1,4,0.0063406764664529595,2019-03-28 12:45:00,2019-03-28 13:00:00
189,1,0,1,0.003427234540010432,2019-03-28 12:45:00,2019-03-28 13:00:00
190,3,1,2,0.010648012532908794,2019-03-28 12:45:00,2019-03-28 13:00:00
191,3,2,1,0.016328545031954845,2019-03-28 12:45:00,2019-03-28 13:00:00
195,1,0,1,0.003427234540010432,2019-03-28 12:45:00,2019-03-28 13:00:00
196,5,1,4,0.004352168311832033,2019-03-28 12:45:00,2019-03-28 13:00:00
197,1,1,0,0.0063406764664529595,2019-03-28 12:45:00,2019-03-28 13:00:00
199,1,1,0,0.0063406764664529595,2019-03-28 12:45:00,2019-03-28 13:00:00
2,1,0,1,0.0035222512118573412,2019-03-28 13:00:00,2019-03-28 13:15:00
5,3,2,1,0.015155784776700314,2019-03-28 13:00:00,2019-03-28 13:15:00
10,1,0,1,0.0035222512118573412,2019-03-28 13:00:00,2019-03-28 13:15:00
15,3,3,0,0.01848082687048267,2019-03-28 13:00:00,2019-03-28 13:15:00
16,4,3,1,0.014338233021318016,2019-03-28 13:00:00,2019-03-28 13:15:00
18,1,1,0,0.01571132664317019,2019-03-28 13:00:00,2019-03-28 13:15:00
19,1,0,1,0.0035222512118573412,2019-03-28 13:00:00,2019-03-28 13:15:00
20,1,1,0,0.018697559342378604,2019-03-28 13:00:00,2019-03-28 13:15:00
23,2,2,0,0.017241743456013002,2019-03-28 13:00:00,2019-03-28 13:15:00
26,1,0,1,0.0035222512118573412,2019-03-28 13:00:00,2019-03-28 13:15:00
27,2,1,1,0.006516437116050896,2019-03-28 13:00:00,2019-03-28 13:15:00
37,2,1,1,0.008646578344071208,2019-03-28 13:00:00,2019-03-28 13:15:00
41,1,1,0,0.006516437116050896,2019-03-28 13:00:00,2019-03-28 13:15:00
57,2,0,2,0.0035222512118573412,2019-03-28 13:00:00,2019-03-28 13:15:00
58,4,2,2,0.009836793105276614,2019-03-28 13:00:00,2019-03-28 13:15:00
62,2,1,1,0.005019344163954119,2019-03-28 13:00:00,2019-03-28 13:15:00
67,6,2,4,0.006516437116050896,2019-03-28 13:00:00,2019-03-28 13:15:00
68,4,1,3,0.00491495946930238,2019-03-28 13:00:00,2019-03-28 13:15:00
74,3,3,0,0.007676889113103058,2019-03-28 13:00:00,2019-03-28 13:15:00
75,1,1,0,0.006516437116050896,2019-03-28 13:00:00,2019-03-28 13:15:00
80,2,1,1,0.02292051032720785,2019-03-28 13:00:00,2019-03-28 13:15:00
85,2,2,0,0.006516437116050896,2019-03-28 13:00:00,2019-03-28 13:15:00
86,2,0,2,0.0035222512118573412,2019-03-28 13:00:00,2019-03-28 13:15:00
88,4,3,1,0.011488300413993452,2019-03-28 13:00:00,2019-03-28 13:15:00
90,1,1,0,0.005019344163954119,2019-03-28 13:00:00,2019-03-28 13:15:00
99,1,0,1,0.0035222512118573412,2019-03-28 13:00:00,2019-03-28 13:15:00
104,1,0,1,0.0035222512118573412,2019-03-28 13:00:00,2019-03-28 13:15:00
109,5,3,2,0.007751607121256457,2019-03-28 13:00:00,2019-03-28 13:15:00
110,2,0,2,0.0035222512118573412,2019-03-28 13:00:00,2019-03-28 13:15:00
111,2,1,1,0.006516437116050896,2019-03-28 13:00:00,2019-03-28 13:15:00
112,5,5,0,0.0166225898862251,2019-03-28 13:00:00,2019-03-28 13:15:00
113,2,0,2,0.0035222512118573412,2019-03-28 13:00:00,2019-03-28 13:15:00
119,5,3,2,0.012055954317711852,2019-03-28 13:00:00,2019-03-28 13:15:00
120,2,1,1,0.006516437116050896,2019-03-28 13:00:00,2019-03-28 13:15:00
126,8,6,2,0.035701965701367605,2019-03-28 13:00:00,2019-03-28 13:15:00
127,1,1,0,0.005019344163954119,2019-03-28 13:00:00,2019-03-28 13:15:00
133,1,0,1,0.0035222512118573412,2019-03-28 13:00:00,2019-03-28 13:15:00
137,10,3,7,0.023433117523450748,2019-03-28 13:00:00,2019-03-28 13:15:00
138,4,3,1,0.010710998841200926,2019-03-28 13:00:00,2019-03-28 13:15:00
140,2,0,2,0.0035222512118573412,2019-03-28 13:00:00,2019-03-28 13:15:00
151,1,1,0,0.006516437116050896,2019-03-28 13:00:00,2019-03-28 13:15:00
153,3,2,1,0.012055954317711852,2019-03-28 13:00:00,2019-03-28 13:15:00
154,3,1,2,0.006368078550480745,2019-03-28 13:00:00,2019-03-28 13:15:00
157,2,0,2,0.0035222512118573412,2019-03-28 13:00:00,2019-03-28 13:15:00
158,2,2,0,0.010111786114336621,2019-03-28 13:00:00,2019-03-28 13:15:00
160,1,0,1,0.0035222512118573412,2019-03-28 13:00:00,2019-03-28 13:15:00
162,1,1,0,0.006516437116050896,2019-03-28 13:00:00,2019-03-28 13:15:00
164,5,2,3,0.016282635628412326,2019-03-28 13:00:00,2019-03-28 13:15:00
168,1,0,1,0.0035222512118573412,2019-03-28 13:00:00,2019-03-28 13:15:00
169,4,3,1,0.005318762754373474,2019-03-28 13:00:00,2019-03-28 13:15:00
170,5,0,5,0.0035222512118573412,2019-03-28 13:00:00,2019-03-28 13:15:00
172,1,0,1,0.0035222512118573412,2019-03-28 13:00:00,2019-03-28 13:15:00
173,1,0,1,0.0035222512118573412,2019-03-28 13:00:00,2019-03-28 13:15:00
189,1,1,0,0.005019344163954119,2019-03-28 13:00:00,2019-03-28 13:15:00
191,3,1,2,0.005019344163954119,2019-03-28 13:00:00,2019-03-28 13:15:00
195,2,0,2,0.0035222512118573412,2019-03-28 13:00:00,2019-03-28 13:15:00
196,1,0,1,0.0035222512118573412,2019-03-28 13:00:00,2019-03-28 13:15:00
199,1,1,0,0.006516437116050896,2019-03-28 13:00:00,2019-03-28 13:15:00
203,1,0,1,0.0035222512118573412,2019-03-28 13:00:00,2019-03-28 13:15:00
5,3,2,1,0.009615968401629722,2019-03-28 13:15:00,2019-03-28 13:30:00
10,2,0,2,0.003286041747718517,2019-03-28 13:15:00,2019-03-28 13:30:00
15,3,3,0,0.008086917685322149,2019-03-28 13:15:00,2019-03-28 13:30:00
16,4,3,1,0.016748917521986206,2019-03-28 13:15:00,2019-03-28 13:30:00
18,1,1,0,0.017524549120645237,2019-03-28 13:15:00,2019-03-28 13:30:00
19,5,0,5,0.003286041747718517,2019-03-28 13:15:00,2019-03-28 13:30:00
20,2,2,0,0.007111959123886613,2019-03-28 13:15:00,2019-03-28 13:30:00
23,2,2,0,0.009946602334048421,2019-03-28 13:15:00,2019-03-28 13:30:00
26,3,2,1,0.011291144957362657,2019-03-28 13:15:00,2019-03-28 13:30:00
27,2,2,0,0.0067777568391491246,2019-03-28 13:15:00,2019-03-28 13:30:00
28,3,3,0,0.008663403098928211,2019-03-28 13:15:00,2019-03-28 13:30:00
35,1,0,1,0.003286041747718517,2019-03-28 13:15:00,2019-03-28 13:30:00
37,3,1,2,0.014489214090338475,2019-03-28 13:15:00,2019-03-28 13:30:00
40,2,1,1,0.0059585438596230274,2019-03-28 13:15:00,2019-03-28 13:30:00
41,1,1,0,0.00468272778429076,2019-03-28 13:15:00,2019-03-28 13:30:00
57,1,0,1,0.003286041747718517,2019-03-28 13:15:00,2019-03-28 13:30:00
58,4,1,3,0.004585340870076543,2019-03-28 13:15:00,2019-03-28 13:30:00
61,1,0,1,0.003286041747718517,2019-03-28 13:15:00,2019-03-28 13:30:00
62,1,1,0,0.0042171657721000125,2019-03-28 13:15:00,2019-03-28 13:30:00
66,1,1,0,0.01661405349626191,2019-03-28 13:15:00,2019-03-28 13:30:00
67,7,2,5,0.006079413820863003,2019-03-28 13:15:00,2019-03-28 13:30:00
70,4,2,2,0.021804226077992695,2019-03-28 13:15:00,2019-03-28 13:30:00
74,4,4,0,0.0074204245926228485,2019-03-28 13:15:00,2019-03-28 13:30:00
75,1,1,0,0.00468272778429076,2019-03-28 13:15:00,2019-03-28 13:30:00
80,2,1,1,0.021804226077992695,2019-03-28 13:15:00,2019-03-28 13:30:00
85,4,4,0,0.007196762650120797,2019-03-28 13:15:00,2019-03-28 13:30:00
86,2,0,2,0.003286041747718517,2019-03-28 13:15:00,2019-03-28 13:30:00
88,3,2,1,0.012238071480614409,2019-03-28 13:15:00,2019-03-28 13:30:00
89,2,1,1,0.009444699407469923,2019-03-28 13:15:00,2019-03-28 13:30:00
90,2,2,0,0.004403390576976311,2019-03-28 13:15:00,2019-03-28 13:30:00
99,1,0,1,0.003286041747718517,2019-03-28 13:15:00,2019-03-28 13:30:00
101,1,1,0,0.004585340870076543,2019-03-28 13:15:00,2019-03-28 13:30:00
104,2,1,1,0.007266717062355968,2019-03-28 13:15:00,2019-03-28 13:30:00
109,7,4,3,0.009431460308636386,2019-03-28 13:15:00,2019-03-28 13:30:00
110,2,1,1,0.008351299557166658,2019-03-28 13:15:00,2019-03-28 13:30:00
111,6,3,3,0.006447588918839534,2019-03-28 13:15:00,2019-03-28 13:30:00
112,3,2,1,0.015678056232017994,2019-03-28 13:15:00,2019-03-28 13:30:00
113,3,0,3,0.003286041747718517,2019-03-28 13:15:00,2019-03-28 13:30:00
114,1,0,1,0.003286041747718517,2019-03-28 13:15:00,2019-03-28 13:30:00
119,3,2,1,0.013178758171556811,2019-03-28 13:15:00,2019-03-28 13:30:00
120,1,1,0,0.004585340870076543,2019-03-28 13:15:00,2019-03-28 13:30:00
122,1,0,1,0.003286041747718517,2019-03-28 13:15:00,2019-03-28 13:30:00
126,5,4,1,0.05421104865597251,2019-03-28 13:15:00,2019-03-28 13:30:00
127,2,1,1,0.00468272778429076,2019-03-28 13:15:00,2019-03-28 13:30:00
129,1,1,0,0.011315025892580769,2019-03-28 13:15:00,2019-03-28 13:30:00
133,2,0,2,0.003286041747718517,2019-03-28 13:15:00,2019-03-28 13:30:00
137,10,5,5,0.026394530298494923,2019-03-28 13:15:00,2019-03-28 13:30:00
138,4,2,2,0.012261292263896977,2019-03-28 13:15:00,2019-03-28 13:30:00
140,5,0,5,0.003286041747718517,2019-03-28 13:15:00,2019-03-28 13:30:00
147,3,1,2,0.005715273087314369,2019-03-28 13:15:00,2019-03-28 13:30:00
153,4,3,1,0.006230380028886767,2019-03-28 13:15:00,2019-03-28 13:30:00
154,1,0,1,0.003286041747718517,2019-03-28 13:15:00,2019-03-28 13:30:00
157,2,0,2,0.003286041747718517,2019-03-28 13:15:00,2019-03-28 13:30:00
158,2,2,0,0.007407373309453277,2019-03-28 13:15:00,2019-03-28 13:30:00
162,1,1,0,0.006079413820863003,2019-03-28 13:15:00,2019-03-28 13:30:00
164,4,1,3,0.005113031199628972,2019-03-28 13:15:00,2019-03-28 13:30:00
168,1,0,1,0.003286041747718517,2019-03-28 13:15:00,2019-03-28 13:30:00
169,1,0,1,0.003286041747718517,2019-03-28 13:15:00,2019-03-28 13:30:00
170,2,1,1,0.00468272778429076,2019-03-28 13:15:00,2019-03-28 13:30:00
172,1,0,1,0.003286041747718517,2019-03-28 13:15:00,2019-03-28 13:30:00
173,4,0,4,0.003286041747718517,2019-03-28 13:15:00,2019-03-28 13:30:00
189,1,1,0,0.005113031199628972,2019-03-28 13:15:00,2019-03-28 13:30:00
191,2,0,2,0.003286041747718517,2019-03-28 13:15:00,2019-03-28 13:30:00
195,2,0,2,0.003286041747718517,2019-03-28 13:15:00,2019-03-28 13:30:00
196,1,1,0,0.006079413820863003,2019-03-28 13:15:00,2019-03-28 13:30:00
199,1,1,0,0.009463350014286439,2019-03-28 13:15:00,2019-03-28 13:30:00
201,1,1,0,0.003844716162347414,2019-03-28 13:15:00,2019-03-28 13:30:00
203,4,1,3,0.004585340870076543,2019-03-28 13:15:00,2019-03-28 13:30:00
2,1,0,1,0.0029609835061727304,2019-03-28 13:30:00,2019-03-28 13:45:00
5,2,1,1,0.005997966653660368,2019-03-28 13:30:00,2019-03-28 13:45:00
10,6,1,5,0.003567518109874811,2019-03-28 13:30:00,2019-03-28 13:45:00
13,2,1,1,0.019701629274366958,2019-03-28 13:30:00,2019-03-28 13:45:00
15,2,1,1,0.006809043109495521,2019-03-28 13:30:00,2019-03-28 13:45:00
16,1,1,0,0.00621975917111613,2019-03-28 13:30:00,2019-03-28 13:45:00
19,6,1,5,0.003567518109874811,2019-03-28 13:30:00,2019-03-28 13:45:00
20,2,2,0,0.006084577657772127,2019-03-28 13:30:00,2019-03-28 13:45:00
22,2,1,1,0.019701629274366958,2019-03-28 13:30:00,2019-03-28 13:45:00
23,1,1,0,0.009010374447204011,2019-03-28 13:30:00,2019-03-28 13:45:00
26,4,2,2,0.011527433995101328,2019-03-28 13:30:00,2019-03-28 13:45:00
28,2,2,0,0.009853299356797896,2019-03-28 13:30:00,2019-03-28 13:45:00
35,1,0,1,0.0029609835061727304,2019-03-28 13:30:00,2019-03-28 13:45:00
37,2,1,1,0.005478043054070047,2019-03-28 13:30:00,2019-03-28 13:45:00
40,2,1,1,0.006279068438740495,2019-03-28 13:30:00,2019-03-28 13:45:00
41,2,2,0,0.004174052713576891,2019-03-28 13:30:00,2019-03-28 13:45:00
57,4,2,2,0.010768438598754952,2019-03-28 13:30:00,2019-03-28 13:45:00
58,3,1,2,0.005149943842598984,2019-03-28 13:30:00,2019-03-28 13:45:00
61,3,0,3,0.0029609835061727304,2019-03-28 13:30:00,2019-03-28 13:45:00
62,1,1,0,0.004156625715574045,2019-03-28 13:30:00,2019-03-28 13:45:00
66,1,1,0,0.00590177431669228,2019-03-28 13:30:00,2019-03-28 13:45:00
67,11,6,5,0.017860281484414264,2019-03-28 13:30:00,2019-03-28 13:45:00
68,3,1,2,0.005149943842598984,2019-03-28 13:30:00,2019-03-28 13:45:00
70,2,2,0,0.008842565127211831,2019-03-28 13:30:00,2019-03-28 13:45:00
74,10,5,5,0.018204475703709335,2019-03-28 13:30:00,2019-03-28 13:45:00
80,2,1,1,0.019701629274366958,2019-03-28 13:30:00,2019-03-28 13:45:00
85,2,2,0,0.004174052713576891,2019-03-28 13:30:00,2019-03-28 13:45:00
86,2,0,2,0.0029609835061727304,2019-03-28 13:30:00,2019-03-28 13:45:00
88,5,2,3,0.005525283305162157,2019-03-28 13:30:00,2019-03-28 13:45:00
89,1,1,0,0.007617777214683305,2019-03-28 13:30:00,2019-03-28 13:45:00
101,1,1,0,0.005478043054070047,2019-03-28 13:30:00,2019-03-28 13:45:00
104,5,3,2,0.010737064610008187,2019-03-28 13:30:00,2019-03-28 13:45:00
109,4,2,2,0.0078064399083253334,2019-03-28 13:30:00,2019-03-28 13:45:00
110,3,2,1,0.05518316567423413,2019-03-28 13:30:00,2019-03-28 13:45:00
111,8,3,5,0.007541228261401614,2019-03-28 13:30:00,2019-03-28 13:45:00
112,5,2,3,0.010377886753329403,2019-03-28 13:30:00,2019-03-28 13:45:00
113,4,1,3,0.004219513280121389,2019-03-28 13:30:00,2019-03-28 13:45:00
114,1,0,1,0.0029609835061727304,2019-03-28 13:30:00,2019-03-28 13:45:00
116,3,3,0,0.008132131884912372,2019-03-28 13:30:00,2019-03-28 13:45:00
119,1,0,1,0.0029609835061727304,2019-03-28 13:30:00,2019-03-28 13:45:00
120,3,2,1,0.05817646838146083,2019-03-28 13:30:00,2019-03-28 13:45:00
126,2,1,1,0.019701629274366958,2019-03-28 13:30:00,2019-03-28 13:45:00
127,2,0,2,0.0029609835061727304,2019-03-28 13:30:00,2019-03-28 13:45:00
129,3,1,2,0.005149943842598984,2019-03-28 13:30:00,2019-03-28 13:45:00
133,1,0,1,0.0029609835061727304,2019-03-28 13:30:00,2019-03-28 13:45:00
137,10,5,5,0.019166438285896356,2019-03-28 13:30:00,2019-03-28 13:45:00
138,7,5,2,0.014231794971475208,2019-03-28 13:30:00,2019-03-28 13:45:00
140,2,1,1,0.005478043054070047,2019-03-28 13:30:00,2019-03-28 13:45:00
147,1,0,1,0.0029609835061727304,2019-03-28 13:30:00,2019-03-28 13:45:00
151,1,1,0,0.007860827205432087,2019-03-28 13:30:00,2019-03-28 13:45:00
153,4,4,0,0.007202032899302251,2019-03-28 13:30:00,2019-03-28 13:45:00
154,2,1,1,0.019701629274366958,2019-03-28 13:30:00,2019-03-28 13:45:00
158,1,0,1,0.0029609835061727304,2019-03-28 13:30:00,2019-03-28 13:45:00
164,2,2,0,0.00676019295356476,2019-03-28 13:30:00,2019-03-28 13:45:00
168,2,1,1,0.004526653303696583,2019-03-28 13:30:00,2019-03-28 13:45:00
170,3,1,2,0.005478043054070047,2019-03-28 13:30:00,2019-03-28 13:45:00
172,1,1,0,0.007538134330653217,2019-03-28 13:30:00,2019-03-28 13:45:00
189,1,0,1,0.0029609835061727304,2019-03-28 13:30:00,2019-03-28 13:45:00
191,5,2,3,0.007644107318790314,2019-03-28 13:30:00,2019-03-28 13:45:00
195,1,0,1,0.0029609835061727304,2019-03-28 13:30:00,2019-03-28 13:45:00
196,2,1,1,0.0038000033554718357,2019-03-28 13:30:00,2019-03-28 13:45:00
199,1,1,0,0.007524902502542608,2019-03-28 13:30:00,2019-03-28 13:45:00
201,1,1,0,0.003567518109874811,2019-03-28 13:30:00,2019-03-28 13:45:00
203,1,0,1,0.0029609835061727304,2019-03-28 13:30:00,2019-03-28 13:45:00
1,2,1,1,0.004273119230510923,2019-03-28 13:45:00,2019-03-28 14:00:00
2,5,2,3,0.006921071411922738,2019-03-28 13:45:00,2019-03-28 14:00:00
5,1,1,0,0.009235425826797511,2019-03-28 13:45:00,2019-03-28 14:00:00
10,5,1,4,0.003807843936378772,2019-03-28 13:45:00,2019-03-28 14:00:00
15,1,1,0,0.006958735014734421,2019-03-28 13:45:00,2019-03-28 14:00:00
18,2,1,1,0.0036358568209151083,2019-03-28 13:45:00,2019-03-28 14:00:00
19,1,1,0,0.003807843936378772,2019-03-28 13:45:00,2019-03-28 14:00:00
20,1,1,0,0.004273119230510923,2019-03-28 13:45:00,2019-03-28 14:00:00
21,2,1,1,0.004273119230510923,2019-03-28 13:45:00,2019-03-28 14:00:00
23,4,3,1,0.059515628642187464,2019-03-28 13:45:00,2019-03-28 14:00:00
26,2,1,1,0.005789982444234308,2019-03-28 13:45:00,2019-03-28 14:00:00
28,1,1,0,0.004706508720146176,2019-03-28 13:45:00,2019-03-28 14:00:00
35,1,1,0,0.004959832911621016,2019-03-28 13:45:00,2019-03-28 14:00:00
37,5,3,2,0.021315878187234395,2019-03-28 13:45:00,2019-03-28 14:00:00
41,5,3,2,0.014672092686667347,2019-03-28 13:45:00,2019-03-28 14:00:00
50,2,1,1,0.003508404338995945,2019-03-28 13:45:00,2019-03-28 14:00:00
57,2,0,2,0.0029985944113192927,2019-03-28 13:45:00,2019-03-28 14:00:00
58,4,2,2,0.00743218880385837,2019-03-28 13:45:00,2019-03-28 14:00:00
61,1,0,1,0.0029985944113192927,2019-03-28 13:45:00,2019-03-28 14:00:00
62,2,1,1,0.005547644049702554,2019-03-28 13:45:00,2019-03-28 14:00:00
66,1,0,1,0.0029985944113192927,2019-03-28 13:45:00,2019-03-28 14:00:00
67,9,7,2,0.02365438884677246,2019-03-28 13:45:00,2019-03-28 14:00:00
68,1,0,1,0.0029985944113192927,2019-03-28 13:45:00,2019-03-28 14:00:00
69,2,1,1,0.006631117773790687,2019-03-28 13:45:00,2019-03-28 14:00:00
74,6,2,4,0.018690676692857695,2019-03-28 13:45:00,2019-03-28 14:00:00
86,2,0,2,0.0029985944113192927,2019-03-28 13:45:00,2019-03-28 14:00:00
88,3,2,1,0.00743218880385837,2019-03-28 13:45:00,2019-03-28 14:00:00
89,2,1,1,0.012059738704033136,2019-03-28 13:45:00,2019-03-28 14:00:00
90,1,0,1,0.0029985944113192927,2019-03-28 13:45:00,2019-03-28 14:00:00
104,4,2,2,0.004018214266672597,2019-03-28 13:45:00,2019-03-28 14:00:00
109,1,1,0,0.005547644049702554,2019-03-28 13:45:00,2019-03-28 14:00:00
110,3,1,2,0.0052153916075888315,2019-03-28 13:45:00,2019-03-28 14:00:00
111,3,1,2,0.0052153916075888315,2019-03-28 13:45:00,2019-03-28 14:00:00
112,2,0,2,0.0029985944113192927,2019-03-28 13:45:00,2019-03-28 14:00:00
113,1,0,1,0.0029985944113192927,2019-03-28 13:45:00,2019-03-28 14:00:00
114,1,1,0,0.005378328112658271,2019-03-28 13:45:00,2019-03-28 14:00:00
115,1,0,1,0.0029985944113192927,2019-03-28 13:45:00,2019-03-28 14:00:00
116,2,2,0,0.007758061813997248,2019-03-28 13:45:00,2019-03-28 14:00:00
119,2,1,1,0.013251576956629957,2019-03-28 13:45:00,2019-03-28 14:00:00
120,5,2,3,0.006921071411922738,2019-03-28 13:45:00,2019-03-28 14:00:00
126,6,3,3,0.015305786309719342,2019-03-28 13:45:00,2019-03-28 14:00:00
129,1,0,1,0.0029985944113192927,2019-03-28 13:45:00,2019-03-28 14:00:00
137,5,0,5,0.0029985944113192927,2019-03-28 13:45:00,2019-03-28 14:00:00
138,5,3,2,0.006567263905055859,2019-03-28 13:45:00,2019-03-28 14:00:00
140,1,1,0,0.005547644049702554,2019-03-28 13:45:00,2019-03-28 14:00:00
141,5,3,2,0.036909385422279034,2019-03-28 13:45:00,2019-03-28 14:00:00
147,2,0,2,0.0029985944113192927,2019-03-28 13:45:00,2019-03-28 14:00:00
151,1,1,0,0.007920638131440382,2019-03-28 13:45:00,2019-03-28 14:00:00
153,4,4,0,0.014813761657389122,2019-03-28 13:45:00,2019-03-28 14:00:00
157,4,0,4,0.0029985944113192927,2019-03-28 13:45:00,2019-03-28 14:00:00
158,3,2,1,0.08006387483662643,2019-03-28 13:45:00,2019-03-28 14:00:00
159,3,1,2,0.0052153916075888315,2019-03-28 13:45:00,2019-03-28 14:00:00
162,1,1,0,0.007714591497878818,2019-03-28 13:45:00,2019-03-28 14:00:00
164,2,2,0,0.006822168868894185,2019-03-28 13:45:00,2019-03-28 14:00:00
168,3,1,2,0.009316733558014184,2019-03-28 13:45:00,2019-03-28 14:00:00
169,3,3,0,0.004910381640106739,2019-03-28 13:45:00,2019-03-28 14:00:00
170,1,0,1,0.0029985944113192927,2019-03-28 13:45:00,2019-03-28 14:00:00
172,1,1,0,0.004273119230510923,2019-03-28 13:45:00,2019-03-28 14:00:00
189,1,0,1,0.0029985944113192927,2019-03-28 13:45:00,2019-03-28 14:00:00
191,6,2,4,0.011196664327099233,2019-03-28 13:45:00,2019-03-28 14:00:00
196,1,1,0,0.005547644049702554,2019-03-28 13:45:00,2019-03-28 14:00:00
197,1,1,0,0.005981033539337807,2019-03-28 13:45:00,2019-03-28 14:00:00
199,1,1,0,0.004706508720146176,2019-03-28 13:45:00,2019-03-28 14:00:00
1,1,1,0,0.006857211639816539,2019-03-28 14:00:00,2019-03-28 14:15:00
2,1,0,1,0.0031021264158466876,2019-03-28 14:00:00,2019-03-28 14:15:00
5,1,1,0,0.011381374761202585,2019-03-28 14:00:00,2019-03-28 14:15:00
10,3,2,1,0.023554747030950417,2019-03-28 14:00:00,2019-03-28 14:15:00
15,2,1,1,0.005541568773614822,2019-03-28 14:00:00,2019-03-28 14:15:00
16,1,1,0,0.004420667070362807,2019-03-28 14:00:00,2019-03-28 14:15:00
18,3,2,1,0.011279266721113745,2019-03-28 14:00:00,2019-03-28 14:15:00
19,5,4,1,0.09482818650342373,2019-03-28 14:00:00,2019-03-28 14:15:00
20,1,0,1,0.0031021264158466876,2019-03-28 14:00:00,2019-03-28 14:15:00
21,2,0,2,0.0031021264158466876,2019-03-28 14:00:00,2019-03-28 14:15:00
22,1,0,1,0.0031021264158466876,2019-03-28 14:00:00,2019-03-28 14:15:00
23,6,2,4,0.007281928720045449,2019-03-28 14:00:00,2019-03-28 14:15:00
35,3,1,2,0.005739207724878926,2019-03-28 14:00:00,2019-03-28 14:15:00
37,5,4,1,0.02115974339642226,2019-03-28 14:00:00,2019-03-28 14:15:00
40,1,1,0,0.006370328141120805,2019-03-28 14:00:00,2019-03-28 14:15:00
41,4,3,1,0.009739065337404448,2019-03-28 14:00:00,2019-03-28 14:15:00
50,2,1,1,0.0036295426776531354,2019-03-28 14:00:00,2019-03-28 14:15:00
57,1,1,0,0.005739207724878926,2019-03-28 14:00:00,2019-03-28 14:15:00
58,3,1,2,0.0036295426776531354,2019-03-28 14:00:00,2019-03-28 14:15:00
61,1,0,1,0.0031021264158466876,2019-03-28 14:00:00,2019-03-28 14:15:00
62,3,1,2,0.007981011131382956,2019-03-28 14:00:00,2019-03-28 14:15:00
64,1,1,0,0.00464484741101321,2019-03-28 14:00:00,2019-03-28 14:15:00
67,5,3,2,0.008376289033911164,2019-03-28 14:00:00,2019-03-28 14:15:00
69,3,2,1,0.005968259375696968,2019-03-28 14:00:00,2019-03-28 14:15:00
74,2,2,0,0.011736096355352808,2019-03-28 14:00:00,2019-03-28 14:15:00
86,2,0,2,0.0031021264158466876,2019-03-28 14:00:00,2019-03-28 14:15:00
88,2,1,1,0.005541568773614822,2019-03-28 14:00:00,2019-03-28 14:15:00
89,1,1,0,0.021090611142318968,2019-03-28 14:00:00,2019-03-28 14:15:00
90,2,0,2,0.0031021264158466876,2019-03-28 14:00:00,2019-03-28 14:15:00
104,3,2,1,0.004156958939459583,2019-03-28 14:00:00,2019-03-28 14:15:00
109,4,2,2,0.007688868795636924,2019-03-28 14:00:00,2019-03-28 14:15:00
110,1,0,1,0.0031021264158466876,2019-03-28 14:00:00,2019-03-28 14:15:00
111,1,0,1,0.0031021264158466876,2019-03-28 14:00:00,2019-03-28 14:15:00
112,5,3,2,0.008834392335547248,2019-03-28 14:00:00,2019-03-28 14:15:00
113,2,1,1,0.005739207724878926,2019-03-28 14:00:00,2019-03-28 14:15:00
114,3,2,1,0.00910191283463497,2019-03-28 14:00:00,2019-03-28 14:15:00
115,3,1,2,0.005395497605741806,2019-03-28 14:00:00,2019-03-28 14:15:00
118,1,1,0,0.004649718721180848,2019-03-28 14:00:00,2019-03-28 14:15:00
119,2,0,2,0.0031021264158466876,2019-03-28 14:00:00,2019-03-28 14:15:00
120,1,0,1,0.0031021264158466876,2019-03-28 14:00:00,2019-03-28 14:15:00
122,1,0,1,0.0031021264158466876,2019-03-28 14:00:00,2019-03-28 14:15:00
126,4,2,2,0.011296048601406887,2019-03-28 14:00:00,2019-03-28 14:15:00
135,1,0,1,0.0031021264158466876,2019-03-28 14:00:00,2019-03-28 14:15:00
137,5,0,5,0.0031021264158466876,2019-03-28 14:00:00,2019-03-28 14:15:00
138,1,0,1,0.0031021264158466876,2019-03-28 14:00:00,2019-03-28 14:15:00
141,4,3,1,0.03290451645499783,2019-03-28 14:00:00,2019-03-28 14:15:00
147,2,2,0,0.007057748379395046,2019-03-28 14:00:00,2019-03-28 14:15:00
153,3,3,0,0.014101117600949337,2019-03-28 14:00:00,2019-03-28 14:15:00
156,1,1,0,0.005739207724878926,2019-03-28 14:00:00,2019-03-28 14:15:00
157,6,0,6,0.0031021264158466876,2019-03-28 14:00:00,2019-03-28 14:15:00
158,2,1,1,0.0206329440859356,2019-03-28 14:00:00,2019-03-28 14:15:00
159,1,0,1,0.0031021264158466876,2019-03-28 14:00:00,2019-03-28 14:15:00
160,2,1,1,0.0206329440859356,2019-03-28 14:00:00,2019-03-28 14:15:00
162,1,1,0,0.006494482786356627,2019-03-28 14:00:00,2019-03-28 14:15:00
164,2,2,0,0.011568108664842598,2019-03-28 14:00:00,2019-03-28 14:15:00
168,4,2,2,0.005739207724878926,2019-03-28 14:00:00,2019-03-28 14:15:00
169,3,3,0,0.004420667070362807,2019-03-28 14:00:00,2019-03-28 14:15:00
170,3,1,2,0.005395497605741806,2019-03-28 14:00:00,2019-03-28 14:15:00
172,1,0,1,0.0031021264158466876,2019-03-28 14:00:00,2019-03-28 14:15:00
173,1,0,1,0.0031021264158466876,2019-03-28 14:00:00,2019-03-28 14:15:00
189,2,0,2,0.0031021264158466876,2019-03-28 14:00:00,2019-03-28 14:15:00
191,4,2,2,0.008376289033911164,2019-03-28 14:00:00,2019-03-28 14:15:00
197,2,1,1,0.006187568406179731,2019-03-28 14:00:00,2019-03-28 14:15:00
199,1,1,0,0.006635929087480538,2019-03-28 14:00:00,2019-03-28 14:15:00
202,1,1,0,0.004420667070362807,2019-03-28 14:00:00,2019-03-28 14:15:00
2,2,1,1,0.004860911679255911,2019-03-28 14:15:00,2019-03-28 14:30:00
5,2,1,1,0.01228857757358429,2019-03-28 14:15:00,2019-03-28 14:30:00
10,3,2,1,0.027484460581114672,2019-03-28 14:15:00,2019-03-28 14:30:00
16,2,2,0,0.0075838748671563,2019-03-28 14:15:00,2019-03-28 14:30:00
18,3,1,2,0.0075432656121798836,2019-03-28 14:15:00,2019-03-28 14:30:00
19,6,5,1,0.0676067813799176,2019-03-28 14:15:00,2019-03-28 14:30:00
20,2,1,1,0.007611348893608684,2019-03-28 14:15:00,2019-03-28 14:30:00
21,3,0,3,0.003411068101832906,2019-03-28 14:15:00,2019-03-28 14:30:00
23,4,1,3,0.007611348893608684,2019-03-28 14:15:00,2019-03-28 14:30:00
26,2,1,1,0.022669782085258324,2019-03-28 14:15:00,2019-03-28 14:30:00
27,1,1,0,0.004331634306632135,2019-03-28 14:15:00,2019-03-28 14:30:00
35,2,0,2,0.003411068101832906,2019-03-28 14:15:00,2019-03-28 14:30:00
37,2,2,0,0.006310755256678916,2019-03-28 14:15:00,2019-03-28 14:30:00
41,2,2,0,0.008993109189602888,2019-03-28 14:15:00,2019-03-28 14:30:00
46,1,0,1,0.003411068101832906,2019-03-28 14:15:00,2019-03-28 14:30:00
50,2,2,0,0.005298196691580805,2019-03-28 14:15:00,2019-03-28 14:30:00
57,2,2,0,0.009210442411524928,2019-03-28 14:15:00,2019-03-28 14:30:00
58,2,1,1,0.004730511746102688,2019-03-28 14:15:00,2019-03-28 14:30:00
62,2,1,1,0.007611348893608684,2019-03-28 14:15:00,2019-03-28 14:30:00
64,1,1,0,0.007432427935820208,2019-03-28 14:15:00,2019-03-28 14:30:00
67,4,2,2,0.006310755256678917,2019-03-28 14:15:00,2019-03-28 14:30:00
69,2,1,1,0.0055679144328218515,2019-03-28 14:15:00,2019-03-28 14:30:00
74,5,3,2,0.018831191622118923,2019-03-28 14:15:00,2019-03-28 14:30:00
85,1,0,1,0.003411068101832906,2019-03-28 14:15:00,2019-03-28 14:30:00
86,2,0,2,0.003411068101832906,2019-03-28 14:15:00,2019-03-28 14:30:00
88,2,1,1,0.004860911679255911,2019-03-28 14:15:00,2019-03-28 14:30:00
90,1,0,1,0.003411068101832906,2019-03-28 14:15:00,2019-03-28 14:30:00
104,4,3,1,0.006970521595171699,2019-03-28 14:15:00,2019-03-28 14:30:00
109,3,0,3,0.003411068101832906,2019-03-28 14:15:00,2019-03-28 14:30:00
110,2,0,2,0.003411068101832906,2019-03-28 14:15:00,2019-03-28 14:30:00
111,1,1,0,0.004860911679255911,2019-03-28 14:15:00,2019-03-28 14:30:00
112,3,3,0,0.010624447918656809,2019-03-28 14:15:00,2019-03-28 14:30:00
113,3,1,2,0.009881607094799745,2019-03-28 14:15:00,2019-03-28 14:30:00
114,2,1,1,0.004860911679255911,2019-03-28 14:15:00,2019-03-28 14:30:00
115,1,1,0,0.0075432656121798836,2019-03-28 14:15:00,2019-03-28 14:30:00
116,2,2,0,0.0180579450719256,2019-03-28 14:15:00,2019-03-28 14:30:00
119,2,0,2,0.003411068101832906,2019-03-28 14:15:00,2019-03-28 14:30:00
122,1,0,1,0.003411068101832906,2019-03-28 14:15:00,2019-03-28 14:30:00
126,5,1,4,0.004331634306632135,2019-03-28 14:15:00,2019-03-28 14:30:00
135,2,0,2,0.003411068101832906,2019-03-28 14:15:00,2019-03-28 14:30:00
137,7,2,5,0.007760598834101923,2019-03-28 14:15:00,2019-03-28 14:30:00
138,3,1,2,0.009881607094799745,2019-03-28 14:15:00,2019-03-28 14:30:00
140,1,1,0,0.00661731248220763,2019-03-28 14:15:00,2019-03-28 14:30:00
141,2,1,1,0.004730511746102688,2019-03-28 14:15:00,2019-03-28 14:30:00
147,2,2,0,0.012382088109729098,2019-03-28 14:15:00,2019-03-28 14:30:00
151,2,2,0,0.005344192871730246,2019-03-28 14:15:00,2019-03-28 14:30:00
156,1,1,0,0.004860911679255911,2019-03-28 14:15:00,2019-03-28 14:30:00
157,4,0,4,0.003411068101832906,2019-03-28 14:15:00,2019-03-28 14:30:00
158,3,2,1,0.03142923293051722,2019-03-28 14:15:00,2019-03-28 14:30:00
164,1,0,1,0.003411068101832906,2019-03-28 14:15:00,2019-03-28 14:30:00
168,2,0,2,0.003411068101832906,2019-03-28 14:15:00,2019-03-28 14:30:00
169,3,3,0,0.005585833467967414,2019-03-28 14:15:00,2019-03-28 14:30:00
172,1,0,1,0.003411068101832906,2019-03-28 14:15:00,2019-03-28 14:30:00
173,1,0,1,0.003411068101832906,2019-03-28 14:15:00,2019-03-28 14:30:00
191,4,3,1,0.010442952767025893,2019-03-28 14:15:00,2019-03-28 14:30:00
197,2,0,2,0.003411068101832906,2019-03-28 14:15:00,2019-03-28 14:30:00
199,1,1,0,0.0093366782793124,2019-03-28 14:15:00,2019-03-28 14:30:00
202,2,2,0,0.010332115090666219,2019-03-28 14:15:00,2019-03-28 14:30:00
2,4,2,2,0.006688005663629195,2019-03-28 14:30:00,2019-03-28 14:45:00
5,3,2,1,0.00763981940100771,2019-03-28 14:30:00,2019-03-28 14:45:00
10,6,3,3,0.011404148545238166,2019-03-28 14:30:00,2019-03-28 14:45:00
16,8,5,3,0.01234346521729946,2019-03-28 14:30:00,2019-03-28 14:45:00
18,7,3,4,0.016609078588444282,2019-03-28 14:30:00,2019-03-28 14:45:00
19,6,4,2,0.021677794506459243,2019-03-28 14:30:00,2019-03-28 14:45:00
20,1,1,0,0.004603234162984306,2019-03-28 14:30:00,2019-03-28 14:45:00
21,1,0,1,0.003134857101217842,2019-03-28 14:30:00,2019-03-28 14:45:00
23,6,2,4,0.0058455484291106185,2019-03-28 14:30:00,2019-03-28 14:45:00
26,2,1,1,0.020715227076990878,2019-03-28 14:30:00,2019-03-28 14:45:00
27,1,1,0,0.004855727343573493,2019-03-28 14:30:00,2019-03-28 14:45:00
28,3,1,2,0.005799718523026357,2019-03-28 14:30:00,2019-03-28 14:45:00
35,1,0,1,0.003134857101217842,2019-03-28 14:30:00,2019-03-28 14:45:00
37,4,4,0,0.00728188597395381,2019-03-28 14:30:00,2019-03-28 14:45:00
40,2,0,2,0.003134857101217842,2019-03-28 14:30:00,2019-03-28 14:45:00
46,1,0,1,0.003134857101217842,2019-03-28 14:30:00,2019-03-28 14:45:00
50,9,5,4,0.016227358050840503,2019-03-28 14:30:00,2019-03-28 14:45:00
57,5,4,1,0.010050697062729394,2019-03-28 14:30:00,2019-03-28 14:45:00
58,1,0,1,0.003134857101217842,2019-03-28 14:30:00,2019-03-28 14:45:00
62,3,2,1,0.006688005663629195,2019-03-28 14:30:00,2019-03-28 14:45:00
64,2,2,0,0.023983934634886354,2019-03-28 14:30:00,2019-03-28 14:45:00
67,3,2,1,0.005799718523026357,2019-03-28 14:30:00,2019-03-28 14:45:00
68,3,1,2,0.005452333855842036,2019-03-28 14:30:00,2019-03-28 14:45:00
69,1,1,0,0.006632594307788687,2019-03-28 14:30:00,2019-03-28 14:45:00
70,1,0,1,0.003134857101217842,2019-03-28 14:30:00,2019-03-28 14:45:00
74,4,2,2,0.014027471539970172,2019-03-28 14:30:00,2019-03-28 14:45:00
85,3,3,0,0.00879671434907745,2019-03-28 14:30:00,2019-03-28 14:45:00
86,2,0,2,0.003134857101217842,2019-03-28 14:30:00,2019-03-28 14:45:00
87,1,1,0,0.006366502642296858,2019-03-28 14:30:00,2019-03-28 14:45:00
88,3,1,2,0.005799718523026357,2019-03-28 14:30:00,2019-03-28 14:45:00
90,2,0,2,0.003134857101217842,2019-03-28 14:30:00,2019-03-28 14:45:00
99,2,2,0,0.009479920278989064,2019-03-28 14:30:00,2019-03-28 14:45:00
104,5,3,2,0.007774275172372272,2019-03-28 14:30:00,2019-03-28 14:45:00
109,5,1,4,0.006632594307788687,2019-03-28 14:30:00,2019-03-28 14:45:00
110,2,1,1,0.0038188538563204014,2019-03-28 14:30:00,2019-03-28 14:45:00
111,5,3,2,0.009666162977815633,2019-03-28 14:30:00,2019-03-28 14:45:00
112,1,1,0,0.0072434458944550745,2019-03-28 14:30:00,2019-03-28 14:45:00
113,3,0,3,0.003134857101217842,2019-03-28 14:30:00,2019-03-28 14:45:00
114,1,0,1,0.003134857101217842,2019-03-28 14:30:00,2019-03-28 14:45:00
115,3,2,1,0.03696316634185967,2019-03-28 14:30:00,2019-03-28 14:45:00
116,6,4,2,0.015543043488214078,2019-03-28 14:30:00,2019-03-28 14:45:00
119,6,1,5,0.00402314424182068,2019-03-28 14:30:00,2019-03-28 14:45:00
122,2,1,1,0.006632594307788687,2019-03-28 14:30:00,2019-03-28 14:45:00
126,9,4,5,0.010121649357704897,2019-03-28 14:30:00,2019-03-28 14:45:00
127,2,2,0,0.02008269773654882,2019-03-28 14:30:00,2019-03-28 14:45:00
135,1,0,1,0.003134857101217842,2019-03-28 14:30:00,2019-03-28 14:45:00
137,11,5,6,0.010299653394897608,2019-03-28 14:30:00,2019-03-28 14:45:00
138,11,3,8,0.013818417366480991,2019-03-28 14:30:00,2019-03-28 14:45:00
140,2,2,0,0.007997120178993136,2019-03-28 14:30:00,2019-03-28 14:45:00
141,1,0,1,0.003134857101217842,2019-03-28 14:30:00,2019-03-28 14:45:00
147,2,1,1,0.009097243057048808,2019-03-28 14:30:00,2019-03-28 14:45:00
151,1,1,0,0.005799718523026357,2019-03-28 14:30:00,2019-03-28 14:45:00
153,1,1,0,0.004377171367344154,2019-03-28 14:30:00,2019-03-28 14:45:00
157,4,0,4,0.003134857101217842,2019-03-28 14:30:00,2019-03-28 14:45:00
158,6,5,1,0.021390033292290337,2019-03-28 14:30:00,2019-03-28 14:45:00
162,1,0,1,0.003134857101217842,2019-03-28 14:30:00,2019-03-28 14:45:00
168,3,0,3,0.003134857101217842,2019-03-28 14:30:00,2019-03-28 14:45:00
169,3,3,0,0.005133503167574228,2019-03-28 14:30:00,2019-03-28 14:45:00
170,1,1,0,0.004603234162984306,2019-03-28 14:30:00,2019-03-28 14:45:00
189,2,0,2,0.003134857101217842,2019-03-28 14:30:00,2019-03-28 14:45:00
190,2,0,2,0.003134857101217842,2019-03-28 14:30:00,2019-03-28 14:45:00
191,8,4,4,0.014927715201070318,2019-03-28 14:30:00,2019-03-28 14:45:00
196,1,0,1,0.003134857101217842,2019-03-28 14:30:00,2019-03-28 14:45:00
197,9,5,4,0.020568429493092434,2019-03-28 14:30:00,2019-03-28 14:45:00
199,1,1,0,0.006439293886272776,2019-03-28 14:30:00,2019-03-28 14:45:00
201,1,1,0,0.008773220760311411,2019-03-28 14:30:00,2019-03-28 14:45:00
202,1,1,0,0.004467287812122099,2019-03-28 14:30:00,2019-03-28 14:45:00
2,4,2,2,0.010807616131933612,2019-03-28 14:45:00,2019-03-28 15:00:00
5,2,2,0,0.007829514478776285,2019-03-28 14:45:00,2019-03-28 15:00:00
10,6,2,4,0.004806985304195905,2019-03-28 14:45:00,2019-03-28 15:00:00
15,1,1,0,0.005194231165882425,2019-03-28 14:45:00,2019-03-28 15:00:00
16,11,5,6,0.013825683082746109,2019-03-28 14:45:00,2019-03-28 15:00:00
18,12,8,4,0.01819327503782247,2019-03-28 14:45:00,2019-03-28 15:00:00
19,7,4,3,0.008827582714206805,2019-03-28 14:45:00,2019-03-28 15:00:00
20,1,0,1,0.003235357040392141,2019-03-28 14:45:00,2019-03-28 15:00:00
23,2,1,1,0.0045714276735193266,2019-03-28 14:45:00,2019-03-28 15:00:00
26,4,2,2,0.021370134443573933,2019-03-28 14:45:00,2019-03-28 15:00:00
27,2,0,2,0.003235357040392141,2019-03-28 14:45:00,2019-03-28 15:00:00
28,2,0,2,0.003235357040392141,2019-03-28 14:45:00,2019-03-28 15:00:00
30,2,2,0,0.014398293112220061,2019-03-28 14:45:00,2019-03-28 15:00:00
37,2,2,0,0.004986942921550601,2019-03-28 14:45:00,2019-03-28 15:00:00
40,3,1,2,0.004923735071595325,2019-03-28 14:45:00,2019-03-28 15:00:00
41,3,0,3,0.003235357040392141,2019-03-28 14:45:00,2019-03-28 15:00:00
46,1,1,0,0.004299374191163552,2019-03-28 14:45:00,2019-03-28 15:00:00
50,3,1,2,0.004256930319886266,2019-03-28 14:45:00,2019-03-28 15:00:00
57,6,2,4,0.009589961511986992,2019-03-28 14:45:00,2019-03-28 15:00:00
58,2,2,0,0.006648609887870669,2019-03-28 14:45:00,2019-03-28 15:00:00
62,3,2,1,0.007360769422714433,2019-03-28 14:45:00,2019-03-28 15:00:00
64,1,1,0,0.010197650827317592,2019-03-28 14:45:00,2019-03-28 15:00:00
67,4,3,1,0.010205511714031768,2019-03-28 14:45:00,2019-03-28 15:00:00
68,1,0,1,0.003235357040392141,2019-03-28 14:45:00,2019-03-28 15:00:00
69,3,3,0,0.010970031560585628,2019-03-28 14:45:00,2019-03-28 15:00:00
70,1,0,1,0.003235357040392141,2019-03-28 14:45:00,2019-03-28 15:00:00
74,1,1,0,0.01191095899902154,2019-03-28 14:45:00,2019-03-28 15:00:00
85,4,4,0,0.013243992843719753,2019-03-28 14:45:00,2019-03-28 15:00:00
86,2,0,2,0.003235357040392141,2019-03-28 14:45:00,2019-03-28 15:00:00
87,3,3,0,0.011210970321506863,2019-03-28 14:45:00,2019-03-28 15:00:00
88,4,0,4,0.003235357040392141,2019-03-28 14:45:00,2019-03-28 15:00:00
89,2,1,1,0.007101883685453881,2019-03-28 14:45:00,2019-03-28 15:00:00
90,2,0,2,0.003235357040392141,2019-03-28 14:45:00,2019-03-28 15:00:00
99,2,2,0,0.0050001539582942315,2019-03-28 14:45:00,2019-03-28 15:00:00
104,6,3,3,0.01096509897276109,2019-03-28 14:45:00,2019-03-28 15:00:00
108,1,1,0,0.007455236792483572,2019-03-28 14:45:00,2019-03-28 15:00:00
109,6,2,4,0.007944506087430619,2019-03-28 14:45:00,2019-03-28 15:00:00
110,5,3,2,0.028359579654667136,2019-03-28 14:45:00,2019-03-28 15:00:00
111,5,3,2,0.012602433528550273,2019-03-28 14:45:00,2019-03-28 15:00:00
112,4,2,2,0.00992802526350622,2019-03-28 14:45:00,2019-03-28 15:00:00
113,2,0,2,0.003235357040392141,2019-03-28 14:45:00,2019-03-28 15:00:00
115,1,0,1,0.003235357040392141,2019-03-28 14:45:00,2019-03-28 15:00:00
116,3,1,2,0.0063425036797927084,2019-03-28 14:45:00,2019-03-28 15:00:00
118,1,1,0,0.007121441032561436,2019-03-28 14:45:00,2019-03-28 15:00:00
119,7,2,5,0.006258248316653836,2019-03-28 14:45:00,2019-03-28 15:00:00
120,1,1,0,0.005273472427096571,2019-03-28 14:45:00,2019-03-28 15:00:00
122,1,1,0,0.005931217498773985,2019-03-28 14:45:00,2019-03-28 15:00:00
126,5,3,2,0.010342696980579186,2019-03-28 14:45:00,2019-03-28 15:00:00
127,4,3,1,0.011513915160822032,2019-03-28 14:45:00,2019-03-28 15:00:00
133,1,1,0,0.009281004436541658,2019-03-28 14:45:00,2019-03-28 15:00:00
135,1,0,1,0.003235357040392141,2019-03-28 14:45:00,2019-03-28 15:00:00
137,11,6,5,0.0186877570620885,2019-03-28 14:45:00,2019-03-28 15:00:00
138,14,4,10,0.015716737633775325,2019-03-28 14:45:00,2019-03-28 15:00:00
140,3,2,1,0.007111867934002809,2019-03-28 14:45:00,2019-03-28 15:00:00
141,3,0,3,0.003235357040392141,2019-03-28 14:45:00,2019-03-28 15:00:00
147,1,0,1,0.003235357040392141,2019-03-28 14:45:00,2019-03-28 15:00:00
153,3,1,2,0.007121441032561436,2019-03-28 14:45:00,2019-03-28 15:00:00
154,1,0,1,0.003235357040392141,2019-03-28 14:45:00,2019-03-28 15:00:00
156,2,1,1,0.005985631961940336,2019-03-28 14:45:00,2019-03-28 15:00:00
157,5,0,5,0.003235357040392141,2019-03-28 14:45:00,2019-03-28 15:00:00
158,4,3,1,0.008190129442942234,2019-03-28 14:45:00,2019-03-28 15:00:00
159,1,0,1,0.003235357040392141,2019-03-28 14:45:00,2019-03-28 15:00:00
160,1,1,0,0.005985631961940336,2019-03-28 14:45:00,2019-03-28 15:00:00
162,1,0,1,0.003235357040392141,2019-03-28 14:45:00,2019-03-28 15:00:00
168,2,1,1,0.007829121394608955,2019-03-28 14:45:00,2019-03-28 15:00:00
169,3,3,0,0.004885521993321058,2019-03-28 14:45:00,2019-03-28 15:00:00
170,2,2,0,0.006530301799009611,2019-03-28 14:45:00,2019-03-28 15:00:00
171,2,1,1,0.0045714276735193266,2019-03-28 14:45:00,2019-03-28 15:00:00
172,2,2,0,0.00725926198697544,2019-03-28 14:45:00,2019-03-28 15:00:00
177,1,1,0,0.005931217498773985,2019-03-28 14:45:00,2019-03-28 15:00:00
190,2,2,0,0.00714466526538831,2019-03-28 14:45:00,2019-03-28 15:00:00
191,5,1,4,0.004152115347574873,2019-03-28 14:45:00,2019-03-28 15:00:00
195,1,0,1,0.003235357040392141,2019-03-28 14:45:00,2019-03-28 15:00:00
196,2,0,2,0.003235357040392141,2019-03-28 14:45:00,2019-03-28 15:00:00
197,11,6,5,0.022059729638785476,2019-03-28 14:45:00,2019-03-28 15:00:00
199,1,1,0,0.0063425036797927084,2019-03-28 14:45:00,2019-03-28 15:00:00
202,1,1,0,0.004610494501166238,2019-03-28 14:45:00,2019-03-28 15:00:00
1,1,1,0,0.012828553102658041,2019-03-28 15:00:00,2019-03-28 15:15:00
2,4,3,1,0.02057331045384108,2019-03-28 15:00:00,2019-03-28 15:15:00
5,2,2,0,0.005733208051859924,2019-03-28 15:00:00,2019-03-28 15:15:00
10,4,1,3,0.004079518580044125,2019-03-28 15:00:00,2019-03-28 15:15:00
15,2,1,1,0.00364509051999569,2019-03-28 15:00:00,2019-03-28 15:15:00
16,7,2,5,0.004243949248064853,2019-03-28 15:00:00,2019-03-28 15:15:00
18,16,13,3,0.02457083926393832,2019-03-28 15:00:00,2019-03-28 15:15:00
19,5,2,3,0.007802057986670927,2019-03-28 15:00:00,2019-03-28 15:15:00
20,2,1,1,0.004542490740714471,2019-03-28 15:00:00,2019-03-28 15:15:00
21,1,0,1,0.0029235594248684616,2019-03-28 15:00:00,2019-03-28 15:15:00
23,6,3,3,0.006041994774605336,2019-03-28 15:00:00,2019-03-28 15:15:00
26,3,1,2,0.005084785468299177,2019-03-28 15:00:00,2019-03-28 15:15:00
27,4,1,3,0.005574584127280935,2019-03-28 15:00:00,2019-03-28 15:15:00
28,1,1,0,0.004844502271052395,2019-03-28 15:00:00,2019-03-28 15:15:00
30,3,1,2,0.00540877496028401,2019-03-28 15:00:00,2019-03-28 15:15:00
35,1,0,1,0.0029235594248684616,2019-03-28 15:00:00,2019-03-28 15:15:00
37,4,2,2,0.006641019672481643,2019-03-28 15:00:00,2019-03-28 15:15:00
40,6,1,5,0.0035224181529376246,2019-03-28 15:00:00,2019-03-28 15:15:00
41,4,2,2,0.007521400362341059,2019-03-28 15:00:00,2019-03-28 15:15:00
46,3,1,2,0.005084785468299177,2019-03-28 15:00:00,2019-03-28 15:15:00
57,4,1,3,0.00364509051999569,2019-03-28 15:00:00,2019-03-28 15:15:00
58,5,4,1,0.012624510055750621,2019-03-28 15:00:00,2019-03-28 15:15:00
61,1,1,0,0.0045031634961493015,2019-03-28 15:00:00,2019-03-28 15:15:00
62,2,2,0,0.016300378610770598,2019-03-28 15:00:00,2019-03-28 15:15:00
64,1,1,0,0.004411832675104096,2019-03-28 15:00:00,2019-03-28 15:15:00
66,1,0,1,0.0029235594248684616,2019-03-28 15:00:00,2019-03-28 15:15:00
67,4,3,1,0.007130817808142024,2019-03-28 15:00:00,2019-03-28 15:15:00
68,2,2,0,0.014483981794411047,2019-03-28 15:00:00,2019-03-28 15:15:00
69,4,4,0,0.009333067365072839,2019-03-28 15:00:00,2019-03-28 15:15:00
70,1,1,0,0.005084785468299177,2019-03-28 15:00:00,2019-03-28 15:15:00
74,2,2,0,0.010003123044004617,2019-03-28 15:00:00,2019-03-28 15:15:00
85,3,1,2,0.003956418548437086,2019-03-28 15:00:00,2019-03-28 15:15:00
86,3,1,2,0.003751964603340311,2019-03-28 15:00:00,2019-03-28 15:15:00
87,9,7,2,0.0267029667688879,2019-03-28 15:00:00,2019-03-28 15:15:00
88,4,1,3,0.007125546855754322,2019-03-28 15:00:00,2019-03-28 15:15:00
89,3,1,2,0.009885986055288388,2019-03-28 15:00:00,2019-03-28 15:15:00
90,2,0,2,0.0029235594248684616,2019-03-28 15:00:00,2019-03-28 15:15:00
99,2,2,0,0.00540877496028401,2019-03-28 15:00:00,2019-03-28 15:15:00
104,6,4,2,0.017992569871244722,2019-03-28 15:00:00,2019-03-28 15:15:00
108,1,1,0,0.0039413938053741255,2019-03-28 15:00:00,2019-03-28 15:15:00
109,5,2,3,0.0067791366171103705,2019-03-28 15:00:00,2019-03-28 15:15:00
110,8,6,2,0.06530805912613194,2019-03-28 15:00:00,2019-03-28 15:15:00
111,3,1,2,0.00380894148397948,2019-03-28 15:00:00,2019-03-28 15:15:00
112,7,2,5,0.005986754537871841,2019-03-28 15:00:00,2019-03-28 15:15:00
113,2,0,2,0.0029235594248684616,2019-03-28 15:00:00,2019-03-28 15:15:00
116,2,0,2,0.0029235594248684616,2019-03-28 15:00:00,2019-03-28 15:15:00
119,3,0,3,0.0029235594248684616,2019-03-28 15:00:00,2019-03-28 15:15:00
120,2,2,0,0.008054036093480037,2019-03-28 15:00:00,2019-03-28 15:15:00
122,2,2,0,0.006087110038760169,2019-03-28 15:00:00,2019-03-28 15:15:00
126,4,2,2,0.008062535356771252,2019-03-28 15:00:00,2019-03-28 15:15:00
127,1,0,1,0.0029235594248684616,2019-03-28 15:00:00,2019-03-28 15:15:00
129,1,0,1,0.0029235594248684616,2019-03-28 15:00:00,2019-03-28 15:15:00
137,10,5,5,0.01919490622724613,2019-03-28 15:00:00,2019-03-28 15:15:00
138,7,1,6,0.004079518580044125,2019-03-28 15:00:00,2019-03-28 15:15:00
140,5,3,2,0.009640446963836286,2019-03-28 15:00:00,2019-03-28 15:15:00
141,5,1,4,0.004166167192576236,2019-03-28 15:00:00,2019-03-28 15:15:00
153,3,0,3,0.0029235594248684616,2019-03-28 15:00:00,2019-03-28 15:15:00
154,1,0,1,0.0029235594248684616,2019-03-28 15:00:00,2019-03-28 15:15:00
156,4,2,2,0.006237180138755859,2019-03-28 15:00:00,2019-03-28 15:15:00
157,3,0,3,0.0029235594248684616,2019-03-28 15:00:00,2019-03-28 15:15:00
158,3,1,2,0.0035015390024562927,2019-03-28 15:00:00,2019-03-28 15:15:00
162,2,1,1,0.014273689716123462,2019-03-28 15:00:00,2019-03-28 15:15:00
164,2,0,2,0.0029235594248684616,2019-03-28 15:00:00,2019-03-28 15:15:00
168,4,2,2,0.02330237087877558,2019-03-28 15:00:00,2019-03-28 15:15:00
169,3,3,0,0.00540877496028401,2019-03-28 15:00:00,2019-03-28 15:15:00
170,2,1,1,0.00364509051999569,2019-03-28 15:00:00,2019-03-28 15:15:00
171,1,1,0,0.0035015390024562927,2019-03-28 15:00:00,2019-03-28 15:15:00
172,2,2,0,0.013768158394495904,2019-03-28 15:00:00,2019-03-28 15:15:00
173,1,1,0,0.003751964603340311,2019-03-28 15:00:00,2019-03-28 15:15:00
175,1,1,0,0.004844502271052395,2019-03-28 15:00:00,2019-03-28 15:15:00
177,1,1,0,0.004166167192576236,2019-03-28 15:00:00,2019-03-28 15:15:00
189,7,3,4,0.01359408618307269,2019-03-28 15:00:00,2019-03-28 15:15:00
191,2,0,2,0.0029235594248684616,2019-03-28 15:00:00,2019-03-28 15:15:00
195,3,0,3,0.0029235594248684616,2019-03-28 15:00:00,2019-03-28 15:15:00
197,9,5,4,0.01555867921938103,2019-03-28 15:00:00,2019-03-28 15:15:00
199,3,3,0,0.013750335366647149,2019-03-28 15:00:00,2019-03-28 15:15:00
201,1,0,1,0.0029235594248684616,2019-03-28 15:00:00,2019-03-28 15:15:00
202,2,1,1,0.004166167192576236,2019-03-28 15:00:00,2019-03-28 15:15:00
203,2,1,1,0.00618704929720621,2019-03-28 15:00:00,2019-03-28 15:15:00
1,4,4,0,0.027370977278901417,2019-03-28 15:15:00,2019-03-28 15:30:00
2,3,2,1,0.01150909721413186,2019-03-28 15:15:00,2019-03-28 15:30:00
5,1,1,0,0.005211678072802426,2019-03-28 15:15:00,2019-03-28 15:30:00
10,3,1,2,0.004899517940417115,2019-03-28 15:15:00,2019-03-28 15:30:00
15,2,0,2,0.0028170097048476283,2019-03-28 15:15:00,2019-03-28 15:30:00
16,4,1,3,0.0039308588460877725,2019-03-28 15:15:00,2019-03-28 15:30:00
18,15,9,6,0.02428178225951915,2019-03-28 15:15:00,2019-03-28 15:30:00
19,7,5,2,0.01260982822290678,2019-03-28 15:15:00,2019-03-28 15:30:00
20,8,3,5,0.008013375002564167,2019-03-28 15:15:00,2019-03-28 15:30:00
21,4,0,4,0.0028170097048476283,2019-03-28 15:15:00,2019-03-28 15:30:00
23,4,2,2,0.005899972525150189,2019-03-28 15:15:00,2019-03-28 15:30:00
26,1,0,1,0.0028170097048476283,2019-03-28 15:15:00,2019-03-28 15:30:00
27,2,2,0,0.009273511501067696,2019-03-28 15:15:00,2019-03-28 15:30:00
28,1,1,0,0.003843572202684621,2019-03-28 15:15:00,2019-03-28 15:30:00
30,2,0,2,0.0028170097048476283,2019-03-28 15:15:00,2019-03-28 15:30:00
35,2,1,1,0.004934725614984089,2019-03-28 15:15:00,2019-03-28 15:30:00
37,2,1,1,0.0040143438888250275,2019-03-28 15:15:00,2019-03-28 15:30:00
40,1,0,1,0.0028170097048476283,2019-03-28 15:15:00,2019-03-28 15:30:00
41,2,2,0,0.005211678072802426,2019-03-28 15:15:00,2019-03-28 15:30:00
46,7,2,5,0.007539195535128079,2019-03-28 15:15:00,2019-03-28 15:30:00
50,1,1,0,0.007673187548244377,2019-03-28 15:15:00,2019-03-28 15:30:00
57,4,2,2,0.0049574213439247655,2019-03-28 15:15:00,2019-03-28 15:30:00
58,6,4,2,0.011424826820548453,2019-03-28 15:15:00,2019-03-28 15:30:00
62,4,4,0,0.0108234662546106,2019-03-28 15:15:00,2019-03-28 15:30:00
64,4,3,1,0.05714110095207846,2019-03-28 15:15:00,2019-03-28 15:30:00
66,1,0,1,0.0028170097048476283,2019-03-28 15:15:00,2019-03-28 15:30:00
67,7,5,2,0.013403810371285223,2019-03-28 15:15:00,2019-03-28 15:30:00
68,4,4,0,0.01442988555485081,2019-03-28 15:15:00,2019-03-28 15:30:00
69,4,3,1,0.017317948892681824,2019-03-28 15:15:00,2019-03-28 15:30:00
70,1,1,0,0.00409883735935755,2019-03-28 15:15:00,2019-03-28 15:30:00
74,4,2,2,0.011272629085635248,2019-03-28 15:15:00,2019-03-28 15:30:00
85,3,1,2,0.004934725614984089,2019-03-28 15:15:00,2019-03-28 15:30:00
86,3,1,2,0.0036847977538486095,2019-03-28 15:15:00,2019-03-28 15:30:00
87,5,2,3,0.009784709269963252,2019-03-28 15:15:00,2019-03-28 15:30:00
88,2,1,1,0.008176817830147095,2019-03-28 15:15:00,2019-03-28 15:30:00
90,2,0,2,0.0028170097048476283,2019-03-28 15:15:00,2019-03-28 15:30:00
99,2,2,0,0.005957781639015338,2019-03-28 15:15:00,2019-03-28 15:30:00
104,4,3,1,0.010999310361087117,2019-03-28 15:15:00,2019-03-28 15:30:00
106,1,0,1,0.0028170097048476283,2019-03-28 15:15:00,2019-03-28 15:30:00
108,1,1,0,0.01753928065077094,2019-03-28 15:15:00,2019-03-28 15:30:00
109,7,2,5,0.006037975684067756,2019-03-28 15:15:00,2019-03-28 15:30:00
110,5,3,2,0.034543538522680904,2019-03-28 15:15:00,2019-03-28 15:30:00
111,5,1,4,0.009964415558119392,2019-03-28 15:15:00,2019-03-28 15:30:00
112,6,3,3,0.009734108641386987,2019-03-28 15:15:00,2019-03-28 15:30:00
113,4,1,3,0.0036152324941658943,2019-03-28 15:15:00,2019-03-28 15:30:00
114,2,1,1,0.004179450871334008,2019-03-28 15:15:00,2019-03-28 15:30:00
116,3,1,2,0.003841419291349045,2019-03-28 15:15:00,2019-03-28 15:30:00
118,2,2,0,0.009697726056388684,2019-03-28 15:15:00,2019-03-28 15:30:00
119,2,0,2,0.0028170097048476283,2019-03-28 15:15:00,2019-03-28 15:30:00
120,3,2,1,0.006728403617374918,2019-03-28 15:15:00,2019-03-28 15:30:00
122,3,3,0,0.006074995066830234,2019-03-28 15:15:00,2019-03-28 15:30:00
126,7,3,4,0.007863796671564904,2019-03-28 15:15:00,2019-03-28 15:30:00
127,4,2,2,0.005380665013867473,2019-03-28 15:15:00,2019-03-28 15:30:00
129,4,0,4,0.0028170097048476283,2019-03-28 15:15:00,2019-03-28 15:30:00
133,1,0,1,0.0028170097048476283,2019-03-28 15:15:00,2019-03-28 15:30:00
137,6,3,3,0.008367142057171486,2019-03-28 15:15:00,2019-03-28 15:30:00
138,4,2,2,0.006181345594927036,2019-03-28 15:15:00,2019-03-28 15:30:00
140,3,1,2,0.0040143438888250275,2019-03-28 15:15:00,2019-03-28 15:30:00
141,6,5,1,0.00840766833403957,2019-03-28 15:15:00,2019-03-28 15:30:00
147,1,0,1,0.0028170097048476283,2019-03-28 15:15:00,2019-03-28 15:30:00
151,3,3,0,0.007481594160874516,2019-03-28 15:15:00,2019-03-28 15:30:00
153,6,1,5,0.0051040641247798516,2019-03-28 15:15:00,2019-03-28 15:30:00
154,3,1,2,0.005211678072802426,2019-03-28 15:15:00,2019-03-28 15:30:00
156,2,1,1,0.0034156767968363277,2019-03-28 15:15:00,2019-03-28 15:30:00
157,6,0,6,0.0028170097048476283,2019-03-28 15:15:00,2019-03-28 15:30:00
158,1,0,1,0.0028170097048476283,2019-03-28 15:15:00,2019-03-28 15:30:00
162,2,1,1,0.005589700859099666,2019-03-28 15:15:00,2019-03-28 15:30:00
164,5,2,3,0.011881077894207467,2019-03-28 15:15:00,2019-03-28 15:30:00
168,5,3,2,0.01526096352669108,2019-03-28 15:15:00,2019-03-28 15:30:00
169,3,3,0,0.0040143438888250275,2019-03-28 15:15:00,2019-03-28 15:30:00
170,1,0,1,0.0028170097048476283,2019-03-28 15:15:00,2019-03-28 15:30:00
172,1,0,1,0.0028170097048476283,2019-03-28 15:15:00,2019-03-28 15:30:00
173,1,1,0,0.0036152324941658943,2019-03-28 15:15:00,2019-03-28 15:30:00
175,1,1,0,0.003843572202684621,2019-03-28 15:15:00,2019-03-28 15:30:00
189,5,1,4,0.006257367880618156,2019-03-28 15:15:00,2019-03-28 15:30:00
190,1,0,1,0.0028170097048476283,2019-03-28 15:15:00,2019-03-28 15:30:00
191,5,2,3,0.005541892037820387,2019-03-28 15:15:00,2019-03-28 15:30:00
195,3,0,3,0.0028170097048476283,2019-03-28 15:15:00,2019-03-28 15:30:00
196,1,1,0,0.004924126542827612,2019-03-28 15:15:00,2019-03-28 15:30:00
197,5,2,3,0.0060565940626506245,2019-03-28 15:15:00,2019-03-28 15:30:00
199,4,3,1,0.017320630251844153,2019-03-28 15:15:00,2019-03-28 15:30:00
201,1,1,0,0.004523264182487117,2019-03-28 15:15:00,2019-03-28 15:30:00
202,4,4,0,0.006409012256779825,2019-03-28 15:15:00,2019-03-28 15:30:00
203,3,1,2,0.005187980945082108,2019-03-28 15:15:00,2019-03-28 15:30:00
1,4,4,0,0.011686652994108877,2019-03-28 15:30:00,2019-03-28 15:45:00
2,2,2,0,0.004700063149726281,2019-03-28 15:30:00,2019-03-28 15:45:00
5,1,1,0,0.005519450606457298,2019-03-28 15:30:00,2019-03-28 15:45:00
10,2,1,1,0.018413279646033218,2019-03-28 15:30:00,2019-03-28 15:45:00
15,3,0,3,0.002773058233112767,2019-03-28 15:30:00,2019-03-28 15:45:00
16,7,1,6,0.0032307902953368555,2019-03-28 15:30:00,2019-03-28 15:45:00
18,11,6,5,0.017525551577287878,2019-03-28 15:30:00,2019-03-28 15:45:00
19,8,4,4,0.015695478698717073,2019-03-28 15:30:00,2019-03-28 15:45:00
20,5,1,4,0.003692410918880505,2019-03-28 15:30:00,2019-03-28 15:45:00
21,3,0,3,0.002773058233112767,2019-03-28 15:30:00,2019-03-28 15:45:00
23,6,4,2,0.012479453121500925,2019-03-28 15:30:00,2019-03-28 15:45:00
26,1,0,1,0.002773058233112767,2019-03-28 15:30:00,2019-03-28 15:45:00
27,1,1,0,0.005797403086694767,2019-03-28 15:30:00,2019-03-28 15:45:00
28,3,1,2,0.0035360835502155994,2019-03-28 15:30:00,2019-03-28 15:45:00
30,1,0,1,0.002773058233112767,2019-03-28 15:30:00,2019-03-28 15:45:00
35,1,1,0,0.0036222168423268516,2019-03-28 15:30:00,2019-03-28 15:45:00
37,7,4,3,0.013341819685830019,2019-03-28 15:30:00,2019-03-28 15:45:00
40,2,1,1,0.0032307902953368555,2019-03-28 15:30:00,2019-03-28 15:45:00
41,4,4,0,0.012259458852856859,2019-03-28 15:30:00,2019-03-28 15:45:00
46,5,1,4,0.0057527660878323224,2019-03-28 15:30:00,2019-03-28 15:45:00
50,2,2,0,0.005242649307366993,2019-03-28 15:30:00,2019-03-28 15:45:00
57,1,1,0,0.0035360835502155994,2019-03-28 15:30:00,2019-03-28 15:45:00
58,6,2,4,0.007402724123834194,2019-03-28 15:30:00,2019-03-28 15:45:00
62,3,3,0,0.007663199685430996,2019-03-28 15:30:00,2019-03-28 15:45:00
64,9,5,4,0.04339635266384968,2019-03-28 15:30:00,2019-03-28 15:45:00
66,1,1,0,0.0057527660878323224,2019-03-28 15:30:00,2019-03-28 15:45:00
67,8,6,2,0.017170471121897637,2019-03-28 15:30:00,2019-03-28 15:45:00
68,3,3,0,0.014667140673582402,2019-03-28 15:30:00,2019-03-28 15:45:00
69,5,2,3,0.013341189801187998,2019-03-28 15:30:00,2019-03-28 15:45:00
70,2,2,0,0.004543886538220289,2019-03-28 15:30:00,2019-03-28 15:45:00
74,4,1,3,0.010071362292065296,2019-03-28 15:30:00,2019-03-28 15:45:00
80,1,1,0,0.005008997954998498,2019-03-28 15:30:00,2019-03-28 15:45:00
85,3,2,1,0.00616093844802223,2019-03-28 15:30:00,2019-03-28 15:45:00
86,3,1,2,0.005030823560447712,2019-03-28 15:30:00,2019-03-28 15:45:00
87,3,0,3,0.002773058233112767,2019-03-28 15:30:00,2019-03-28 15:45:00
88,4,3,1,0.009074437942256205,2019-03-28 15:30:00,2019-03-28 15:45:00
89,1,0,1,0.002773058233112767,2019-03-28 15:30:00,2019-03-28 15:45:00
90,5,3,2,0.013318190343920086,2019-03-28 15:30:00,2019-03-28 15:45:00
99,2,2,0,0.007226413876475919,2019-03-28 15:30:00,2019-03-28 15:45:00
104,4,3,1,0.008808466310812802,2019-03-28 15:30:00,2019-03-28 15:45:00
106,1,0,1,0.002773058233112767,2019-03-28 15:30:00,2019-03-28 15:45:00
108,1,1,0,0.0065535655146201095,2019-03-28 15:30:00,2019-03-28 15:45:00
109,8,3,5,0.00448800775013131,2019-03-28 15:30:00,2019-03-28 15:45:00
110,5,3,2,0.03405350105895366,2019-03-28 15:30:00,2019-03-28 15:45:00
111,5,1,4,0.003995659400577689,2019-03-28 15:30:00,2019-03-28 15:45:00
112,6,4,2,0.011537028660460743,2019-03-28 15:30:00,2019-03-28 15:45:00
113,4,1,3,0.005528911255280371,2019-03-28 15:30:00,2019-03-28 15:45:00
114,2,1,1,0.0035577600463115957,2019-03-28 15:30:00,2019-03-28 15:45:00
116,5,2,3,0.005913049480606926,2019-03-28 15:30:00,2019-03-28 15:45:00
118,2,2,0,0.008732473942551878,2019-03-28 15:30:00,2019-03-28 15:45:00
119,6,3,3,0.005997010505965992,2019-03-28 15:30:00,2019-03-28 15:45:00
120,6,4,2,0.008586100781029731,2019-03-28 15:30:00,2019-03-28 15:45:00
122,4,3,1,0.008749419486981705,2019-03-28 15:30:00,2019-03-28 15:45:00
126,11,5,6,0.01578105437088923,2019-03-28 15:30:00,2019-03-28 15:45:00
127,4,2,2,0.00521826056804261,2019-03-28 15:30:00,2019-03-28 15:45:00
129,3,2,1,0.004299108867318432,2019-03-28 15:30:00,2019-03-28 15:45:00
133,1,0,1,0.002773058233112767,2019-03-28 15:30:00,2019-03-28 15:45:00
137,10,5,5,0.012821352844714902,2019-03-28 15:30:00,2019-03-28 15:45:00
138,8,2,6,0.0038695125083979677,2019-03-28 15:30:00,2019-03-28 15:45:00
140,3,1,2,0.008434167929069631,2019-03-28 15:30:00,2019-03-28 15:45:00
141,11,7,4,0.01653894816306785,2019-03-28 15:30:00,2019-03-28 15:45:00
147,2,1,1,0.00513034096085237,2019-03-28 15:30:00,2019-03-28 15:45:00
151,4,4,0,0.012935497867173271,2019-03-28 15:30:00,2019-03-28 15:45:00
153,3,1,2,0.005311779838808145,2019-03-28 15:30:00,2019-03-28 15:45:00
154,5,0,5,0.002773058233112767,2019-03-28 15:30:00,2019-03-28 15:45:00
156,1,1,0,0.005528911255280371,2019-03-28 15:30:00,2019-03-28 15:45:00
157,7,1,6,0.004339776266536789,2019-03-28 15:30:00,2019-03-28 15:45:00
158,2,1,1,0.0032307902953368555,2019-03-28 15:30:00,2019-03-28 15:45:00
159,2,1,1,0.005626961139003765,2019-03-28 15:30:00,2019-03-28 15:45:00
162,1,1,0,0.003558819142359301,2019-03-28 15:30:00,2019-03-28 15:45:00
164,9,4,5,0.014931720664574521,2019-03-28 15:30:00,2019-03-28 15:45:00
168,2,0,2,0.002773058233112767,2019-03-28 15:30:00,2019-03-28 15:45:00
169,3,3,0,0.004617652744323533,2019-03-28 15:30:00,2019-03-28 15:45:00
170,2,2,0,0.005778977563497795,2019-03-28 15:30:00,2019-03-28 15:45:00
171,1,0,1,0.002773058233112767,2019-03-28 15:30:00,2019-03-28 15:45:00
173,6,2,4,0.004217603230939457,2019-03-28 15:30:00,2019-03-28 15:45:00
175,1,1,0,0.0035360835502155994,2019-03-28 15:30:00,2019-03-28 15:45:00
189,1,0,1,0.002773058233112767,2019-03-28 15:30:00,2019-03-28 15:45:00
190,3,1,2,0.007676891825661748,2019-03-28 15:30:00,2019-03-28 15:45:00
191,5,3,2,0.005238779719694513,2019-03-28 15:30:00,2019-03-28 15:45:00
195,6,2,4,0.012966883342018953,2019-03-28 15:30:00,2019-03-28 15:45:00
196,4,2,2,0.008961254937759646,2019-03-28 15:30:00,2019-03-28 15:45:00
197,4,1,3,0.0032445147786606876,2019-03-28 15:30:00,2019-03-28 15:45:00
199,1,1,0,0.010261234584782203,2019-03-28 15:30:00,2019-03-28 15:45:00
202,1,1,0,0.003558819142359301,2019-03-28 15:30:00,2019-03-28 15:45:00
203,5,1,4,0.0035214217858564787,2019-03-28 15:30:00,2019-03-28 15:45:00
1,6,5,1,0.008467484707832576,2019-03-28 15:45:00,2019-03-28 16:00:00
2,4,4,0,0.005061210223978211,2019-03-28 15:45:00,2019-03-28 16:00:00
5,5,2,3,0.004775036890113175,2019-03-28 15:45:00,2019-03-28 16:00:00
10,5,4,1,0.0902613359189987,2019-03-28 15:45:00,2019-03-28 16:00:00
15,5,3,2,0.007651010295244782,2019-03-28 15:45:00,2019-03-28 16:00:00
16,6,4,2,0.008911038596970098,2019-03-28 15:45:00,2019-03-28 16:00:00
18,7,3,4,0.013795224342719774,2019-03-28 15:45:00,2019-03-28 16:00:00
19,5,3,2,0.01784861311555499,2019-03-28 15:45:00,2019-03-28 16:00:00
20,4,2,2,0.0056032064853298105,2019-03-28 15:45:00,2019-03-28 16:00:00
21,1,0,1,0.002201983569992228,2019-03-28 15:45:00,2019-03-28 16:00:00
22,1,0,1,0.002201983569992228,2019-03-28 15:45:00,2019-03-28 16:00:00
23,2,2,0,0.0056032064853298105,2019-03-28 15:45:00,2019-03-28 16:00:00
26,5,1,4,0.009400378210913631,2019-03-28 15:45:00,2019-03-28 16:00:00
27,1,0,1,0.002201983569992228,2019-03-28 15:45:00,2019-03-28 16:00:00
28,3,1,2,0.003361099623909439,2019-03-28 15:45:00,2019-03-28 16:00:00
30,2,2,0,0.003607084893856606,2019-03-28 15:45:00,2019-03-28 16:00:00
35,1,0,1,0.002201983569992228,2019-03-28 15:45:00,2019-03-28 16:00:00
37,3,1,2,0.014187442736699451,2019-03-28 15:45:00,2019-03-28 16:00:00
40,2,0,2,0.002201983569992228,2019-03-28 15:45:00,2019-03-28 16:00:00
41,5,4,1,0.022098948628223723,2019-03-28 15:45:00,2019-03-28 16:00:00
46,5,1,4,0.0034593112527418956,2019-03-28 15:45:00,2019-03-28 16:00:00
50,1,1,0,0.007216696375335593,2019-03-28 15:45:00,2019-03-28 16:00:00
57,4,2,2,0.007085378219934176,2019-03-28 15:45:00,2019-03-28 16:00:00
58,8,3,5,0.008995354347923451,2019-03-28 15:45:00,2019-03-28 16:00:00
62,3,3,0,0.005034052931612829,2019-03-28 15:45:00,2019-03-28 16:00:00
64,5,3,2,0.05466876078924378,2019-03-28 15:45:00,2019-03-28 16:00:00
66,5,3,2,0.007474854204297771,2019-03-28 15:45:00,2019-03-28 16:00:00
67,6,4,2,0.011797530545471616,2019-03-28 15:45:00,2019-03-28 16:00:00
68,1,1,0,0.0038391265788266286,2019-03-28 15:45:00,2019-03-28 16:00:00
69,4,2,2,0.006510106730274254,2019-03-28 15:45:00,2019-03-28 16:00:00
70,2,2,0,0.0036297490287105407,2019-03-28 15:45:00,2019-03-28 16:00:00
74,5,2,3,0.008152606686622139,2019-03-28 15:45:00,2019-03-28 16:00:00
79,1,1,0,0.003707590586175134,2019-03-28 15:45:00,2019-03-28 16:00:00
80,1,1,0,0.003271018640723081,2019-03-28 15:45:00,2019-03-28 16:00:00
85,3,1,2,0.0038297817866395443,2019-03-28 15:45:00,2019-03-28 16:00:00
86,3,1,2,0.0031378938812787745,2019-03-28 15:45:00,2019-03-28 16:00:00
87,2,1,1,0.004073804192565321,2019-03-28 15:45:00,2019-03-28 16:00:00
88,1,1,0,0.0031378938812787745,2019-03-28 15:45:00,2019-03-28 16:00:00
89,1,0,1,0.002201983569992228,2019-03-28 15:45:00,2019-03-28 16:00:00
90,7,5,2,0.007814128407673482,2019-03-28 15:45:00,2019-03-28 16:00:00
99,1,1,0,0.004199867342663601,2019-03-28 15:45:00,2019-03-28 16:00:00
104,8,7,1,0.023800339204432933,2019-03-28 15:45:00,2019-03-28 16:00:00
106,1,0,1,0.002201983569992228,2019-03-28 15:45:00,2019-03-28 16:00:00
109,5,1,4,0.005454040728854662,2019-03-28 15:45:00,2019-03-28 16:00:00
110,2,1,1,0.002802537734378655,2019-03-28 15:45:00,2019-03-28 16:00:00
111,2,1,1,0.002937147283212353,2019-03-28 15:45:00,2019-03-28 16:00:00
112,7,3,4,0.007555064612471709,2019-03-28 15:45:00,2019-03-28 16:00:00
113,3,0,3,0.002201983569992228,2019-03-28 15:45:00,2019-03-28 16:00:00
114,1,0,1,0.002201983569992228,2019-03-28 15:45:00,2019-03-28 16:00:00
115,1,0,1,0.002201983569992228,2019-03-28 15:45:00,2019-03-28 16:00:00
116,2,1,1,0.003731385862756718,2019-03-28 15:45:00,2019-03-28 16:00:00
118,9,5,4,0.018312998047461997,2019-03-28 15:45:00,2019-03-28 16:00:00
119,3,2,1,0.014097811602299976,2019-03-28 15:45:00,2019-03-28 16:00:00
120,7,5,2,0.012808346616156574,2019-03-28 15:45:00,2019-03-28 16:00:00
122,5,2,3,0.004437270016453847,2019-03-28 15:45:00,2019-03-28 16:00:00
126,11,4,7,0.008802471425081896,2019-03-28 15:45:00,2019-03-28 16:00:00
127,4,1,3,0.02098895391924914,2019-03-28 15:45:00,2019-03-28 16:00:00
129,6,3,3,0.005777543360576317,2019-03-28 15:45:00,2019-03-28 16:00:00
135,2,0,2,0.002201983569992228,2019-03-28 15:45:00,2019-03-28 16:00:00
137,15,9,6,0.020359058772597576,2019-03-28 15:45:00,2019-03-28 16:00:00
138,6,1,5,0.004073804192565321,2019-03-28 15:45:00,2019-03-28 16:00:00
140,4,3,1,0.010963226218246705,2019-03-28 15:45:00,2019-03-28 16:00:00
141,7,1,6,0.0025654493938807544,2019-03-28 15:45:00,2019-03-28 16:00:00
147,2,0,2,0.002201983569992228,2019-03-28 15:45:00,2019-03-28 16:00:00
151,4,4,0,0.009914623218474817,2019-03-28 15:45:00,2019-03-28 16:00:00
153,3,2,1,0.012660944773545263,2019-03-28 15:45:00,2019-03-28 16:00:00
154,2,0,2,0.002201983569992228,2019-03-28 15:45:00,2019-03-28 16:00:00
157,5,1,4,0.002825923777516592,2019-03-28 15:45:00,2019-03-28 16:00:00
158,6,2,4,0.007128737036387667,2019-03-28 15:45:00,2019-03-28 16:00:00
159,2,1,1,0.004512222957602881,2019-03-28 15:45:00,2019-03-28 16:00:00
162,1,1,0,0.0056649922974831655,2019-03-28 15:45:00,2019-03-28 16:00:00
164,7,3,4,0.005359897919541451,2019-03-28 15:45:00,2019-03-28 16:00:00
168,3,0,3,0.002201983569992228,2019-03-28 15:45:00,2019-03-28 16:00:00
169,3,3,0,0.004003646063151508,2019-03-28 15:45:00,2019-03-28 16:00:00
170,3,2,1,0.005059191279376672,2019-03-28 15:45:00,2019-03-28 16:00:00
172,1,0,1,0.002201983569992228,2019-03-28 15:45:00,2019-03-28 16:00:00
173,6,2,4,0.0036757464318304296,2019-03-28 15:45:00,2019-03-28 16:00:00
177,2,1,1,0.014659927987462771,2019-03-28 15:45:00,2019-03-28 16:00:00
190,5,2,3,0.005313257402723834,2019-03-28 15:45:00,2019-03-28 16:00:00
191,5,4,1,0.010678386202531085,2019-03-28 15:45:00,2019-03-28 16:00:00
195,4,1,3,0.0034593112527418956,2019-03-28 15:45:00,2019-03-28 16:00:00
196,5,2,3,0.008381565120770715,2019-03-28 15:45:00,2019-03-28 16:00:00
197,3,2,1,0.023660412994951523,2019-03-28 15:45:00,2019-03-28 16:00:00
199,1,1,0,0.022436171208619387,2019-03-28 15:45:00,2019-03-28 16:00:00
203,2,0,2,0.002201983569992228,2019-03-28 15:45:00,2019-03-28 16:00:00
1,5,3,2,0.003951062174481201,2019-03-28 16:00:00,2019-03-28 16:15:00
2,4,3,1,0.03180183826822342,2019-03-28 16:00:00,2019-03-28 16:15:00
5,6,3,3,0.005091818431508821,2019-03-28 16:00:00,2019-03-28 16:15:00
10,6,5,1,0.07588223854368231,2019-03-28 16:00:00,2019-03-28 16:15:00
15,3,1,2,0.0029901343314154075,2019-03-28 16:00:00,2019-03-28 16:15:00
16,6,5,1,0.05311894135170891,2019-03-28 16:00:00,2019-03-28 16:15:00
18,12,5,7,0.011487666608752686,2019-03-28 16:00:00,2019-03-28 16:15:00
19,7,6,1,0.13475435137268538,2019-03-28 16:00:00,2019-03-28 16:15:00
20,4,2,2,0.00852251788102728,2019-03-28 16:00:00,2019-03-28 16:15:00
21,1,0,1,0.0020982874564348256,2019-03-28 16:00:00,2019-03-28 16:15:00
22,2,0,2,0.0020982874564348256,2019-03-28 16:00:00,2019-03-28 16:15:00
23,2,1,1,0.0033057077583381386,2019-03-28 16:00:00,2019-03-28 16:15:00
26,4,3,1,0.0044912231229344915,2019-03-28 16:00:00,2019-03-28 16:15:00
27,1,0,1,0.0020982874564348256,2019-03-28 16:00:00,2019-03-28 16:15:00
28,3,3,0,0.004081536955864162,2019-03-28 16:00:00,2019-03-28 16:15:00
30,3,3,0,0.009682279964379776,2019-03-28 16:00:00,2019-03-28 16:15:00
35,4,3,1,0.0063625426027372955,2019-03-28 16:00:00,2019-03-28 16:15:00
37,2,1,1,0.0037082394916566975,2019-03-28 16:00:00,2019-03-28 16:15:00
40,2,0,2,0.0020982874564348256,2019-03-28 16:00:00,2019-03-28 16:15:00
41,3,3,0,0.005583341151942007,2019-03-28 16:00:00,2019-03-28 16:15:00
46,1,0,1,0.0020982874564348256,2019-03-28 16:00:00,2019-03-28 16:15:00
50,2,2,0,0.004207372662027403,2019-03-28 16:00:00,2019-03-28 16:15:00
57,6,4,2,0.02413777247598075,2019-03-28 16:00:00,2019-03-28 16:15:00
58,4,2,2,0.010916840590729945,2019-03-28 16:00:00,2019-03-28 16:15:00
61,1,1,0,0.010046347472762916,2019-03-28 16:00:00,2019-03-28 16:15:00
62,6,3,3,0.006006786060230209,2019-03-28 16:00:00,2019-03-28 16:15:00
64,4,2,2,0.013979707781150267,2019-03-28 16:00:00,2019-03-28 16:15:00
66,3,0,3,0.0020982874564348256,2019-03-28 16:00:00,2019-03-28 16:15:00
67,6,3,3,0.005869117922182708,2019-03-28 16:00:00,2019-03-28 16:15:00
68,4,2,2,0.004201645623591413,2019-03-28 16:00:00,2019-03-28 16:15:00
69,4,3,1,0.008731971110052632,2019-03-28 16:00:00,2019-03-28 16:15:00
70,4,1,3,0.0037082394916566975,2019-03-28 16:00:00,2019-03-28 16:15:00
74,5,4,1,0.005539696655974171,2019-03-28 16:00:00,2019-03-28 16:15:00
79,3,2,1,0.022034866943066663,2019-03-28 16:00:00,2019-03-28 16:15:00
80,1,1,0,0.002846305440461897,2019-03-28 16:00:00,2019-03-28 16:15:00
85,2,1,1,0.013979707781150267,2019-03-28 16:00:00,2019-03-28 16:15:00
86,3,1,2,0.0025414877346630637,2019-03-28 16:00:00,2019-03-28 16:15:00
87,5,2,3,0.007753170875030999,2019-03-28 16:00:00,2019-03-28 16:15:00
88,2,1,1,0.0025442108939251165,2019-03-28 16:00:00,2019-03-28 16:15:00
89,4,1,3,0.004261057684571283,2019-03-28 16:00:00,2019-03-28 16:15:00
90,2,2,0,0.003488641721136343,2019-03-28 16:00:00,2019-03-28 16:15:00
104,8,7,1,0.00852958418571455,2019-03-28 16:00:00,2019-03-28 16:15:00
108,2,2,0,0.007858466631243765,2019-03-28 16:00:00,2019-03-28 16:15:00
109,4,2,2,0.0029874111721533547,2019-03-28 16:00:00,2019-03-28 16:15:00
110,2,2,0,0.008550761445622727,2019-03-28 16:00:00,2019-03-28 16:15:00
111,2,1,1,0.003081131331927993,2019-03-28 16:00:00,2019-03-28 16:15:00
112,3,1,2,0.003649488430233659,2019-03-28 16:00:00,2019-03-28 16:15:00
113,3,1,2,0.004584776335588885,2019-03-28 16:00:00,2019-03-28 16:15:00
114,4,2,2,0.008134007278116182,2019-03-28 16:00:00,2019-03-28 16:15:00
118,5,2,3,0.003287416623075601,2019-03-28 16:00:00,2019-03-28 16:15:00
119,9,5,4,0.007574885846621014,2019-03-28 16:00:00,2019-03-28 16:15:00
120,3,1,2,0.003649488430233659,2019-03-28 16:00:00,2019-03-28 16:15:00
122,2,2,0,0.004476545789716377,2019-03-28 16:00:00,2019-03-28 16:15:00
126,10,3,7,0.006158922175918421,2019-03-28 16:00:00,2019-03-28 16:15:00
127,5,1,4,0.002664557716951582,2019-03-28 16:00:00,2019-03-28 16:15:00
129,2,0,2,0.0020982874564348256,2019-03-28 16:00:00,2019-03-28 16:15:00
135,4,0,4,0.0020982874564348256,2019-03-28 16:00:00,2019-03-28 16:15:00
137,15,7,8,0.0065421074705423795,2019-03-28 16:00:00,2019-03-28 16:15:00
138,8,3,5,0.005780500625515538,2019-03-28 16:00:00,2019-03-28 16:15:00
140,3,2,1,0.006279678834149037,2019-03-28 16:00:00,2019-03-28 16:15:00
141,1,0,1,0.0020982874564348256,2019-03-28 16:00:00,2019-03-28 16:15:00
147,8,1,7,0.003649488430233659,2019-03-28 16:00:00,2019-03-28 16:15:00
151,2,2,0,0.004309028834737199,2019-03-28 16:00:00,2019-03-28 16:15:00
153,14,6,8,0.015153313388921487,2019-03-28 16:00:00,2019-03-28 16:15:00
154,2,0,2,0.0020982874564348256,2019-03-28 16:00:00,2019-03-28 16:15:00
156,5,0,5,0.0020982874564348256,2019-03-28 16:00:00,2019-03-28 16:15:00
157,2,1,1,0.003881981206395989,2019-03-28 16:00:00,2019-03-28 16:15:00
158,4,0,4,0.0020982874564348256,2019-03-28 16:00:00,2019-03-28 16:15:00
164,6,2,4,0.005700419060681174,2019-03-28 16:00:00,2019-03-28 16:15:00
168,1,1,0,0.0027934645887855844,2019-03-28 16:00:00,2019-03-28 16:15:00
170,4,2,2,0.004151850679696496,2019-03-28 16:00:00,2019-03-28 16:15:00
172,2,1,1,0.002846305440461897,2019-03-28 16:00:00,2019-03-28 16:15:00
173,5,3,2,0.009251371826619682,2019-03-28 16:00:00,2019-03-28 16:15:00
177,6,3,3,0.008773519005166036,2019-03-28 16:00:00,2019-03-28 16:15:00
190,3,1,2,0.002846305440461897,2019-03-28 16:00:00,2019-03-28 16:15:00
191,6,4,2,0.01213408795305149,2019-03-28 16:00:00,2019-03-28 16:15:00
195,3,1,2,0.003649488430233659,2019-03-28 16:00:00,2019-03-28 16:15:00
196,1,0,1,0.0020982874564348256,2019-03-28 16:00:00,2019-03-28 16:15:00
197,1,1,0,0.003541132890886791,2019-03-28 16:00:00,2019-03-28 16:15:00
199,2,1,1,0.009349321398380177,2019-03-28 16:00:00,2019-03-28 16:15:00
202,2,1,1,0.003493470603484891,2019-03-28 16:00:00,2019-03-28 16:15:00
203,2,1,1,0.0037082394916566975,2019-03-28 16:00:00,2019-03-28 16:15:00
1,7,4,3,0.00568440057600324,2019-03-28 16:15:00,2019-03-28 16:30:00
2,4,2,2,0.015688176181910173,2019-03-28 16:15:00,2019-03-28 16:30:00
5,7,3,4,0.007572809451987883,2019-03-28 16:15:00,2019-03-28 16:30:00
10,5,4,1,0.06735421404135056,2019-03-28 16:15:00,2019-03-28 16:30:00
11,1,1,0,0.0038618461496473734,2019-03-28 16:15:00,2019-03-28 16:30:00
15,6,2,4,0.006530141259395573,2019-03-28 16:15:00,2019-03-28 16:30:00
16,8,5,3,0.011973449492075563,2019-03-28 16:15:00,2019-03-28 16:30:00
18,10,5,5,0.009012867211124306,2019-03-28 16:15:00,2019-03-28 16:30:00
19,10,5,5,0.008832631913286815,2019-03-28 16:15:00,2019-03-28 16:30:00
20,3,3,0,0.008485786627577666,2019-03-28 16:15:00,2019-03-28 16:30:00
21,1,0,1,0.002356737284491053,2019-03-28 16:15:00,2019-03-28 16:30:00
22,2,0,2,0.002356737284491053,2019-03-28 16:15:00,2019-03-28 16:30:00
23,2,0,2,0.002356737284491053,2019-03-28 16:15:00,2019-03-28 16:30:00
26,5,4,1,0.006397240710507523,2019-03-28 16:15:00,2019-03-28 16:30:00
28,3,3,0,0.008462743125204229,2019-03-28 16:15:00,2019-03-28 16:30:00
30,3,3,0,0.011254908824675176,2019-03-28 16:15:00,2019-03-28 16:30:00
35,4,3,1,0.005747989491445009,2019-03-28 16:15:00,2019-03-28 16:30:00
37,2,1,1,0.0051422691593319865,2019-03-28 16:15:00,2019-03-28 16:30:00
40,2,0,2,0.002356737284491053,2019-03-28 16:15:00,2019-03-28 16:30:00
41,4,2,2,0.005152508389308478,2019-03-28 16:15:00,2019-03-28 16:30:00
46,1,0,1,0.002356737284491053,2019-03-28 16:15:00,2019-03-28 16:30:00
50,3,2,1,0.022353895630619732,2019-03-28 16:15:00,2019-03-28 16:30:00
57,7,7,0,0.02680863217575119,2019-03-28 16:15:00,2019-03-28 16:30:00
58,5,3,2,0.00648897430099494,2019-03-28 16:15:00,2019-03-28 16:30:00
61,1,1,0,0.003984218949065844,2019-03-28 16:15:00,2019-03-28 16:30:00
62,7,3,4,0.008551332751079149,2019-03-28 16:15:00,2019-03-28 16:30:00
64,4,2,2,0.015688176181910173,2019-03-28 16:15:00,2019-03-28 16:30:00
66,3,0,3,0.002356737284491053,2019-03-28 16:15:00,2019-03-28 16:30:00
67,5,3,2,0.006793110324145658,2019-03-28 16:15:00,2019-03-28 16:30:00
68,2,0,2,0.002356737284491053,2019-03-28 16:15:00,2019-03-28 16:30:00
69,1,1,0,0.004156258260538685,2019-03-28 16:15:00,2019-03-28 16:30:00
70,4,1,3,0.0051422691593319865,2019-03-28 16:15:00,2019-03-28 16:30:00
74,5,2,3,0.00624583730771902,2019-03-28 16:15:00,2019-03-28 16:30:00
79,3,2,1,0.030385454404252082,2019-03-28 16:15:00,2019-03-28 16:30:00
85,2,1,1,0.015688176181910173,2019-03-28 16:15:00,2019-03-28 16:30:00
86,5,2,3,0.005754068665497155,2019-03-28 16:15:00,2019-03-28 16:30:00
87,6,2,4,0.004373192320984149,2019-03-28 16:15:00,2019-03-28 16:30:00
88,1,1,0,0.0034548198782309494,2019-03-28 16:15:00,2019-03-28 16:30:00
89,2,0,2,0.002356737284491053,2019-03-28 16:15:00,2019-03-28 16:30:00
104,8,3,5,0.004474922683037606,2019-03-28 16:15:00,2019-03-28 16:30:00
106,1,1,0,0.00834236385499214,2019-03-28 16:15:00,2019-03-28 16:30:00
108,4,3,1,0.007040967960705944,2019-03-28 16:15:00,2019-03-28 16:30:00
109,11,5,6,0.0077502628337661915,2019-03-28 16:15:00,2019-03-28 16:30:00
110,3,2,1,0.00743437052368194,2019-03-28 16:15:00,2019-03-28 16:30:00
111,5,4,1,0.006564631988339512,2019-03-28 16:15:00,2019-03-28 16:30:00
112,5,3,2,0.011717671996463345,2019-03-28 16:15:00,2019-03-28 16:30:00
113,2,1,1,0.004725919345267579,2019-03-28 16:15:00,2019-03-28 16:30:00
114,5,1,4,0.005114914513355957,2019-03-28 16:15:00,2019-03-28 16:30:00
115,1,1,0,0.0033584273379362374,2019-03-28 16:15:00,2019-03-28 16:30:00
116,4,3,1,0.05017386548957631,2019-03-28 16:15:00,2019-03-28 16:30:00
118,8,6,2,0.010391865370598974,2019-03-28 16:15:00,2019-03-28 16:30:00
119,11,6,5,0.016382710889229758,2019-03-28 16:15:00,2019-03-28 16:30:00
120,10,4,6,0.005439405358007958,2019-03-28 16:15:00,2019-03-28 16:30:00
122,5,4,1,0.011998130434389596,2019-03-28 16:15:00,2019-03-28 16:30:00
126,12,5,7,0.009193229573784113,2019-03-28 16:15:00,2019-03-28 16:30:00
127,3,0,3,0.002356737284491053,2019-03-28 16:15:00,2019-03-28 16:30:00
129,1,0,1,0.002356737284491053,2019-03-28 16:15:00,2019-03-28 16:30:00
135,2,0,2,0.002356737284491053,2019-03-28 16:15:00,2019-03-28 16:30:00
137,10,3,7,0.005813954989145385,2019-03-28 16:15:00,2019-03-28 16:30:00
138,11,5,6,0.011436478442694948,2019-03-28 16:15:00,2019-03-28 16:30:00
140,3,2,1,0.00493921305102298,2019-03-28 16:15:00,2019-03-28 16:30:00
147,6,1,5,0.004126587000922365,2019-03-28 16:15:00,2019-03-28 16:30:00
151,1,1,0,0.004156258260538685,2019-03-28 16:15:00,2019-03-28 16:30:00
153,16,6,10,0.01382628912806621,2019-03-28 16:15:00,2019-03-28 16:30:00
156,6,0,6,0.002356737284491053,2019-03-28 16:15:00,2019-03-28 16:30:00
157,1,1,0,0.004360117391381422,2019-03-28 16:15:00,2019-03-28 16:30:00
159,2,2,0,0.004078506069036368,2019-03-28 16:15:00,2019-03-28 16:30:00
161,3,1,2,0.004098953179701286,2019-03-28 16:15:00,2019-03-28 16:30:00
162,1,1,0,0.0036966145899140494,2019-03-28 16:15:00,2019-03-28 16:30:00
164,2,1,1,0.007937384209947497,2019-03-28 16:15:00,2019-03-28 16:30:00
168,2,1,1,0.008676859151647153,2019-03-28 16:15:00,2019-03-28 16:30:00
170,4,2,2,0.004233713456033747,2019-03-28 16:15:00,2019-03-28 16:30:00
172,3,3,0,0.005900141117705384,2019-03-28 16:15:00,2019-03-28 16:30:00
173,4,3,1,0.007434127821732278,2019-03-28 16:15:00,2019-03-28 16:30:00
177,6,3,3,0.008360687282642677,2019-03-28 16:15:00,2019-03-28 16:30:00
190,4,2,2,0.00520172345507037,2019-03-28 16:15:00,2019-03-28 16:30:00
191,11,5,6,0.009456633973475844,2019-03-28 16:15:00,2019-03-28 16:30:00
195,4,2,2,0.0038289957584439296,2019-03-28 16:15:00,2019-03-28 16:30:00
196,1,0,1,0.002356737284491053,2019-03-28 16:15:00,2019-03-28 16:30:00
197,7,3,4,0.007082012875787901,2019-03-28 16:15:00,2019-03-28 16:30:00
201,10,5,5,0.021037747346281926,2019-03-28 16:15:00,2019-03-28 16:30:00
202,3,1,2,0.0038891396331882967,2019-03-28 16:15:00,2019-03-28 16:30:00
203,2,1,1,0.0051422691593319865,2019-03-28 16:15:00,2019-03-28 16:30:00
1,5,3,2,0.006813171395649359,2019-03-28 16:30:00,2019-03-28 16:45:00
2,3,1,2,0.005351760964536783,2019-03-28 16:30:00,2019-03-28 16:45:00
5,5,4,1,0.0133478211910219,2019-03-28 16:30:00,2019-03-28 16:45:00
10,2,1,1,0.015326561901598763,2019-03-28 16:30:00,2019-03-28 16:45:00
11,1,1,0,0.0050247157588715705,2019-03-28 16:30:00,2019-03-28 16:45:00
13,2,0,2,0.0023114349353110576,2019-03-28 16:30:00,2019-03-28 16:45:00
15,6,2,4,0.004377569757709349,2019-03-28 16:30:00,2019-03-28 16:45:00
16,3,2,1,0.0056646300680790376,2019-03-28 16:30:00,2019-03-28 16:45:00
18,12,5,7,0.01037539127022579,2019-03-28 16:30:00,2019-03-28 16:45:00
19,7,3,4,0.015929936318466523,2019-03-28 16:30:00,2019-03-28 16:45:00
20,4,4,0,0.012239266904088,2019-03-28 16:30:00,2019-03-28 16:45:00
21,1,0,1,0.0023114349353110576,2019-03-28 16:30:00,2019-03-28 16:45:00
22,2,0,2,0.0023114349353110576,2019-03-28 16:30:00,2019-03-28 16:45:00
23,4,1,3,0.005814501271392146,2019-03-28 16:30:00,2019-03-28 16:45:00
26,7,4,3,0.008517472120686879,2019-03-28 16:30:00,2019-03-28 16:45:00
27,1,1,0,0.0056969440545194035,2019-03-28 16:30:00,2019-03-28 16:45:00
28,5,3,2,0.014844971314581703,2019-03-28 16:30:00,2019-03-28 16:45:00
30,4,3,1,0.010180978640247387,2019-03-28 16:30:00,2019-03-28 16:45:00
35,2,0,2,0.0023114349353110576,2019-03-28 16:30:00,2019-03-28 16:45:00
37,8,5,3,0.011493141429310431,2019-03-28 16:30:00,2019-03-28 16:45:00
40,5,3,2,0.009979262092662398,2019-03-28 16:30:00,2019-03-28 16:45:00
41,3,1,2,0.012026251391525718,2019-03-28 16:30:00,2019-03-28 16:45:00
46,5,3,2,0.01024651681515478,2019-03-28 16:30:00,2019-03-28 16:45:00
57,11,4,7,0.009352757745552071,2019-03-28 16:30:00,2019-03-28 16:45:00
58,5,3,2,0.008216937407081881,2019-03-28 16:30:00,2019-03-28 16:45:00
61,4,4,0,0.00972400918823901,2019-03-28 16:30:00,2019-03-28 16:45:00
62,5,3,2,0.009022436709956535,2019-03-28 16:30:00,2019-03-28 16:45:00
64,1,0,1,0.0023114349353110576,2019-03-28 16:30:00,2019-03-28 16:45:00
66,2,1,1,0.005389852557919404,2019-03-28 16:30:00,2019-03-28 16:45:00
67,8,4,4,0.016482437424845953,2019-03-28 16:30:00,2019-03-28 16:45:00
68,2,1,1,0.0030147223791531412,2019-03-28 16:30:00,2019-03-28 16:45:00
69,4,3,1,0.008273858163938374,2019-03-28 16:30:00,2019-03-28 16:45:00
70,3,2,1,0.010327367675595044,2019-03-28 16:30:00,2019-03-28 16:45:00
74,4,1,3,0.005814501271392146,2019-03-28 16:30:00,2019-03-28 16:45:00
75,2,1,1,0.015326561901598763,2019-03-28 16:30:00,2019-03-28 16:45:00
79,3,2,1,0.030519894796535354,2019-03-28 16:30:00,2019-03-28 16:45:00
85,1,1,0,0.005568170243870966,2019-03-28 16:30:00,2019-03-28 16:45:00
86,4,1,3,0.003293851704061284,2019-03-28 16:30:00,2019-03-28 16:45:00
87,6,2,4,0.0034342187499483336,2019-03-28 16:30:00,2019-03-28 16:45:00
88,3,3,0,0.014682472532222993,2019-03-28 16:30:00,2019-03-28 16:45:00
89,1,0,1,0.0023114349353110576,2019-03-28 16:30:00,2019-03-28 16:45:00
90,1,0,1,0.0023114349353110576,2019-03-28 16:30:00,2019-03-28 16:45:00
104,11,5,6,0.009838738362141893,2019-03-28 16:30:00,2019-03-28 16:45:00
106,4,2,2,0.022855054245817845,2019-03-28 16:30:00,2019-03-28 16:45:00
108,3,2,1,0.012738278443977942,2019-03-28 16:30:00,2019-03-28 16:45:00
109,10,5,5,0.014373843141662495,2019-03-28 16:30:00,2019-03-28 16:45:00
110,1,0,1,0.0023114349353110576,2019-03-28 16:30:00,2019-03-28 16:45:00
111,3,2,1,0.010850205982446235,2019-03-28 16:30:00,2019-03-28 16:45:00
112,3,2,1,0.01253530364687775,2019-03-28 16:30:00,2019-03-28 16:45:00
113,5,3,2,0.006668680376016017,2019-03-28 16:30:00,2019-03-28 16:45:00
114,3,1,2,0.0037053846178170926,2019-03-28 16:30:00,2019-03-28 16:45:00
115,2,0,2,0.0023114349353110576,2019-03-28 16:30:00,2019-03-28 16:45:00
116,5,3,2,0.014434348907042713,2019-03-28 16:30:00,2019-03-28 16:45:00
118,8,5,3,0.012906020489013731,2019-03-28 16:30:00,2019-03-28 16:45:00
119,14,6,8,0.012565943085601506,2019-03-28 16:30:00,2019-03-28 16:45:00
120,11,5,6,0.01644885110815983,2019-03-28 16:30:00,2019-03-28 16:45:00
122,7,4,3,0.010729532018877818,2019-03-28 16:30:00,2019-03-28 16:45:00
126,10,3,7,0.008597523127874256,2019-03-28 16:30:00,2019-03-28 16:45:00
127,2,0,2,0.0023114349353110576,2019-03-28 16:30:00,2019-03-28 16:45:00
135,2,1,1,0.015326561901598763,2019-03-28 16:30:00,2019-03-28 16:45:00
137,8,2,6,0.004963991503322919,2019-03-28 16:30:00,2019-03-28 16:45:00
138,11,6,5,0.018106019329029582,2019-03-28 16:30:00,2019-03-28 16:45:00
140,4,2,2,0.004747720800868534,2019-03-28 16:30:00,2019-03-28 16:45:00
141,5,2,3,0.005334611471522337,2019-03-28 16:30:00,2019-03-28 16:45:00
147,2,1,1,0.003959102344810232,2019-03-28 16:30:00,2019-03-28 16:45:00
151,4,4,0,0.008746685777833631,2019-03-28 16:30:00,2019-03-28 16:45:00
153,7,3,4,0.010487129020353843,2019-03-28 16:30:00,2019-03-28 16:45:00
154,1,0,1,0.0023114349353110576,2019-03-28 16:30:00,2019-03-28 16:45:00
156,2,0,2,0.0023114349353110576,2019-03-28 16:30:00,2019-03-28 16:45:00
157,1,1,0,0.006666662755941709,2019-03-28 16:30:00,2019-03-28 16:45:00
158,1,1,0,0.003959102344810232,2019-03-28 16:30:00,2019-03-28 16:45:00
159,2,2,0,0.004224166187989385,2019-03-28 16:30:00,2019-03-28 16:45:00
161,3,1,2,0.004020085458440851,2019-03-28 16:30:00,2019-03-28 16:45:00
162,3,3,0,0.004669235180311601,2019-03-28 16:30:00,2019-03-28 16:45:00
164,2,1,1,0.0032417494192391585,2019-03-28 16:30:00,2019-03-28 16:45:00
168,2,2,0,0.005006085579948695,2019-03-28 16:30:00,2019-03-28 16:45:00
169,1,1,0,0.005568170243870966,2019-03-28 16:30:00,2019-03-28 16:45:00
170,5,2,3,0.005258685241561737,2019-03-28 16:30:00,2019-03-28 16:45:00
171,2,2,0,0.00427626847281151,2019-03-28 16:30:00,2019-03-28 16:45:00
172,2,2,0,0.004279311538992688,2019-03-28 16:30:00,2019-03-28 16:45:00
173,5,3,2,0.006993516597503748,2019-03-28 16:30:00,2019-03-28 16:45:00
175,1,1,0,0.00427626847281151,2019-03-28 16:30:00,2019-03-28 16:45:00
177,5,2,3,0.009981488994904017,2019-03-28 16:30:00,2019-03-28 16:45:00
189,2,2,0,0.0057777756927787,2019-03-28 16:30:00,2019-03-28 16:45:00
190,4,2,2,0.005417682466371661,2019-03-28 16:30:00,2019-03-28 16:45:00
191,5,0,5,0.0023114349353110576,2019-03-28 16:30:00,2019-03-28 16:45:00
195,2,0,2,0.0023114349353110576,2019-03-28 16:30:00,2019-03-28 16:45:00
196,2,2,0,0.01169979784754034,2019-03-28 16:30:00,2019-03-28 16:45:00
197,6,3,3,0.009575259148634606,2019-03-28 16:30:00,2019-03-28 16:45:00
199,1,0,1,0.0023114349353110576,2019-03-28 16:30:00,2019-03-28 16:45:00
201,10,4,6,0.012044433810282744,2019-03-28 16:30:00,2019-03-28 16:45:00
202,3,1,2,0.004586138010532613,2019-03-28 16:30:00,2019-03-28 16:45:00
203,1,0,1,0.0023114349353110576,2019-03-28 16:30:00,2019-03-28 16:45:00
1,4,3,1,0.004990621159715716,2019-03-28 16:45:00,2019-03-28 17:00:00
2,6,1,5,0.006288951359820407,2019-03-28 16:45:00,2019-03-28 17:00:00
5,7,6,1,0.02320592912199703,2019-03-28 16:45:00,2019-03-28 17:00:00
10,3,1,2,0.003162174897567536,2019-03-28 16:45:00,2019-03-28 17:00:00
11,4,2,2,0.012100271539320282,2019-03-28 16:45:00,2019-03-28 17:00:00
13,2,0,2,0.0018181924228532318,2019-03-28 16:45:00,2019-03-28 17:00:00
15,7,3,4,0.008357187944478223,2019-03-28 16:45:00,2019-03-28 17:00:00
16,2,1,1,0.003422705967917063,2019-03-28 16:45:00,2019-03-28 17:00:00
18,18,7,11,0.022180362067548507,2019-03-28 16:45:00,2019-03-28 17:00:00
19,6,2,4,0.01027518232976051,2019-03-28 16:45:00,2019-03-28 17:00:00
20,7,4,3,0.008005633042777755,2019-03-28 16:45:00,2019-03-28 17:00:00
21,1,0,1,0.0018181924228532318,2019-03-28 16:45:00,2019-03-28 17:00:00
22,3,0,3,0.0018181924228532318,2019-03-28 16:45:00,2019-03-28 17:00:00
23,3,2,1,0.007265932243019448,2019-03-28 16:45:00,2019-03-28 17:00:00
26,8,4,4,0.011649403981942037,2019-03-28 16:45:00,2019-03-28 17:00:00
27,2,2,0,0.004638769449637557,2019-03-28 16:45:00,2019-03-28 17:00:00
28,11,7,4,0.011603785638479271,2019-03-28 16:45:00,2019-03-28 17:00:00
30,3,3,0,0.007459236044872529,2019-03-28 16:45:00,2019-03-28 17:00:00
37,14,8,6,0.0384030380318647,2019-03-28 16:45:00,2019-03-28 17:00:00
40,2,1,1,0.003398539790870831,2019-03-28 16:45:00,2019-03-28 17:00:00
41,5,3,2,0.005392289591607119,2019-03-28 16:45:00,2019-03-28 17:00:00
46,6,2,4,0.004523903686274865,2019-03-28 16:45:00,2019-03-28 17:00:00
57,16,10,6,0.0298426857428562,2019-03-28 16:45:00,2019-03-28 17:00:00
58,5,3,2,0.011932335239939817,2019-03-28 16:45:00,2019-03-28 17:00:00
61,3,3,0,0.005651893366906579,2019-03-28 16:45:00,2019-03-28 17:00:00
62,5,2,3,0.007673628524234098,2019-03-28 16:45:00,2019-03-28 17:00:00
64,3,2,1,0.007869298727838007,2019-03-28 16:45:00,2019-03-28 17:00:00
66,3,1,2,0.00259095256931702,2019-03-28 16:45:00,2019-03-28 17:00:00
67,8,5,3,0.00895818004059789,2019-03-28 16:45:00,2019-03-28 17:00:00
68,3,1,2,0.002352484052665041,2019-03-28 16:45:00,2019-03-28 17:00:00
69,6,2,4,0.0050868767911468205,2019-03-28 16:45:00,2019-03-28 17:00:00
70,5,4,1,0.007865048162521194,2019-03-28 16:45:00,2019-03-28 17:00:00
71,1,1,0,0.0028992483612324616,2019-03-28 16:45:00,2019-03-28 17:00:00
74,4,2,2,0.005902007432815102,2019-03-28 16:45:00,2019-03-28 17:00:00
75,6,3,3,0.005521057758657204,2019-03-28 16:45:00,2019-03-28 17:00:00
79,5,4,1,0.04544480864412614,2019-03-28 16:45:00,2019-03-28 17:00:00
85,4,2,2,0.013707280421777497,2019-03-28 16:45:00,2019-03-28 17:00:00
86,3,1,2,0.0038016294783061594,2019-03-28 16:45:00,2019-03-28 17:00:00
87,6,3,3,0.014535256844828055,2019-03-28 16:45:00,2019-03-28 17:00:00
88,4,2,2,0.01059941465489513,2019-03-28 16:45:00,2019-03-28 17:00:00
89,2,1,1,0.012100271539320282,2019-03-28 16:45:00,2019-03-28 17:00:00
90,2,1,1,0.0032775529037949933,2019-03-28 16:45:00,2019-03-28 17:00:00
104,12,6,6,0.010286007810302695,2019-03-28 16:45:00,2019-03-28 17:00:00
106,2,0,2,0.0018181924228532318,2019-03-28 16:45:00,2019-03-28 17:00:00
108,2,1,1,0.004326676630374968,2019-03-28 16:45:00,2019-03-28 17:00:00
109,8,2,6,0.011153372324693704,2019-03-28 16:45:00,2019-03-28 17:00:00
110,4,4,0,0.0052031567453389,2019-03-28 16:45:00,2019-03-28 17:00:00
111,11,4,7,0.027501825762637266,2019-03-28 16:45:00,2019-03-28 17:00:00
112,2,0,2,0.0018181924228532318,2019-03-28 16:45:00,2019-03-28 17:00:00
113,5,3,2,0.008439066612542699,2019-03-28 16:45:00,2019-03-28 17:00:00
114,2,1,1,0.003275546970429026,2019-03-28 16:45:00,2019-03-28 17:00:00
115,3,2,1,0.004947049397763067,2019-03-28 16:45:00,2019-03-28 17:00:00
116,4,2,2,0.004987197222997497,2019-03-28 16:45:00,2019-03-28 17:00:00
118,7,4,3,0.008637974245103675,2019-03-28 16:45:00,2019-03-28 17:00:00
119,8,2,6,0.0096989125641395,2019-03-28 16:45:00,2019-03-28 17:00:00
120,5,2,3,0.004196105619457026,2019-03-28 16:45:00,2019-03-28 17:00:00
122,7,5,2,0.010518450021200507,2019-03-28 16:45:00,2019-03-28 17:00:00
126,12,3,9,0.0076364312345439875,2019-03-28 16:45:00,2019-03-28 17:00:00
133,3,0,3,0.0018181924228532318,2019-03-28 16:45:00,2019-03-28 17:00:00
135,4,2,2,0.004834221076751504,2019-03-28 16:45:00,2019-03-28 17:00:00
137,11,3,8,0.005028087798252539,2019-03-28 16:45:00,2019-03-28 17:00:00
138,5,2,3,0.006392418666930907,2019-03-28 16:45:00,2019-03-28 17:00:00
140,3,1,2,0.0037751232383677526,2019-03-28 16:45:00,2019-03-28 17:00:00
141,4,2,2,0.0034335399910442707,2019-03-28 16:45:00,2019-03-28 17:00:00
147,1,0,1,0.0018181924228532318,2019-03-28 16:45:00,2019-03-28 17:00:00
151,6,5,1,0.06555095427409449,2019-03-28 16:45:00,2019-03-28 17:00:00
153,7,3,4,0.008139536869491504,2019-03-28 16:45:00,2019-03-28 17:00:00
154,2,1,1,0.003398539790870831,2019-03-28 16:45:00,2019-03-28 17:00:00
156,2,1,1,0.0023333658538290903,2019-03-28 16:45:00,2019-03-28 17:00:00
157,10,6,4,0.030334969037167533,2019-03-28 16:45:00,2019-03-28 17:00:00
158,1,1,0,0.003398539790870831,2019-03-28 16:45:00,2019-03-28 17:00:00
159,1,1,0,0.0035944013612127746,2019-03-28 16:45:00,2019-03-28 17:00:00
161,1,0,1,0.0018181924228532318,2019-03-28 16:45:00,2019-03-28 17:00:00
162,3,3,0,0.006134737873584229,2019-03-28 16:45:00,2019-03-28 17:00:00
164,1,0,1,0.0018181924228532318,2019-03-28 16:45:00,2019-03-28 17:00:00
168,3,2,1,0.014868070741701309,2019-03-28 16:45:00,2019-03-28 17:00:00
169,1,1,0,0.007259469553375126,2019-03-28 16:45:00,2019-03-28 17:00:00
170,5,3,2,0.009981826976025251,2019-03-28 16:45:00,2019-03-28 17:00:00
172,2,1,1,0.0028874108470277587,2019-03-28 16:45:00,2019-03-28 17:00:00
173,8,2,6,0.00449379616844073,2019-03-28 16:45:00,2019-03-28 17:00:00
175,1,1,0,0.008507867880659421,2019-03-28 16:45:00,2019-03-28 17:00:00
177,4,2,2,0.006167008705798114,2019-03-28 16:45:00,2019-03-28 17:00:00
189,4,3,1,0.008949870959951728,2019-03-28 16:45:00,2019-03-28 17:00:00
190,1,0,1,0.0018181924228532318,2019-03-28 16:45:00,2019-03-28 17:00:00
191,6,3,3,0.009778845932269244,2019-03-28 16:45:00,2019-03-28 17:00:00
195,2,1,1,0.0023333658538290903,2019-03-28 16:45:00,2019-03-28 17:00:00
196,3,2,1,0.006095583355556473,2019-03-28 16:45:00,2019-03-28 17:00:00
197,5,3,2,0.008253970427808876,2019-03-28 16:45:00,2019-03-28 17:00:00
201,3,1,2,0.0046042775183420094,2019-03-28 16:45:00,2019-03-28 17:00:00
202,3,2,1,0.004944060083798408,2019-03-28 16:45:00,2019-03-28 17:00:00
203,2,1,1,0.004326676630374968,2019-03-28 16:45:00,2019-03-28 17:00:00
1,2,2,0,0.0027922777907020747,2019-03-28 17:00:00,2019-03-28 17:15:00
2,5,0,5,0.0021988858099731656,2019-03-28 17:00:00,2019-03-28 17:15:00
5,8,5,3,0.021243274994516087,2019-03-28 17:00:00,2019-03-28 17:15:00
10,5,2,3,0.0076237956914054494,2019-03-28 17:00:00,2019-03-28 17:15:00
15,9,5,4,0.00772440861351151,2019-03-28 17:00:00,2019-03-28 17:15:00
16,5,3,2,0.01883303673397256,2019-03-28 17:00:00,2019-03-28 17:15:00
18,8,4,4,0.012810957629683936,2019-03-28 17:00:00,2019-03-28 17:15:00
19,4,1,3,0.008859108015364674,2019-03-28 17:00:00,2019-03-28 17:15:00
20,7,3,4,0.013626675954589199,2019-03-28 17:00:00,2019-03-28 17:15:00
22,1,0,1,0.0021988858099731656,2019-03-28 17:00:00,2019-03-28 17:15:00
23,9,4,5,0.01591163011476425,2019-03-28 17:00:00,2019-03-28 17:15:00
26,6,3,3,0.00614487206994305,2019-03-28 17:00:00,2019-03-28 17:15:00
27,3,2,1,0.00552172249019191,2019-03-28 17:00:00,2019-03-28 17:15:00
28,9,6,3,0.01139705873471067,2019-03-28 17:00:00,2019-03-28 17:15:00
30,2,2,0,0.006240917678467086,2019-03-28 17:00:00,2019-03-28 17:15:00
37,12,7,5,0.012537817401135177,2019-03-28 17:00:00,2019-03-28 17:15:00
40,1,0,1,0.0021988858099731656,2019-03-28 17:00:00,2019-03-28 17:15:00
41,5,4,1,0.008573328998603425,2019-03-28 17:00:00,2019-03-28 17:15:00
46,5,1,4,0.0037772239496206865,2019-03-28 17:00:00,2019-03-28 17:15:00
57,9,6,3,0.023503414011325607,2019-03-28 17:00:00,2019-03-28 17:15:00
58,3,2,1,0.00979679255858898,2019-03-28 17:00:00,2019-03-28 17:15:00
61,1,1,0,0.0059693512061299355,2019-03-28 17:00:00,2019-03-28 17:15:00
62,5,2,3,0.008865382453718257,2019-03-28 17:00:00,2019-03-28 17:15:00
64,4,2,2,0.015309009258668939,2019-03-28 17:00:00,2019-03-28 17:15:00
66,4,2,2,0.007609714816361232,2019-03-28 17:00:00,2019-03-28 17:15:00
67,9,3,6,0.004350501407282258,2019-03-28 17:00:00,2019-03-28 17:15:00
68,2,1,1,0.004068037196274689,2019-03-28 17:00:00,2019-03-28 17:15:00
69,5,1,4,0.004260726376442135,2019-03-28 17:00:00,2019-03-28 17:15:00
70,7,3,4,0.00742695104881256,2019-03-28 17:00:00,2019-03-28 17:15:00
71,1,1,0,0.003104400483081242,2019-03-28 17:00:00,2019-03-28 17:15:00
74,7,4,3,0.007506016630181541,2019-03-28 17:00:00,2019-03-28 17:15:00
75,6,3,3,0.004111557144699747,2019-03-28 17:00:00,2019-03-28 17:15:00
79,2,2,0,0.007398065501982711,2019-03-28 17:00:00,2019-03-28 17:15:00
85,2,1,1,0.007394997725288259,2019-03-28 17:00:00,2019-03-28 17:15:00
86,3,0,3,0.0021988858099731656,2019-03-28 17:00:00,2019-03-28 17:15:00
87,2,1,1,0.003840475077839197,2019-03-28 17:00:00,2019-03-28 17:15:00
88,5,1,4,0.005094917057561488,2019-03-28 17:00:00,2019-03-28 17:15:00
89,3,2,1,0.008692384602056123,2019-03-28 17:00:00,2019-03-28 17:15:00
90,2,1,1,0.004330560336602025,2019-03-28 17:00:00,2019-03-28 17:15:00
99,1,1,0,0.006892892062943917,2019-03-28 17:00:00,2019-03-28 17:15:00
101,2,0,2,0.0021988858099731656,2019-03-28 17:00:00,2019-03-28 17:15:00
104,10,5,5,0.006751962749426763,2019-03-28 17:00:00,2019-03-28 17:15:00
106,2,0,2,0.0021988858099731656,2019-03-28 17:00:00,2019-03-28 17:15:00
108,2,1,1,0.004325736655855429,2019-03-28 17:00:00,2019-03-28 17:15:00
109,8,2,6,0.009595030199305037,2019-03-28 17:00:00,2019-03-28 17:15:00
110,7,7,0,0.01480403405085207,2019-03-28 17:00:00,2019-03-28 17:15:00
111,12,5,7,0.028443660468519833,2019-03-28 17:00:00,2019-03-28 17:15:00
112,6,4,2,0.03548877397160836,2019-03-28 17:00:00,2019-03-28 17:15:00
113,6,3,3,0.01330567252475797,2019-03-28 17:00:00,2019-03-28 17:15:00
114,3,2,1,0.004297715927179136,2019-03-28 17:00:00,2019-03-28 17:15:00
115,2,2,0,0.00452890737038511,2019-03-28 17:00:00,2019-03-28 17:15:00
116,2,0,2,0.0021988858099731656,2019-03-28 17:00:00,2019-03-28 17:15:00
118,4,3,1,0.0056427040888027725,2019-03-28 17:00:00,2019-03-28 17:15:00
119,9,0,9,0.0021988858099731656,2019-03-28 17:00:00,2019-03-28 17:15:00
120,1,1,0,0.005433504902719784,2019-03-28 17:00:00,2019-03-28 17:15:00
122,6,5,1,0.01382258788951925,2019-03-28 17:00:00,2019-03-28 17:15:00
126,10,2,8,0.0027922777907020747,2019-03-28 17:00:00,2019-03-28 17:15:00
129,1,1,0,0.0024065692973400015,2019-03-28 17:00:00,2019-03-28 17:15:00
133,4,1,3,0.004330560336602025,2019-03-28 17:00:00,2019-03-28 17:15:00
135,4,2,2,0.005220439400592778,2019-03-28 17:00:00,2019-03-28 17:15:00
137,17,7,10,0.01304850126615533,2019-03-28 17:00:00,2019-03-28 17:15:00
138,14,6,8,0.01940235807481704,2019-03-28 17:00:00,2019-03-28 17:15:00
140,2,1,1,0.0033081532862358778,2019-03-28 17:00:00,2019-03-28 17:15:00
141,6,4,2,0.006432202911869378,2019-03-28 17:00:00,2019-03-28 17:15:00
147,2,1,1,0.004068037196274689,2019-03-28 17:00:00,2019-03-28 17:15:00
151,7,6,1,0.044709461956865544,2019-03-28 17:00:00,2019-03-28 17:15:00
153,4,2,2,0.012468925799828952,2019-03-28 17:00:00,2019-03-28 17:15:00
154,3,2,1,0.0037660938636399073,2019-03-28 17:00:00,2019-03-28 17:15:00
156,1,0,1,0.0021988858099731656,2019-03-28 17:00:00,2019-03-28 17:15:00
157,8,4,4,0.024447443761309955,2019-03-28 17:00:00,2019-03-28 17:15:00
158,2,2,0,0.004917934942572977,2019-03-28 17:00:00,2019-03-28 17:15:00
159,1,1,0,0.003840475077839197,2019-03-28 17:00:00,2019-03-28 17:15:00
161,1,0,1,0.0021988858099731656,2019-03-28 17:00:00,2019-03-28 17:15:00
162,2,1,1,0.0028219362720736736,2019-03-28 17:00:00,2019-03-28 17:15:00
164,6,5,1,0.01276107451070571,2019-03-28 17:00:00,2019-03-28 17:15:00
168,5,3,2,0.004745927311335696,2019-03-28 17:00:00,2019-03-28 17:15:00
169,2,0,2,0.0021988858099731656,2019-03-28 17:00:00,2019-03-28 17:15:00
170,5,2,3,0.005774233395913958,2019-03-28 17:00:00,2019-03-28 17:15:00
171,1,1,0,0.004417726584236944,2019-03-28 17:00:00,2019-03-28 17:15:00
172,7,3,4,0.004474497469092339,2019-03-28 17:00:00,2019-03-28 17:15:00
173,8,2,6,0.0057340028725044855,2019-03-28 17:00:00,2019-03-28 17:15:00
175,1,1,0,0.008706086041206703,2019-03-28 17:00:00,2019-03-28 17:15:00
177,5,4,1,0.010981568438529684,2019-03-28 17:00:00,2019-03-28 17:15:00
189,1,1,0,0.0049215898859382295,2019-03-28 17:00:00,2019-03-28 17:15:00
191,1,1,0,0.010253116258337953,2019-03-28 17:00:00,2019-03-28 17:15:00
195,1,0,1,0.0021988858099731656,2019-03-28 17:00:00,2019-03-28 17:15:00
196,1,0,1,0.0021988858099731656,2019-03-28 17:00:00,2019-03-28 17:15:00
197,4,3,1,0.009474492137515502,2019-03-28 17:00:00,2019-03-28 17:15:00
202,3,2,1,0.014406648911589097,2019-03-28 17:00:00,2019-03-28 17:15:00
203,1,1,0,0.004325736655855429,2019-03-28 17:00:00,2019-03-28 17:15:00
1,4,4,0,0.005295796626427672,2019-03-28 17:15:00,2019-03-28 17:30:00
2,5,1,4,0.007038453440287437,2019-03-28 17:15:00,2019-03-28 17:30:00
5,4,2,2,0.0052802370325154375,2019-03-28 17:15:00,2019-03-28 17:30:00
10,4,2,2,0.015382067047935384,2019-03-28 17:15:00,2019-03-28 17:30:00
15,9,7,2,0.008749533635358846,2019-03-28 17:15:00,2019-03-28 17:30:00
16,4,4,0,0.017655185953372298,2019-03-28 17:15:00,2019-03-28 17:30:00
18,5,3,2,0.007830418655366602,2019-03-28 17:15:00,2019-03-28 17:30:00
19,4,0,4,0.0025695658471636034,2019-03-28 17:15:00,2019-03-28 17:30:00
20,8,3,5,0.007272315932241265,2019-03-28 17:15:00,2019-03-28 17:30:00
23,11,8,3,0.01401707039871469,2019-03-28 17:15:00,2019-03-28 17:30:00
26,3,0,3,0.0025695658471636034,2019-03-28 17:15:00,2019-03-28 17:30:00
27,4,3,1,0.00451341185205483,2019-03-28 17:15:00,2019-03-28 17:30:00
28,3,1,2,0.004469145059713041,2019-03-28 17:15:00,2019-03-28 17:30:00
30,1,1,0,0.004469145059713041,2019-03-28 17:15:00,2019-03-28 17:30:00
35,1,0,1,0.0025695658471636034,2019-03-28 17:15:00,2019-03-28 17:30:00
37,7,3,4,0.005201402284612016,2019-03-28 17:15:00,2019-03-28 17:30:00
40,1,0,1,0.0025695658471636034,2019-03-28 17:15:00,2019-03-28 17:30:00
41,3,3,0,0.005436797546663331,2019-03-28 17:15:00,2019-03-28 17:30:00
46,3,1,2,0.0035798609543056855,2019-03-28 17:15:00,2019-03-28 17:30:00
57,7,6,1,0.011560002189861814,2019-03-28 17:15:00,2019-03-28 17:30:00
58,5,4,1,0.018508316256006744,2019-03-28 17:15:00,2019-03-28 17:30:00
61,1,1,0,0.00472646159924711,2019-03-28 17:15:00,2019-03-28 17:30:00
62,8,5,3,0.010575790216510225,2019-03-28 17:15:00,2019-03-28 17:30:00
64,4,2,2,0.0067038919077438905,2019-03-28 17:15:00,2019-03-28 17:30:00
66,4,2,2,0.010513584292020484,2019-03-28 17:15:00,2019-03-28 17:30:00
67,12,7,5,0.011473581352508979,2019-03-28 17:15:00,2019-03-28 17:30:00
68,4,2,2,0.003449950367934482,2019-03-28 17:15:00,2019-03-28 17:30:00
69,8,2,6,0.004057578488620599,2019-03-28 17:15:00,2019-03-28 17:30:00
70,5,1,4,0.004753883704245656,2019-03-28 17:15:00,2019-03-28 17:30:00
71,1,1,0,0.003144447506677341,2019-03-28 17:15:00,2019-03-28 17:30:00
74,6,4,2,0.008967921297281755,2019-03-28 17:15:00,2019-03-28 17:30:00
75,6,3,3,0.007760409748098271,2019-03-28 17:15:00,2019-03-28 17:30:00
79,2,2,0,0.006192827624968814,2019-03-28 17:15:00,2019-03-28 17:30:00
85,1,1,0,0.005699663883036889,2019-03-28 17:15:00,2019-03-28 17:30:00
86,4,0,4,0.0025695658471636034,2019-03-28 17:15:00,2019-03-28 17:30:00
87,4,3,1,0.007380650689018983,2019-03-28 17:15:00,2019-03-28 17:30:00
88,4,1,3,0.003805989880795107,2019-03-28 17:15:00,2019-03-28 17:30:00
89,4,3,1,0.009852426023149799,2019-03-28 17:15:00,2019-03-28 17:30:00
90,4,3,1,0.005355271872074684,2019-03-28 17:15:00,2019-03-28 17:30:00
99,1,1,0,0.006406345881390158,2019-03-28 17:15:00,2019-03-28 17:30:00
101,2,0,2,0.0025695658471636034,2019-03-28 17:15:00,2019-03-28 17:30:00
104,1,1,0,0.0032976717995242873,2019-03-28 17:15:00,2019-03-28 17:30:00
106,1,0,1,0.0025695658471636034,2019-03-28 17:15:00,2019-03-28 17:30:00
108,1,1,0,0.0063814356360893665,2019-03-28 17:15:00,2019-03-28 17:30:00
109,4,2,2,0.0068516716913123435,2019-03-28 17:15:00,2019-03-28 17:30:00
110,6,4,2,0.015313687021781222,2019-03-28 17:15:00,2019-03-28 17:30:00
111,8,5,3,0.030743522159468743,2019-03-28 17:15:00,2019-03-28 17:30:00
112,9,4,5,0.006955175621847476,2019-03-28 17:15:00,2019-03-28 17:30:00
113,9,3,6,0.015223197251864239,2019-03-28 17:15:00,2019-03-28 17:30:00
114,2,1,1,0.005228714377065983,2019-03-28 17:15:00,2019-03-28 17:30:00
115,2,2,0,0.006967749002034756,2019-03-28 17:15:00,2019-03-28 17:30:00
116,3,0,3,0.0025695658471636034,2019-03-28 17:15:00,2019-03-28 17:30:00
118,3,0,3,0.0025695658471636034,2019-03-28 17:15:00,2019-03-28 17:30:00
119,12,4,8,0.004469145059713041,2019-03-28 17:15:00,2019-03-28 17:30:00
120,9,2,7,0.0033938661235085373,2019-03-28 17:15:00,2019-03-28 17:30:00
122,3,1,2,0.0028750687084207445,2019-03-28 17:15:00,2019-03-28 17:30:00
126,5,1,4,0.003263020648535608,2019-03-28 17:15:00,2019-03-28 17:30:00
129,1,1,0,0.0030444606503009625,2019-03-28 17:15:00,2019-03-28 17:30:00
133,1,0,1,0.0025695658471636034,2019-03-28 17:15:00,2019-03-28 17:30:00
135,3,1,2,0.004469145059713041,2019-03-28 17:15:00,2019-03-28 17:30:00
137,10,7,3,0.01104608509380801,2019-03-28 17:15:00,2019-03-28 17:30:00
138,9,1,8,0.0028750687084207445,2019-03-28 17:15:00,2019-03-28 17:30:00
140,4,0,4,0.0025695658471636034,2019-03-28 17:15:00,2019-03-28 17:30:00
141,1,1,0,0.003144447506677341,2019-03-28 17:15:00,2019-03-28 17:30:00
147,1,0,1,0.0025695658471636034,2019-03-28 17:15:00,2019-03-28 17:30:00
151,2,2,0,0.004296455314952796,2019-03-28 17:15:00,2019-03-28 17:30:00
153,7,1,6,0.00472646159924711,2019-03-28 17:15:00,2019-03-28 17:30:00
154,1,1,0,0.004035931872885308,2019-03-28 17:15:00,2019-03-28 17:30:00
157,7,3,4,0.007090151944967527,2019-03-28 17:15:00,2019-03-28 17:30:00
158,2,0,2,0.0025695658471636034,2019-03-28 17:15:00,2019-03-28 17:30:00
159,1,0,1,0.0025695658471636034,2019-03-28 17:15:00,2019-03-28 17:30:00
160,4,3,1,0.0364462181022945,2019-03-28 17:15:00,2019-03-28 17:30:00
162,3,2,1,0.05534724919657269,2019-03-28 17:15:00,2019-03-28 17:30:00
164,5,5,0,0.02830948366144201,2019-03-28 17:15:00,2019-03-28 17:30:00
168,4,3,1,0.004624767636136994,2019-03-28 17:15:00,2019-03-28 17:30:00
169,2,0,2,0.0025695658471636034,2019-03-28 17:15:00,2019-03-28 17:30:00
170,4,1,3,0.004065442008913149,2019-03-28 17:15:00,2019-03-28 17:30:00
171,1,1,0,0.004469145059713041,2019-03-28 17:15:00,2019-03-28 17:30:00
172,6,3,3,0.009383739068717908,2019-03-28 17:15:00,2019-03-28 17:30:00
173,3,1,2,0.004469145059713041,2019-03-28 17:15:00,2019-03-28 17:30:00
175,1,1,0,0.005419050839169945,2019-03-28 17:15:00,2019-03-28 17:30:00
177,6,5,1,0.061484791675317035,2019-03-28 17:15:00,2019-03-28 17:30:00
189,1,0,1,0.0025695658471636034,2019-03-28 17:15:00,2019-03-28 17:30:00
190,2,2,0,0.005598011035772595,2019-03-28 17:15:00,2019-03-28 17:30:00
191,6,1,5,0.003095919175433385,2019-03-28 17:15:00,2019-03-28 17:30:00
197,3,2,1,0.004188078103974412,2019-03-28 17:15:00,2019-03-28 17:30:00
201,1,1,0,0.005699663883036889,2019-03-28 17:15:00,2019-03-28 17:30:00
202,1,1,0,0.0028750687084207445,2019-03-28 17:15:00,2019-03-28 17:30:00
1,4,3,1,0.004296604164863747,2019-03-28 17:30:00,2019-03-28 17:45:00
2,9,3,6,0.005523863583032604,2019-03-28 17:30:00,2019-03-28 17:45:00
5,2,2,0,0.00567752746718784,2019-03-28 17:30:00,2019-03-28 17:45:00
10,4,2,2,0.010945760910097038,2019-03-28 17:30:00,2019-03-28 17:45:00
15,9,8,1,0.01056343380936187,2019-03-28 17:30:00,2019-03-28 17:45:00
16,8,2,6,0.00492345255876394,2019-03-28 17:30:00,2019-03-28 17:45:00
18,3,2,1,0.013380338151458056,2019-03-28 17:30:00,2019-03-28 17:45:00
19,4,2,2,0.011886272408666632,2019-03-28 17:30:00,2019-03-28 17:45:00
20,5,2,3,0.00687018914218201,2019-03-28 17:30:00,2019-03-28 17:45:00
23,9,6,3,0.01281720729632479,2019-03-28 17:30:00,2019-03-28 17:45:00
26,3,1,2,0.0057111468027926,2019-03-28 17:30:00,2019-03-28 17:45:00
27,3,2,1,0.005673737018392809,2019-03-28 17:30:00,2019-03-28 17:45:00
28,1,0,1,0.0026612278334922374,2019-03-28 17:30:00,2019-03-28 17:45:00
30,1,1,0,0.003929015041947087,2019-03-28 17:30:00,2019-03-28 17:45:00
35,3,1,2,0.003358777621143779,2019-03-28 17:30:00,2019-03-28 17:45:00
37,3,2,1,0.017045443175519957,2019-03-28 17:30:00,2019-03-28 17:45:00
40,1,0,1,0.0026612278334922374,2019-03-28 17:30:00,2019-03-28 17:45:00
41,3,3,0,0.009476740121219024,2019-03-28 17:30:00,2019-03-28 17:45:00
46,2,1,1,0.006526014225961899,2019-03-28 17:30:00,2019-03-28 17:45:00
57,9,6,3,0.02707457470531334,2019-03-28 17:30:00,2019-03-28 17:45:00
58,3,3,0,0.00806533187493114,2019-03-28 17:30:00,2019-03-28 17:45:00
61,3,2,1,0.008069436993801173,2019-03-28 17:30:00,2019-03-28 17:45:00
62,7,5,2,0.010940137755966849,2019-03-28 17:30:00,2019-03-28 17:45:00
64,2,0,2,0.0026612278334922374,2019-03-28 17:30:00,2019-03-28 17:45:00
66,2,0,2,0.0026612278334922374,2019-03-28 17:30:00,2019-03-28 17:45:00
67,4,2,2,0.006569577487661854,2019-03-28 17:30:00,2019-03-28 17:45:00
68,2,0,2,0.0026612278334922374,2019-03-28 17:30:00,2019-03-28 17:45:00
69,5,2,3,0.005612197010748555,2019-03-28 17:30:00,2019-03-28 17:45:00
74,5,3,2,0.007864852379264608,2019-03-28 17:30:00,2019-03-28 17:45:00
75,8,3,5,0.005092230639427224,2019-03-28 17:30:00,2019-03-28 17:45:00
79,1,1,0,0.0057111468027926,2019-03-28 17:30:00,2019-03-28 17:45:00
85,2,0,2,0.0026612278334922374,2019-03-28 17:30:00,2019-03-28 17:45:00
86,6,2,4,0.004628540618329782,2019-03-28 17:30:00,2019-03-28 17:45:00
87,4,2,2,0.007995787947185655,2019-03-28 17:30:00,2019-03-28 17:45:00
88,2,1,1,0.0046079644169103075,2019-03-28 17:30:00,2019-03-28 17:45:00
89,3,3,0,0.026734304045613125,2019-03-28 17:30:00,2019-03-28 17:45:00
90,3,2,1,0.018742295994123227,2019-03-28 17:30:00,2019-03-28 17:45:00
101,2,0,2,0.0026612278334922374,2019-03-28 17:30:00,2019-03-28 17:45:00
108,1,1,0,0.0060041377667068565,2019-03-28 17:30:00,2019-03-28 17:45:00
109,3,0,3,0.0026612278334922374,2019-03-28 17:30:00,2019-03-28 17:45:00
110,2,0,2,0.0026612278334922374,2019-03-28 17:30:00,2019-03-28 17:45:00
111,3,3,0,0.009712693469263872,2019-03-28 17:30:00,2019-03-28 17:45:00
112,7,3,4,0.008563166188004873,2019-03-28 17:30:00,2019-03-28 17:45:00
113,9,5,4,0.014350572499015198,2019-03-28 17:30:00,2019-03-28 17:45:00
114,3,1,2,0.004913577200477324,2019-03-28 17:30:00,2019-03-28 17:45:00
115,4,4,0,0.00761651294598723,2019-03-28 17:30:00,2019-03-28 17:45:00
116,6,1,5,0.0032063532772827405,2019-03-28 17:30:00,2019-03-28 17:45:00
118,1,0,1,0.0026612278334922374,2019-03-28 17:30:00,2019-03-28 17:45:00
119,4,2,2,0.015790868295606865,2019-03-28 17:30:00,2019-03-28 17:45:00
120,10,1,9,0.0029388042296036023,2019-03-28 17:30:00,2019-03-28 17:45:00
122,1,0,1,0.0026612278334922374,2019-03-28 17:30:00,2019-03-28 17:45:00
126,6,1,5,0.0032063532772827405,2019-03-28 17:30:00,2019-03-28 17:45:00
135,2,1,1,0.017625954683721346,2019-03-28 17:30:00,2019-03-28 17:45:00
137,9,8,1,0.02260970962867357,2019-03-28 17:30:00,2019-03-28 17:45:00
138,12,6,6,0.012275810040859127,2019-03-28 17:30:00,2019-03-28 17:45:00
140,3,1,2,0.006275341069727735,2019-03-28 17:30:00,2019-03-28 17:45:00
141,2,1,1,0.0042515031641178315,2019-03-28 17:30:00,2019-03-28 17:45:00
147,1,0,1,0.0026612278334922374,2019-03-28 17:30:00,2019-03-28 17:45:00
151,2,2,0,0.008294861648674781,2019-03-28 17:30:00,2019-03-28 17:45:00
153,13,3,10,0.0068810831199779005,2019-03-28 17:30:00,2019-03-28 17:45:00
154,3,2,1,0.004546415104551989,2019-03-28 17:30:00,2019-03-28 17:45:00
157,10,6,4,0.0132880412900993,2019-03-28 17:30:00,2019-03-28 17:45:00
158,4,1,3,0.0037923401961280885,2019-03-28 17:30:00,2019-03-28 17:45:00
160,2,1,1,0.017625954683721346,2019-03-28 17:30:00,2019-03-28 17:45:00
161,1,1,0,0.003415302741916138,2019-03-28 17:30:00,2019-03-28 17:45:00
162,1,1,0,0.0036448842259110097,2019-03-28 17:30:00,2019-03-28 17:45:00
164,3,1,2,0.0037923401961280885,2019-03-28 17:30:00,2019-03-28 17:45:00
168,1,1,0,0.0037923401961280885,2019-03-28 17:30:00,2019-03-28 17:45:00
169,5,1,4,0.003379413844485624,2019-03-28 17:30:00,2019-03-28 17:45:00
170,6,4,2,0.009512652369236669,2019-03-28 17:30:00,2019-03-28 17:45:00
172,6,3,3,0.007948547123703773,2019-03-28 17:30:00,2019-03-28 17:45:00
173,5,2,3,0.0044741404857375905,2019-03-28 17:30:00,2019-03-28 17:45:00
175,1,1,0,0.0037923401961280885,2019-03-28 17:30:00,2019-03-28 17:45:00
177,2,2,0,0.011961395810169386,2019-03-28 17:30:00,2019-03-28 17:45:00
189,2,0,2,0.0026612278334922374,2019-03-28 17:30:00,2019-03-28 17:45:00
190,4,3,1,0.011617911361128401,2019-03-28 17:30:00,2019-03-28 17:45:00
191,3,0,3,0.0026612278334922374,2019-03-28 17:30:00,2019-03-28 17:45:00
195,1,0,1,0.0026612278334922374,2019-03-28 17:30:00,2019-03-28 17:45:00
196,5,4,1,0.04004602227023861,2019-03-28 17:30:00,2019-03-28 17:45:00
197,2,1,1,0.0037358150753557294,2019-03-28 17:30:00,2019-03-28 17:45:00
199,2,1,1,0.009521077196095433,2019-03-28 17:30:00,2019-03-28 17:45:00
201,2,2,0,0.025474637579479827,2019-03-28 17:30:00,2019-03-28 17:45:00
202,4,2,2,0.007653769076767747,2019-03-28 17:30:00,2019-03-28 17:45:00
203,3,2,1,0.004226468945974966,2019-03-28 17:30:00,2019-03-28 17:45:00
1,5,3,2,0.0038044319996189875,2019-03-28 17:45:00,2019-03-28 18:00:00
2,8,5,3,0.01358802467472826,2019-03-28 17:45:00,2019-03-28 18:00:00
5,2,2,0,0.004958402696618173,2019-03-28 17:45:00,2019-03-28 18:00:00
10,3,2,1,0.03361209721373311,2019-03-28 17:45:00,2019-03-28 18:00:00
15,5,4,1,0.03462740161882745,2019-03-28 17:45:00,2019-03-28 18:00:00
16,15,6,9,0.017496888566079553,2019-03-28 17:45:00,2019-03-28 18:00:00
18,5,2,3,0.005164712557141075,2019-03-28 17:45:00,2019-03-28 18:00:00
19,8,3,5,0.0052495617067321015,2019-03-28 17:45:00,2019-03-28 18:00:00
20,9,3,6,0.0057768666512258236,2019-03-28 17:45:00,2019-03-28 18:00:00
23,5,3,2,0.006623362242404222,2019-03-28 17:45:00,2019-03-28 18:00:00
26,2,1,1,0.0066166542854285875,2019-03-28 17:45:00,2019-03-28 18:00:00
27,1,0,1,0.002237727945344955,2019-03-28 17:45:00,2019-03-28 18:00:00
28,2,1,1,0.0038547481684659953,2019-03-28 17:45:00,2019-03-28 18:00:00
30,1,1,0,0.0036646441306110054,2019-03-28 17:45:00,2019-03-28 18:00:00
35,1,0,1,0.002237727945344955,2019-03-28 17:45:00,2019-03-28 18:00:00
37,2,1,1,0.008388060657415247,2019-03-28 17:45:00,2019-03-28 18:00:00
40,1,0,1,0.002237727945344955,2019-03-28 17:45:00,2019-03-28 18:00:00
41,7,5,2,0.008212350828954516,2019-03-28 17:45:00,2019-03-28 18:00:00
46,3,2,1,0.005690410682777083,2019-03-28 17:45:00,2019-03-28 18:00:00
57,6,5,1,0.012442340561618179,2019-03-28 17:45:00,2019-03-28 18:00:00
58,5,3,2,0.011362569517948392,2019-03-28 17:45:00,2019-03-28 18:00:00
61,2,2,0,0.004875712885118084,2019-03-28 17:45:00,2019-03-28 18:00:00
62,4,3,1,0.005843018292151484,2019-03-28 17:45:00,2019-03-28 18:00:00
64,1,0,1,0.002237727945344955,2019-03-28 17:45:00,2019-03-28 18:00:00
66,2,0,2,0.002237727945344955,2019-03-28 17:45:00,2019-03-28 18:00:00
67,5,2,3,0.00572440611819338,2019-03-28 17:45:00,2019-03-28 18:00:00
68,3,0,3,0.002237727945344955,2019-03-28 17:45:00,2019-03-28 18:00:00
69,1,1,0,0.0028717982109001438,2019-03-28 17:45:00,2019-03-28 18:00:00
74,3,1,2,0.004139938742010521,2019-03-28 17:45:00,2019-03-28 18:00:00
75,2,0,2,0.002237727945344955,2019-03-28 17:45:00,2019-03-28 18:00:00
79,1,1,0,0.0066166542854285875,2019-03-28 17:45:00,2019-03-28 18:00:00
85,4,0,4,0.002237727945344955,2019-03-28 17:45:00,2019-03-28 18:00:00
86,4,2,2,0.014898389418735955,2019-03-28 17:45:00,2019-03-28 18:00:00
87,6,0,6,0.002237727945344955,2019-03-28 17:45:00,2019-03-28 18:00:00
88,3,0,3,0.002237727945344955,2019-03-28 17:45:00,2019-03-28 18:00:00
89,4,4,0,0.017915016797952585,2019-03-28 17:45:00,2019-03-28 18:00:00
90,9,6,3,0.020149301329218994,2019-03-28 17:45:00,2019-03-28 18:00:00
104,1,1,0,0.0031302289811994703,2019-03-28 17:45:00,2019-03-28 18:00:00
108,1,1,0,0.003997347359237846,2019-03-28 17:45:00,2019-03-28 18:00:00
109,3,0,3,0.002237727945344955,2019-03-28 17:45:00,2019-03-28 18:00:00
110,1,1,0,0.007947786113052115,2019-03-28 17:45:00,2019-03-28 18:00:00
111,7,4,3,0.016095051280583385,2019-03-28 17:45:00,2019-03-28 18:00:00
112,6,3,3,0.009555189474835255,2019-03-28 17:45:00,2019-03-28 18:00:00
113,6,3,3,0.01545300959992779,2019-03-28 17:45:00,2019-03-28 18:00:00
114,1,0,1,0.002237727945344955,2019-03-28 17:45:00,2019-03-28 18:00:00
115,5,2,3,0.005113660479158333,2019-03-28 17:45:00,2019-03-28 18:00:00
116,9,2,7,0.002955566248767758,2019-03-28 17:45:00,2019-03-28 18:00:00
118,1,0,1,0.002237727945344955,2019-03-28 17:45:00,2019-03-28 18:00:00
119,8,5,3,0.021703674292265884,2019-03-28 17:45:00,2019-03-28 18:00:00
120,6,2,4,0.010507450352073547,2019-03-28 17:45:00,2019-03-28 18:00:00
122,1,0,1,0.002237727945344955,2019-03-28 17:45:00,2019-03-28 18:00:00
126,5,1,4,0.0028416203966262705,2019-03-28 17:45:00,2019-03-28 18:00:00
129,1,1,0,0.003859786869756501,2019-03-28 17:45:00,2019-03-28 18:00:00
135,3,2,1,0.025691108958984167,2019-03-28 17:45:00,2019-03-28 18:00:00
137,11,8,3,0.016396174614156225,2019-03-28 17:45:00,2019-03-28 18:00:00
138,8,4,4,0.009971670493754296,2019-03-28 17:45:00,2019-03-28 18:00:00
140,3,1,2,0.003878283766713263,2019-03-28 17:45:00,2019-03-28 18:00:00
141,3,1,2,0.003859786869756501,2019-03-28 17:45:00,2019-03-28 18:00:00
147,1,0,1,0.002237727945344955,2019-03-28 17:45:00,2019-03-28 18:00:00
151,1,1,0,0.004546707695733737,2019-03-28 17:45:00,2019-03-28 18:00:00
153,4,1,3,0.0025966470970563565,2019-03-28 17:45:00,2019-03-28 18:00:00
154,6,2,4,0.0035058684764553323,2019-03-28 17:45:00,2019-03-28 18:00:00
157,10,7,3,0.03852693424044522,2019-03-28 17:45:00,2019-03-28 18:00:00
158,2,1,1,0.007067675987607226,2019-03-28 17:45:00,2019-03-28 18:00:00
159,1,1,0,0.003860913542892519,2019-03-28 17:45:00,2019-03-28 18:00:00
160,2,1,1,0.014898389418735955,2019-03-28 17:45:00,2019-03-28 18:00:00
161,1,1,0,0.0028717982109001438,2019-03-28 17:45:00,2019-03-28 18:00:00
164,5,3,2,0.0035477524953891394,2019-03-28 17:45:00,2019-03-28 18:00:00
168,6,5,1,0.011370849548795787,2019-03-28 17:45:00,2019-03-28 18:00:00
169,3,0,3,0.002237727945344955,2019-03-28 17:45:00,2019-03-28 18:00:00
170,11,6,5,0.013579799038327213,2019-03-28 17:45:00,2019-03-28 18:00:00
171,2,1,1,0.002982785316364716,2019-03-28 17:45:00,2019-03-28 18:00:00
172,6,3,3,0.014898389418735955,2019-03-28 17:45:00,2019-03-28 18:00:00
173,6,3,3,0.005035694116193359,2019-03-28 17:45:00,2019-03-28 18:00:00
175,1,1,0,0.004139938742010521,2019-03-28 17:45:00,2019-03-28 18:00:00
177,1,1,0,0.00720480982668864,2019-03-28 17:45:00,2019-03-28 18:00:00
189,1,0,1,0.002237727945344955,2019-03-28 17:45:00,2019-03-28 18:00:00
190,3,2,1,0.007810893498693818,2019-03-28 17:45:00,2019-03-28 18:00:00
191,4,1,3,0.005728311217957234,2019-03-28 17:45:00,2019-03-28 18:00:00
195,1,0,1,0.002237727945344955,2019-03-28 17:45:00,2019-03-28 18:00:00
196,5,4,1,0.07116535939275238,2019-03-28 17:45:00,2019-03-28 18:00:00
197,1,1,0,0.0037456461677863534,2019-03-28 17:45:00,2019-03-28 18:00:00
199,1,0,1,0.002237727945344955,2019-03-28 17:45:00,2019-03-28 18:00:00
201,1,1,0,0.010687231311559428,2019-03-28 17:45:00,2019-03-28 18:00:00
202,3,1,2,0.004357117640003256,2019-03-28 17:45:00,2019-03-28 18:00:00
203,3,2,1,0.009938870150426675,2019-03-28 17:45:00,2019-03-28 18:00:00
1,3,3,0,0.009109425516899139,2019-03-28 18:00:00,2019-03-28 18:15:00
2,3,3,0,0.00619912085351417,2019-03-28 18:00:00,2019-03-28 18:15:00
5,2,2,0,0.004413540291502349,2019-03-28 18:00:00,2019-03-28 18:15:00
10,3,2,1,0.03735741791136961,2019-03-28 18:00:00,2019-03-28 18:15:00
15,4,2,2,0.007813981451716514,2019-03-28 18:00:00,2019-03-28 18:15:00
16,12,8,4,0.03197355535995205,2019-03-28 18:00:00,2019-03-28 18:15:00
18,6,3,3,0.007650557787646132,2019-03-28 18:00:00,2019-03-28 18:15:00
19,7,2,5,0.005777104161547049,2019-03-28 18:00:00,2019-03-28 18:15:00
20,6,1,5,0.00326259043447123,2019-03-28 18:00:00,2019-03-28 18:15:00
22,1,0,1,0.0027079045427973983,2019-03-28 18:00:00,2019-03-28 18:15:00
23,6,3,3,0.010306822036245956,2019-03-28 18:00:00,2019-03-28 18:15:00
26,1,1,0,0.0050098042568596365,2019-03-28 18:00:00,2019-03-28 18:15:00
28,1,0,1,0.0027079045427973983,2019-03-28 18:00:00,2019-03-28 18:15:00
30,1,1,0,0.004654980266760091,2019-03-28 18:00:00,2019-03-28 18:15:00
35,4,3,1,0.005396599046271183,2019-03-28 18:00:00,2019-03-28 18:15:00
37,1,1,0,0.005072106627628227,2019-03-28 18:00:00,2019-03-28 18:15:00
40,2,0,2,0.0027079045427973983,2019-03-28 18:00:00,2019-03-28 18:15:00
41,4,3,1,0.004371962217818893,2019-03-28 18:00:00,2019-03-28 18:15:00
46,2,0,2,0.0027079045427973983,2019-03-28 18:00:00,2019-03-28 18:15:00
58,6,1,5,0.004875810209099374,2019-03-28 18:00:00,2019-03-28 18:15:00
62,4,2,2,0.005180647369507628,2019-03-28 18:00:00,2019-03-28 18:15:00
66,1,0,1,0.0027079045427973983,2019-03-28 18:00:00,2019-03-28 18:15:00
67,6,3,3,0.00857926946521823,2019-03-28 18:00:00,2019-03-28 18:15:00
68,1,0,1,0.0027079045427973983,2019-03-28 18:00:00,2019-03-28 18:15:00
69,4,2,2,0.008713358058788381,2019-03-28 18:00:00,2019-03-28 18:15:00
74,6,3,3,0.012670606002737632,2019-03-28 18:00:00,2019-03-28 18:15:00
75,2,0,2,0.0027079045427973983,2019-03-28 18:00:00,2019-03-28 18:15:00
79,1,1,0,0.0050098042568596365,2019-03-28 18:00:00,2019-03-28 18:15:00
85,3,0,3,0.0027079045427973983,2019-03-28 18:00:00,2019-03-28 18:15:00
86,4,2,2,0.01800767552142,2019-03-28 18:00:00,2019-03-28 18:15:00
87,5,1,4,0.0034386861839007547,2019-03-28 18:00:00,2019-03-28 18:15:00
88,1,1,0,0.0034386861839007547,2019-03-28 18:00:00,2019-03-28 18:15:00
89,3,2,1,0.007252535180383249,2019-03-28 18:00:00,2019-03-28 18:15:00
90,7,4,3,0.029277383864775974,2019-03-28 18:00:00,2019-03-28 18:15:00
99,1,0,1,0.0027079045427973983,2019-03-28 18:00:00,2019-03-28 18:15:00
104,2,2,0,0.0059919976534092735,2019-03-28 18:00:00,2019-03-28 18:15:00
108,4,1,3,0.006298332546095067,2019-03-28 18:00:00,2019-03-28 18:15:00
109,2,1,1,0.0040767690959144605,2019-03-28 18:00:00,2019-03-28 18:15:00
110,2,2,0,0.01183235241313682,2019-03-28 18:00:00,2019-03-28 18:15:00
111,4,2,2,0.007950180633562148,2019-03-28 18:00:00,2019-03-28 18:15:00
112,4,2,2,0.01800767552142,2019-03-28 18:00:00,2019-03-28 18:15:00
113,5,2,3,0.005384641543610268,2019-03-28 18:00:00,2019-03-28 18:15:00
114,1,0,1,0.0027079045427973983,2019-03-28 18:00:00,2019-03-28 18:15:00
115,8,3,5,0.006995246720445743,2019-03-28 18:00:00,2019-03-28 18:15:00
116,4,1,3,0.00688170971748499,2019-03-28 18:00:00,2019-03-28 18:15:00
118,2,0,2,0.0027079045427973983,2019-03-28 18:00:00,2019-03-28 18:15:00
119,6,2,4,0.01112433032985162,2019-03-28 18:00:00,2019-03-28 18:15:00
120,6,2,4,0.006440971180745289,2019-03-28 18:00:00,2019-03-28 18:15:00
122,1,1,0,0.005072106627628227,2019-03-28 18:00:00,2019-03-28 18:15:00
126,5,2,3,0.007854401008735011,2019-03-28 18:00:00,2019-03-28 18:15:00
127,4,4,0,0.007609069325419981,2019-03-28 18:00:00,2019-03-28 18:15:00
129,1,1,0,0.005138960101229552,2019-03-28 18:00:00,2019-03-28 18:15:00
135,3,2,1,0.034147604374032706,2019-03-28 18:00:00,2019-03-28 18:15:00
137,11,8,3,0.02043615902931289,2019-03-28 18:00:00,2019-03-28 18:15:00
138,3,1,2,0.006424863325799184,2019-03-28 18:00:00,2019-03-28 18:15:00
140,2,1,1,0.006424863325799184,2019-03-28 18:00:00,2019-03-28 18:15:00
141,3,2,1,0.007869968954645205,2019-03-28 18:00:00,2019-03-28 18:15:00
151,1,0,1,0.0027079045427973983,2019-03-28 18:00:00,2019-03-28 18:15:00
153,8,2,6,0.0054267910628706464,2019-03-28 18:00:00,2019-03-28 18:15:00
154,4,1,3,0.006298332546095067,2019-03-28 18:00:00,2019-03-28 18:15:00
157,4,4,0,0.010471821963690942,2019-03-28 18:00:00,2019-03-28 18:15:00
158,1,1,0,0.00353687930158423,2019-03-28 18:00:00,2019-03-28 18:15:00
159,1,1,0,0.003944275956152514,2019-03-28 18:00:00,2019-03-28 18:15:00
160,3,2,1,0.03330744650004261,2019-03-28 18:00:00,2019-03-28 18:15:00
161,1,1,0,0.006173501542441983,2019-03-28 18:00:00,2019-03-28 18:15:00
162,1,1,0,0.0049098909947936165,2019-03-28 18:00:00,2019-03-28 18:15:00
164,13,5,8,0.007789062726829537,2019-03-28 18:00:00,2019-03-28 18:15:00
168,2,1,1,0.0036900979393470357,2019-03-28 18:00:00,2019-03-28 18:15:00
169,3,0,3,0.0027079045427973983,2019-03-28 18:00:00,2019-03-28 18:15:00
170,7,3,4,0.01748834868168083,2019-03-28 18:00:00,2019-03-28 18:15:00
171,1,1,0,0.004492637146976695,2019-03-28 18:00:00,2019-03-28 18:15:00
172,6,3,3,0.01800767552142,2019-03-28 18:00:00,2019-03-28 18:15:00
173,6,3,3,0.00687127034028576,2019-03-28 18:00:00,2019-03-28 18:15:00
177,2,1,1,0.0049098909947936165,2019-03-28 18:00:00,2019-03-28 18:15:00
189,1,1,0,0.006029248847537217,2019-03-28 18:00:00,2019-03-28 18:15:00
190,1,1,0,0.0038588543998285176,2019-03-28 18:00:00,2019-03-28 18:15:00
191,5,2,3,0.004363248251965529,2019-03-28 18:00:00,2019-03-28 18:15:00
196,7,5,2,0.011851004718609722,2019-03-28 18:00:00,2019-03-28 18:15:00
197,1,1,0,0.003535576397381464,2019-03-28 18:00:00,2019-03-28 18:15:00
202,1,1,0,0.008873529512630257,2019-03-28 18:00:00,2019-03-28 18:15:00
203,1,1,0,0.0064114583447261436,2019-03-28 18:00:00,2019-03-28 18:15:00
1,2,2,0,0.005112274606010889,2019-03-28 18:15:00,2019-03-28 18:30:00
2,5,4,1,0.007200883008793124,2019-03-28 18:15:00,2019-03-28 18:30:00
5,2,1,1,0.004188632707995823,2019-03-28 18:15:00,2019-03-28 18:30:00
10,2,1,1,0.019515470214688527,2019-03-28 18:15:00,2019-03-28 18:30:00
15,3,1,2,0.005112274606010889,2019-03-28 18:15:00,2019-03-28 18:30:00
16,8,7,1,0.019609147062638638,2019-03-28 18:15:00,2019-03-28 18:30:00
18,6,3,3,0.006411138602764242,2019-03-28 18:15:00,2019-03-28 18:30:00
19,8,4,4,0.011330560592744508,2019-03-28 18:15:00,2019-03-28 18:30:00
20,2,1,1,0.019515470214688527,2019-03-28 18:15:00,2019-03-28 18:30:00
22,1,0,1,0.0029393042037405884,2019-03-28 18:15:00,2019-03-28 18:30:00
23,8,3,5,0.0064317868203302535,2019-03-28 18:15:00,2019-03-28 18:30:00
26,3,3,0,0.0209437281734089,2019-03-28 18:15:00,2019-03-28 18:30:00
27,1,1,0,0.004188632707995823,2019-03-28 18:15:00,2019-03-28 18:30:00
28,4,3,1,0.010473530329450292,2019-03-28 18:15:00,2019-03-28 18:30:00
30,6,4,2,0.012059470986565695,2019-03-28 18:15:00,2019-03-28 18:30:00
35,4,2,2,0.0055830927113119004,2019-03-28 18:15:00,2019-03-28 18:30:00
37,3,1,2,0.004677210083295588,2019-03-28 18:15:00,2019-03-28 18:30:00
40,2,0,2,0.0029393042037405884,2019-03-28 18:15:00,2019-03-28 18:30:00
41,3,2,1,0.00667174438441373,2019-03-28 18:15:00,2019-03-28 18:30:00
46,2,2,0,0.021426028757212185,2019-03-28 18:15:00,2019-03-28 18:30:00
50,1,1,0,0.004781186234096558,2019-03-28 18:15:00,2019-03-28 18:30:00
58,2,0,2,0.0029393042037405884,2019-03-28 18:15:00,2019-03-28 18:30:00
61,1,0,1,0.0029393042037405884,2019-03-28 18:15:00,2019-03-28 18:30:00
62,5,1,4,0.004781186234096558,2019-03-28 18:15:00,2019-03-28 18:30:00
64,1,1,0,0.004756012285891844,2019-03-28 18:15:00,2019-03-28 18:30:00
66,1,1,0,0.0033455967922492533,2019-03-28 18:15:00,2019-03-28 18:30:00
67,6,2,4,0.004605075542747568,2019-03-28 18:15:00,2019-03-28 18:30:00
68,3,1,2,0.004188632707995823,2019-03-28 18:15:00,2019-03-28 18:30:00
69,4,2,2,0.007936618220761528,2019-03-28 18:15:00,2019-03-28 18:30:00
70,1,1,0,0.006312744750911486,2019-03-28 18:15:00,2019-03-28 18:30:00
74,4,2,2,0.005552546388228229,2019-03-28 18:15:00,2019-03-28 18:30:00
75,2,0,2,0.0029393042037405884,2019-03-28 18:15:00,2019-03-28 18:30:00
79,2,2,0,0.007936618220761528,2019-03-28 18:15:00,2019-03-28 18:30:00
85,2,1,1,0.006425981128482373,2019-03-28 18:15:00,2019-03-28 18:30:00
86,4,2,2,0.019515470214688527,2019-03-28 18:15:00,2019-03-28 18:30:00
87,3,1,2,0.005112274606010889,2019-03-28 18:15:00,2019-03-28 18:30:00
88,3,3,0,0.00910388165748674,2019-03-28 18:15:00,2019-03-28 18:30:00
89,4,1,3,0.004101529845321183,2019-03-28 18:15:00,2019-03-28 18:30:00
90,3,1,2,0.004695471473787216,2019-03-28 18:15:00,2019-03-28 18:30:00
99,1,0,1,0.0029393042037405884,2019-03-28 18:15:00,2019-03-28 18:30:00
101,2,1,1,0.019515470214688527,2019-03-28 18:15:00,2019-03-28 18:30:00
104,6,4,2,0.010705292338784915,2019-03-28 18:15:00,2019-03-28 18:30:00
108,3,0,3,0.0029393042037405884,2019-03-28 18:15:00,2019-03-28 18:30:00
109,5,3,2,0.005688460986554805,2019-03-28 18:15:00,2019-03-28 18:30:00
110,3,1,2,0.004131679125526613,2019-03-28 18:15:00,2019-03-28 18:30:00
111,2,1,1,0.0033455967922492533,2019-03-28 18:15:00,2019-03-28 18:30:00
112,4,2,2,0.019515470214688527,2019-03-28 18:15:00,2019-03-28 18:30:00
113,3,1,2,0.005112274606010889,2019-03-28 18:15:00,2019-03-28 18:30:00
114,1,1,0,0.008065372593378228,2019-03-28 18:15:00,2019-03-28 18:30:00
115,6,1,5,0.004188632707995823,2019-03-28 18:15:00,2019-03-28 18:30:00
116,1,1,0,0.0063017796437012715,2019-03-28 18:15:00,2019-03-28 18:30:00
118,1,1,0,0.003917987129687483,2019-03-28 18:15:00,2019-03-28 18:30:00
119,4,1,3,0.006132991290583853,2019-03-28 18:15:00,2019-03-28 18:30:00
120,8,1,7,0.0033455967922492533,2019-03-28 18:15:00,2019-03-28 18:30:00
122,4,2,2,0.006665263425705863,2019-03-28 18:15:00,2019-03-28 18:30:00
126,6,2,4,0.005112274606010889,2019-03-28 18:15:00,2019-03-28 18:30:00
127,11,6,5,0.014939429541908555,2019-03-28 18:15:00,2019-03-28 18:30:00
129,1,1,0,0.003917987129687483,2019-03-28 18:15:00,2019-03-28 18:30:00
135,2,1,1,0.019515470214688527,2019-03-28 18:15:00,2019-03-28 18:30:00
137,7,3,4,0.004944264302543942,2019-03-28 18:15:00,2019-03-28 18:30:00
138,2,0,2,0.0029393042037405884,2019-03-28 18:15:00,2019-03-28 18:30:00
140,1,1,0,0.004444668565550557,2019-03-28 18:15:00,2019-03-28 18:30:00
141,3,3,0,0.005879458239936379,2019-03-28 18:15:00,2019-03-28 18:30:00
147,1,0,1,0.0029393042037405884,2019-03-28 18:15:00,2019-03-28 18:30:00
151,1,0,1,0.0029393042037405884,2019-03-28 18:15:00,2019-03-28 18:30:00
153,7,3,4,0.0062199112738915395,2019-03-28 18:15:00,2019-03-28 18:30:00
154,2,2,0,0.007055565922501087,2019-03-28 18:15:00,2019-03-28 18:30:00
156,2,0,2,0.0029393042037405884,2019-03-28 18:15:00,2019-03-28 18:30:00
157,4,3,1,0.005437961212251059,2019-03-28 18:15:00,2019-03-28 18:30:00
158,1,1,0,0.005347350894507574,2019-03-28 18:15:00,2019-03-28 18:30:00
159,2,2,0,0.01179771189409173,2019-03-28 18:15:00,2019-03-28 18:30:00
160,3,1,2,0.005112274606010889,2019-03-28 18:15:00,2019-03-28 18:30:00
161,1,1,0,0.00535717627535519,2019-03-28 18:15:00,2019-03-28 18:30:00
162,1,1,0,0.003955422098397561,2019-03-28 18:15:00,2019-03-28 18:30:00
164,13,5,8,0.011220887528869157,2019-03-28 18:15:00,2019-03-28 18:30:00
168,1,0,1,0.0029393042037405884,2019-03-28 18:15:00,2019-03-28 18:30:00
169,3,0,3,0.0029393042037405884,2019-03-28 18:15:00,2019-03-28 18:30:00
170,4,1,3,0.005312409313216664,2019-03-28 18:15:00,2019-03-28 18:30:00
172,6,3,3,0.019515470214688527,2019-03-28 18:15:00,2019-03-28 18:30:00
173,7,2,5,0.004363589415727909,2019-03-28 18:15:00,2019-03-28 18:30:00
177,2,1,1,0.003955422098397561,2019-03-28 18:15:00,2019-03-28 18:30:00
189,1,1,0,0.005112274606010889,2019-03-28 18:15:00,2019-03-28 18:30:00
190,4,1,3,0.006500017233708889,2019-03-28 18:15:00,2019-03-28 18:30:00
191,4,3,1,0.007864119306199754,2019-03-28 18:15:00,2019-03-28 18:30:00
195,1,1,0,0.00535717627535519,2019-03-28 18:15:00,2019-03-28 18:30:00
196,8,5,3,0.011270361687971435,2019-03-28 18:15:00,2019-03-28 18:30:00
197,2,2,0,0.009803438882024668,2019-03-28 18:15:00,2019-03-28 18:30:00
199,1,1,0,0.0036811947320472774,2019-03-28 18:15:00,2019-03-28 18:30:00
201,3,3,0,0.01306703272151996,2019-03-28 18:15:00,2019-03-28 18:30:00
202,2,1,1,0.004101529845321183,2019-03-28 18:15:00,2019-03-28 18:30:00
203,1,1,0,0.006312744750911486,2019-03-28 18:15:00,2019-03-28 18:30:00
1,3,2,1,0.008529413078974757,2019-03-28 18:30:00,2019-03-28 18:45:00
2,3,3,0,0.007146820178110687,2019-03-28 18:30:00,2019-03-28 18:45:00
5,1,0,1,0.002745343575125578,2019-03-28 18:30:00,2019-03-28 18:45:00
10,4,3,1,0.0455913454070074,2019-03-28 18:30:00,2019-03-28 18:45:00
11,1,1,0,0.0038872932668550355,2019-03-28 18:30:00,2019-03-28 18:45:00
15,3,2,1,0.023948397709272633,2019-03-28 18:30:00,2019-03-28 18:45:00
16,6,5,1,0.011487277870340993,2019-03-28 18:30:00,2019-03-28 18:45:00
18,6,3,3,0.006601532435714539,2019-03-28 18:30:00,2019-03-28 18:45:00
19,9,4,5,0.006716644456478194,2019-03-28 18:30:00,2019-03-28 18:45:00
20,2,1,1,0.01826013658967867,2019-03-28 18:30:00,2019-03-28 18:45:00
23,8,2,6,0.006046720713749078,2019-03-28 18:30:00,2019-03-28 18:45:00
26,3,1,2,0.003979002304835947,2019-03-28 18:30:00,2019-03-28 18:45:00
27,1,1,0,0.003912222672161567,2019-03-28 18:30:00,2019-03-28 18:45:00
28,2,2,0,0.005237674646549225,2019-03-28 18:30:00,2019-03-28 18:45:00
30,5,5,0,0.010831951522575399,2019-03-28 18:30:00,2019-03-28 18:45:00
35,3,1,2,0.0041147964547256595,2019-03-28 18:30:00,2019-03-28 18:45:00
37,8,1,7,0.0057083845710506065,2019-03-28 18:30:00,2019-03-28 18:45:00
41,9,5,4,0.009683854139463363,2019-03-28 18:30:00,2019-03-28 18:45:00
46,3,2,1,0.005757975012372022,2019-03-28 18:30:00,2019-03-28 18:45:00
57,2,1,1,0.004242875673721986,2019-03-28 18:30:00,2019-03-28 18:45:00
58,3,0,3,0.002745343575125578,2019-03-28 18:30:00,2019-03-28 18:45:00
62,5,2,3,0.004301182371173563,2019-03-28 18:30:00,2019-03-28 18:45:00
64,1,1,0,0.004616025320642565,2019-03-28 18:30:00,2019-03-28 18:45:00
66,3,3,0,0.009060385265987634,2019-03-28 18:30:00,2019-03-28 18:45:00
67,3,0,3,0.002745343575125578,2019-03-28 18:30:00,2019-03-28 18:45:00
68,6,1,5,0.003912222672161567,2019-03-28 18:30:00,2019-03-28 18:45:00
69,3,1,2,0.005079101769197555,2019-03-28 18:30:00,2019-03-28 18:45:00
70,3,3,0,0.006234468556344117,2019-03-28 18:30:00,2019-03-28 18:45:00
74,3,1,2,0.003410487014876225,2019-03-28 18:30:00,2019-03-28 18:45:00
75,2,0,2,0.002745343575125578,2019-03-28 18:30:00,2019-03-28 18:45:00
79,1,1,0,0.005079101769197555,2019-03-28 18:30:00,2019-03-28 18:45:00
85,2,2,0,0.012749910116372219,2019-03-28 18:30:00,2019-03-28 18:45:00
86,4,2,2,0.01826013658967867,2019-03-28 18:30:00,2019-03-28 18:45:00
87,2,1,1,0.01826013658967867,2019-03-28 18:30:00,2019-03-28 18:45:00
88,6,5,1,0.011570970092904373,2019-03-28 18:30:00,2019-03-28 18:45:00
89,5,4,1,0.00983123889715999,2019-03-28 18:30:00,2019-03-28 18:45:00
90,5,1,4,0.004436611125349537,2019-03-28 18:30:00,2019-03-28 18:45:00
99,1,0,1,0.002745343575125578,2019-03-28 18:30:00,2019-03-28 18:45:00
101,4,2,2,0.01826013658967867,2019-03-28 18:30:00,2019-03-28 18:45:00
104,4,4,0,0.008278586988159897,2019-03-28 18:30:00,2019-03-28 18:45:00
109,7,3,4,0.005157916670652499,2019-03-28 18:30:00,2019-03-28 18:45:00
110,3,1,2,0.003979002304835947,2019-03-28 18:30:00,2019-03-28 18:45:00
111,7,4,3,0.008957863044981978,2019-03-28 18:30:00,2019-03-28 18:45:00
112,4,2,2,0.01826013658967867,2019-03-28 18:30:00,2019-03-28 18:45:00
114,1,1,0,0.004436611125349537,2019-03-28 18:30:00,2019-03-28 18:45:00
115,5,3,2,0.00795898183819714,2019-03-28 18:30:00,2019-03-28 18:45:00
116,1,1,0,0.006115199215516719,2019-03-28 18:30:00,2019-03-28 18:45:00
118,3,1,2,0.0035232629731495706,2019-03-28 18:30:00,2019-03-28 18:45:00
119,9,4,5,0.0174268591006247,2019-03-28 18:30:00,2019-03-28 18:45:00
120,6,0,6,0.002745343575125578,2019-03-28 18:30:00,2019-03-28 18:45:00
122,4,1,3,0.003438605606943468,2019-03-28 18:30:00,2019-03-28 18:45:00
126,10,5,5,0.017009381672450048,2019-03-28 18:30:00,2019-03-28 18:45:00
127,7,3,4,0.006499243039989968,2019-03-28 18:30:00,2019-03-28 18:45:00
129,1,1,0,0.0035232629731495706,2019-03-28 18:30:00,2019-03-28 18:45:00
133,2,0,2,0.002745343575125578,2019-03-28 18:30:00,2019-03-28 18:45:00
135,2,1,1,0.01826013658967867,2019-03-28 18:30:00,2019-03-28 18:45:00
137,10,4,6,0.014593543101929118,2019-03-28 18:30:00,2019-03-28 18:45:00
140,2,1,1,0.00528372662473021,2019-03-28 18:30:00,2019-03-28 18:45:00
141,8,4,4,0.012137097696253055,2019-03-28 18:30:00,2019-03-28 18:45:00
151,1,0,1,0.002745343575125578,2019-03-28 18:30:00,2019-03-28 18:45:00
153,10,5,5,0.008054452232762549,2019-03-28 18:30:00,2019-03-28 18:45:00
154,3,3,0,0.007055540122452363,2019-03-28 18:30:00,2019-03-28 18:45:00
156,2,0,2,0.002745343575125578,2019-03-28 18:30:00,2019-03-28 18:45:00
157,8,5,3,0.009379174582167424,2019-03-28 18:30:00,2019-03-28 18:45:00
158,5,5,0,0.010654092538257517,2019-03-28 18:30:00,2019-03-28 18:45:00
159,2,2,0,0.006248431793608518,2019-03-28 18:30:00,2019-03-28 18:45:00
160,1,0,1,0.002745343575125578,2019-03-28 18:30:00,2019-03-28 18:45:00
161,1,1,0,0.0038415220342496426,2019-03-28 18:30:00,2019-03-28 18:45:00
164,10,4,6,0.008707039512913087,2019-03-28 18:30:00,2019-03-28 18:45:00
168,1,0,1,0.002745343575125578,2019-03-28 18:30:00,2019-03-28 18:45:00
169,3,0,3,0.002745343575125578,2019-03-28 18:30:00,2019-03-28 18:45:00
170,5,2,3,0.005187603527824611,2019-03-28 18:30:00,2019-03-28 18:45:00
171,2,2,0,0.007134910425646576,2019-03-28 18:30:00,2019-03-28 18:45:00
172,6,3,3,0.01826013658967867,2019-03-28 18:30:00,2019-03-28 18:45:00
173,4,0,4,0.002745343575125578,2019-03-28 18:30:00,2019-03-28 18:45:00
177,2,1,1,0.003964133641896796,2019-03-28 18:30:00,2019-03-28 18:45:00
189,1,1,0,0.003438605606943468,2019-03-28 18:30:00,2019-03-28 18:45:00
190,3,0,3,0.002745343575125578,2019-03-28 18:30:00,2019-03-28 18:45:00
191,4,1,3,0.004126595181217807,2019-03-28 18:30:00,2019-03-28 18:45:00
195,1,1,0,0.0038415220342496426,2019-03-28 18:30:00,2019-03-28 18:45:00
196,6,3,3,0.0060501802920547056,2019-03-28 18:30:00,2019-03-28 18:45:00
197,1,1,0,0.004803435320125738,2019-03-28 18:30:00,2019-03-28 18:45:00
199,2,2,0,0.010579910205022735,2019-03-28 18:30:00,2019-03-28 18:45:00
201,1,1,0,0.00528372662473021,2019-03-28 18:30:00,2019-03-28 18:45:00
202,4,2,2,0.011768259965341712,2019-03-28 18:30:00,2019-03-28 18:45:00
203,1,1,0,0.004904181676842824,2019-03-28 18:30:00,2019-03-28 18:45:00
1,2,2,0,0.007086400788208677,2019-03-28 18:45:00,2019-03-28 19:00:00
2,4,4,0,0.007503823929491684,2019-03-28 18:45:00,2019-03-28 19:00:00
5,1,0,1,0.003114416810085103,2019-03-28 18:45:00,2019-03-28 19:00:00
10,8,4,4,0.018796601512407054,2019-03-28 18:45:00,2019-03-28 19:00:00
11,1,1,0,0.004338936101303274,2019-03-28 18:45:00,2019-03-28 19:00:00
15,1,1,0,0.007719147557454363,2019-03-28 18:45:00,2019-03-28 19:00:00
16,8,6,2,0.015001485308875599,2019-03-28 18:45:00,2019-03-28 19:00:00
18,4,2,2,0.007801210718238841,2019-03-28 18:45:00,2019-03-28 19:00:00
19,5,1,4,0.005761900206793477,2019-03-28 18:45:00,2019-03-28 19:00:00
20,3,1,2,0.005416782183769732,2019-03-28 18:45:00,2019-03-28 19:00:00
21,1,1,0,0.00726229605223635,2019-03-28 18:45:00,2019-03-28 19:00:00
23,2,1,1,0.005416782183769732,2019-03-28 18:45:00,2019-03-28 19:00:00
26,2,1,1,0.004435182641071296,2019-03-28 18:45:00,2019-03-28 19:00:00
28,1,1,0,0.004799366643752477,2019-03-28 18:45:00,2019-03-28 19:00:00
30,1,1,0,0.004663217885255721,2019-03-28 18:45:00,2019-03-28 19:00:00
35,1,1,0,0.00705647036975442,2019-03-28 18:45:00,2019-03-28 19:00:00
37,10,3,7,0.005158032376740036,2019-03-28 18:45:00,2019-03-28 19:00:00
40,3,1,2,0.005416782183769732,2019-03-28 18:45:00,2019-03-28 19:00:00
41,5,3,2,0.009048990987999998,2019-03-28 18:45:00,2019-03-28 19:00:00
46,4,1,3,0.004338936101303274,2019-03-28 18:45:00,2019-03-28 19:00:00
57,3,3,0,0.010745032824420173,2019-03-28 18:45:00,2019-03-28 19:00:00
58,3,1,2,0.005416782183769732,2019-03-28 18:45:00,2019-03-28 19:00:00
62,8,4,4,0.015737572129325243,2019-03-28 18:45:00,2019-03-28 19:00:00
64,1,1,0,0.006430327921793138,2019-03-28 18:45:00,2019-03-28 19:00:00
66,2,2,0,0.005083661226028269,2019-03-28 18:45:00,2019-03-28 19:00:00
67,1,0,1,0.003114416810085103,2019-03-28 18:45:00,2019-03-28 19:00:00
68,3,0,3,0.003114416810085103,2019-03-28 18:45:00,2019-03-28 19:00:00
69,7,3,4,0.008593482409772226,2019-03-28 18:45:00,2019-03-28 19:00:00
70,3,2,1,0.004879405741224019,2019-03-28 18:45:00,2019-03-28 19:00:00
75,2,0,2,0.003114416810085103,2019-03-28 18:45:00,2019-03-28 19:00:00
85,5,1,4,0.011247483578695408,2019-03-28 18:45:00,2019-03-28 19:00:00
86,4,2,2,0.02066996182435721,2019-03-28 18:45:00,2019-03-28 19:00:00
87,1,1,0,0.005761900206793477,2019-03-28 18:45:00,2019-03-28 19:00:00
88,2,2,0,0.009331340964093944,2019-03-28 18:45:00,2019-03-28 19:00:00
89,2,1,1,0.0037408104343523113,2019-03-28 18:45:00,2019-03-28 19:00:00
90,3,2,1,0.005647609684427828,2019-03-28 18:45:00,2019-03-28 19:00:00
104,4,4,0,0.017501030165092173,2019-03-28 18:45:00,2019-03-28 19:00:00
108,1,0,1,0.003114416810085103,2019-03-28 18:45:00,2019-03-28 19:00:00
109,4,1,3,0.005416782183769732,2019-03-28 18:45:00,2019-03-28 19:00:00
110,5,3,2,0.008446552310867694,2019-03-28 18:45:00,2019-03-28 19:00:00
111,6,3,3,0.007826662153788083,2019-03-28 18:45:00,2019-03-28 19:00:00
112,6,4,2,0.03534372802877421,2019-03-28 18:45:00,2019-03-28 19:00:00
113,5,0,5,0.003114416810085103,2019-03-28 18:45:00,2019-03-28 19:00:00
114,1,1,0,0.004099039018056686,2019-03-28 18:45:00,2019-03-28 19:00:00
115,4,4,0,0.016975557299627443,2019-03-28 18:45:00,2019-03-28 19:00:00
118,1,0,1,0.003114416810085103,2019-03-28 18:45:00,2019-03-28 19:00:00
119,12,4,8,0.00926605487185973,2019-03-28 18:45:00,2019-03-28 19:00:00
120,5,0,5,0.003114416810085103,2019-03-28 18:45:00,2019-03-28 19:00:00
122,3,0,3,0.003114416810085103,2019-03-28 18:45:00,2019-03-28 19:00:00
126,7,3,4,0.009344758486690164,2019-03-28 18:45:00,2019-03-28 19:00:00
127,6,3,3,0.007763287356917349,2019-03-28 18:45:00,2019-03-28 19:00:00
129,1,0,1,0.003114416810085103,2019-03-28 18:45:00,2019-03-28 19:00:00
133,2,0,2,0.003114416810085103,2019-03-28 18:45:00,2019-03-28 19:00:00
135,2,1,1,0.02066996182435721,2019-03-28 18:45:00,2019-03-28 19:00:00
137,15,6,9,0.012835959430274275,2019-03-28 18:45:00,2019-03-28 19:00:00
138,1,1,0,0.004099039018056686,2019-03-28 18:45:00,2019-03-28 19:00:00
140,1,0,1,0.003114416810085103,2019-03-28 18:45:00,2019-03-28 19:00:00
141,6,4,2,0.009552721281875759,2019-03-28 18:45:00,2019-03-28 19:00:00
153,4,2,2,0.009274271565858432,2019-03-28 18:45:00,2019-03-28 19:00:00
154,3,2,1,0.029447734331493274,2019-03-28 18:45:00,2019-03-28 19:00:00
157,10,6,4,0.012199749155300683,2019-03-28 18:45:00,2019-03-28 19:00:00
158,5,5,0,0.011155983251461086,2019-03-28 18:45:00,2019-03-28 19:00:00
159,1,1,0,0.00443815850843929,2019-03-28 18:45:00,2019-03-28 19:00:00
162,1,1,0,0.006459110747119379,2019-03-28 18:45:00,2019-03-28 19:00:00
164,6,2,4,0.006214712471758574,2019-03-28 18:45:00,2019-03-28 19:00:00
168,2,1,1,0.0047044068628182886,2019-03-28 18:45:00,2019-03-28 19:00:00
169,4,1,3,0.0043268438534416346,2019-03-28 18:45:00,2019-03-28 19:00:00
170,2,1,1,0.0037408104343523113,2019-03-28 18:45:00,2019-03-28 19:00:00
171,2,2,0,0.007747892195855264,2019-03-28 18:45:00,2019-03-28 19:00:00
173,3,1,2,0.0036439134894267777,2019-03-28 18:45:00,2019-03-28 19:00:00
177,1,1,0,0.006459110747119379,2019-03-28 18:45:00,2019-03-28 19:00:00
189,3,1,2,0.0037408104343523113,2019-03-28 18:45:00,2019-03-28 19:00:00
190,1,0,1,0.003114416810085103,2019-03-28 18:45:00,2019-03-28 19:00:00
191,2,0,2,0.003114416810085103,2019-03-28 18:45:00,2019-03-28 19:00:00
195,1,1,0,0.0046493270592081895,2019-03-28 18:45:00,2019-03-28 19:00:00
196,5,2,3,0.005946278863111408,2019-03-28 18:45:00,2019-03-28 19:00:00
199,1,1,0,0.004663217885255721,2019-03-28 18:45:00,2019-03-28 19:00:00
201,1,1,0,0.0043268438534416346,2019-03-28 18:45:00,2019-03-28 19:00:00
202,4,3,1,0.009567265387119507,2019-03-28 18:45:00,2019-03-28 19:00:00
203,1,1,0,0.004940772009980811,2019-03-28 18:45:00,2019-03-28 19:00:00
1,3,3,0,0.004625143532410206,2019-03-28 19:00:00,2019-03-28 19:15:00
2,1,1,0,0.003972137894266509,2019-03-28 19:00:00,2019-03-28 19:15:00
5,3,3,0,0.006305828415003908,2019-03-28 19:00:00,2019-03-28 19:15:00
10,6,3,3,0.008113943172751544,2019-03-28 19:00:00,2019-03-28 19:15:00
11,1,1,0,0.0033046054103722973,2019-03-28 19:00:00,2019-03-28 19:15:00
13,1,1,0,0.008124677026123872,2019-03-28 19:00:00,2019-03-28 19:15:00
16,4,3,1,0.005450237703378491,2019-03-28 19:00:00,2019-03-28 19:15:00
18,5,3,2,0.016755696502998074,2019-03-28 19:00:00,2019-03-28 19:15:00
19,5,0,5,0.0028244097296312395,2019-03-28 19:00:00,2019-03-28 19:15:00
20,2,1,1,0.01879090160463002,2019-03-28 19:00:00,2019-03-28 19:15:00
21,1,1,0,0.009001618229973044,2019-03-28 19:00:00,2019-03-28 19:15:00
23,3,2,1,0.005691606900188708,2019-03-28 19:00:00,2019-03-28 19:15:00
26,5,2,3,0.004499596117335931,2019-03-28 19:00:00,2019-03-28 19:15:00
27,1,0,1,0.0028244097296312395,2019-03-28 19:00:00,2019-03-28 19:15:00
28,1,1,0,0.005973484515430116,2019-03-28 19:00:00,2019-03-28 19:15:00
30,2,1,1,0.005756780035068477,2019-03-28 19:00:00,2019-03-28 19:15:00
35,2,1,1,0.004758461320706384,2019-03-28 19:00:00,2019-03-28 19:15:00
37,5,3,2,0.004645257133741657,2019-03-28 19:00:00,2019-03-28 19:15:00
40,1,0,1,0.0028244097296312395,2019-03-28 19:00:00,2019-03-28 19:15:00
41,5,2,3,0.005276247892068181,2019-03-28 19:00:00,2019-03-28 19:15:00
46,3,2,1,0.0513159815784508,2019-03-28 19:00:00,2019-03-28 19:15:00
57,6,3,3,0.01560792847160181,2019-03-28 19:00:00,2019-03-28 19:15:00
58,3,2,1,0.005392629446782482,2019-03-28 19:00:00,2019-03-28 19:15:00
62,5,3,2,0.008023200437989738,2019-03-28 19:00:00,2019-03-28 19:15:00
64,1,1,0,0.009946824166132523,2019-03-28 19:00:00,2019-03-28 19:15:00
66,1,1,0,0.0052253881333365285,2019-03-28 19:00:00,2019-03-28 19:15:00
67,3,1,2,0.003937242182862758,2019-03-28 19:00:00,2019-03-28 19:15:00
68,3,1,2,0.0052253881333365285,2019-03-28 19:00:00,2019-03-28 19:15:00
69,6,3,3,0.01879090160463002,2019-03-28 19:00:00,2019-03-28 19:15:00
70,3,2,1,0.007266459081661533,2019-03-28 19:00:00,2019-03-28 19:15:00
75,1,1,0,0.004024898931483884,2019-03-28 19:00:00,2019-03-28 19:15:00
85,1,0,1,0.0028244097296312395,2019-03-28 19:00:00,2019-03-28 19:15:00
87,3,1,2,0.004912433766041424,2019-03-28 19:00:00,2019-03-28 19:15:00
88,5,2,3,0.008465147180349613,2019-03-28 19:00:00,2019-03-28 19:15:00
89,4,2,2,0.00762194051788187,2019-03-28 19:00:00,2019-03-28 19:15:00
90,2,2,0,0.010498560388921765,2019-03-28 19:00:00,2019-03-28 19:15:00
104,5,5,0,0.01234195012561668,2019-03-28 19:00:00,2019-03-28 19:15:00
108,1,0,1,0.0028244097296312395,2019-03-28 19:00:00,2019-03-28 19:15:00
109,1,0,1,0.0028244097296312395,2019-03-28 19:00:00,2019-03-28 19:15:00
110,5,2,3,0.0055427817468318916,2019-03-28 19:00:00,2019-03-28 19:15:00
111,2,0,2,0.0028244097296312395,2019-03-28 19:00:00,2019-03-28 19:15:00
112,7,5,2,0.07951091490077868,2019-03-28 19:00:00,2019-03-28 19:15:00
113,4,1,3,0.00405032881084971,2019-03-28 19:00:00,2019-03-28 19:15:00
114,1,1,0,0.003712819600037298,2019-03-28 19:00:00,2019-03-28 19:15:00
116,1,0,1,0.0028244097296312395,2019-03-28 19:00:00,2019-03-28 19:15:00
118,3,1,2,0.0068695929553225545,2019-03-28 19:00:00,2019-03-28 19:15:00
119,6,1,5,0.0052253881333365285,2019-03-28 19:00:00,2019-03-28 19:15:00
120,7,1,6,0.003290628496483419,2019-03-28 19:00:00,2019-03-28 19:15:00
122,8,3,5,0.006545204830796384,2019-03-28 19:00:00,2019-03-28 19:15:00
126,4,0,4,0.0028244097296312395,2019-03-28 19:00:00,2019-03-28 19:15:00
127,8,3,5,0.007210299483143326,2019-03-28 19:00:00,2019-03-28 19:15:00
129,1,0,1,0.0028244097296312395,2019-03-28 19:00:00,2019-03-28 19:15:00
135,2,1,1,0.01879090160463002,2019-03-28 19:00:00,2019-03-28 19:15:00
137,5,4,1,0.008556591061166203,2019-03-28 19:00:00,2019-03-28 19:15:00
138,1,1,0,0.003712819600037298,2019-03-28 19:00:00,2019-03-28 19:15:00
141,6,4,2,0.027187664852791588,2019-03-28 19:00:00,2019-03-28 19:15:00
151,1,1,0,0.005744357140007737,2019-03-28 19:00:00,2019-03-28 19:15:00
153,8,4,4,0.009100238227689794,2019-03-28 19:00:00,2019-03-28 19:15:00
154,2,1,1,0.0032245727969154544,2019-03-28 19:00:00,2019-03-28 19:15:00
157,6,4,2,0.00659958994133429,2019-03-28 19:00:00,2019-03-28 19:15:00
158,3,3,0,0.0050814251511844145,2019-03-28 19:00:00,2019-03-28 19:15:00
162,2,1,1,0.006234750235947558,2019-03-28 19:00:00,2019-03-28 19:15:00
164,6,0,6,0.0028244097296312395,2019-03-28 19:00:00,2019-03-28 19:15:00
168,1,0,1,0.0028244097296312395,2019-03-28 19:00:00,2019-03-28 19:15:00
169,4,0,4,0.0028244097296312395,2019-03-28 19:00:00,2019-03-28 19:15:00
171,1,1,0,0.004497929481906969,2019-03-28 19:00:00,2019-03-28 19:15:00
172,2,2,0,0.011670361899399925,2019-03-28 19:00:00,2019-03-28 19:15:00
173,4,2,2,0.006898907885612256,2019-03-28 19:00:00,2019-03-28 19:15:00
177,1,1,0,0.006234750235947558,2019-03-28 19:00:00,2019-03-28 19:15:00
191,2,1,1,0.01879090160463002,2019-03-28 19:00:00,2019-03-28 19:15:00
195,1,0,1,0.0028244097296312395,2019-03-28 19:00:00,2019-03-28 19:15:00
196,3,1,2,0.00740867199211661,2019-03-28 19:00:00,2019-03-28 19:15:00
197,1,1,0,0.0033046054103722973,2019-03-28 19:00:00,2019-03-28 19:15:00
199,1,1,0,0.005756780035068477,2019-03-28 19:00:00,2019-03-28 19:15:00
201,1,1,0,0.007247385814515582,2019-03-28 19:00:00,2019-03-28 19:15:00
202,3,2,1,0.008465147180349611,2019-03-28 19:00:00,2019-03-28 19:15:00
1,4,3,1,0.0058798575643182055,2019-03-28 19:15:00,2019-03-28 19:30:00
2,1,1,0,0.005103185202281327,2019-03-28 19:15:00,2019-03-28 19:30:00
5,5,4,1,0.014381578819114022,2019-03-28 19:15:00,2019-03-28 19:30:00
10,4,1,3,0.004434826057846078,2019-03-28 19:15:00,2019-03-28 19:30:00
13,1,1,0,0.0058798575643182055,2019-03-28 19:15:00,2019-03-28 19:30:00
15,4,1,3,0.003853587152730848,2019-03-28 19:15:00,2019-03-28 19:30:00
16,1,1,0,0.009322831935599804,2019-03-28 19:15:00,2019-03-28 19:30:00
18,6,3,3,0.010240097410787127,2019-03-28 19:15:00,2019-03-28 19:30:00
19,4,0,4,0.0031781636822017286,2019-03-28 19:15:00,2019-03-28 19:30:00
20,3,1,2,0.005527690911705166,2019-03-28 19:15:00,2019-03-28 19:30:00
23,1,1,0,0.003853587152730848,2019-03-28 19:15:00,2019-03-28 19:30:00
26,3,1,2,0.0064378127014391995,2019-03-28 19:15:00,2019-03-28 19:30:00
27,2,1,1,0.004078728309573888,2019-03-28 19:15:00,2019-03-28 19:30:00
30,2,1,1,0.009329574380637112,2019-03-28 19:15:00,2019-03-28 19:30:00
35,3,2,1,0.007228180230856763,2019-03-28 19:15:00,2019-03-28 19:30:00
37,4,1,3,0.004529010623259967,2019-03-28 19:15:00,2019-03-28 19:30:00
41,3,1,2,0.005527690911705166,2019-03-28 19:15:00,2019-03-28 19:30:00
46,1,1,0,0.011109543601344942,2019-03-28 19:15:00,2019-03-28 19:30:00
50,1,1,0,0.00738582557585282,2019-03-28 19:15:00,2019-03-28 19:30:00
57,5,2,3,0.021777332015068426,2019-03-28 19:15:00,2019-03-28 19:30:00
58,2,1,1,0.003853587152730848,2019-03-28 19:15:00,2019-03-28 19:30:00
62,3,2,1,0.005691488433490427,2019-03-28 19:15:00,2019-03-28 19:30:00
66,1,0,1,0.0031781636822017286,2019-03-28 19:15:00,2019-03-28 19:30:00
67,2,1,1,0.009205722020646175,2019-03-28 19:15:00,2019-03-28 19:30:00
68,1,1,0,0.0058798575643182055,2019-03-28 19:15:00,2019-03-28 19:30:00
69,4,2,2,0.021071906374376614,2019-03-28 19:15:00,2019-03-28 19:30:00
75,1,1,0,0.0058798575643182055,2019-03-28 19:15:00,2019-03-28 19:30:00
88,3,1,2,0.005877333289798525,2019-03-28 19:15:00,2019-03-28 19:30:00
89,6,3,3,0.009525329718615323,2019-03-28 19:15:00,2019-03-28 19:30:00
90,2,0,2,0.0031781636822017286,2019-03-28 19:15:00,2019-03-28 19:30:00
104,3,3,0,0.009551495884886118,2019-03-28 19:15:00,2019-03-28 19:30:00
110,4,1,3,0.004434826057846078,2019-03-28 19:15:00,2019-03-28 19:30:00
111,1,0,1,0.0031781636822017286,2019-03-28 19:15:00,2019-03-28 19:30:00
112,6,4,2,0.05197160448584193,2019-03-28 19:15:00,2019-03-28 19:30:00
113,3,1,2,0.004529010623259967,2019-03-28 19:15:00,2019-03-28 19:30:00
114,3,0,3,0.0031781636822017286,2019-03-28 19:15:00,2019-03-28 19:30:00
116,2,1,1,0.008176555880403643,2019-03-28 19:15:00,2019-03-28 19:30:00
118,1,0,1,0.0031781636822017286,2019-03-28 19:15:00,2019-03-28 19:30:00
119,2,0,2,0.0031781636822017286,2019-03-28 19:15:00,2019-03-28 19:30:00
120,4,0,4,0.0031781636822017286,2019-03-28 19:15:00,2019-03-28 19:30:00
122,10,6,4,0.02835999286549845,2019-03-28 19:15:00,2019-03-28 19:30:00
126,3,0,3,0.0031781636822017286,2019-03-28 19:15:00,2019-03-28 19:30:00
127,2,0,2,0.0031781636822017286,2019-03-28 19:15:00,2019-03-28 19:30:00
135,2,1,1,0.021071906374376614,2019-03-28 19:15:00,2019-03-28 19:30:00
137,7,5,2,0.007996270610738257,2019-03-28 19:15:00,2019-03-28 19:30:00
140,1,1,0,0.005527690911705166,2019-03-28 19:15:00,2019-03-28 19:30:00
141,3,1,2,0.005527690911705166,2019-03-28 19:15:00,2019-03-28 19:30:00
151,1,1,0,0.0058798575643182055,2019-03-28 19:15:00,2019-03-28 19:30:00
153,5,3,2,0.009899150327141518,2019-03-28 19:15:00,2019-03-28 19:30:00
154,5,3,2,0.01499387709470972,2019-03-28 19:15:00,2019-03-28 19:30:00
157,6,5,1,0.009189475655958628,2019-03-28 19:15:00,2019-03-28 19:30:00
158,2,2,0,0.005204434093789087,2019-03-28 19:15:00,2019-03-28 19:30:00
162,1,0,1,0.0031781636822017286,2019-03-28 19:15:00,2019-03-28 19:30:00
164,4,2,2,0.007668899833316053,2019-03-28 19:15:00,2019-03-28 19:30:00
168,1,1,0,0.0044615113622547935,2019-03-28 19:15:00,2019-03-28 19:30:00
169,4,0,4,0.0031781636822017286,2019-03-28 19:15:00,2019-03-28 19:30:00
170,1,1,0,0.01637265391536229,2019-03-28 19:15:00,2019-03-28 19:30:00
172,3,2,1,0.015520464902551342,2019-03-28 19:15:00,2019-03-28 19:30:00
173,4,2,2,0.014471616333586906,2019-03-28 19:15:00,2019-03-28 19:30:00
177,1,1,0,0.008016444053951348,2019-03-28 19:15:00,2019-03-28 19:30:00
191,2,2,0,0.013339582271612365,2019-03-28 19:15:00,2019-03-28 19:30:00
195,1,0,1,0.0031781636822017286,2019-03-28 19:15:00,2019-03-28 19:30:00
196,3,1,2,0.006454032143339564,2019-03-28 19:15:00,2019-03-28 19:30:00
197,1,1,0,0.003853587152730848,2019-03-28 19:15:00,2019-03-28 19:30:00
199,1,1,0,0.009329574380637112,2019-03-28 19:15:00,2019-03-28 19:30:00
201,1,1,0,0.009349314292376535,2019-03-28 19:15:00,2019-03-28 19:30:00
203,1,1,0,0.006079883764177497,2019-03-28 19:15:00,2019-03-28 19:30:00
1,7,4,3,0.018912900238508654,2019-03-28 19:30:00,2019-03-28 19:45:00
5,4,3,1,0.01452342283439895,2019-03-28 19:30:00,2019-03-28 19:45:00
10,5,4,1,0.043396679930501884,2019-03-28 19:30:00,2019-03-28 19:45:00
15,5,1,4,0.004568029012628112,2019-03-28 19:30:00,2019-03-28 19:45:00
16,6,4,2,0.015421655324331617,2019-03-28 19:30:00,2019-03-28 19:45:00
18,2,0,2,0.0029557439907165932,2019-03-28 19:30:00,2019-03-28 19:45:00
19,4,1,3,0.008437495180908862,2019-03-28 19:30:00,2019-03-28 19:45:00
20,3,1,2,0.005140800453422388,2019-03-28 19:30:00,2019-03-28 19:45:00
23,1,1,0,0.010148065041355542,2019-03-28 19:30:00,2019-03-28 19:45:00
26,2,1,1,0.009510750723630407,2019-03-28 19:30:00,2019-03-28 19:45:00
27,1,1,0,0.005468339808733672,2019-03-28 19:30:00,2019-03-28 19:45:00
28,1,0,1,0.0029557439907165932,2019-03-28 19:30:00,2019-03-28 19:45:00
30,2,0,2,0.0029557439907165932,2019-03-28 19:30:00,2019-03-28 19:45:00
35,3,2,1,0.0067246377177422115,2019-03-28 19:30:00,2019-03-28 19:45:00
37,1,1,0,0.004212041899725133,2019-03-28 19:30:00,2019-03-28 19:45:00
41,5,3,2,0.007002556206846209,2019-03-28 19:30:00,2019-03-28 19:45:00
46,3,2,1,0.005468339808733672,2019-03-28 19:30:00,2019-03-28 19:45:00
50,2,2,0,0.006733453617018779,2019-03-28 19:30:00,2019-03-28 19:45:00
57,8,4,4,0.025793198977235237,2019-03-28 19:30:00,2019-03-28 19:45:00
58,4,1,3,0.005346673957035938,2019-03-28 19:30:00,2019-03-28 19:45:00
61,1,1,0,0.004212041899725133,2019-03-28 19:30:00,2019-03-28 19:45:00
62,6,1,5,0.003561201835131874,2019-03-28 19:30:00,2019-03-28 19:45:00
66,3,2,1,0.0046308078693946455,2019-03-28 19:30:00,2019-03-28 19:45:00
67,4,3,1,0.01067720768545222,2019-03-28 19:30:00,2019-03-28 19:45:00
68,2,0,2,0.0029557439907165932,2019-03-28 19:30:00,2019-03-28 19:45:00
69,5,2,3,0.006821959298741175,2019-03-28 19:30:00,2019-03-28 19:45:00
70,1,1,0,0.004212041899725133,2019-03-28 19:30:00,2019-03-28 19:45:00
75,1,1,0,0.004505250155861578,2019-03-28 19:30:00,2019-03-28 19:45:00
85,2,2,0,0.006054756321006563,2019-03-28 19:30:00,2019-03-28 19:45:00
86,1,0,1,0.0029557439907165932,2019-03-28 19:30:00,2019-03-28 19:45:00
87,1,1,0,0.0076042624861515475,2019-03-28 19:30:00,2019-03-28 19:45:00
88,3,1,2,0.0037932759300556194,2019-03-28 19:30:00,2019-03-28 19:45:00
89,2,0,2,0.0029557439907165932,2019-03-28 19:30:00,2019-03-28 19:45:00
90,1,0,1,0.0029557439907165932,2019-03-28 19:30:00,2019-03-28 19:45:00
106,4,2,2,0.01959674237826349,2019-03-28 19:30:00,2019-03-28 19:45:00
109,1,1,0,0.008437495180908862,2019-03-28 19:30:00,2019-03-28 19:45:00
110,7,3,4,0.011277471499906835,2019-03-28 19:30:00,2019-03-28 19:45:00
111,4,1,3,0.005468339808733672,2019-03-28 19:30:00,2019-03-28 19:45:00
112,7,4,3,0.025381125173855858,2019-03-28 19:30:00,2019-03-28 19:45:00
113,4,3,1,0.00798093562675075,2019-03-28 19:30:00,2019-03-28 19:45:00
114,1,0,1,0.0029557439907165932,2019-03-28 19:30:00,2019-03-28 19:45:00
115,3,0,3,0.0029557439907165932,2019-03-28 19:30:00,2019-03-28 19:45:00
116,4,3,1,0.0113907880117303,2019-03-28 19:30:00,2019-03-28 19:45:00
118,7,2,5,0.00856851515718004,2019-03-28 19:30:00,2019-03-28 19:45:00
119,2,0,2,0.0029557439907165932,2019-03-28 19:30:00,2019-03-28 19:45:00
120,1,1,0,0.007763584132579275,2019-03-28 19:30:00,2019-03-28 19:45:00
122,5,2,3,0.016966524759331227,2019-03-28 19:30:00,2019-03-28 19:45:00
126,2,0,2,0.0029557439907165932,2019-03-28 19:30:00,2019-03-28 19:45:00
127,2,0,2,0.0029557439907165932,2019-03-28 19:30:00,2019-03-28 19:45:00
135,4,2,2,0.01959674237826349,2019-03-28 19:30:00,2019-03-28 19:45:00
137,9,8,1,0.015003354682909316,2019-03-28 19:30:00,2019-03-28 19:45:00
138,1,0,1,0.0029557439907165932,2019-03-28 19:30:00,2019-03-28 19:45:00
141,6,2,4,0.005140800453422388,2019-03-28 19:30:00,2019-03-28 19:45:00
147,1,1,0,0.005468339808733672,2019-03-28 19:30:00,2019-03-28 19:45:00
151,2,1,1,0.004888851644728884,2019-03-28 19:30:00,2019-03-28 19:45:00
153,4,4,0,0.01846814650358722,2019-03-28 19:30:00,2019-03-28 19:45:00
154,9,4,5,0.016314866972099107,2019-03-28 19:30:00,2019-03-28 19:45:00
157,5,4,1,0.008776735123858398,2019-03-28 19:30:00,2019-03-28 19:45:00
158,2,2,0,0.006602971866044478,2019-03-28 19:30:00,2019-03-28 19:45:00
162,1,1,0,0.005983033212792997,2019-03-28 19:30:00,2019-03-28 19:45:00
164,4,2,2,0.008444723642823598,2019-03-28 19:30:00,2019-03-28 19:45:00
169,4,0,4,0.0029557439907165932,2019-03-28 19:30:00,2019-03-28 19:45:00
170,1,1,0,0.0169321887068647,2019-03-28 19:30:00,2019-03-28 19:45:00
171,3,3,0,0.014946207005357405,2019-03-28 19:30:00,2019-03-28 19:45:00
172,4,3,1,0.016440658088394778,2019-03-28 19:30:00,2019-03-28 19:45:00
173,2,0,2,0.0029557439907165932,2019-03-28 19:30:00,2019-03-28 19:45:00
177,2,1,1,0.003561201835131874,2019-03-28 19:30:00,2019-03-28 19:45:00
190,3,1,2,0.00593212782480652,2019-03-28 19:30:00,2019-03-28 19:45:00
191,2,0,2,0.0029557439907165932,2019-03-28 19:30:00,2019-03-28 19:45:00
196,2,0,2,0.0029557439907165932,2019-03-28 19:30:00,2019-03-28 19:45:00
197,1,0,1,0.0029557439907165932,2019-03-28 19:30:00,2019-03-28 19:45:00
199,1,1,0,0.004212041899725133,2019-03-28 19:30:00,2019-03-28 19:45:00
203,1,1,0,0.004212041899725133,2019-03-28 19:30:00,2019-03-28 19:45:00
1,6,4,2,0.01165239887056925,2019-03-28 19:45:00,2019-03-28 20:00:00
5,1,1,0,0.0035101504454671272,2019-03-28 19:45:00,2019-03-28 20:00:00
10,5,4,1,0.03666822897382138,2019-03-28 19:45:00,2019-03-28 20:00:00
15,2,0,2,0.002894920213699565,2019-03-28 19:45:00,2019-03-28 20:00:00
16,9,3,6,0.017285724045491266,2019-03-28 19:45:00,2019-03-28 20:00:00
18,4,0,4,0.002894920213699565,2019-03-28 19:45:00,2019-03-28 20:00:00
19,8,3,5,0.008173642263667766,2019-03-28 19:45:00,2019-03-28 20:00:00
20,2,1,1,0.01925646757218759,2019-03-28 19:45:00,2019-03-28 20:00:00
26,2,1,1,0.005344091199915399,2019-03-28 19:45:00,2019-03-28 20:00:00
27,1,1,0,0.004716096443387694,2019-03-28 19:45:00,2019-03-28 20:00:00
28,5,1,4,0.0036761914789504207,2019-03-28 19:45:00,2019-03-28 20:00:00
30,1,0,1,0.002894920213699565,2019-03-28 19:45:00,2019-03-28 20:00:00
35,3,3,0,0.012890880602476801,2019-03-28 19:45:00,2019-03-28 20:00:00
37,1,1,0,0.009384782085913672,2019-03-28 19:45:00,2019-03-28 20:00:00
41,3,2,1,0.004889937119344507,2019-03-28 19:45:00,2019-03-28 20:00:00
46,2,1,1,0.005355841140769814,2019-03-28 19:45:00,2019-03-28 20:00:00
50,1,1,0,0.00412538067723469,2019-03-28 19:45:00,2019-03-28 20:00:00
57,4,2,2,0.004899849928369495,2019-03-28 19:45:00,2019-03-28 20:00:00
58,10,4,6,0.007452281352453063,2019-03-28 19:45:00,2019-03-28 20:00:00
61,1,1,0,0.003715227189389648,2019-03-28 19:45:00,2019-03-28 20:00:00
62,4,0,4,0.002894920213699565,2019-03-28 19:45:00,2019-03-28 20:00:00
66,2,2,0,0.004535534165079731,2019-03-28 19:45:00,2019-03-28 20:00:00
67,4,2,2,0.005855648760420109,2019-03-28 19:45:00,2019-03-28 20:00:00
68,3,0,3,0.002894920213699565,2019-03-28 19:45:00,2019-03-28 20:00:00
69,5,2,3,0.0066817750371805755,2019-03-28 19:45:00,2019-03-28 20:00:00
70,2,2,0,0.004535534165079731,2019-03-28 19:45:00,2019-03-28 20:00:00
85,2,2,0,0.007447871511284593,2019-03-28 19:45:00,2019-03-28 20:00:00
86,5,2,3,0.0066817750371805755,2019-03-28 19:45:00,2019-03-28 20:00:00
87,4,3,1,0.010207444859039351,2019-03-28 19:45:00,2019-03-28 20:00:00
88,3,2,1,0.008250128723741704,2019-03-28 19:45:00,2019-03-28 20:00:00
89,2,0,2,0.002894920213699565,2019-03-28 19:45:00,2019-03-28 20:00:00
90,2,1,1,0.007429821748051622,2019-03-28 19:45:00,2019-03-28 20:00:00
106,4,2,2,0.01925646757218759,2019-03-28 19:45:00,2019-03-28 20:00:00
109,3,2,1,0.014033257071776842,2019-03-28 19:45:00,2019-03-28 20:00:00
110,4,4,0,0.013018926606944627,2019-03-28 19:45:00,2019-03-28 20:00:00
111,3,1,2,0.005355841140769814,2019-03-28 19:45:00,2019-03-28 20:00:00
112,8,6,2,0.07436694652942669,2019-03-28 19:45:00,2019-03-28 20:00:00
113,4,2,2,0.004906651942485545,2019-03-28 19:45:00,2019-03-28 20:00:00
114,1,1,0,0.0039508074323166085,2019-03-28 19:45:00,2019-03-28 20:00:00
115,3,0,3,0.002894920213699565,2019-03-28 19:45:00,2019-03-28 20:00:00
116,3,3,0,0.01140813802512384,2019-03-28 19:45:00,2019-03-28 20:00:00
118,5,1,4,0.006965521794845447,2019-03-28 19:45:00,2019-03-28 20:00:00
119,4,2,2,0.015267805476472465,2019-03-28 19:45:00,2019-03-28 20:00:00
120,1,1,0,0.007447871511284593,2019-03-28 19:45:00,2019-03-28 20:00:00
122,2,1,1,0.005355841140769814,2019-03-28 19:45:00,2019-03-28 20:00:00
126,2,0,2,0.002894920213699565,2019-03-28 19:45:00,2019-03-28 20:00:00
127,1,0,1,0.002894920213699565,2019-03-28 19:45:00,2019-03-28 20:00:00
129,1,0,1,0.002894920213699565,2019-03-28 19:45:00,2019-03-28 20:00:00
135,3,1,2,0.005035075019048247,2019-03-28 19:45:00,2019-03-28 20:00:00
137,6,3,3,0.016003010462387626,2019-03-28 19:45:00,2019-03-28 20:00:00
140,2,2,0,0.007793262186131234,2019-03-28 19:45:00,2019-03-28 20:00:00
141,8,3,5,0.008115414488524573,2019-03-28 19:45:00,2019-03-28 20:00:00
147,1,1,0,0.00478834762544007,2019-03-28 19:45:00,2019-03-28 20:00:00
151,2,1,1,0.00478834762544007,2019-03-28 19:45:00,2019-03-28 20:00:00
153,5,3,2,0.014554236428358144,2019-03-28 19:45:00,2019-03-28 20:00:00
154,5,2,3,0.006574551663450523,2019-03-28 19:45:00,2019-03-28 20:00:00
157,1,1,0,0.004977600239702042,2019-03-28 19:45:00,2019-03-28 20:00:00
158,2,2,0,0.01077448156881604,2019-03-28 19:45:00,2019-03-28 20:00:00
162,1,1,0,0.0058788487333985085,2019-03-28 19:45:00,2019-03-28 20:00:00
164,7,4,3,0.010699932422931558,2019-03-28 19:45:00,2019-03-28 20:00:00
170,1,1,0,0.0035101504454671272,2019-03-28 19:45:00,2019-03-28 20:00:00
171,6,4,2,0.03892334670173595,2019-03-28 19:45:00,2019-03-28 20:00:00
172,3,1,2,0.00412538067723469,2019-03-28 19:45:00,2019-03-28 20:00:00
173,3,1,2,0.004284619696601933,2019-03-28 19:45:00,2019-03-28 20:00:00
177,2,1,1,0.0035101504454671272,2019-03-28 19:45:00,2019-03-28 20:00:00
190,2,0,2,0.002894920213699565,2019-03-28 19:45:00,2019-03-28 20:00:00
191,1,0,1,0.002894920213699565,2019-03-28 19:45:00,2019-03-28 20:00:00
196,2,0,2,0.002894920213699565,2019-03-28 19:45:00,2019-03-28 20:00:00
197,1,0,1,0.002894920213699565,2019-03-28 19:45:00,2019-03-28 20:00:00
199,1,1,0,0.004716096443387694,2019-03-28 19:45:00,2019-03-28 20:00:00
202,2,1,1,0.005926943626303785,2019-03-28 19:45:00,2019-03-28 20:00:00
203,1,1,0,0.0035101504454671272,2019-03-28 19:45:00,2019-03-28 20:00:00
1,3,3,0,0.0077640873426677234,2019-03-28 20:00:00,2019-03-28 20:15:00
10,2,1,1,0.020233344125008646,2019-03-28 20:00:00,2019-03-28 20:15:00
15,3,2,1,0.01215450776425998,2019-03-28 20:00:00,2019-03-28 20:15:00
16,7,1,6,0.003543060111630511,2019-03-28 20:00:00,2019-03-28 20:15:00
18,2,1,1,0.005181089220355867,2019-03-28 20:00:00,2019-03-28 20:15:00
19,6,3,3,0.007483263819008362,2019-03-28 20:00:00,2019-03-28 20:15:00
20,2,1,1,0.020233344125008646,2019-03-28 20:00:00,2019-03-28 20:15:00
26,1,1,0,0.003543060111630511,2019-03-28 20:00:00,2019-03-28 20:15:00
28,3,1,2,0.004209338726106201,2019-03-28 20:00:00,2019-03-28 20:15:00
30,1,0,1,0.003041073542410734,2019-03-28 20:00:00,2019-03-28 20:15:00
35,8,5,3,0.016079971767689244,2019-03-28 20:00:00,2019-03-28 20:15:00
37,1,1,0,0.004209338726106201,2019-03-28 20:00:00,2019-03-28 20:15:00
40,3,0,3,0.003041073542410734,2019-03-28 20:00:00,2019-03-28 20:15:00
41,4,3,1,0.009051926619012128,2019-03-28 20:00:00,2019-03-28 20:15:00
46,5,2,3,0.013321349376932098,2019-03-28 20:00:00,2019-03-28 20:15:00
57,4,1,3,0.005161611346276395,2019-03-28 20:00:00,2019-03-28 20:15:00
58,5,1,4,0.005161611346276395,2019-03-28 20:00:00,2019-03-28 20:15:00
61,1,1,0,0.005626249022769909,2019-03-28 20:00:00,2019-03-28 20:15:00
62,1,0,1,0.003041073542410734,2019-03-28 20:00:00,2019-03-28 20:15:00
67,2,0,2,0.003041073542410734,2019-03-28 20:00:00,2019-03-28 20:15:00
68,1,0,1,0.003041073542410734,2019-03-28 20:00:00,2019-03-28 20:15:00
69,1,0,1,0.003041073542410734,2019-03-28 20:00:00,2019-03-28 20:15:00
79,3,2,1,0.03163624145278632,2019-03-28 20:00:00,2019-03-28 20:15:00
85,1,0,1,0.003041073542410734,2019-03-28 20:00:00,2019-03-28 20:15:00
86,4,2,2,0.020233344125008646,2019-03-28 20:00:00,2019-03-28 20:15:00
87,2,0,2,0.003041073542410734,2019-03-28 20:00:00,2019-03-28 20:15:00
89,3,1,2,0.004858880206120347,2019-03-28 20:00:00,2019-03-28 20:15:00
90,5,2,3,0.007551999963470424,2019-03-28 20:00:00,2019-03-28 20:15:00
109,3,3,0,0.009039374566815157,2019-03-28 20:00:00,2019-03-28 20:15:00
110,5,2,3,0.0070191907126580765,2019-03-28 20:00:00,2019-03-28 20:15:00
111,8,5,3,0.009504012243308673,2019-03-28 20:00:00,2019-03-28 20:15:00
112,9,7,2,0.10171483533450158,2019-03-28 20:00:00,2019-03-28 20:15:00
113,2,1,1,0.006815969782926097,2019-03-28 20:00:00,2019-03-28 20:15:00
114,1,1,0,0.004138054654970452,2019-03-28 20:00:00,2019-03-28 20:15:00
116,2,1,1,0.003543060111630511,2019-03-28 20:00:00,2019-03-28 20:15:00
119,6,2,4,0.005497081701542325,2019-03-28 20:00:00,2019-03-28 20:15:00
120,1,1,0,0.004858880206120347,2019-03-28 20:00:00,2019-03-28 20:15:00
126,4,1,3,0.006052992957729398,2019-03-28 20:00:00,2019-03-28 20:15:00
129,1,0,1,0.003041073542410734,2019-03-28 20:00:00,2019-03-28 20:15:00
133,1,1,0,0.006815969782926097,2019-03-28 20:00:00,2019-03-28 20:15:00
135,3,1,2,0.005289301593888926,2019-03-28 20:00:00,2019-03-28 20:15:00
137,9,4,5,0.01069154766754096,2019-03-28 20:00:00,2019-03-28 20:15:00
138,3,3,0,0.02032108337753312,2019-03-28 20:00:00,2019-03-28 20:15:00
140,3,2,1,0.0040450466808502885,2019-03-28 20:00:00,2019-03-28 20:15:00
141,3,1,2,0.005626249022769909,2019-03-28 20:00:00,2019-03-28 20:15:00
151,1,1,0,0.005626249022769909,2019-03-28 20:00:00,2019-03-28 20:15:00
153,4,1,3,0.004333661282590322,2019-03-28 20:00:00,2019-03-28 20:15:00
154,2,2,0,0.006865233236424085,2019-03-28 20:00:00,2019-03-28 20:15:00
157,3,3,0,0.009889954540523847,2019-03-28 20:00:00,2019-03-28 20:15:00
158,1,1,0,0.004209338726106201,2019-03-28 20:00:00,2019-03-28 20:15:00
160,2,1,1,0.020233344125008646,2019-03-28 20:00:00,2019-03-28 20:15:00
164,3,2,1,0.006619415611778251,2019-03-28 20:00:00,2019-03-28 20:15:00
168,5,3,2,0.013302316572507527,2019-03-28 20:00:00,2019-03-28 20:15:00
170,1,1,0,0.007445556932761575,2019-03-28 20:00:00,2019-03-28 20:15:00
171,2,0,2,0.003041073542410734,2019-03-28 20:00:00,2019-03-28 20:15:00
172,2,0,2,0.003041073542410734,2019-03-28 20:00:00,2019-03-28 20:15:00
173,3,1,2,0.004138054654970452,2019-03-28 20:00:00,2019-03-28 20:15:00
177,1,1,0,0.005626249022769909,2019-03-28 20:00:00,2019-03-28 20:15:00
189,2,2,0,0.006676686869829959,2019-03-28 20:00:00,2019-03-28 20:15:00
191,1,0,1,0.003041073542410734,2019-03-28 20:00:00,2019-03-28 20:15:00
196,1,0,1,0.003041073542410734,2019-03-28 20:00:00,2019-03-28 20:15:00
197,1,0,1,0.003041073542410734,2019-03-28 20:00:00,2019-03-28 20:15:00
199,1,1,0,0.004799950609750471,2019-03-28 20:00:00,2019-03-28 20:15:00
202,2,2,0,0.010657320022708026,2019-03-28 20:00:00,2019-03-28 20:15:00
1,2,2,0,0.004239443715772555,2019-03-28 20:15:00,2019-03-28 20:30:00
5,1,1,0,0.007365931302709766,2019-03-28 20:15:00,2019-03-28 20:30:00
10,2,1,1,0.01978452562362527,2019-03-28 20:15:00,2019-03-28 20:30:00
15,4,2,2,0.006220536130683028,2019-03-28 20:15:00,2019-03-28 20:30:00
16,9,7,2,0.007660208845633782,2019-03-28 20:15:00,2019-03-28 20:30:00
18,4,3,1,0.020716494717694968,2019-03-28 20:15:00,2019-03-28 20:30:00
19,2,1,1,0.005174270448938204,2019-03-28 20:15:00,2019-03-28 20:30:00
20,4,2,2,0.00957287678979923,2019-03-28 20:15:00,2019-03-28 20:30:00
23,2,1,1,0.005165250052416206,2019-03-28 20:15:00,2019-03-28 20:30:00
26,1,1,0,0.006230919933080423,2019-03-28 20:15:00,2019-03-28 20:30:00
28,2,1,1,0.004299189290031481,2019-03-28 20:15:00,2019-03-28 20:30:00
35,3,1,2,0.003817951570017601,2019-03-28 20:15:00,2019-03-28 20:30:00
37,1,1,0,0.004299189290031481,2019-03-28 20:15:00,2019-03-28 20:30:00
40,5,0,5,0.002974967278507692,2019-03-28 20:15:00,2019-03-28 20:30:00
41,8,5,3,0.011343223131832225,2019-03-28 20:15:00,2019-03-28 20:30:00
46,2,1,1,0.0061892635010823115,2019-03-28 20:15:00,2019-03-28 20:30:00
57,5,1,4,0.02058701174842968,2019-03-28 20:15:00,2019-03-28 20:30:00
58,6,4,2,0.011439864926216481,2019-03-28 20:15:00,2019-03-28 20:30:00
61,1,1,0,0.008370384063619857,2019-03-28 20:15:00,2019-03-28 20:30:00
62,1,0,1,0.002974967278507692,2019-03-28 20:15:00,2019-03-28 20:30:00
66,1,1,0,0.004082652056203064,2019-03-28 20:15:00,2019-03-28 20:30:00
67,3,0,3,0.002974967278507692,2019-03-28 20:15:00,2019-03-28 20:30:00
68,4,3,1,0.006346904444547327,2019-03-28 20:15:00,2019-03-28 20:30:00
70,2,0,2,0.002974967278507692,2019-03-28 20:15:00,2019-03-28 20:30:00
79,3,2,1,0.023986915209904664,2019-03-28 20:15:00,2019-03-28 20:30:00
86,4,2,2,0.01978452562362527,2019-03-28 20:15:00,2019-03-28 20:30:00
87,3,0,3,0.002974967278507692,2019-03-28 20:15:00,2019-03-28 20:30:00
89,3,2,1,0.005347128493467928,2019-03-28 20:15:00,2019-03-28 20:30:00
90,4,3,1,0.012940613799113782,2019-03-28 20:15:00,2019-03-28 20:30:00
99,1,1,0,0.006629665185590635,2019-03-28 20:15:00,2019-03-28 20:30:00
109,5,3,2,0.04900503597299941,2019-03-28 20:15:00,2019-03-28 20:30:00
110,6,4,2,0.011117313527950637,2019-03-28 20:15:00,2019-03-28 20:30:00
111,8,4,4,0.005335323294735437,2019-03-28 20:15:00,2019-03-28 20:30:00
112,9,5,4,0.010305977846609402,2019-03-28 20:15:00,2019-03-28 20:30:00
113,2,1,1,0.01978452562362527,2019-03-28 20:15:00,2019-03-28 20:30:00
115,1,1,0,0.003817951570017601,2019-03-28 20:15:00,2019-03-28 20:30:00
116,2,2,0,0.010580227525284387,2019-03-28 20:15:00,2019-03-28 20:30:00
119,5,1,4,0.006230919933080423,2019-03-28 20:15:00,2019-03-28 20:30:00
120,4,3,1,0.03048370525520288,2019-03-28 20:15:00,2019-03-28 20:30:00
126,4,0,4,0.002974967278507692,2019-03-28 20:15:00,2019-03-28 20:30:00
127,1,1,0,0.007837544178140001,2019-03-28 20:15:00,2019-03-28 20:30:00
129,1,1,0,0.005618970393312581,2019-03-28 20:15:00,2019-03-28 20:30:00
133,1,1,0,0.008236467069847733,2019-03-28 20:15:00,2019-03-28 20:30:00
135,3,1,2,0.005174270448938204,2019-03-28 20:15:00,2019-03-28 20:30:00
137,11,2,9,0.011726122592623466,2019-03-28 20:15:00,2019-03-28 20:30:00
138,3,2,1,0.006604254652548235,2019-03-28 20:15:00,2019-03-28 20:30:00
140,2,0,2,0.002974967278507692,2019-03-28 20:15:00,2019-03-28 20:30:00
141,4,1,3,0.004239443715772555,2019-03-28 20:15:00,2019-03-28 20:30:00
153,2,0,2,0.002974967278507692,2019-03-28 20:15:00,2019-03-28 20:30:00
154,4,2,2,0.014557220298062815,2019-03-28 20:15:00,2019-03-28 20:30:00
157,2,2,0,0.008484414338549937,2019-03-28 20:15:00,2019-03-28 20:30:00
158,7,1,6,0.004299189290031481,2019-03-28 20:15:00,2019-03-28 20:30:00
160,4,2,2,0.01978452562362527,2019-03-28 20:15:00,2019-03-28 20:30:00
164,3,0,3,0.002974967278507692,2019-03-28 20:15:00,2019-03-28 20:30:00
168,4,2,2,0.005563665727296344,2019-03-28 20:15:00,2019-03-28 20:30:00
170,2,1,1,0.005165250052416206,2019-03-28 20:15:00,2019-03-28 20:30:00
171,2,0,2,0.002974967278507692,2019-03-28 20:15:00,2019-03-28 20:30:00
172,1,1,0,0.0061892635010823115,2019-03-28 20:15:00,2019-03-28 20:30:00
173,7,5,2,0.01655427105548657,2019-03-28 20:15:00,2019-03-28 20:30:00
177,1,1,0,0.0055039201530374185,2019-03-28 20:15:00,2019-03-28 20:30:00
189,2,2,0,0.005190336833898436,2019-03-28 20:15:00,2019-03-28 20:30:00
190,1,0,1,0.002974967278507692,2019-03-28 20:15:00,2019-03-28 20:30:00
199,1,1,0,0.010011586828665566,2019-03-28 20:15:00,2019-03-28 20:30:00
201,1,1,0,0.004082652056203064,2019-03-28 20:15:00,2019-03-28 20:30:00
202,1,1,0,0.007700651692227179,2019-03-28 20:15:00,2019-03-28 20:30:00
1,6,5,1,0.026962248406457237,2019-03-28 20:30:00,2019-03-28 20:45:00
5,2,1,1,0.009050132182141476,2019-03-28 20:30:00,2019-03-28 20:45:00
10,2,1,1,0.018611886777426746,2019-03-28 20:30:00,2019-03-28 20:45:00
15,2,0,2,0.0028033708939330204,2019-03-28 20:30:00,2019-03-28 20:45:00
16,9,8,1,0.01598921227403252,2019-03-28 20:30:00,2019-03-28 20:45:00
18,3,3,0,0.016910822935663015,2019-03-28 20:30:00,2019-03-28 20:45:00
19,2,1,1,0.003597720886457155,2019-03-28 20:30:00,2019-03-28 20:45:00
20,2,1,1,0.018611886777426746,2019-03-28 20:30:00,2019-03-28 20:45:00
21,1,0,1,0.0028033708939330204,2019-03-28 20:30:00,2019-03-28 20:45:00
23,2,1,1,0.0073477070606051235,2019-03-28 20:30:00,2019-03-28 20:45:00
30,3,1,2,0.004875754007129177,2019-03-28 20:30:00,2019-03-28 20:45:00
35,1,1,0,0.005186420871505425,2019-03-28 20:30:00,2019-03-28 20:45:00
37,1,1,0,0.003911810204913734,2019-03-28 20:30:00,2019-03-28 20:45:00
40,5,0,5,0.0028033708939330204,2019-03-28 20:30:00,2019-03-28 20:45:00
41,6,0,6,0.0028033708939330204,2019-03-28 20:30:00,2019-03-28 20:45:00
46,1,1,0,0.0032005458901950877,2019-03-28 20:30:00,2019-03-28 20:45:00
50,1,1,0,0.003994895882719222,2019-03-28 20:30:00,2019-03-28 20:45:00
57,3,2,1,0.003597720886457155,2019-03-28 20:30:00,2019-03-28 20:45:00
58,1,0,1,0.0028033708939330204,2019-03-28 20:30:00,2019-03-28 20:45:00
61,4,2,2,0.016067385228801124,2019-03-28 20:30:00,2019-03-28 20:45:00
62,2,1,1,0.0051395858008138375,2019-03-28 20:30:00,2019-03-28 20:45:00
66,1,1,0,0.003597720886457155,2019-03-28 20:30:00,2019-03-28 20:45:00
67,1,0,1,0.0028033708939330204,2019-03-28 20:30:00,2019-03-28 20:45:00
68,4,3,1,0.007569470849077829,2019-03-28 20:30:00,2019-03-28 20:45:00
69,1,1,0,0.016396296542925074,2019-03-28 20:30:00,2019-03-28 20:45:00
70,2,0,2,0.0028033708939330204,2019-03-28 20:30:00,2019-03-28 20:45:00
79,2,1,1,0.018611886777426746,2019-03-28 20:30:00,2019-03-28 20:45:00
85,2,2,0,0.007786235511378593,2019-03-28 20:30:00,2019-03-28 20:45:00
87,1,0,1,0.0028033708939330204,2019-03-28 20:30:00,2019-03-28 20:45:00
88,1,0,1,0.0028033708939330204,2019-03-28 20:30:00,2019-03-28 20:45:00
89,3,2,1,0.013194898408533788,2019-03-28 20:30:00,2019-03-28 20:45:00
90,3,2,1,0.007339457446659099,2019-03-28 20:30:00,2019-03-28 20:45:00
104,1,0,1,0.0028033708939330204,2019-03-28 20:30:00,2019-03-28 20:45:00
109,5,2,3,0.00824473088347679,2019-03-28 20:30:00,2019-03-28 20:45:00
110,1,1,0,0.005186420871505425,2019-03-28 20:30:00,2019-03-28 20:45:00
111,4,3,1,0.004233200880476463,2019-03-28 20:30:00,2019-03-28 20:45:00
112,13,5,8,0.04276071997177494,2019-03-28 20:30:00,2019-03-28 20:45:00
116,2,2,0,0.009447307178403544,2019-03-28 20:30:00,2019-03-28 20:45:00
119,4,1,3,0.003911810204913734,2019-03-28 20:30:00,2019-03-28 20:45:00
120,5,3,2,0.01360971246827195,2019-03-28 20:30:00,2019-03-28 20:45:00
126,2,0,2,0.0028033708939330204,2019-03-28 20:30:00,2019-03-28 20:45:00
127,3,2,1,0.0085309824354453,2019-03-28 20:30:00,2019-03-28 20:45:00
129,1,1,0,0.003994895882719222,2019-03-28 20:30:00,2019-03-28 20:45:00
135,2,1,1,0.018611886777426746,2019-03-28 20:30:00,2019-03-28 20:45:00
137,3,0,3,0.0028033708939330204,2019-03-28 20:30:00,2019-03-28 20:45:00
138,3,2,1,0.009082614304653753,2019-03-28 20:30:00,2019-03-28 20:45:00
141,8,3,5,0.02619651039062224,2019-03-28 20:30:00,2019-03-28 20:45:00
153,3,2,1,0.00942009017380128,2019-03-28 20:30:00,2019-03-28 20:45:00
154,5,2,3,0.01180193226563465,2019-03-28 20:30:00,2019-03-28 20:45:00
157,3,1,2,0.0058616809059043855,2019-03-28 20:30:00,2019-03-28 20:45:00
158,6,1,5,0.003911810204913734,2019-03-28 20:30:00,2019-03-28 20:45:00
160,2,1,1,0.018611886777426746,2019-03-28 20:30:00,2019-03-28 20:45:00
164,3,0,3,0.0028033708939330204,2019-03-28 20:30:00,2019-03-28 20:45:00
168,5,3,2,0.012903346292778275,2019-03-28 20:30:00,2019-03-28 20:45:00
170,2,1,1,0.0073477070606051235,2019-03-28 20:30:00,2019-03-28 20:45:00
171,2,1,1,0.025724945946741275,2019-03-28 20:30:00,2019-03-28 20:45:00
172,3,2,1,0.021246639424675702,2019-03-28 20:30:00,2019-03-28 20:45:00
173,5,4,1,0.008530982435445303,2019-03-28 20:30:00,2019-03-28 20:45:00
177,1,1,0,0.007172414589765344,2019-03-28 20:30:00,2019-03-28 20:45:00
189,2,0,2,0.0028033708939330204,2019-03-28 20:30:00,2019-03-28 20:45:00
190,1,1,0,0.0051395858008138375,2019-03-28 20:30:00,2019-03-28 20:45:00
197,3,2,1,0.021246639424675702,2019-03-28 20:30:00,2019-03-28 20:45:00
199,1,1,0,0.010055769591492455,2019-03-28 20:30:00,2019-03-28 20:45:00
202,1,0,1,0.0028033708939330204,2019-03-28 20:30:00,2019-03-28 20:45:00
203,1,1,0,0.0051395858008138375,2019-03-28 20:30:00,2019-03-28 20:45:00
1,6,5,1,0.016922215482156513,2019-03-28 20:45:00,2019-03-28 21:00:00
5,2,1,1,0.003915031001103934,2019-03-28 20:45:00,2019-03-28 21:00:00
10,2,1,1,0.020279227994393807,2019-03-28 20:45:00,2019-03-28 21:00:00
15,1,1,0,0.006156549476843338,2019-03-28 20:45:00,2019-03-28 21:00:00
16,3,0,3,0.003050618480214221,2019-03-28 20:45:00,2019-03-28 21:00:00
18,5,3,2,0.011640363258942178,2019-03-28 20:45:00,2019-03-28 21:00:00
19,3,2,1,0.007704654696348824,2019-03-28 20:45:00,2019-03-28 21:00:00
20,6,4,2,0.015581209126507994,2019-03-28 20:45:00,2019-03-28 21:00:00
21,1,0,1,0.003050618480214221,2019-03-28 20:45:00,2019-03-28 21:00:00
23,2,2,0,0.007166984431267271,2019-03-28 20:45:00,2019-03-28 21:00:00
28,2,1,1,0.020279227994393807,2019-03-28 20:45:00,2019-03-28 21:00:00
30,1,0,1,0.003050618480214221,2019-03-28 20:45:00,2019-03-28 21:00:00
37,1,1,0,0.004573746868598132,2019-03-28 20:45:00,2019-03-28 21:00:00
41,8,2,6,0.004256826623743919,2019-03-28 20:45:00,2019-03-28 21:00:00
46,2,1,1,0.00365372255197907,2019-03-28 20:45:00,2019-03-28 21:00:00
50,1,1,0,0.004347237261548791,2019-03-28 20:45:00,2019-03-28 21:00:00
57,7,6,1,0.01834733492935499,2019-03-28 20:45:00,2019-03-28 21:00:00
58,2,1,1,0.005643856042883361,2019-03-28 20:45:00,2019-03-28 21:00:00
61,1,0,1,0.003050618480214221,2019-03-28 20:45:00,2019-03-28 21:00:00
62,2,1,1,0.008526323875014858,2019-03-28 20:45:00,2019-03-28 21:00:00
68,1,0,1,0.003050618480214221,2019-03-28 20:45:00,2019-03-28 21:00:00
69,1,1,0,0.003915031001103934,2019-03-28 20:45:00,2019-03-28 21:00:00
70,2,1,1,0.005643856042883361,2019-03-28 20:45:00,2019-03-28 21:00:00
88,1,0,1,0.003050618480214221,2019-03-28 20:45:00,2019-03-28 21:00:00
90,1,0,1,0.003050618480214221,2019-03-28 20:45:00,2019-03-28 21:00:00
104,4,1,3,0.02303078327326833,2019-03-28 20:45:00,2019-03-28 21:00:00
109,6,3,3,0.019322853482227974,2019-03-28 20:45:00,2019-03-28 21:00:00
110,2,2,0,0.0065082685637730744,2019-03-28 20:45:00,2019-03-28 21:00:00
111,2,0,2,0.003050618480214221,2019-03-28 20:45:00,2019-03-28 21:00:00
112,9,3,6,0.005463034767273618,2019-03-28 20:45:00,2019-03-28 21:00:00
113,1,0,1,0.003050618480214221,2019-03-28 20:45:00,2019-03-28 21:00:00
114,5,4,1,0.023501182482364356,2019-03-28 20:45:00,2019-03-28 21:00:00
116,1,0,1,0.003050618480214221,2019-03-28 20:45:00,2019-03-28 21:00:00
118,1,1,0,0.00784832510416816,2019-03-28 20:45:00,2019-03-28 21:00:00
119,6,2,4,0.007166984431267271,2019-03-28 20:45:00,2019-03-28 21:00:00
120,3,2,1,0.004689032884188776,2019-03-28 20:45:00,2019-03-28 21:00:00
122,3,1,2,0.005305801384371854,2019-03-28 20:45:00,2019-03-28 21:00:00
126,2,0,2,0.003050618480214221,2019-03-28 20:45:00,2019-03-28 21:00:00
127,2,1,1,0.006301831400589183,2019-03-28 20:45:00,2019-03-28 21:00:00
135,2,1,1,0.020279227994393807,2019-03-28 20:45:00,2019-03-28 21:00:00
137,3,1,2,0.005643856042883361,2019-03-28 20:45:00,2019-03-28 21:00:00
138,4,2,2,0.008032030859275226,2019-03-28 20:45:00,2019-03-28 21:00:00
141,3,0,3,0.003050618480214221,2019-03-28 20:45:00,2019-03-28 21:00:00
153,5,3,2,0.00983180607494298,2019-03-28 20:45:00,2019-03-28 21:00:00
154,2,1,1,0.0038246203632990626,2019-03-28 20:45:00,2019-03-28 21:00:00
157,1,1,0,0.01864758108790266,2019-03-28 20:45:00,2019-03-28 21:00:00
158,1,1,0,0.004573746868598132,2019-03-28 20:45:00,2019-03-28 21:00:00
160,2,1,1,0.020279227994393807,2019-03-28 20:45:00,2019-03-28 21:00:00
164,1,1,0,0.00703665442101745,2019-03-28 20:45:00,2019-03-28 21:00:00
168,5,3,2,0.006076062303328218,2019-03-28 20:45:00,2019-03-28 21:00:00
170,3,0,3,0.003050618480214221,2019-03-28 20:45:00,2019-03-28 21:00:00
171,1,1,0,0.01743595628861572,2019-03-28 20:45:00,2019-03-28 21:00:00
172,3,2,1,0.048019824826881795,2019-03-28 20:45:00,2019-03-28 21:00:00
173,4,0,4,0.003050618480214221,2019-03-28 20:45:00,2019-03-28 21:00:00
177,1,1,0,0.01029911897893832,2019-03-28 20:45:00,2019-03-28 21:00:00
189,2,0,2,0.003050618480214221,2019-03-28 20:45:00,2019-03-28 21:00:00
190,2,1,1,0.008526323875014858,2019-03-28 20:45:00,2019-03-28 21:00:00
191,1,1,0,0.01029911897893832,2019-03-28 20:45:00,2019-03-28 21:00:00
197,3,2,1,0.024284828337056277,2019-03-28 20:45:00,2019-03-28 21:00:00
199,4,4,0,0.005643856042883361,2019-03-28 20:45:00,2019-03-28 21:00:00
201,1,0,1,0.003050618480214221,2019-03-28 20:45:00,2019-03-28 21:00:00
203,1,1,0,0.008526323875014858,2019-03-28 20:45:00,2019-03-28 21:00:00
1,4,2,2,0.0060451705585808,2019-03-28 21:00:00,2019-03-28 21:15:00
10,2,1,1,0.018070352757886456,2019-03-28 21:00:00,2019-03-28 21:15:00
16,5,2,3,0.011962204467520138,2019-03-28 21:00:00,2019-03-28 21:15:00
18,3,1,2,0.004848012022804294,2019-03-28 21:00:00,2019-03-28 21:15:00
19,3,1,2,0.005020914764469259,2019-03-28 21:00:00,2019-03-28 21:15:00
20,6,4,2,0.01590139203853027,2019-03-28 21:00:00,2019-03-28 21:15:00
23,3,2,1,0.005789925694738952,2019-03-28 21:00:00,2019-03-28 21:15:00
26,1,1,0,0.003867398369064721,2019-03-28 21:00:00,2019-03-28 21:15:00
28,2,0,2,0.0027138819736601824,2019-03-28 21:00:00,2019-03-28 21:15:00
37,1,1,0,0.0034828929039298745,2019-03-28 21:00:00,2019-03-28 21:15:00
41,5,2,3,0.007006276455062625,2019-03-28 21:00:00,2019-03-28 21:15:00
50,1,1,0,0.005020914764469259,2019-03-28 21:00:00,2019-03-28 21:15:00
57,11,8,3,0.016134571328169534,2019-03-28 21:00:00,2019-03-28 21:15:00
58,2,1,1,0.005020914764469259,2019-03-28 21:00:00,2019-03-28 21:15:00
62,2,1,1,0.017044030581460982,2019-03-28 21:00:00,2019-03-28 21:15:00
67,5,2,3,0.004251903834199567,2019-03-28 21:00:00,2019-03-28 21:15:00
70,3,0,3,0.0027138819736601824,2019-03-28 21:00:00,2019-03-28 21:15:00
74,1,0,1,0.0027138819736601824,2019-03-28 21:00:00,2019-03-28 21:15:00
88,1,0,1,0.0027138819736601824,2019-03-28 21:00:00,2019-03-28 21:15:00
104,1,1,0,0.0052833969512842,2019-03-28 21:00:00,2019-03-28 21:15:00
109,9,7,2,0.03371192243787072,2019-03-28 21:00:00,2019-03-28 21:15:00
110,5,3,2,0.012883370389618839,2019-03-28 21:00:00,2019-03-28 21:15:00
111,4,1,3,0.005020914764469259,2019-03-28 21:00:00,2019-03-28 21:15:00
112,6,4,2,0.12101992525033192,2019-03-28 21:00:00,2019-03-28 21:15:00
113,1,0,1,0.0027138819736601824,2019-03-28 21:00:00,2019-03-28 21:15:00
114,3,2,1,0.01178009053784001,2019-03-28 21:00:00,2019-03-28 21:15:00
116,1,0,1,0.0027138819736601824,2019-03-28 21:00:00,2019-03-28 21:15:00
118,1,1,0,0.0034828929039298745,2019-03-28 21:00:00,2019-03-28 21:15:00
119,3,0,3,0.0027138819736601824,2019-03-28 21:00:00,2019-03-28 21:15:00
120,2,1,1,0.007635884507774788,2019-03-28 21:00:00,2019-03-28 21:15:00
122,1,0,1,0.0027138819736601824,2019-03-28 21:00:00,2019-03-28 21:15:00
126,3,1,2,0.003918721194480796,2019-03-28 21:00:00,2019-03-28 21:15:00
127,2,1,1,0.005020914764469259,2019-03-28 21:00:00,2019-03-28 21:15:00
129,4,3,1,0.04276424821412724,2019-03-28 21:00:00,2019-03-28 21:15:00
135,2,1,1,0.018070352757886456,2019-03-28 21:00:00,2019-03-28 21:15:00
137,1,0,1,0.0027138819736601824,2019-03-28 21:00:00,2019-03-28 21:15:00
138,3,1,2,0.005020914764469259,2019-03-28 21:00:00,2019-03-28 21:15:00
141,8,4,4,0.008732928085871946,2019-03-28 21:00:00,2019-03-28 21:15:00
153,2,1,1,0.004848012022804294,2019-03-28 21:00:00,2019-03-28 21:15:00
158,1,1,0,0.0034828929039298745,2019-03-28 21:00:00,2019-03-28 21:15:00
164,2,1,1,0.009205222221659357,2019-03-28 21:00:00,2019-03-28 21:15:00
168,2,0,2,0.0027138819736601824,2019-03-28 21:00:00,2019-03-28 21:15:00
170,2,0,2,0.0027138819736601824,2019-03-28 21:00:00,2019-03-28 21:15:00
171,1,1,0,0.0052833969512842,2019-03-28 21:00:00,2019-03-28 21:15:00
172,2,1,1,0.018070352757886456,2019-03-28 21:00:00,2019-03-28 21:15:00
173,2,1,1,0.012728601562833768,2019-03-28 21:00:00,2019-03-28 21:15:00
177,1,1,0,0.01720430347797701,2019-03-28 21:00:00,2019-03-28 21:15:00
189,1,0,1,0.0027138819736601824,2019-03-28 21:00:00,2019-03-28 21:15:00
191,1,0,1,0.0027138819736601824,2019-03-28 21:00:00,2019-03-28 21:15:00
196,1,1,0,0.004848012022804294,2019-03-28 21:00:00,2019-03-28 21:15:00
197,3,2,1,0.046476261535529924,2019-03-28 21:00:00,2019-03-28 21:15:00
199,1,1,0,0.013535184085920065,2019-03-28 21:00:00,2019-03-28 21:15:00
201,1,0,1,0.0027138819736601824,2019-03-28 21:00:00,2019-03-28 21:15:00
1,3,2,1,0.006235290864284752,2019-03-28 21:15:00,2019-03-28 21:30:00
10,2,1,1,0.020443887066656917,2019-03-28 21:15:00,2019-03-28 21:30:00
16,4,4,0,0.012455887501641321,2019-03-28 21:15:00,2019-03-28 21:30:00
20,4,3,1,0.03781735518600684,2019-03-28 21:15:00,2019-03-28 21:30:00
23,6,1,5,0.0036993872551139726,2019-03-28 21:15:00,2019-03-28 21:30:00
26,2,1,1,0.005930535933896141,2019-03-28 21:15:00,2019-03-28 21:30:00
28,4,3,1,0.012242191159050106,2019-03-28 21:15:00,2019-03-28 21:30:00
37,2,2,0,0.006383841696386845,2019-03-28 21:15:00,2019-03-28 21:30:00
40,5,2,3,0.007087123818368634,2019-03-28 21:15:00,2019-03-28 21:30:00
41,5,2,3,0.00973013838451087,2019-03-28 21:15:00,2019-03-28 21:30:00
50,1,1,0,0.0036993872551139726,2019-03-28 21:15:00,2019-03-28 21:30:00
57,11,6,5,0.013488670417005248,2019-03-28 21:15:00,2019-03-28 21:30:00
58,2,0,2,0.0030704189473069834,2019-03-28 21:15:00,2019-03-28 21:30:00
61,1,1,0,0.007899484733923844,2019-03-28 21:15:00,2019-03-28 21:30:00
62,1,0,1,0.0030704189473069834,2019-03-28 21:15:00,2019-03-28 21:30:00
67,4,0,4,0.0030704189473069834,2019-03-28 21:15:00,2019-03-28 21:30:00
68,1,1,0,0.0036993872551139726,2019-03-28 21:15:00,2019-03-28 21:30:00
70,1,0,1,0.0030704189473069834,2019-03-28 21:15:00,2019-03-28 21:30:00
74,1,0,1,0.0030704189473069834,2019-03-28 21:15:00,2019-03-28 21:30:00
88,2,0,2,0.0030704189473069834,2019-03-28 21:15:00,2019-03-28 21:30:00
90,1,0,1,0.0030704189473069834,2019-03-28 21:15:00,2019-03-28 21:30:00
104,1,1,0,0.008371088404535345,2019-03-28 21:15:00,2019-03-28 21:30:00
109,4,2,2,0.00516697997333028,2019-03-28 21:15:00,2019-03-28 21:30:00
110,4,1,3,0.0036993872551139726,2019-03-28 21:15:00,2019-03-28 21:30:00
111,4,2,2,0.006728840087416704,2019-03-28 21:15:00,2019-03-28 21:30:00
112,7,5,2,0.10863432828836028,2019-03-28 21:15:00,2019-03-28 21:30:00
114,2,1,1,0.0056805595744050565,2019-03-28 21:15:00,2019-03-28 21:30:00
116,2,1,1,0.004590423817066917,2019-03-28 21:15:00,2019-03-28 21:30:00
118,1,1,0,0.0056805595744050565,2019-03-28 21:15:00,2019-03-28 21:30:00
119,2,0,2,0.0030704189473069834,2019-03-28 21:15:00,2019-03-28 21:30:00
120,1,1,0,0.0036993872551139726,2019-03-28 21:15:00,2019-03-28 21:30:00
126,3,1,2,0.0037229541040815018,2019-03-28 21:15:00,2019-03-28 21:30:00
127,4,1,3,0.005363888468408298,2019-03-28 21:15:00,2019-03-28 21:30:00
129,6,4,2,0.0525806826782587,2019-03-28 21:15:00,2019-03-28 21:30:00
135,2,1,1,0.020443887066656917,2019-03-28 21:15:00,2019-03-28 21:30:00
137,1,0,1,0.0030704189473069834,2019-03-28 21:15:00,2019-03-28 21:30:00
138,4,4,0,0.011255897824159963,2019-03-28 21:15:00,2019-03-28 21:30:00
140,1,1,0,0.00437548926085602,2019-03-28 21:15:00,2019-03-28 21:30:00
141,4,2,2,0.0056805595744050565,2019-03-28 21:15:00,2019-03-28 21:30:00
154,1,0,1,0.0030704189473069834,2019-03-28 21:15:00,2019-03-28 21:30:00
158,2,2,0,0.00657172776096651,2019-03-28 21:15:00,2019-03-28 21:30:00
164,1,0,1,0.0030704189473069834,2019-03-28 21:15:00,2019-03-28 21:30:00
168,2,0,2,0.0030704189473069834,2019-03-28 21:15:00,2019-03-28 21:30:00
170,2,0,2,0.0030704189473069834,2019-03-28 21:15:00,2019-03-28 21:30:00
172,2,1,1,0.020443887066656917,2019-03-28 21:15:00,2019-03-28 21:30:00
173,1,0,1,0.0030704189473069834,2019-03-28 21:15:00,2019-03-28 21:30:00
177,1,1,0,0.0056805595744050565,2019-03-28 21:15:00,2019-03-28 21:30:00
196,1,0,1,0.0030704189473069834,2019-03-28 21:15:00,2019-03-28 21:30:00
197,3,2,1,0.030554422620632567,2019-03-28 21:15:00,2019-03-28 21:30:00
199,1,1,0,0.0056805595744050565,2019-03-28 21:15:00,2019-03-28 21:30:00
203,1,1,0,0.0056805595744050565,2019-03-28 21:15:00,2019-03-28 21:30:00
1,2,2,0,0.006051753931653577,2019-03-28 21:30:00,2019-03-28 21:45:00
10,3,1,2,0.006093686711558029,2019-03-28 21:30:00,2019-03-28 21:45:00
15,1,0,1,0.0035035609667008302,2019-03-28 21:30:00,2019-03-28 21:45:00
16,1,1,0,0.015019809498964032,2019-03-28 21:30:00,2019-03-28 21:45:00
18,5,1,4,0.004449094627576779,2019-03-28 21:30:00,2019-03-28 21:45:00
20,4,3,1,0.04306544186803083,2019-03-28 21:30:00,2019-03-28 21:45:00
23,6,2,4,0.005394628288452729,2019-03-28 21:30:00,2019-03-28 21:45:00
26,2,2,0,0.019208296585286166,2019-03-28 21:30:00,2019-03-28 21:45:00
27,1,1,0,0.004992724562157893,2019-03-28 21:30:00,2019-03-28 21:45:00
28,3,2,1,0.011992102118074069,2019-03-28 21:30:00,2019-03-28 21:45:00
35,2,2,0,0.011992102118074069,2019-03-28 21:30:00,2019-03-28 21:45:00
37,2,2,0,0.007582850307015091,2019-03-28 21:30:00,2019-03-28 21:45:00
40,3,1,2,0.006093686711558029,2019-03-28 21:30:00,2019-03-28 21:45:00
41,4,2,2,0.023284501417365832,2019-03-28 21:30:00,2019-03-28 21:45:00
46,1,1,0,0.004650046490724198,2019-03-28 21:30:00,2019-03-28 21:45:00
50,1,1,0,0.004650046490724198,2019-03-28 21:30:00,2019-03-28 21:45:00
57,6,3,3,0.008467439618224371,2019-03-28 21:30:00,2019-03-28 21:45:00
58,3,2,1,0.01354667680157276,2019-03-28 21:30:00,2019-03-28 21:45:00
61,2,2,0,0.009013774927159945,2019-03-28 21:30:00,2019-03-28 21:45:00
62,1,1,0,0.0047776574491772035,2019-03-28 21:30:00,2019-03-28 21:45:00
67,3,0,3,0.0035035609667008302,2019-03-28 21:30:00,2019-03-28 21:45:00
68,1,1,0,0.004650046490724198,2019-03-28 21:30:00,2019-03-28 21:45:00
69,1,1,0,0.008295611010358302,2019-03-28 21:30:00,2019-03-28 21:45:00
74,1,0,1,0.0035035609667008302,2019-03-28 21:30:00,2019-03-28 21:45:00
88,1,0,1,0.0035035609667008302,2019-03-28 21:30:00,2019-03-28 21:45:00
90,1,0,1,0.0035035609667008302,2019-03-28 21:30:00,2019-03-28 21:45:00
109,1,0,1,0.0035035609667008302,2019-03-28 21:30:00,2019-03-28 21:45:00
110,1,1,0,0.004650046490724198,2019-03-28 21:30:00,2019-03-28 21:45:00
111,2,1,1,0.006481888157614955,2019-03-28 21:30:00,2019-03-28 21:45:00
112,4,2,2,0.023284501417365832,2019-03-28 21:30:00,2019-03-28 21:45:00
113,1,0,1,0.0035035609667008302,2019-03-28 21:30:00,2019-03-28 21:45:00
114,3,1,2,0.006481888157614955,2019-03-28 21:30:00,2019-03-28 21:45:00
118,1,0,1,0.0035035609667008302,2019-03-28 21:30:00,2019-03-28 21:45:00
119,2,0,2,0.0035035609667008302,2019-03-28 21:30:00,2019-03-28 21:45:00
122,1,0,1,0.0035035609667008302,2019-03-28 21:30:00,2019-03-28 21:45:00
126,4,1,3,0.0044963366970055384,2019-03-28 21:30:00,2019-03-28 21:45:00
127,1,0,1,0.0035035609667008302,2019-03-28 21:30:00,2019-03-28 21:45:00
135,2,1,1,0.023284501417365832,2019-03-28 21:30:00,2019-03-28 21:45:00
137,1,0,1,0.0035035609667008302,2019-03-28 21:30:00,2019-03-28 21:45:00
138,4,3,1,0.010701699440189937,2019-03-28 21:30:00,2019-03-28 21:45:00
140,2,1,1,0.006481888157614955,2019-03-28 21:30:00,2019-03-28 21:45:00
141,1,1,0,0.006481888157614955,2019-03-28 21:30:00,2019-03-28 21:45:00
153,1,0,1,0.0035035609667008302,2019-03-28 21:30:00,2019-03-28 21:45:00
158,3,2,1,0.007582850307015091,2019-03-28 21:30:00,2019-03-28 21:45:00
164,2,2,0,0.012928083032101847,2019-03-28 21:30:00,2019-03-28 21:45:00
168,1,0,1,0.0035035609667008302,2019-03-28 21:30:00,2019-03-28 21:45:00
170,2,0,2,0.0035035609667008302,2019-03-28 21:30:00,2019-03-28 21:45:00
172,2,1,1,0.023284501417365832,2019-03-28 21:30:00,2019-03-28 21:45:00
173,2,0,2,0.0035035609667008302,2019-03-28 21:30:00,2019-03-28 21:45:00
191,1,1,0,0.006481888157614955,2019-03-28 21:30:00,2019-03-28 21:45:00
196,2,1,1,0.006481888157614955,2019-03-28 21:30:00,2019-03-28 21:45:00
197,2,1,1,0.023284501417365832,2019-03-28 21:30:00,2019-03-28 21:45:00
199,1,1,0,0.004992724562157893,2019-03-28 21:30:00,2019-03-28 21:45:00
202,1,1,0,0.006481888157614955,2019-03-28 21:30:00,2019-03-28 21:45:00
203,4,2,2,0.011273938201272427,2019-03-28 21:30:00,2019-03-28 21:45:00
1,2,2,0,0.005641132538768063,2019-03-28 21:45:00,2019-03-28 22:00:00
10,3,1,2,0.00626248542128445,2019-03-28 21:45:00,2019-03-28 22:00:00
15,1,0,1,0.0036005797294677835,2019-03-28 21:45:00,2019-03-28 22:00:00
19,1,0,1,0.0036005797294677835,2019-03-28 21:45:00,2019-03-28 22:00:00
20,2,1,1,0.023943321724192935,2019-03-28 21:45:00,2019-03-28 22:00:00
23,2,0,2,0.0036005797294677835,2019-03-28 21:45:00,2019-03-28 22:00:00
26,2,2,0,0.009722238157368623,2019-03-28 21:45:00,2019-03-28 22:00:00
27,1,1,0,0.006432021206491243,2019-03-28 21:45:00,2019-03-28 22:00:00
28,1,0,1,0.0036005797294677835,2019-03-28 21:45:00,2019-03-28 22:00:00
30,1,1,0,0.009263462683514703,2019-03-28 21:45:00,2019-03-28 22:00:00
35,1,1,0,0.006661408943418203,2019-03-28 21:45:00,2019-03-28 22:00:00
37,4,3,1,0.051795529024463986,2019-03-28 21:45:00,2019-03-28 22:00:00
40,3,1,2,0.00626248542128445,2019-03-28 21:45:00,2019-03-28 22:00:00
41,2,1,1,0.023943321724192935,2019-03-28 21:45:00,2019-03-28 22:00:00
46,3,2,1,0.006661408943418203,2019-03-28 21:45:00,2019-03-28 22:00:00
57,4,4,0,0.01798717485151204,2019-03-28 21:45:00,2019-03-28 22:00:00
58,3,2,1,0.009722238157368623,2019-03-28 21:45:00,2019-03-28 22:00:00
62,1,1,0,0.004620856134117923,2019-03-28 21:45:00,2019-03-28 22:00:00
67,2,0,2,0.0036005797294677835,2019-03-28 21:45:00,2019-03-28 22:00:00
68,1,0,1,0.0036005797294677835,2019-03-28 21:45:00,2019-03-28 22:00:00
69,1,1,0,0.006661408943418203,2019-03-28 21:45:00,2019-03-28 22:00:00
90,1,1,0,0.006661408943418203,2019-03-28 21:45:00,2019-03-28 22:00:00
109,5,1,4,0.0045723089265752885,2019-03-28 21:45:00,2019-03-28 22:00:00
111,1,0,1,0.0036005797294677835,2019-03-28 21:45:00,2019-03-28 22:00:00
112,4,2,2,0.023943321724192935,2019-03-28 21:45:00,2019-03-28 22:00:00
113,1,0,1,0.0036005797294677835,2019-03-28 21:45:00,2019-03-28 22:00:00
118,1,0,1,0.0036005797294677835,2019-03-28 21:45:00,2019-03-28 22:00:00
119,2,0,2,0.0036005797294677835,2019-03-28 21:45:00,2019-03-28 22:00:00
122,1,0,1,0.0036005797294677835,2019-03-28 21:45:00,2019-03-28 22:00:00
126,3,0,3,0.0036005797294677835,2019-03-28 21:45:00,2019-03-28 22:00:00
135,2,1,1,0.023943321724192935,2019-03-28 21:45:00,2019-03-28 22:00:00
138,1,0,1,0.0036005797294677835,2019-03-28 21:45:00,2019-03-28 22:00:00
153,3,0,3,0.0036005797294677835,2019-03-28 21:45:00,2019-03-28 22:00:00
158,3,3,0,0.014154682484962555,2019-03-28 21:45:00,2019-03-28 22:00:00
164,6,4,2,0.014966649794336106,2019-03-28 21:45:00,2019-03-28 22:00:00
168,1,0,1,0.0036005797294677835,2019-03-28 21:45:00,2019-03-28 22:00:00
172,2,1,1,0.023943321724192935,2019-03-28 21:45:00,2019-03-28 22:00:00
173,3,1,2,0.006661408943418203,2019-03-28 21:45:00,2019-03-28 22:00:00
191,4,4,0,0.007633138140525708,2019-03-28 21:45:00,2019-03-28 22:00:00
197,2,1,1,0.023943321724192935,2019-03-28 21:45:00,2019-03-28 22:00:00
199,1,1,0,0.006432021206491243,2019-03-28 21:45:00,2019-03-28 22:00:00
202,1,1,0,0.006661408943418203,2019-03-28 21:45:00,2019-03-28 22:00:00
203,1,0,1,0.0036005797294677835,2019-03-28 21:45:00,2019-03-28 22:00:00
1,3,2,1,0.008407513331538394,2019-03-28 22:00:00,2019-03-28 22:15:00
5,7,2,5,0.0051147715596778585,2019-03-28 22:00:00,2019-03-28 22:15:00
10,2,1,1,0.022459662037871777,2019-03-28 22:00:00,2019-03-28 22:15:00
16,1,1,0,0.004810296448128398,2019-03-28 22:00:00,2019-03-28 22:15:00
18,2,2,0,0.0062450530974827115,2019-03-28 22:00:00,2019-03-28 22:15:00
20,3,2,1,0.05314134842893054,2019-03-28 22:00:00,2019-03-28 22:15:00
23,1,0,1,0.003375539798774084,2019-03-28 22:00:00,2019-03-28 22:15:00
27,1,1,0,0.0072497012885367335,2019-03-28 22:00:00,2019-03-28 22:15:00
28,1,1,0,0.0062450530974827115,2019-03-28 22:00:00,2019-03-28 22:15:00
30,1,1,0,0.0062450530974827115,2019-03-28 22:00:00,2019-03-28 22:15:00
40,2,1,1,0.022459662037871777,2019-03-28 22:00:00,2019-03-28 22:15:00
41,5,3,2,0.005984387440129746,2019-03-28 22:00:00,2019-03-28 22:15:00
46,1,0,1,0.003375539798774084,2019-03-28 22:00:00,2019-03-28 22:15:00
50,1,0,1,0.003375539798774084,2019-03-28 22:00:00,2019-03-28 22:15:00
57,2,0,2,0.003375539798774084,2019-03-28 22:00:00,2019-03-28 22:15:00
58,5,3,2,0.014816204990023753,2019-03-28 22:00:00,2019-03-28 22:15:00
68,1,0,1,0.003375539798774084,2019-03-28 22:00:00,2019-03-28 22:15:00
69,1,1,0,0.0062450530974827115,2019-03-28 22:00:00,2019-03-28 22:15:00
87,2,2,0,0.005748811488630624,2019-03-28 22:00:00,2019-03-28 22:15:00
90,1,1,0,0.011599334718989517,2019-03-28 22:00:00,2019-03-28 22:15:00
101,2,1,1,0.022459662037871777,2019-03-28 22:00:00,2019-03-28 22:15:00
109,5,1,4,0.005583397619013261,2019-03-28 22:00:00,2019-03-28 22:15:00
110,5,2,3,0.007791255439252439,2019-03-28 22:00:00,2019-03-28 22:15:00
112,5,3,2,0.03936974457583975,2019-03-28 22:00:00,2019-03-28 22:15:00
113,1,0,1,0.003375539798774084,2019-03-28 22:00:00,2019-03-28 22:15:00
114,1,0,1,0.003375539798774084,2019-03-28 22:00:00,2019-03-28 22:15:00
116,1,0,1,0.003375539798774084,2019-03-28 22:00:00,2019-03-28 22:15:00
119,1,0,1,0.003375539798774084,2019-03-28 22:00:00,2019-03-28 22:15:00
126,3,1,2,0.005919221025791505,2019-03-28 22:00:00,2019-03-28 22:15:00
129,2,2,0,0.0062450530974827115,2019-03-28 22:00:00,2019-03-28 22:15:00
135,2,1,1,0.022459662037871777,2019-03-28 22:00:00,2019-03-28 22:15:00
137,1,1,0,0.004810296448128398,2019-03-28 22:00:00,2019-03-28 22:15:00
138,2,0,2,0.003375539798774084,2019-03-28 22:00:00,2019-03-28 22:15:00
140,2,0,2,0.003375539798774084,2019-03-28 22:00:00,2019-03-28 22:15:00
157,1,0,1,0.003375539798774084,2019-03-28 22:00:00,2019-03-28 22:15:00
158,3,3,0,0.011387814614995814,2019-03-28 22:00:00,2019-03-28 22:15:00
164,6,3,3,0.008022059707435098,2019-03-28 22:00:00,2019-03-28 22:15:00
168,2,1,1,0.009673443472510652,2019-03-28 22:00:00,2019-03-28 22:15:00
171,1,1,0,0.0062450530974827115,2019-03-28 22:00:00,2019-03-28 22:15:00
172,3,2,1,0.041543784276969475,2019-03-28 22:00:00,2019-03-28 22:15:00
173,4,2,2,0.00911456639619134,2019-03-28 22:00:00,2019-03-28 22:15:00
195,1,0,1,0.003375539798774084,2019-03-28 22:00:00,2019-03-28 22:15:00
197,4,2,2,0.010862097885910716,2019-03-28 22:00:00,2019-03-28 22:15:00
199,2,2,0,0.01439705712030221,2019-03-28 22:00:00,2019-03-28 22:15:00
203,1,0,1,0.003375539798774084,2019-03-28 22:00:00,2019-03-28 22:15:00
1,3,2,1,0.008056285191353547,2019-03-28 22:15:00,2019-03-28 22:30:00
10,3,2,1,0.04477604401974576,2019-03-28 22:15:00,2019-03-28 22:30:00
16,5,2,3,0.010198469740201523,2019-03-28 22:15:00,2019-03-28 22:30:00
18,2,2,0,0.006739946180752226,2019-03-28 22:15:00,2019-03-28 22:30:00
20,4,2,2,0.013011980618541008,2019-03-28 22:15:00,2019-03-28 22:30:00
23,1,0,1,0.003643048338529342,2019-03-28 22:15:00,2019-03-28 22:30:00
26,1,0,1,0.003643048338529342,2019-03-28 22:15:00,2019-03-28 22:30:00
27,2,2,0,0.0051914972596407835,2019-03-28 22:15:00,2019-03-28 22:30:00
28,1,1,0,0.006739946180752226,2019-03-28 22:15:00,2019-03-28 22:30:00
30,1,1,0,0.004417272799085063,2019-03-28 22:15:00,2019-03-28 22:30:00
37,1,1,0,0.006533040521485456,2019-03-28 22:15:00,2019-03-28 22:30:00
41,2,0,2,0.003643048338529342,2019-03-28 22:15:00,2019-03-28 22:30:00
50,2,0,2,0.003643048338529342,2019-03-28 22:15:00,2019-03-28 22:30:00
57,2,0,2,0.003643048338529342,2019-03-28 22:15:00,2019-03-28 22:30:00
58,5,2,3,0.009405015550596734,2019-03-28 22:15:00,2019-03-28 22:30:00
62,1,1,0,0.009005578426860224,2019-03-28 22:15:00,2019-03-28 22:30:00
70,1,1,0,0.006739946180752226,2019-03-28 22:15:00,2019-03-28 22:30:00
87,4,2,2,0.005692072178589071,2019-03-28 22:15:00,2019-03-28 22:30:00
88,1,1,0,0.004675347619270303,2019-03-28 22:15:00,2019-03-28 22:30:00
90,1,1,0,0.013119168521495438,2019-03-28 22:15:00,2019-03-28 22:30:00
109,6,1,5,0.006025788791221263,2019-03-28 22:15:00,2019-03-28 22:30:00
110,5,2,3,0.008408529243913183,2019-03-28 22:15:00,2019-03-28 22:30:00
112,5,3,2,0.034492795099441656,2019-03-28 22:15:00,2019-03-28 22:30:00
113,1,0,1,0.003643048338529342,2019-03-28 22:15:00,2019-03-28 22:30:00
114,1,0,1,0.003643048338529342,2019-03-28 22:15:00,2019-03-28 22:30:00
119,1,0,1,0.003643048338529342,2019-03-28 22:15:00,2019-03-28 22:30:00
126,3,1,2,0.0051914972596407835,2019-03-28 22:15:00,2019-03-28 22:30:00
127,1,0,1,0.003643048338529342,2019-03-28 22:15:00,2019-03-28 22:30:00
129,1,1,0,0.004675347619270303,2019-03-28 22:15:00,2019-03-28 22:30:00
135,2,1,1,0.02420954617913755,2019-03-28 22:15:00,2019-03-28 22:30:00
137,1,1,0,0.004675347619270303,2019-03-28 22:15:00,2019-03-28 22:30:00
138,3,0,3,0.003643048338529342,2019-03-28 22:15:00,2019-03-28 22:30:00
140,1,1,0,0.006533040521485456,2019-03-28 22:15:00,2019-03-28 22:30:00
151,1,1,0,0.006739946180752226,2019-03-28 22:15:00,2019-03-28 22:30:00
153,1,0,1,0.003643048338529342,2019-03-28 22:15:00,2019-03-28 22:30:00
157,1,0,1,0.003643048338529342,2019-03-28 22:15:00,2019-03-28 22:30:00
158,3,2,1,0.009836844022975109,2019-03-28 22:15:00,2019-03-28 22:30:00
164,3,3,0,0.01405432606321724,2019-03-28 22:15:00,2019-03-28 22:30:00
168,4,3,1,0.011146948209593128,2019-03-28 22:15:00,2019-03-28 22:30:00
172,3,2,1,0.044776044019745755,2019-03-28 22:15:00,2019-03-28 22:30:00
173,4,0,4,0.003643048338529342,2019-03-28 22:15:00,2019-03-28 22:30:00
189,1,1,0,0.006533040521485456,2019-03-28 22:15:00,2019-03-28 22:30:00
191,1,1,0,0.0051914972596407835,2019-03-28 22:15:00,2019-03-28 22:30:00
196,2,1,1,0.006308117708373851,2019-03-28 22:15:00,2019-03-28 22:30:00
197,4,2,2,0.009029520058010132,2019-03-28 22:15:00,2019-03-28 22:30:00
199,2,2,0,0.011265898406659506,2019-03-28 22:15:00,2019-03-28 22:30:00
1,2,2,0,0.006314193473680917,2019-03-28 22:30:00,2019-03-28 22:45:00
2,1,1,0,0.006314193473680917,2019-03-28 22:30:00,2019-03-28 22:45:00
10,3,2,1,0.03948251864609602,2019-03-28 22:30:00,2019-03-28 22:45:00
16,4,2,2,0.006661456176494626,2019-03-28 22:30:00,2019-03-28 22:45:00
18,5,4,1,0.07769734697731488,2019-03-28 22:30:00,2019-03-28 22:45:00
19,1,0,1,0.0034128749715633517,2019-03-28 22:30:00,2019-03-28 22:45:00
20,3,1,2,0.005936126550965234,2019-03-28 22:30:00,2019-03-28 22:45:00
26,2,1,1,0.004138204597092743,2019-03-28 22:30:00,2019-03-28 22:45:00
27,2,1,1,0.006314193473680917,2019-03-28 22:30:00,2019-03-28 22:45:00
30,1,1,0,0.006314193473680917,2019-03-28 22:30:00,2019-03-28 22:45:00
37,1,1,0,0.00624444119971941,2019-03-28 22:30:00,2019-03-28 22:45:00
50,2,1,1,0.004863534222622134,2019-03-28 22:30:00,2019-03-28 22:45:00
57,2,0,2,0.0034128749715633517,2019-03-28 22:30:00,2019-03-28 22:45:00
58,2,1,1,0.005274620420961036,2019-03-28 22:30:00,2019-03-28 22:45:00
62,2,2,0,0.008998111319756403,2019-03-28 22:30:00,2019-03-28 22:45:00
66,1,1,0,0.004863534222622134,2019-03-28 22:30:00,2019-03-28 22:45:00
70,2,1,1,0.004379981138935873,2019-03-28 22:30:00,2019-03-28 22:45:00
88,1,1,0,0.0071363658703587195,2019-03-28 22:30:00,2019-03-28 22:45:00
109,4,0,4,0.0034128749715633517,2019-03-28 22:30:00,2019-03-28 22:45:00
110,6,3,3,0.022709322598530625,2019-03-28 22:30:00,2019-03-28 22:45:00
112,4,2,2,0.022709322598530625,2019-03-28 22:30:00,2019-03-28 22:45:00
119,1,0,1,0.0034128749715633517,2019-03-28 22:30:00,2019-03-28 22:45:00
126,2,0,2,0.0034128749715633517,2019-03-28 22:30:00,2019-03-28 22:45:00
127,3,1,2,0.005936126550965234,2019-03-28 22:30:00,2019-03-28 22:45:00
135,2,1,1,0.022709322598530625,2019-03-28 22:30:00,2019-03-28 22:45:00
137,6,2,4,0.005936126550965234,2019-03-28 22:30:00,2019-03-28 22:45:00
138,2,1,1,0.004379981138935873,2019-03-28 22:30:00,2019-03-28 22:45:00
140,1,1,0,0.004674500761264293,2019-03-28 22:30:00,2019-03-28 22:45:00
141,1,0,1,0.0034128749715633517,2019-03-28 22:30:00,2019-03-28 22:45:00
151,1,1,0,0.006930822771189269,2019-03-28 22:30:00,2019-03-28 22:45:00
153,3,0,3,0.0034128749715633517,2019-03-28 22:30:00,2019-03-28 22:45:00
157,2,0,2,0.0034128749715633517,2019-03-28 22:30:00,2019-03-28 22:45:00
158,2,1,1,0.006314193473680917,2019-03-28 22:30:00,2019-03-28 22:45:00
164,3,3,0,0.010231369914773109,2019-03-28 22:30:00,2019-03-28 22:45:00
168,1,1,0,0.007896945238139672,2019-03-28 22:30:00,2019-03-28 22:45:00
172,2,1,1,0.022709322598530625,2019-03-28 22:30:00,2019-03-28 22:45:00
173,1,0,1,0.0034128749715633517,2019-03-28 22:30:00,2019-03-28 22:45:00
189,1,1,0,0.00624444119971941,2019-03-28 22:30:00,2019-03-28 22:45:00
196,3,1,2,0.004379981138935873,2019-03-28 22:30:00,2019-03-28 22:45:00
197,3,2,1,0.05020333478792274,2019-03-28 22:30:00,2019-03-28 22:45:00
203,1,1,0,0.004674500761264293,2019-03-28 22:30:00,2019-03-28 22:45:00
1,2,2,0,0.006168641524772748,2019-03-28 22:45:00,2019-03-28 23:00:00
10,2,1,1,0.022190639034920717,2019-03-28 22:45:00,2019-03-28 23:00:00
15,1,1,0,0.004751425722091194,2019-03-28 22:45:00,2019-03-28 23:00:00
16,6,5,1,0.055594851914212234,2019-03-28 22:45:00,2019-03-28 23:00:00
18,3,2,1,0.008790678455532582,2019-03-28 22:45:00,2019-03-28 23:00:00
19,2,0,2,0.0033342099194096416,2019-03-28 22:45:00,2019-03-28 23:00:00
20,3,1,2,0.005799281395651392,2019-03-28 22:45:00,2019-03-28 23:00:00
23,2,2,0,0.004652640336503069,2019-03-28 22:45:00,2019-03-28 23:00:00
26,2,1,1,0.004279020454530677,2019-03-28 22:45:00,2019-03-28 23:00:00
27,2,1,1,0.004751425722091194,2019-03-28 22:45:00,2019-03-28 23:00:00
28,3,2,1,0.006877249426113524,2019-03-28 22:45:00,2019-03-28 23:00:00
37,1,0,1,0.0033342099194096416,2019-03-28 22:45:00,2019-03-28 23:00:00
41,1,1,0,0.004751425722091194,2019-03-28 22:45:00,2019-03-28 23:00:00
46,1,1,0,0.006168641524772748,2019-03-28 22:45:00,2019-03-28 23:00:00
50,1,1,0,0.005052631004110765,2019-03-28 22:45:00,2019-03-28 23:00:00
57,2,2,0,0.006877249426113524,2019-03-28 22:45:00,2019-03-28 23:00:00
58,2,1,1,0.004042817820750418,2019-03-28 22:45:00,2019-03-28 23:00:00
61,5,3,2,0.061074565038116736,2019-03-28 22:45:00,2019-03-28 23:00:00
62,3,2,1,0.008794741528769547,2019-03-28 22:45:00,2019-03-28 23:00:00
66,1,1,0,0.005052631004110765,2019-03-28 22:45:00,2019-03-28 23:00:00
70,2,1,1,0.005311855545049782,2019-03-28 22:45:00,2019-03-28 23:00:00
88,1,1,0,0.007849930993648512,2019-03-28 22:45:00,2019-03-28 23:00:00
109,3,0,3,0.0033342099194096416,2019-03-28 22:45:00,2019-03-28 23:00:00
110,5,3,2,0.07188624204264943,2019-03-28 22:45:00,2019-03-28 23:00:00
112,8,2,6,0.004652640336503069,2019-03-28 22:45:00,2019-03-28 23:00:00
115,1,0,1,0.0033342099194096416,2019-03-28 22:45:00,2019-03-28 23:00:00
118,1,0,1,0.0033342099194096416,2019-03-28 22:45:00,2019-03-28 23:00:00
119,1,0,1,0.0033342099194096416,2019-03-28 22:45:00,2019-03-28 23:00:00
120,1,1,0,0.004186926065024277,2019-03-28 22:45:00,2019-03-28 23:00:00
126,2,0,2,0.0033342099194096416,2019-03-28 22:45:00,2019-03-28 23:00:00
127,3,0,3,0.0033342099194096416,2019-03-28 22:45:00,2019-03-28 23:00:00
135,1,1,0,0.004279020454530677,2019-03-28 22:45:00,2019-03-28 23:00:00
137,9,2,7,0.007021357670387383,2019-03-28 22:45:00,2019-03-28 23:00:00
138,2,1,1,0.005311855545049782,2019-03-28 22:45:00,2019-03-28 23:00:00
140,1,1,0,0.004186926065024277,2019-03-28 22:45:00,2019-03-28 23:00:00
151,1,1,0,0.0069718556101582676,2019-03-28 22:45:00,2019-03-28 23:00:00
153,4,2,2,0.004652640336503069,2019-03-28 22:45:00,2019-03-28 23:00:00
154,1,0,1,0.0033342099194096416,2019-03-28 22:45:00,2019-03-28 23:00:00
157,3,1,2,0.004042817820750418,2019-03-28 22:45:00,2019-03-28 23:00:00
158,1,1,0,0.006168641524772748,2019-03-28 22:45:00,2019-03-28 23:00:00
164,2,2,0,0.005223830989651712,2019-03-28 22:45:00,2019-03-28 23:00:00
168,1,1,0,0.006771052088811888,2019-03-28 22:45:00,2019-03-28 23:00:00
172,2,1,1,0.022190639034920717,2019-03-28 22:45:00,2019-03-28 23:00:00
177,1,1,0,0.010810902888707279,2019-03-28 22:45:00,2019-03-28 23:00:00
189,2,0,2,0.0033342099194096416,2019-03-28 22:45:00,2019-03-28 23:00:00
196,4,0,4,0.0033342099194096416,2019-03-28 22:45:00,2019-03-28 23:00:00
197,3,2,1,0.028476115406757735,2019-03-28 22:45:00,2019-03-28 23:00:00
203,1,1,0,0.004186926065024277,2019-03-28 22:45:00,2019-03-28 23:00:00
1,2,2,0,0.008937973355710425,2019-03-28 23:00:00,2019-03-28 23:15:00
10,2,1,1,0.02397184049379096,2019-03-28 23:00:00,2019-03-28 23:15:00
15,1,1,0,0.004372456798329615,2019-03-28 23:00:00,2019-03-28 23:15:00
16,5,5,0,0.006671576848045024,2019-03-28 23:00:00,2019-03-28 23:15:00
18,8,5,3,0.0101828718522721,2019-03-28 23:00:00,2019-03-28 23:15:00
20,4,2,2,0.02397184049379096,2019-03-28 23:00:00,2019-03-28 23:15:00
23,4,2,2,0.005031972899801883,2019-03-28 23:00:00,2019-03-28 23:15:00
26,1,1,0,0.004627914581631328,2019-03-28 23:00:00,2019-03-28 23:15:00
28,3,2,1,0.007693407981251873,2019-03-28 23:00:00,2019-03-28 23:15:00
41,3,1,2,0.006272028402067452,2019-03-28 23:00:00,2019-03-28 23:15:00
46,2,2,0,0.010729375035380911,2019-03-28 23:00:00,2019-03-28 23:15:00
57,3,3,0,0.011678992810033366,2019-03-28 23:00:00,2019-03-28 23:15:00
58,4,3,1,0.01343489478451417,2019-03-28 23:00:00,2019-03-28 23:15:00
61,4,2,2,0.02397184049379096,2019-03-28 23:00:00,2019-03-28 23:15:00
62,2,2,0,0.007693407981251873,2019-03-28 23:00:00,2019-03-28 23:15:00
70,1,0,1,0.003606083448424479,2019-03-28 23:00:00,2019-03-28 23:15:00
88,1,1,0,0.006671576848045025,2019-03-28 23:00:00,2019-03-28 23:15:00
90,4,0,4,0.003606083448424479,2019-03-28 23:00:00,2019-03-28 23:15:00
109,3,0,3,0.003606083448424479,2019-03-28 23:00:00,2019-03-28 23:15:00
110,1,1,0,0.006491590022801381,2019-03-28 23:00:00,2019-03-28 23:15:00
111,4,2,2,0.005138830148234751,2019-03-28 23:00:00,2019-03-28 23:15:00
112,8,2,6,0.005031972899801883,2019-03-28 23:00:00,2019-03-28 23:15:00
118,1,0,1,0.003606083448424479,2019-03-28 23:00:00,2019-03-28 23:15:00
119,1,0,1,0.003606083448424479,2019-03-28 23:00:00,2019-03-28 23:15:00
120,1,1,0,0.004116999015027903,2019-03-28 23:00:00,2019-03-28 23:15:00
126,3,1,2,0.006272028402067452,2019-03-28 23:00:00,2019-03-28 23:15:00
127,3,0,3,0.003606083448424479,2019-03-28 23:00:00,2019-03-28 23:15:00
135,1,1,0,0.004627914581631328,2019-03-28 23:00:00,2019-03-28 23:15:00
137,6,0,6,0.003606083448424479,2019-03-28 23:00:00,2019-03-28 23:15:00
138,1,0,1,0.003606083448424479,2019-03-28 23:00:00,2019-03-28 23:15:00
147,2,1,1,0.02397184049379096,2019-03-28 23:00:00,2019-03-28 23:15:00
153,2,2,0,0.005031972899801883,2019-03-28 23:00:00,2019-03-28 23:15:00
154,1,0,1,0.003606083448424479,2019-03-28 23:00:00,2019-03-28 23:15:00
157,1,1,0,0.004627914581631328,2019-03-28 23:00:00,2019-03-28 23:15:00
158,4,3,1,0.011040071220982346,2019-03-28 23:00:00,2019-03-28 23:15:00
164,8,4,4,0.019092763502917654,2019-03-28 23:00:00,2019-03-28 23:15:00
168,1,1,0,0.01502741235434899,2019-03-28 23:00:00,2019-03-28 23:15:00
171,1,1,0,0.007663881635760365,2019-03-28 23:00:00,2019-03-28 23:15:00
172,2,1,1,0.02397184049379096,2019-03-28 23:00:00,2019-03-28 23:15:00
189,4,0,4,0.003606083448424479,2019-03-28 23:00:00,2019-03-28 23:15:00
196,3,0,3,0.003606083448424479,2019-03-28 23:00:00,2019-03-28 23:15:00
197,3,2,1,0.03076042617557979,2019-03-28 23:00:00,2019-03-28 23:15:00
203,3,2,1,0.027366133334685374,2019-03-28 23:00:00,2019-03-28 23:15:00
1,4,4,0,0.010830593182744366,2019-03-28 23:15:00,2019-03-28 23:30:00
10,2,1,1,0.022536854981749486,2019-03-28 23:15:00,2019-03-28 23:30:00
15,1,0,1,0.003386396970960177,2019-03-28 23:15:00,2019-03-28 23:30:00
16,6,4,2,0.014463932633407325,2019-03-28 23:15:00,2019-03-28 23:30:00
18,4,2,2,0.005437096521780602,2019-03-28 23:15:00,2019-03-28 23:30:00
20,7,4,3,0.018485728844738106,2019-03-28 23:15:00,2019-03-28 23:30:00
28,4,1,3,0.004300315942627633,2019-03-28 23:15:00,2019-03-28 23:30:00
41,3,1,2,0.0058899364479623306,2019-03-28 23:15:00,2019-03-28 23:30:00
46,4,2,2,0.007703323009264846,2019-03-28 23:15:00,2019-03-28 23:30:00
57,2,2,0,0.007483693315752376,2019-03-28 23:15:00,2019-03-28 23:30:00
58,2,1,1,0.004824585293362587,2019-03-28 23:15:00,2019-03-28 23:30:00
61,2,1,1,0.022536854981749486,2019-03-28 23:15:00,2019-03-28 23:30:00
62,5,1,4,0.004300315942627633,2019-03-28 23:15:00,2019-03-28 23:30:00
69,1,1,0,0.004825765828911307,2019-03-28 23:15:00,2019-03-28 23:30:00
88,1,1,0,0.004825765828911307,2019-03-28 23:15:00,2019-03-28 23:30:00
90,5,1,4,0.004824585293362587,2019-03-28 23:15:00,2019-03-28 23:30:00
104,2,1,1,0.022536854981749486,2019-03-28 23:15:00,2019-03-28 23:30:00
110,2,0,2,0.003386396970960177,2019-03-28 23:15:00,2019-03-28 23:30:00
112,4,2,2,0.022536854981749486,2019-03-28 23:15:00,2019-03-28 23:30:00
114,1,1,0,0.0062175669850778985,2019-03-28 23:15:00,2019-03-28 23:30:00
116,1,1,0,0.004300315942627633,2019-03-28 23:15:00,2019-03-28 23:30:00
118,1,0,1,0.003386396970960177,2019-03-28 23:15:00,2019-03-28 23:30:00
119,1,0,1,0.003386396970960177,2019-03-28 23:15:00,2019-03-28 23:30:00
120,3,2,1,0.06339721694136807,2019-03-28 23:15:00,2019-03-28 23:30:00
122,1,1,0,0.004824585293362587,2019-03-28 23:15:00,2019-03-28 23:30:00
126,3,1,2,0.0058899364479623306,2019-03-28 23:15:00,2019-03-28 23:30:00
127,1,0,1,0.003386396970960177,2019-03-28 23:15:00,2019-03-28 23:30:00
137,1,0,1,0.003386396970960177,2019-03-28 23:15:00,2019-03-28 23:30:00
138,1,1,0,0.008625014923118823,2019-03-28 23:15:00,2019-03-28 23:30:00
147,2,1,1,0.022536854981749486,2019-03-28 23:15:00,2019-03-28 23:30:00
153,3,1,2,0.006660717879392602,2019-03-28 23:15:00,2019-03-28 23:30:00
158,2,1,1,0.006265134686862435,2019-03-28 23:15:00,2019-03-28 23:30:00
162,1,1,0,0.0062175669850778985,2019-03-28 23:15:00,2019-03-28 23:30:00
164,8,2,6,0.010150565724488846,2019-03-28 23:15:00,2019-03-28 23:30:00
168,1,1,0,0.007487796072601027,2019-03-28 23:15:00,2019-03-28 23:30:00
171,2,2,0,0.008098906201795012,2019-03-28 23:15:00,2019-03-28 23:30:00
172,2,1,1,0.022536854981749486,2019-03-28 23:15:00,2019-03-28 23:30:00
177,1,1,0,0.004300315942627633,2019-03-28 23:15:00,2019-03-28 23:30:00
197,3,2,1,0.04168731299253879,2019-03-28 23:15:00,2019-03-28 23:30:00
1,4,2,2,0.006636690256661236,2019-03-28 23:30:00,2019-03-28 23:45:00
2,1,1,0,0.006636690256661236,2019-03-28 23:30:00,2019-03-28 23:45:00
10,2,1,1,0.023819667711446953,2019-03-28 23:30:00,2019-03-28 23:45:00
15,1,0,1,0.003587228179984245,2019-03-28 23:30:00,2019-03-28 23:45:00
16,5,3,2,0.010550274906090323,2019-03-28 23:30:00,2019-03-28 23:45:00
18,4,1,3,0.00500565910302346,2019-03-28 23:30:00,2019-03-28 23:45:00
20,6,4,2,0.01647747316821425,2019-03-28 23:30:00,2019-03-28 23:45:00
28,1,1,0,0.004555346037177838,2019-03-28 23:30:00,2019-03-28 23:45:00
40,1,0,1,0.003587228179984245,2019-03-28 23:30:00,2019-03-28 23:45:00
41,1,0,1,0.003587228179984245,2019-03-28 23:30:00,2019-03-28 23:45:00
46,3,1,2,0.020270328013263974,2019-03-28 23:30:00,2019-03-28 23:45:00
57,1,1,0,0.0064081430774508815,2019-03-28 23:30:00,2019-03-28 23:45:00
58,1,0,1,0.003587228179984245,2019-03-28 23:30:00,2019-03-28 23:45:00
61,2,1,1,0.023819667711446953,2019-03-28 23:30:00,2019-03-28 23:45:00
62,5,1,4,0.004555346037177838,2019-03-28 23:30:00,2019-03-28 23:45:00
68,2,1,1,0.006636690256661236,2019-03-28 23:30:00,2019-03-28 23:45:00
69,1,1,0,0.005111959218322741,2019-03-28 23:30:00,2019-03-28 23:45:00
88,1,1,0,0.005111959218322741,2019-03-28 23:30:00,2019-03-28 23:45:00
89,1,1,0,0.006636690256661236,2019-03-28 23:30:00,2019-03-28 23:45:00
90,3,1,2,0.004603715538876576,2019-03-28 23:30:00,2019-03-28 23:45:00
109,2,2,0,0.012556040744219052,2019-03-28 23:30:00,2019-03-28 23:45:00
110,2,0,2,0.003587228179984245,2019-03-28 23:30:00,2019-03-28 23:45:00
112,4,2,2,0.023819667711446953,2019-03-28 23:30:00,2019-03-28 23:45:00
114,1,0,1,0.003587228179984245,2019-03-28 23:30:00,2019-03-28 23:45:00
116,1,1,0,0.004555346037177838,2019-03-28 23:30:00,2019-03-28 23:45:00
118,2,1,1,0.019623220799170716,2019-03-28 23:30:00,2019-03-28 23:45:00
119,1,0,1,0.003587228179984245,2019-03-28 23:30:00,2019-03-28 23:45:00
120,1,0,1,0.003587228179984245,2019-03-28 23:30:00,2019-03-28 23:45:00
122,1,1,0,0.004603715538876576,2019-03-28 23:30:00,2019-03-28 23:45:00
126,2,0,2,0.003587228179984245,2019-03-28 23:30:00,2019-03-28 23:45:00
140,1,1,0,0.006636690256661236,2019-03-28 23:30:00,2019-03-28 23:45:00
141,1,0,1,0.003587228179984245,2019-03-28 23:30:00,2019-03-28 23:45:00
147,2,1,1,0.023819667711446953,2019-03-28 23:30:00,2019-03-28 23:45:00
153,2,1,1,0.012204042297209523,2019-03-28 23:30:00,2019-03-28 23:45:00
158,1,1,0,0.006636690256661236,2019-03-28 23:30:00,2019-03-28 23:45:00
162,1,1,0,0.013962885355026582,2019-03-28 23:30:00,2019-03-28 23:45:00
164,3,0,3,0.003587228179984245,2019-03-28 23:30:00,2019-03-28 23:45:00
168,1,1,0,0.006636690256661236,2019-03-28 23:30:00,2019-03-28 23:45:00
171,4,3,1,0.018862359451035128,2019-03-28 23:30:00,2019-03-28 23:45:00
172,2,1,1,0.023819667711446953,2019-03-28 23:30:00,2019-03-28 23:45:00
177,1,1,0,0.004555346037177838,2019-03-28 23:30:00,2019-03-28 23:45:00
190,1,1,0,0.010591149245458831,2019-03-28 23:30:00,2019-03-28 23:45:00
196,1,0,1,0.003587228179984245,2019-03-28 23:30:00,2019-03-28 23:45:00
197,2,1,1,0.023819667711446953,2019-03-28 23:30:00,2019-03-28 23:45:00
199,1,1,0,0.0064081430774508815,2019-03-28 23:30:00,2019-03-28 23:45:00
203,1,1,0,0.006636690256661236,2019-03-28 23:30:00,2019-03-28 23:45:00
1,5,3,2,0.011113101365236154,2019-03-28 23:45:00,2019-03-29 00:00:00
2,2,2,0,0.009325169558066691,2019-03-28 23:45:00,2019-03-29 00:00:00
10,3,1,2,0.006006721611697534,2019-03-28 23:45:00,2019-03-29 00:00:00
16,3,1,2,0.008885129120129103,2019-03-28 23:45:00,2019-03-29 00:00:00
18,3,2,1,0.03995374763509027,2019-03-28 23:45:00,2019-03-29 00:00:00
20,3,1,2,0.006006721611697534,2019-03-28 23:45:00,2019-03-29 00:00:00
23,1,0,1,0.003453531734928225,2019-03-28 23:45:00,2019-03-29 00:00:00
27,1,1,0,0.006389350646497458,2019-03-28 23:45:00,2019-03-29 00:00:00
28,1,0,1,0.003453531734928225,2019-03-28 23:45:00,2019-03-29 00:00:00
35,1,1,0,0.006389350646497458,2019-03-28 23:45:00,2019-03-29 00:00:00
46,2,1,1,0.008885129120129103,2019-03-28 23:45:00,2019-03-29 00:00:00
57,2,2,0,0.011113101365236154,2019-03-28 23:45:00,2019-03-29 00:00:00
58,1,0,1,0.003453531734928225,2019-03-28 23:45:00,2019-03-29 00:00:00
61,1,1,0,0.006389350646497458,2019-03-28 23:45:00,2019-03-29 00:00:00
62,1,0,1,0.003453531734928225,2019-03-28 23:45:00,2019-03-29 00:00:00
68,1,1,0,0.006389350646497458,2019-03-28 23:45:00,2019-03-29 00:00:00
69,2,2,0,0.008942540523266767,2019-03-28 23:45:00,2019-03-29 00:00:00
86,3,1,2,0.006006721611697534,2019-03-28 23:45:00,2019-03-29 00:00:00
87,1,0,1,0.003453531734928225,2019-03-28 23:45:00,2019-03-29 00:00:00
90,2,1,1,0.006389350646497458,2019-03-28 23:45:00,2019-03-29 00:00:00
104,1,0,1,0.003453531734928225,2019-03-28 23:45:00,2019-03-29 00:00:00
109,4,3,1,0.07319292699202082,2019-03-28 23:45:00,2019-03-29 00:00:00
110,1,0,1,0.003453531734928225,2019-03-28 23:45:00,2019-03-29 00:00:00
112,5,3,2,0.05909782148875603,2019-03-28 23:45:00,2019-03-29 00:00:00
114,1,0,1,0.003453531734928225,2019-03-28 23:45:00,2019-03-29 00:00:00
118,2,1,1,0.006389350646497458,2019-03-28 23:45:00,2019-03-29 00:00:00
119,1,0,1,0.003453531734928225,2019-03-28 23:45:00,2019-03-29 00:00:00
126,2,0,2,0.003453531734928225,2019-03-28 23:45:00,2019-03-29 00:00:00
133,1,1,0,0.006389350646497458,2019-03-28 23:45:00,2019-03-29 00:00:00
135,1,0,1,0.003453531734928225,2019-03-28 23:45:00,2019-03-29 00:00:00
153,2,1,1,0.011006889437748708,2019-03-28 23:45:00,2019-03-29 00:00:00
158,2,1,1,0.006389350646497458,2019-03-28 23:45:00,2019-03-29 00:00:00
162,1,1,0,0.012810751330110398,2019-03-28 23:45:00,2019-03-29 00:00:00
164,1,0,1,0.003453531734928225,2019-03-28 23:45:00,2019-03-29 00:00:00
168,1,1,0,0.006389350646497458,2019-03-28 23:45:00,2019-03-29 00:00:00
172,2,1,1,0.022980234623393905,2019-03-28 23:45:00,2019-03-29 00:00:00
189,1,0,1,0.003453531734928225,2019-03-28 23:45:00,2019-03-29 00:00:00
190,1,1,0,0.006006721611697534,2019-03-28 23:45:00,2019-03-29 00:00:00
196,1,0,1,0.003453531734928225,2019-03-28 23:45:00,2019-03-29 00:00:00
197,2,1,1,0.022980234623393905,2019-03-28 23:45:00,2019-03-29 00:00:00
1,2,2,0,0.00673286839381367,2019-03-29 00:00:00,2019-03-29 00:15:00
2,2,2,0,0.00982653460863368,2019-03-29 00:00:00,2019-03-29 00:15:00
10,3,1,2,0.006329675820986452,2019-03-29 00:00:00,2019-03-29 00:15:00
16,4,3,1,0.029248873748590254,2019-03-29 00:00:00,2019-03-29 00:15:00
18,1,1,0,0.006329675820986452,2019-03-29 00:00:00,2019-03-29 00:15:00
20,2,1,1,0.024212699012375983,2019-03-29 00:00:00,2019-03-29 00:15:00
23,1,0,1,0.0036392021789936604,2019-03-29 00:00:00,2019-03-29 00:15:00
35,1,1,0,0.00673286839381367,2019-03-29 00:00:00,2019-03-29 00:15:00
46,1,1,0,0.009362845289646237,2019-03-29 00:00:00,2019-03-29 00:15:00
57,2,2,0,0.00982653460863368,2019-03-29 00:00:00,2019-03-29 00:15:00
58,1,0,1,0.0036392021789936604,2019-03-29 00:00:00,2019-03-29 00:15:00
62,1,0,1,0.0036392021789936604,2019-03-29 00:00:00,2019-03-29 00:15:00
90,1,0,1,0.0036392021789936604,2019-03-29 00:00:00,2019-03-29 00:15:00
104,1,1,0,0.00673286839381367,2019-03-29 00:00:00,2019-03-29 00:15:00
109,5,2,3,0.03975002110954404,2019-03-29 00:00:00,2019-03-29 00:15:00
110,4,2,2,0.024212699012375983,2019-03-29 00:00:00,2019-03-29 00:15:00
111,1,0,1,0.0036392021789936604,2019-03-29 00:00:00,2019-03-29 00:15:00
112,5,3,2,0.06226602646432062,2019-03-29 00:00:00,2019-03-29 00:15:00
113,3,0,3,0.0036392021789936604,2019-03-29 00:00:00,2019-03-29 00:15:00
114,1,1,0,0.00673286839381367,2019-03-29 00:00:00,2019-03-29 00:15:00
116,1,1,0,0.00467042425060033,2019-03-29 00:00:00,2019-03-29 00:15:00
118,2,1,1,0.00673286839381367,2019-03-29 00:00:00,2019-03-29 00:15:00
119,1,0,1,0.0036392021789936604,2019-03-29 00:00:00,2019-03-29 00:15:00
126,2,0,2,0.0036392021789936604,2019-03-29 00:00:00,2019-03-29 00:15:00
135,1,0,1,0.0036392021789936604,2019-03-29 00:00:00,2019-03-29 00:15:00
151,1,0,1,0.0036392021789936604,2019-03-29 00:00:00,2019-03-29 00:15:00
153,2,2,0,0.005701646322207,2019-03-29 00:00:00,2019-03-29 00:15:00
154,1,0,1,0.0036392021789936604,2019-03-29 00:00:00,2019-03-29 00:15:00
158,2,1,1,0.00673286839381367,2019-03-29 00:00:00,2019-03-29 00:15:00
168,1,1,0,0.00673286839381367,2019-03-29 00:00:00,2019-03-29 00:15:00
172,2,1,1,0.024212699012375983,2019-03-29 00:00:00,2019-03-29 00:15:00
173,1,0,1,0.0036392021789936604,2019-03-29 00:00:00,2019-03-29 00:15:00
189,1,0,1,0.0036392021789936604,2019-03-29 00:00:00,2019-03-29 00:15:00
196,1,0,1,0.0036392021789936604,2019-03-29 00:00:00,2019-03-29 00:15:00
197,2,1,1,0.024212699012375983,2019-03-29 00:00:00,2019-03-29 00:15:00
200,1,1,0,0.00673286839381367,2019-03-29 00:00:00,2019-03-29 00:15:00
1,2,2,0,0.006392776530597081,2019-03-29 00:15:00,2019-03-29 00:30:00
2,2,1,1,0.006392776530597081,2019-03-29 00:15:00,2019-03-29 00:30:00
10,2,1,1,0.022994266085558723,2019-03-29 00:15:00,2019-03-29 00:30:00
16,6,4,2,0.05310749391020196,2019-03-29 00:15:00,2019-03-29 00:30:00
20,2,1,1,0.022994266085558723,2019-03-29 00:15:00,2019-03-29 00:30:00
41,1,0,1,0.00345535113438768,2019-03-29 00:15:00,2019-03-29 00:30:00
46,1,1,0,0.004924063832492381,2019-03-29 00:15:00,2019-03-29 00:30:00
57,2,1,1,0.006392776530597081,2019-03-29 00:15:00,2019-03-29 00:30:00
58,1,0,1,0.00345535113438768,2019-03-29 00:15:00,2019-03-29 00:30:00
68,1,0,1,0.00345535113438768,2019-03-29 00:15:00,2019-03-29 00:30:00
89,1,1,0,0.008889987923714879,2019-03-29 00:15:00,2019-03-29 00:30:00
90,3,2,1,0.04856035771821921,2019-03-29 00:15:00,2019-03-29 00:30:00
109,2,0,2,0.00345535113438768,2019-03-29 00:15:00,2019-03-29 00:30:00
110,4,2,2,0.022994266085558723,2019-03-29 00:15:00,2019-03-29 00:30:00
111,1,0,1,0.00345535113438768,2019-03-29 00:15:00,2019-03-29 00:30:00
112,4,2,2,0.022994266085558723,2019-03-29 00:15:00,2019-03-29 00:30:00
113,3,0,3,0.00345535113438768,2019-03-29 00:15:00,2019-03-29 00:30:00
116,1,1,0,0.004434492933124147,2019-03-29 00:15:00,2019-03-29 00:30:00
118,2,0,2,0.00345535113438768,2019-03-29 00:15:00,2019-03-29 00:30:00
119,1,0,1,0.00345535113438768,2019-03-29 00:15:00,2019-03-29 00:30:00
120,1,1,0,0.008889987923714879,2019-03-29 00:15:00,2019-03-29 00:30:00
122,1,1,0,0.006392776530597081,2019-03-29 00:15:00,2019-03-29 00:30:00
126,2,0,2,0.00345535113438768,2019-03-29 00:15:00,2019-03-29 00:30:00
135,1,1,0,0.006392776530597081,2019-03-29 00:15:00,2019-03-29 00:30:00
140,2,1,1,0.006392776530597081,2019-03-29 00:15:00,2019-03-29 00:30:00
141,1,0,1,0.00345535113438768,2019-03-29 00:15:00,2019-03-29 00:30:00
151,1,0,1,0.00345535113438768,2019-03-29 00:15:00,2019-03-29 00:30:00
153,4,3,1,0.036020209386339416,2019-03-29 00:15:00,2019-03-29 00:30:00
154,1,0,1,0.00345535113438768,2019-03-29 00:15:00,2019-03-29 00:30:00
158,1,1,0,0.006392776530597081,2019-03-29 00:15:00,2019-03-29 00:30:00
168,2,2,0,0.009330201926806482,2019-03-29 00:15:00,2019-03-29 00:30:00
170,1,1,0,0.006392776530597081,2019-03-29 00:15:00,2019-03-29 00:30:00
171,1,1,0,0.004924063832492381,2019-03-29 00:15:00,2019-03-29 00:30:00
172,2,1,1,0.022994266085558723,2019-03-29 00:15:00,2019-03-29 00:30:00
189,1,0,1,0.00345535113438768,2019-03-29 00:15:00,2019-03-29 00:30:00
197,2,1,1,0.022994266085558723,2019-03-29 00:15:00,2019-03-29 00:30:00
200,1,1,0,0.006392776530597081,2019-03-29 00:15:00,2019-03-29 00:30:00
203,1,0,1,0.00345535113438768,2019-03-29 00:15:00,2019-03-29 00:30:00
1,2,2,0,0.00979324775227607,2019-03-29 00:30:00,2019-03-29 00:45:00
2,2,1,1,0.007042419242781034,2019-03-29 00:30:00,2019-03-29 00:45:00
10,2,1,1,0.025293322859589764,2019-03-29 00:30:00,2019-03-29 00:45:00
15,1,0,1,0.0038065390226324643,2019-03-29 00:30:00,2019-03-29 00:45:00
16,7,1,6,0.004434878173265628,2019-03-29 00:30:00,2019-03-29 00:45:00
20,2,1,1,0.025293322859589764,2019-03-29 00:30:00,2019-03-29 00:45:00
28,1,1,0,0.006799893387454267,2019-03-29 00:30:00,2019-03-29 00:45:00
41,1,0,1,0.0038065390226324643,2019-03-29 00:30:00,2019-03-29 00:45:00
46,1,1,0,0.007042419242781034,2019-03-29 00:30:00,2019-03-29 00:45:00
57,2,0,2,0.0038065390226324643,2019-03-29 00:30:00,2019-03-29 00:45:00
58,2,1,1,0.0054244791327067495,2019-03-29 00:30:00,2019-03-29 00:45:00
62,1,0,1,0.0038065390226324643,2019-03-29 00:30:00,2019-03-29 00:45:00
68,1,0,1,0.0038065390226324643,2019-03-29 00:30:00,2019-03-29 00:45:00
88,1,1,0,0.004434878173265628,2019-03-29 00:30:00,2019-03-29 00:45:00
90,3,3,0,0.013585477033630704,2019-03-29 00:30:00,2019-03-29 00:45:00
99,1,1,0,0.006799893387454267,2019-03-29 00:30:00,2019-03-29 00:45:00
110,7,4,3,0.030073647391888465,2019-03-29 00:30:00,2019-03-29 00:45:00
112,4,2,2,0.025293322859589764,2019-03-29 00:30:00,2019-03-29 00:45:00
113,1,0,1,0.0038065390226324643,2019-03-29 00:30:00,2019-03-29 00:45:00
118,1,0,1,0.0038065390226324643,2019-03-29 00:30:00,2019-03-29 00:45:00
119,1,0,1,0.0038065390226324643,2019-03-29 00:30:00,2019-03-29 00:45:00
120,1,1,0,0.0054244791327067495,2019-03-29 00:30:00,2019-03-29 00:45:00
122,1,1,0,0.007042419242781034,2019-03-29 00:30:00,2019-03-29 00:45:00
126,3,1,2,0.007042419242781034,2019-03-29 00:30:00,2019-03-29 00:45:00
135,1,1,0,0.007042419242781034,2019-03-29 00:30:00,2019-03-29 00:45:00
138,1,0,1,0.0038065390226324643,2019-03-29 00:30:00,2019-03-29 00:45:00
141,1,1,0,0.004434878173265628,2019-03-29 00:30:00,2019-03-29 00:45:00
151,1,0,1,0.0038065390226324643,2019-03-29 00:30:00,2019-03-29 00:45:00
153,3,2,1,0.04678010669654706,2019-03-29 00:30:00,2019-03-29 00:45:00
154,1,0,1,0.0038065390226324643,2019-03-29 00:30:00,2019-03-29 00:45:00
158,1,1,0,0.007042419242781034,2019-03-29 00:30:00,2019-03-29 00:45:00
168,2,2,0,0.011653713717677122,2019-03-29 00:30:00,2019-03-29 00:45:00
170,1,1,0,0.007042419242781034,2019-03-29 00:30:00,2019-03-29 00:45:00
172,2,1,1,0.025293322859589764,2019-03-29 00:30:00,2019-03-29 00:45:00
173,3,1,2,0.007042419242781034,2019-03-29 00:30:00,2019-03-29 00:45:00
189,1,0,1,0.0038065390226324643,2019-03-29 00:30:00,2019-03-29 00:45:00
200,1,1,0,0.007042419242781034,2019-03-29 00:30:00,2019-03-29 00:45:00
202,1,1,0,0.004434878173265628,2019-03-29 00:30:00,2019-03-29 00:45:00
203,1,0,1,0.0038065390226324643,2019-03-29 00:30:00,2019-03-29 00:45:00
1,2,2,0,0.006831164664458763,2019-03-29 00:45:00,2019-03-29 01:00:00
2,1,0,1,0.0037790840485257336,2019-03-29 00:45:00,2019-03-29 01:00:00
5,1,1,0,0.005385376086470963,2019-03-29 00:45:00,2019-03-29 01:00:00
10,2,1,1,0.02513383333551871,2019-03-29 00:45:00,2019-03-29 01:00:00
15,2,0,2,0.0037790840485257336,2019-03-29 00:45:00,2019-03-29 01:00:00
18,1,0,1,0.0037790840485257336,2019-03-29 00:45:00,2019-03-29 01:00:00
19,1,0,1,0.0037790840485257336,2019-03-29 00:45:00,2019-03-29 01:00:00
20,2,1,1,0.02513383333551871,2019-03-29 00:45:00,2019-03-29 01:00:00
46,1,1,0,0.006991668124416192,2019-03-29 00:45:00,2019-03-29 01:00:00
57,2,0,2,0.0037790840485257336,2019-03-29 00:45:00,2019-03-29 01:00:00
58,5,3,2,0.01020425220030665,2019-03-29 00:45:00,2019-03-29 01:00:00
62,2,0,2,0.0037790840485257336,2019-03-29 00:45:00,2019-03-29 01:00:00
69,1,0,1,0.0037790840485257336,2019-03-29 00:45:00,2019-03-29 01:00:00
70,1,1,0,0.0053051243564922485,2019-03-29 00:45:00,2019-03-29 01:00:00
99,1,1,0,0.008357204972425277,2019-03-29 00:45:00,2019-03-29 01:00:00
104,1,0,1,0.0037790840485257336,2019-03-29 00:45:00,2019-03-29 01:00:00
108,1,1,0,0.006991668124416192,2019-03-29 00:45:00,2019-03-29 01:00:00
110,6,4,2,0.09232550603014028,2019-03-29 00:45:00,2019-03-29 01:00:00
112,4,2,2,0.02513383333551871,2019-03-29 00:45:00,2019-03-29 01:00:00
116,1,1,0,0.006991668124416192,2019-03-29 00:45:00,2019-03-29 01:00:00
118,1,0,1,0.0037790840485257336,2019-03-29 00:45:00,2019-03-29 01:00:00
119,1,0,1,0.0037790840485257336,2019-03-29 00:45:00,2019-03-29 01:00:00
122,1,1,0,0.008357204972425277,2019-03-29 00:45:00,2019-03-29 01:00:00
126,4,1,3,0.005385376086470963,2019-03-29 00:45:00,2019-03-29 01:00:00
138,2,1,1,0.008116449782489134,2019-03-29 00:45:00,2019-03-29 01:00:00
153,1,1,0,0.006991668124416192,2019-03-29 00:45:00,2019-03-29 01:00:00
158,1,1,0,0.006991668124416192,2019-03-29 00:45:00,2019-03-29 01:00:00
168,1,1,0,0.008116449782489134,2019-03-29 00:45:00,2019-03-29 01:00:00
172,2,1,1,0.02513383333551871,2019-03-29 00:45:00,2019-03-29 01:00:00
173,2,1,1,0.005385376086470963,2019-03-29 00:45:00,2019-03-29 01:00:00
203,2,1,1,0.005385376086470963,2019-03-29 00:45:00,2019-03-29 01:00:00
1,2,2,0,0.006419416722720326,2019-03-29 01:00:00,2019-03-29 01:15:00
2,1,0,1,0.00409735376436645,2019-03-29 01:00:00,2019-03-29 01:15:00
5,1,1,0,0.007580448201897265,2019-03-29 01:00:00,2019-03-29 01:15:00
10,2,1,1,0.02721733002667715,2019-03-29 01:00:00,2019-03-29 01:15:00
11,2,1,1,0.02721733002667715,2019-03-29 01:00:00,2019-03-29 01:15:00
15,1,0,1,0.00409735376436645,2019-03-29 01:00:00,2019-03-29 01:15:00
16,1,0,1,0.00409735376436645,2019-03-29 01:00:00,2019-03-29 01:15:00
18,1,0,1,0.00409735376436645,2019-03-29 01:00:00,2019-03-29 01:15:00
19,1,1,0,0.007580448201897265,2019-03-29 01:00:00,2019-03-29 01:15:00
20,2,1,1,0.02721733002667715,2019-03-29 01:00:00,2019-03-29 01:15:00
46,1,1,0,0.007580448201897265,2019-03-29 01:00:00,2019-03-29 01:15:00
58,2,0,2,0.00409735376436645,2019-03-29 01:00:00,2019-03-29 01:15:00
62,1,0,1,0.00409735376436645,2019-03-29 01:00:00,2019-03-29 01:15:00
68,1,0,1,0.00409735376436645,2019-03-29 01:00:00,2019-03-29 01:15:00
69,1,0,1,0.00409735376436645,2019-03-29 01:00:00,2019-03-29 01:15:00
70,1,1,0,0.005258385243543388,2019-03-29 01:00:00,2019-03-29 01:15:00
108,1,1,0,0.007580448201897265,2019-03-29 01:00:00,2019-03-29 01:15:00
110,1,1,0,0.007580448201897265,2019-03-29 01:00:00,2019-03-29 01:15:00
111,1,1,0,0.007580448201897265,2019-03-29 01:00:00,2019-03-29 01:15:00
112,4,2,2,0.02721733002667715,2019-03-29 01:00:00,2019-03-29 01:15:00
118,1,0,1,0.00409735376436645,2019-03-29 01:00:00,2019-03-29 01:15:00
126,3,0,3,0.00409735376436645,2019-03-29 01:00:00,2019-03-29 01:15:00
138,1,1,0,0.005838900983131857,2019-03-29 01:00:00,2019-03-29 01:15:00
141,7,3,4,0.01130609322788056,2019-03-29 01:00:00,2019-03-29 01:15:00
153,1,1,0,0.007580448201897265,2019-03-29 01:00:00,2019-03-29 01:15:00
168,1,1,0,0.005838900983131857,2019-03-29 01:00:00,2019-03-29 01:15:00
170,1,1,0,0.006500266918871154,2019-03-29 01:00:00,2019-03-29 01:15:00
172,2,1,1,0.02721733002667715,2019-03-29 01:00:00,2019-03-29 01:15:00
203,1,1,0,0.007580448201897265,2019-03-29 01:00:00,2019-03-29 01:15:00
1,2,2,0,0.007661137019842945,2019-03-29 01:15:00,2019-03-29 01:30:00
2,1,0,1,0.004140964905554188,2019-03-29 01:15:00,2019-03-29 01:30:00
10,2,1,1,0.027507462998648497,2019-03-29 01:15:00,2019-03-29 01:30:00
11,2,1,1,0.027507462998648497,2019-03-29 01:15:00,2019-03-29 01:30:00
16,1,0,1,0.004140964905554188,2019-03-29 01:15:00,2019-03-29 01:30:00
18,2,2,0,0.01010446781248671,2019-03-29 01:15:00,2019-03-29 01:30:00
20,2,1,1,0.027507462998648497,2019-03-29 01:15:00,2019-03-29 01:30:00
46,1,1,0,0.007661137019842945,2019-03-29 01:15:00,2019-03-29 01:30:00
58,1,0,1,0.004140964905554188,2019-03-29 01:15:00,2019-03-29 01:30:00
109,1,0,1,0.004140964905554188,2019-03-29 01:15:00,2019-03-29 01:30:00
110,1,1,0,0.007661137019842945,2019-03-29 01:15:00,2019-03-29 01:30:00
111,1,1,0,0.007661137019842945,2019-03-29 01:15:00,2019-03-29 01:30:00
112,4,2,2,0.027507462998648497,2019-03-29 01:15:00,2019-03-29 01:30:00
118,1,0,1,0.004140964905554188,2019-03-29 01:15:00,2019-03-29 01:30:00
126,2,0,2,0.004140964905554188,2019-03-29 01:15:00,2019-03-29 01:30:00
141,8,3,5,0.00845206588750683,2019-03-29 01:15:00,2019-03-29 01:30:00
157,1,1,0,0.007661137019842945,2019-03-29 01:15:00,2019-03-29 01:30:00
168,1,1,0,0.007661137019842945,2019-03-29 01:15:00,2019-03-29 01:30:00
170,4,2,2,0.00701503222685595,2019-03-29 01:15:00,2019-03-29 01:30:00
172,2,1,1,0.027507462998648497,2019-03-29 01:15:00,2019-03-29 01:30:00
1,2,2,0,0.007609644802024529,2019-03-29 01:30:00,2019-03-29 01:45:00
10,4,3,1,0.06727186188493169,2019-03-29 01:30:00,2019-03-29 01:45:00
18,6,3,3,0.010618655288683684,2019-03-29 01:30:00,2019-03-29 01:45:00
20,2,1,1,0.027334544400801467,2019-03-29 01:30:00,2019-03-29 01:45:00
57,1,1,0,0.007609644802024529,2019-03-29 01:30:00,2019-03-29 01:45:00
58,1,0,1,0.004113116028789031,2019-03-29 01:30:00,2019-03-29 01:45:00
109,1,0,1,0.004113116028789031,2019-03-29 01:30:00,2019-03-29 01:45:00
119,1,0,1,0.004113116028789031,2019-03-29 01:30:00,2019-03-29 01:45:00
120,1,1,0,0.007609644802024529,2019-03-29 01:30:00,2019-03-29 01:45:00
126,2,0,2,0.004113116028789031,2019-03-29 01:30:00,2019-03-29 01:45:00
141,6,3,3,0.027334544400801467,2019-03-29 01:30:00,2019-03-29 01:45:00
154,1,0,1,0.004113116028789031,2019-03-29 01:30:00,2019-03-29 01:45:00
157,1,1,0,0.007609644802024529,2019-03-29 01:30:00,2019-03-29 01:45:00
168,1,1,0,0.007609644802024529,2019-03-29 01:30:00,2019-03-29 01:45:00
170,2,0,2,0.004113116028789031,2019-03-29 01:30:00,2019-03-29 01:45:00
172,2,1,1,0.027334544400801467,2019-03-29 01:30:00,2019-03-29 01:45:00
1,2,2,0,0.007883000726852238,2019-03-29 01:45:00,2019-03-29 02:00:00
10,4,3,1,0.052275984210790064,2019-03-29 01:45:00,2019-03-29 02:00:00
15,3,3,0,0.00741090324705454,2019-03-29 01:45:00,2019-03-29 02:00:00
18,2,0,2,0.004260869383812914,2019-03-29 01:45:00,2019-03-29 02:00:00
20,2,1,1,0.028268426797301495,2019-03-29 01:45:00,2019-03-29 02:00:00
35,1,1,0,0.005945675515851179,2019-03-29 01:45:00,2019-03-29 02:00:00
58,2,1,1,0.005468246498159355,2019-03-29 01:45:00,2019-03-29 02:00:00
88,1,1,0,0.007883000726852238,2019-03-29 01:45:00,2019-03-29 02:00:00
109,4,1,3,0.005945675515851179,2019-03-29 01:45:00,2019-03-29 02:00:00
112,2,0,2,0.004260869383812914,2019-03-29 01:45:00,2019-03-29 02:00:00
126,2,0,2,0.004260869383812914,2019-03-29 01:45:00,2019-03-29 02:00:00
127,1,1,0,0.005468246498159355,2019-03-29 01:45:00,2019-03-29 02:00:00
135,2,2,0,0.007883000726852238,2019-03-29 01:45:00,2019-03-29 02:00:00
138,3,0,3,0.004260869383812914,2019-03-29 01:45:00,2019-03-29 02:00:00
140,1,0,1,0.004260869383812914,2019-03-29 01:45:00,2019-03-29 02:00:00
141,9,3,6,0.00741090324705454,2019-03-29 01:45:00,2019-03-29 02:00:00
157,1,1,0,0.005945675515851179,2019-03-29 01:45:00,2019-03-29 02:00:00
168,1,1,0,0.008909404553459028,2019-03-29 01:45:00,2019-03-29 02:00:00
171,1,1,0,0.005468246498159355,2019-03-29 01:45:00,2019-03-29 02:00:00
172,2,1,1,0.028268426797301495,2019-03-29 01:45:00,2019-03-29 02:00:00
1,2,2,0,0.0076850846117343125,2019-03-29 02:00:00,2019-03-29 02:15:00
10,2,1,1,0.02759344551586506,2019-03-29 02:00:00,2019-03-29 02:15:00
15,5,4,1,0.05103298358063545,2019-03-29 02:00:00,2019-03-29 02:15:00
20,2,1,1,0.02759344551586506,2019-03-29 02:00:00,2019-03-29 02:15:00
35,1,1,0,0.0076850846117343125,2019-03-29 02:00:00,2019-03-29 02:15:00
58,1,0,1,0.004153907451094674,2019-03-29 02:00:00,2019-03-29 02:15:00
88,1,1,0,0.0076850846117343125,2019-03-29 02:00:00,2019-03-29 02:15:00
104,1,1,0,0.005919496031414493,2019-03-29 02:00:00,2019-03-29 02:15:00
109,1,0,1,0.004153907451094674,2019-03-29 02:00:00,2019-03-29 02:15:00
111,2,0,2,0.004153907451094674,2019-03-29 02:00:00,2019-03-29 02:15:00
112,1,0,1,0.004153907451094674,2019-03-29 02:00:00,2019-03-29 02:15:00
126,2,0,2,0.004153907451094674,2019-03-29 02:00:00,2019-03-29 02:15:00
127,1,1,0,0.005919496031414493,2019-03-29 02:00:00,2019-03-29 02:15:00
135,3,1,2,0.0076850846117343125,2019-03-29 02:00:00,2019-03-29 02:15:00
138,2,0,2,0.004153907451094674,2019-03-29 02:00:00,2019-03-29 02:15:00
140,1,0,1,0.004153907451094674,2019-03-29 02:00:00,2019-03-29 02:15:00
141,3,0,3,0.004153907451094674,2019-03-29 02:00:00,2019-03-29 02:15:00
151,2,2,0,0.010686949528354807,2019-03-29 02:00:00,2019-03-29 02:15:00
158,1,1,0,0.005919496031414493,2019-03-29 02:00:00,2019-03-29 02:15:00
168,1,1,0,0.0076850846117343125,2019-03-29 02:00:00,2019-03-29 02:15:00
171,1,1,0,0.005919496031414493,2019-03-29 02:00:00,2019-03-29 02:15:00
172,2,1,1,0.02759344551586506,2019-03-29 02:00:00,2019-03-29 02:15:00
1,2,2,0,0.008032158867952548,2019-03-29 02:15:00,2019-03-29 02:30:00
10,2,1,1,0.028756381633951073,2019-03-29 02:15:00,2019-03-29 02:30:00
15,2,0,2,0.004341494313768019,2019-03-29 02:15:00,2019-03-29 02:30:00
20,2,1,1,0.028756381633951073,2019-03-29 02:15:00,2019-03-29 02:30:00
46,5,3,2,0.013970373084187693,2019-03-29 02:15:00,2019-03-29 02:30:00
58,1,0,1,0.004341494313768019,2019-03-29 02:15:00,2019-03-29 02:30:00
101,1,1,0,0.008032158867952548,2019-03-29 02:15:00,2019-03-29 02:30:00
104,1,1,0,0.008032158867952548,2019-03-29 02:15:00,2019-03-29 02:30:00
111,1,0,1,0.004341494313768019,2019-03-29 02:15:00,2019-03-29 02:30:00
119,3,1,2,0.007551120570574577,2019-03-29 02:15:00,2019-03-29 02:30:00
122,1,1,0,0.007551120570574577,2019-03-29 02:15:00,2019-03-29 02:30:00
126,2,0,2,0.004341494313768019,2019-03-29 02:15:00,2019-03-29 02:30:00
158,1,1,0,0.010279708530003165,2019-03-29 02:15:00,2019-03-29 02:30:00
168,1,1,0,0.008032158867952548,2019-03-29 02:15:00,2019-03-29 02:30:00
172,2,1,1,0.028756381633951073,2019-03-29 02:15:00,2019-03-29 02:30:00
203,1,0,1,0.004341494313768019,2019-03-29 02:15:00,2019-03-29 02:30:00
1,2,2,0,0.00814953903518066,2019-03-29 02:30:00,2019-03-29 02:45:00
10,2,1,1,0.02917657421062627,2019-03-29 02:30:00,2019-03-29 02:45:00
20,2,1,1,0.02917657421062627,2019-03-29 02:30:00,2019-03-29 02:45:00
46,6,1,5,0.0053072742129529485,2019-03-29 02:30:00,2019-03-29 02:45:00
58,1,0,1,0.004404934824224322,2019-03-29 02:30:00,2019-03-29 02:45:00
74,1,1,0,0.01133286812251693,2019-03-29 02:30:00,2019-03-29 02:45:00
101,2,1,1,0.00814953903518066,2019-03-29 02:30:00,2019-03-29 02:45:00
126,2,0,2,0.004404934824224322,2019-03-29 02:30:00,2019-03-29 02:45:00
138,2,2,0,0.0062096136016815745,2019-03-29 02:30:00,2019-03-29 02:45:00
158,2,2,0,0.0062096136016815745,2019-03-29 02:30:00,2019-03-29 02:45:00
168,1,1,0,0.00814953903518066,2019-03-29 02:30:00,2019-03-29 02:45:00
172,2,1,1,0.02917657421062627,2019-03-29 02:30:00,2019-03-29 02:45:00
203,1,0,1,0.004404934824224322,2019-03-29 02:30:00,2019-03-29 02:45:00
1,2,2,0,0.00787495766670576,2019-03-29 02:45:00,2019-03-29 03:00:00
10,2,1,1,0.02823947325708564,2019-03-29 02:45:00,2019-03-29 03:00:00
15,1,0,1,0.004256521977832427,2019-03-29 02:45:00,2019-03-29 03:00:00
19,1,0,1,0.004256521977832427,2019-03-29 02:45:00,2019-03-29 03:00:00
20,2,1,1,0.02823947325708564,2019-03-29 02:45:00,2019-03-29 03:00:00
28,1,0,1,0.004256521977832427,2019-03-29 02:45:00,2019-03-29 03:00:00
58,2,1,1,0.00787495766670576,2019-03-29 02:45:00,2019-03-29 03:00:00
74,2,1,1,0.00787495766670576,2019-03-29 02:45:00,2019-03-29 03:00:00
88,1,1,0,0.00787495766670576,2019-03-29 02:45:00,2019-03-29 03:00:00
101,1,0,1,0.004256521977832427,2019-03-29 02:45:00,2019-03-29 03:00:00
118,1,1,0,0.010951027469316789,2019-03-29 02:45:00,2019-03-29 03:00:00
126,2,0,2,0.004256521977832427,2019-03-29 02:45:00,2019-03-29 03:00:00
158,2,1,1,0.02823947325708564,2019-03-29 02:45:00,2019-03-29 03:00:00
168,1,1,0,0.010951027469316789,2019-03-29 02:45:00,2019-03-29 03:00:00
172,2,1,1,0.02823947325708564,2019-03-29 02:45:00,2019-03-29 03:00:00
173,1,1,0,0.00787495766670576,2019-03-29 02:45:00,2019-03-29 03:00:00
1,2,2,0,0.008155795765743469,2019-03-29 03:00:00,2019-03-29 03:15:00
10,2,1,1,0.029198972446678937,2019-03-29 03:00:00,2019-03-29 03:15:00
15,1,0,1,0.004408316396025694,2019-03-29 03:00:00,2019-03-29 03:15:00
20,2,1,1,0.029198972446678937,2019-03-29 03:00:00,2019-03-29 03:15:00
58,1,0,1,0.004408316396025694,2019-03-29 03:00:00,2019-03-29 03:15:00
74,1,0,1,0.004408316396025694,2019-03-29 03:00:00,2019-03-29 03:15:00
88,1,1,0,0.008155795765743469,2019-03-29 03:00:00,2019-03-29 03:15:00
118,2,1,1,0.008155795765743469,2019-03-29 03:00:00,2019-03-29 03:15:00
126,2,0,2,0.004408316396025694,2019-03-29 03:00:00,2019-03-29 03:15:00
168,1,1,0,0.008155795765743469,2019-03-29 03:00:00,2019-03-29 03:15:00
170,1,1,0,0.011341569579931115,2019-03-29 03:00:00,2019-03-29 03:15:00
172,2,1,1,0.029198972446678937,2019-03-29 03:00:00,2019-03-29 03:15:00
1,2,2,0,0.011299226574289278,2019-03-29 03:15:00,2019-03-29 03:30:00
5,1,1,0,0.006258604246569918,2019-03-29 03:15:00,2019-03-29 03:30:00
10,2,1,1,0.029089818220015846,2019-03-29 03:15:00,2019-03-29 03:30:00
15,1,0,1,0.004391860085340149,2019-03-29 03:15:00,2019-03-29 03:30:00
20,2,1,1,0.029089818220015846,2019-03-29 03:15:00,2019-03-29 03:30:00
46,1,0,1,0.004391860085340149,2019-03-29 03:15:00,2019-03-29 03:30:00
58,1,0,1,0.004391860085340149,2019-03-29 03:15:00,2019-03-29 03:30:00
112,1,1,0,0.008125348407799687,2019-03-29 03:15:00,2019-03-29 03:30:00
118,1,0,1,0.004391860085340149,2019-03-29 03:15:00,2019-03-29 03:30:00
126,3,1,2,0.008125348407799687,2019-03-29 03:15:00,2019-03-29 03:30:00
138,2,0,2,0.004391860085340149,2019-03-29 03:15:00,2019-03-29 03:30:00
158,1,1,0,0.006258604246569918,2019-03-29 03:15:00,2019-03-29 03:30:00
168,1,1,0,0.008125348407799687,2019-03-29 03:15:00,2019-03-29 03:30:00
170,1,1,0,0.008125348407799687,2019-03-29 03:15:00,2019-03-29 03:30:00
172,2,1,1,0.029089818220015846,2019-03-29 03:15:00,2019-03-29 03:30:00
1,2,2,0,0.011139106665745354,2019-03-29 03:30:00,2019-03-29 03:45:00
5,1,1,0,0.008010212269217576,2019-03-29 03:30:00,2019-03-29 03:45:00
10,2,1,1,0.0286771688427092,2019-03-29 03:30:00,2019-03-29 03:45:00
15,1,0,1,0.004329631058320526,2019-03-29 03:30:00,2019-03-29 03:45:00
20,2,1,1,0.0286771688427092,2019-03-29 03:30:00,2019-03-29 03:45:00
46,1,0,1,0.004329631058320526,2019-03-29 03:30:00,2019-03-29 03:45:00
57,2,1,1,0.008010212269217576,2019-03-29 03:30:00,2019-03-29 03:45:00
58,1,0,1,0.004329631058320526,2019-03-29 03:30:00,2019-03-29 03:45:00
104,1,0,1,0.004329631058320526,2019-03-29 03:30:00,2019-03-29 03:45:00
112,1,1,0,0.008010212269217576,2019-03-29 03:30:00,2019-03-29 03:45:00
118,1,0,1,0.004329631058320526,2019-03-29 03:30:00,2019-03-29 03:45:00
126,3,1,2,0.008010212269217576,2019-03-29 03:30:00,2019-03-29 03:45:00
138,1,0,1,0.004329631058320526,2019-03-29 03:30:00,2019-03-29 03:45:00
153,1,1,0,0.008010212269217576,2019-03-29 03:30:00,2019-03-29 03:45:00
154,1,0,1,0.004329631058320526,2019-03-29 03:30:00,2019-03-29 03:45:00
168,1,1,0,0.008010212269217576,2019-03-29 03:30:00,2019-03-29 03:45:00
170,1,1,0,0.008010212269217576,2019-03-29 03:30:00,2019-03-29 03:45:00
172,2,1,1,0.0286771688427092,2019-03-29 03:30:00,2019-03-29 03:45:00
191,1,1,0,0.011139106665745354,2019-03-29 03:30:00,2019-03-29 03:45:00
1,2,2,0,0.008069609714909463,2019-03-29 03:45:00,2019-03-29 04:00:00
10,2,1,1,0.02889010226029482,2019-03-29 03:45:00,2019-03-29 04:00:00
16,1,1,0,0.008069609714909463,2019-03-29 03:45:00,2019-03-29 04:00:00
20,2,1,1,0.02889010226029482,2019-03-29 03:45:00,2019-03-29 04:00:00
57,2,1,1,0.008069609714909463,2019-03-29 03:45:00,2019-03-29 04:00:00
58,2,0,2,0.004361734482475771,2019-03-29 03:45:00,2019-03-29 04:00:00
104,1,0,1,0.004361734482475771,2019-03-29 03:45:00,2019-03-29 04:00:00
116,1,1,0,0.011221710280895022,2019-03-29 03:45:00,2019-03-29 04:00:00
126,2,0,2,0.004361734482475771,2019-03-29 03:45:00,2019-03-29 04:00:00
153,2,1,1,0.008069609714909463,2019-03-29 03:45:00,2019-03-29 04:00:00
154,1,0,1,0.004361734482475771,2019-03-29 03:45:00,2019-03-29 04:00:00
158,1,0,1,0.004361734482475771,2019-03-29 03:45:00,2019-03-29 04:00:00
168,1,1,0,0.006215672098692618,2019-03-29 03:45:00,2019-03-29 04:00:00
172,2,1,1,0.02889010226029482,2019-03-29 03:45:00,2019-03-29 04:00:00
191,2,2,0,0.01307564789711187,2019-03-29 03:45:00,2019-03-29 04:00:00
1,2,2,0,0.008243842798458315,2019-03-29 04:00:00,2019-03-29 04:15:00
10,2,1,1,0.029514521262362887,2019-03-29 04:00:00,2019-03-29 04:15:00
16,1,1,0,0.008243842798458315,2019-03-29 04:00:00,2019-03-29 04:15:00
20,2,1,1,0.029514521262362887,2019-03-29 04:00:00,2019-03-29 04:15:00
58,1,0,1,0.004455904059384602,2019-03-29 04:00:00,2019-03-29 04:15:00
126,2,0,2,0.004455904059384602,2019-03-29 04:00:00,2019-03-29 04:15:00
158,1,0,1,0.004455904059384602,2019-03-29 04:00:00,2019-03-29 04:15:00
168,1,1,0,0.008243842798458315,2019-03-29 04:00:00,2019-03-29 04:15:00
172,2,1,1,0.029514521262362887,2019-03-29 04:00:00,2019-03-29 04:15:00
1,3,3,0,0.008212735740156928,2019-03-29 04:15:00,2019-03-29 04:30:00
10,2,1,1,0.02940299873619042,2019-03-29 04:15:00,2019-03-29 04:30:00
16,1,1,0,0.008212735740156928,2019-03-29 04:15:00,2019-03-29 04:30:00
20,2,1,1,0.02940299873619042,2019-03-29 04:15:00,2019-03-29 04:30:00
58,1,0,1,0.004439091216317163,2019-03-29 04:15:00,2019-03-29 04:30:00
126,3,0,3,0.004439091216317163,2019-03-29 04:15:00,2019-03-29 04:30:00
140,2,0,2,0.004439091216317163,2019-03-29 04:15:00,2019-03-29 04:30:00
158,1,0,1,0.004439091216317163,2019-03-29 04:15:00,2019-03-29 04:30:00
168,1,1,0,0.008212735740156928,2019-03-29 04:15:00,2019-03-29 04:30:00
172,2,1,1,0.02940299873619042,2019-03-29 04:15:00,2019-03-29 04:30:00
201,2,2,0,0.008212735740156928,2019-03-29 04:15:00,2019-03-29 04:30:00
1,3,3,0,0.011877687294433427,2019-03-29 04:30:00,2019-03-29 04:45:00
10,2,1,1,0.029136067279951907,2019-03-29 04:30:00,2019-03-29 04:45:00
20,2,1,1,0.029136067279951907,2019-03-29 04:30:00,2019-03-29 04:45:00
27,2,2,0,0.011597437919510168,2019-03-29 04:30:00,2019-03-29 04:45:00
46,2,0,2,0.004398840572720317,2019-03-29 04:30:00,2019-03-29 04:45:00
58,1,0,1,0.004398840572720317,2019-03-29 04:30:00,2019-03-29 04:45:00
104,1,0,1,0.004398840572720317,2019-03-29 04:30:00,2019-03-29 04:45:00
126,2,0,2,0.004398840572720317,2019-03-29 04:30:00,2019-03-29 04:45:00
138,2,1,1,0.006268552253148594,2019-03-29 04:30:00,2019-03-29 04:45:00
140,2,0,2,0.004398840572720317,2019-03-29 04:30:00,2019-03-29 04:45:00
168,1,1,0,0.008138263933576872,2019-03-29 04:30:00,2019-03-29 04:45:00
172,2,1,1,0.029136067279951907,2019-03-29 04:30:00,2019-03-29 04:45:00
201,2,2,0,0.008138263933576872,2019-03-29 04:30:00,2019-03-29 04:45:00
1,3,3,0,0.011808150513548266,2019-03-29 04:45:00,2019-03-29 05:00:00
10,2,1,1,0.028965213149745796,2019-03-29 04:45:00,2019-03-29 05:00:00
19,2,2,0,0.011808150513548266,2019-03-29 04:45:00,2019-03-29 05:00:00
20,2,1,1,0.028965213149745796,2019-03-29 04:45:00,2019-03-29 05:00:00
27,2,2,0,0.011808150513548266,2019-03-29 04:45:00,2019-03-29 05:00:00
46,1,0,1,0.004373089689376611,2019-03-29 04:45:00,2019-03-29 05:00:00
57,1,0,1,0.004373089689376611,2019-03-29 04:45:00,2019-03-29 05:00:00
58,1,0,1,0.004373089689376611,2019-03-29 04:45:00,2019-03-29 05:00:00
104,1,0,1,0.004373089689376611,2019-03-29 04:45:00,2019-03-29 05:00:00
126,2,0,2,0.004373089689376611,2019-03-29 04:45:00,2019-03-29 05:00:00
138,1,0,1,0.004373089689376611,2019-03-29 04:45:00,2019-03-29 05:00:00
140,2,0,2,0.004373089689376611,2019-03-29 04:45:00,2019-03-29 05:00:00
168,1,1,0,0.008090620101462439,2019-03-29 04:45:00,2019-03-29 05:00:00
172,2,1,1,0.028965213149745796,2019-03-29 04:45:00,2019-03-29 05:00:00
191,1,0,1,0.004373089689376611,2019-03-29 04:45:00,2019-03-29 05:00:00
201,2,2,0,0.008090620101462439,2019-03-29 04:45:00,2019-03-29 05:00:00
1,2,2,0,0.01110276603662455,2019-03-29 05:00:00,2019-03-29 05:15:00
10,2,1,1,0.02858357599759497,2019-03-29 05:00:00,2019-03-29 05:15:00
15,1,1,0,0.007505922107139891,2019-03-29 05:00:00,2019-03-29 05:15:00
18,1,1,0,0.007984081370908586,2019-03-29 05:00:00,2019-03-29 05:15:00
19,1,0,1,0.004315507909890278,2019-03-29 05:00:00,2019-03-29 05:15:00
20,2,1,1,0.02858357599759497,2019-03-29 05:00:00,2019-03-29 05:15:00
21,1,1,0,0.007984081370908586,2019-03-29 05:00:00,2019-03-29 05:15:00
27,2,2,0,0.011652654831926894,2019-03-29 05:00:00,2019-03-29 05:15:00
41,1,1,0,0.007984081370908586,2019-03-29 05:00:00,2019-03-29 05:15:00
46,1,0,1,0.004315507909890278,2019-03-29 05:00:00,2019-03-29 05:15:00
57,1,0,1,0.004315507909890278,2019-03-29 05:00:00,2019-03-29 05:15:00
58,1,0,1,0.004315507909890278,2019-03-29 05:00:00,2019-03-29 05:15:00
114,3,1,2,0.007505922107139891,2019-03-29 05:00:00,2019-03-29 05:15:00
116,1,0,1,0.004315507909890278,2019-03-29 05:00:00,2019-03-29 05:15:00
126,3,1,2,0.007984081370908586,2019-03-29 05:00:00,2019-03-29 05:15:00
138,1,0,1,0.004315507909890278,2019-03-29 05:00:00,2019-03-29 05:15:00
140,2,0,2,0.004315507909890278,2019-03-29 05:00:00,2019-03-29 05:15:00
147,1,0,1,0.004315507909890278,2019-03-29 05:00:00,2019-03-29 05:15:00
168,1,1,0,0.007984081370908586,2019-03-29 05:00:00,2019-03-29 05:15:00
172,2,1,1,0.02858357599759497,2019-03-29 05:00:00,2019-03-29 05:15:00
201,2,2,0,0.007984081370908586,2019-03-29 05:00:00,2019-03-29 05:15:00
1,2,2,0,0.008160925690226788,2019-03-29 05:15:00,2019-03-29 05:30:00
10,2,1,1,0.029155993558103735,2019-03-29 05:15:00,2019-03-29 05:30:00
15,1,1,0,0.008160925690226788,2019-03-29 05:15:00,2019-03-29 05:30:00
18,1,0,1,0.004411122523784535,2019-03-29 05:15:00,2019-03-29 05:30:00
20,2,1,1,0.029155993558103735,2019-03-29 05:15:00,2019-03-29 05:30:00
23,2,1,1,0.008160925690226788,2019-03-29 05:15:00,2019-03-29 05:30:00
28,1,1,0,0.008160925690226788,2019-03-29 05:15:00,2019-03-29 05:30:00
41,1,1,0,0.007672130094312869,2019-03-29 05:15:00,2019-03-29 05:30:00
57,3,1,2,0.007672130094312869,2019-03-29 05:15:00,2019-03-29 05:30:00
58,1,0,1,0.004411122523784535,2019-03-29 05:15:00,2019-03-29 05:30:00
85,1,1,0,0.011348610632108881,2019-03-29 05:15:00,2019-03-29 05:30:00
113,1,0,1,0.004411122523784535,2019-03-29 05:15:00,2019-03-29 05:30:00
114,1,0,1,0.004411122523784535,2019-03-29 05:15:00,2019-03-29 05:30:00
116,1,0,1,0.004411122523784535,2019-03-29 05:15:00,2019-03-29 05:30:00
126,2,0,2,0.004411122523784535,2019-03-29 05:15:00,2019-03-29 05:30:00
140,2,0,2,0.004411122523784535,2019-03-29 05:15:00,2019-03-29 05:30:00
168,1,1,0,0.008160925690226788,2019-03-29 05:15:00,2019-03-29 05:30:00
172,3,1,2,0.007672130094312869,2019-03-29 05:15:00,2019-03-29 05:30:00
190,1,1,0,0.007672130094312869,2019-03-29 05:15:00,2019-03-29 05:30:00
196,1,1,0,0.008160925690226788,2019-03-29 05:15:00,2019-03-29 05:30:00
201,2,2,0,0.008160925690226788,2019-03-29 05:15:00,2019-03-29 05:30:00
1,2,2,0,0.008209864340411563,2019-03-29 05:30:00,2019-03-29 05:45:00
10,2,1,1,0.02933049459711913,2019-03-29 05:30:00,2019-03-29 05:45:00
15,1,1,0,0.008209864340411563,2019-03-29 05:30:00,2019-03-29 05:45:00
20,2,1,1,0.02933049459711913,2019-03-29 05:30:00,2019-03-29 05:45:00
21,1,1,0,0.008209864340411563,2019-03-29 05:30:00,2019-03-29 05:45:00
26,1,1,0,0.008209864340411563,2019-03-29 05:30:00,2019-03-29 05:45:00
37,1,1,0,0.005695003218519971,2019-03-29 05:30:00,2019-03-29 05:45:00
41,1,1,0,0.007718140743908362,2019-03-29 05:30:00,2019-03-29 05:45:00
57,1,0,1,0.004437572657574175,2019-03-29 05:30:00,2019-03-29 05:45:00
58,1,0,1,0.004437572657574175,2019-03-29 05:30:00,2019-03-29 05:45:00
87,1,1,0,0.008209864340411563,2019-03-29 05:30:00,2019-03-29 05:45:00
90,1,0,1,0.004437572657574175,2019-03-29 05:30:00,2019-03-29 05:45:00
109,1,0,1,0.004437572657574175,2019-03-29 05:30:00,2019-03-29 05:45:00
126,2,0,2,0.004437572657574175,2019-03-29 05:30:00,2019-03-29 05:45:00
140,3,0,3,0.004437572657574175,2019-03-29 05:30:00,2019-03-29 05:45:00
151,1,0,1,0.004437572657574175,2019-03-29 05:30:00,2019-03-29 05:45:00
168,1,1,0,0.008209864340411563,2019-03-29 05:30:00,2019-03-29 05:45:00
170,1,1,0,0.008209864340411563,2019-03-29 05:30:00,2019-03-29 05:45:00
172,3,1,2,0.007718140743908362,2019-03-29 05:30:00,2019-03-29 05:45:00
173,1,0,1,0.004437572657574175,2019-03-29 05:30:00,2019-03-29 05:45:00
190,1,1,0,0.008209864340411563,2019-03-29 05:30:00,2019-03-29 05:45:00
201,2,2,0,0.006952433779465767,2019-03-29 05:30:00,2019-03-29 05:45:00
202,1,0,1,0.004437572657574175,2019-03-29 05:30:00,2019-03-29 05:45:00
1,2,2,0,0.008035355186796909,2019-03-29 05:45:00,2019-03-29 06:00:00
10,2,1,1,0.028767199027665183,2019-03-29 05:45:00,2019-03-29 06:00:00
15,1,1,0,0.008035355186796909,2019-03-29 05:45:00,2019-03-29 06:00:00
18,1,0,1,0.004343220144579353,2019-03-29 05:45:00,2019-03-29 06:00:00
20,2,1,1,0.028767199027665183,2019-03-29 05:45:00,2019-03-29 06:00:00
21,1,1,0,0.008035355186796909,2019-03-29 05:45:00,2019-03-29 06:00:00
26,1,1,0,0.008035355186796909,2019-03-29 05:45:00,2019-03-29 06:00:00
58,1,0,1,0.004343220144579353,2019-03-29 05:45:00,2019-03-29 06:00:00
87,1,1,0,0.008035355186796909,2019-03-29 05:45:00,2019-03-29 06:00:00
90,1,0,1,0.004343220144579353,2019-03-29 05:45:00,2019-03-29 06:00:00
126,2,0,2,0.004343220144579353,2019-03-29 05:45:00,2019-03-29 06:00:00
127,2,1,1,0.008035355186796909,2019-03-29 05:45:00,2019-03-29 06:00:00
140,2,0,2,0.004343220144579353,2019-03-29 05:45:00,2019-03-29 06:00:00
151,1,0,1,0.004343220144579353,2019-03-29 05:45:00,2019-03-29 06:00:00
164,1,1,0,0.011174073518807028,2019-03-29 05:45:00,2019-03-29 06:00:00
168,1,1,0,0.008035355186796909,2019-03-29 05:45:00,2019-03-29 06:00:00
172,2,1,1,0.028767199027665183,2019-03-29 05:45:00,2019-03-29 06:00:00
173,1,0,1,0.004343220144579353,2019-03-29 05:45:00,2019-03-29 06:00:00
201,2,2,0,0.008035355186796909,2019-03-29 05:45:00,2019-03-29 06:00:00
202,1,0,1,0.004343220144579353,2019-03-29 05:45:00,2019-03-29 06:00:00
1,2,2,0,0.008181862549134273,2019-03-29 06:00:00,2019-03-29 06:15:00
10,2,1,1,0.029292316045391915,2019-03-29 06:00:00,2019-03-29 06:15:00
18,2,0,2,0.004422404767097214,2019-03-29 06:00:00,2019-03-29 06:15:00
20,2,1,1,0.029292316045391915,2019-03-29 06:00:00,2019-03-29 06:15:00
58,1,0,1,0.004422404767097214,2019-03-29 06:00:00,2019-03-29 06:15:00
70,1,1,0,0.008181862549134273,2019-03-29 06:00:00,2019-03-29 06:15:00
118,1,1,0,0.006302133658115744,2019-03-29 06:00:00,2019-03-29 06:15:00
126,2,0,2,0.004422404767097214,2019-03-29 06:00:00,2019-03-29 06:15:00
140,2,0,2,0.004422404767097214,2019-03-29 06:00:00,2019-03-29 06:15:00
158,1,1,0,0.006302133658115744,2019-03-29 06:00:00,2019-03-29 06:15:00
168,1,1,0,0.008181862549134273,2019-03-29 06:00:00,2019-03-29 06:15:00
171,1,0,1,0.004422404767097214,2019-03-29 06:00:00,2019-03-29 06:15:00
172,2,1,1,0.029292316045391915,2019-03-29 06:00:00,2019-03-29 06:15:00
201,2,2,0,0.008181862549134273,2019-03-29 06:00:00,2019-03-29 06:15:00
1,2,2,0,0.007742779375139148,2019-03-29 06:15:00,2019-03-29 06:30:00
10,3,2,1,0.051417043880804036,2019-03-29 06:15:00,2019-03-29 06:30:00
18,2,0,2,0.004185091404777877,2019-03-29 06:15:00,2019-03-29 06:30:00
19,1,0,1,0.004185091404777877,2019-03-29 06:15:00,2019-03-29 06:30:00
20,3,1,2,0.007279061894113209,2019-03-29 06:15:00,2019-03-29 06:30:00
27,1,1,0,0.007279061894113209,2019-03-29 06:15:00,2019-03-29 06:30:00
57,1,1,0,0.007742779375139148,2019-03-29 06:15:00,2019-03-29 06:30:00
70,3,2,1,0.051417043880804036,2019-03-29 06:15:00,2019-03-29 06:30:00
90,1,0,1,0.004185091404777877,2019-03-29 06:15:00,2019-03-29 06:30:00
118,1,1,0,0.005963935389958513,2019-03-29 06:15:00,2019-03-29 06:30:00
126,2,0,2,0.004185091404777877,2019-03-29 06:15:00,2019-03-29 06:30:00
138,1,0,1,0.004185091404777877,2019-03-29 06:15:00,2019-03-29 06:30:00
157,1,1,0,0.007742779375139148,2019-03-29 06:15:00,2019-03-29 06:30:00
158,1,1,0,0.005963935389958513,2019-03-29 06:15:00,2019-03-29 06:30:00
164,1,1,0,0.007742779375139148,2019-03-29 06:15:00,2019-03-29 06:30:00
171,1,0,1,0.004185091404777877,2019-03-29 06:15:00,2019-03-29 06:30:00
172,2,1,1,0.02780106764279096,2019-03-29 06:15:00,2019-03-29 06:30:00
191,1,0,1,0.004185091404777877,2019-03-29 06:15:00,2019-03-29 06:30:00
1,3,2,1,0.007282699876626615,2019-03-29 06:30:00,2019-03-29 06:45:00
10,6,4,2,0.029255006820607152,2019-03-29 06:30:00,2019-03-29 06:45:00
19,1,0,1,0.003936417678911457,2019-03-29 06:30:00,2019-03-29 06:45:00
20,3,1,2,0.006846522545922913,2019-03-29 06:30:00,2019-03-29 06:45:00
22,1,1,0,0.007282699876626615,2019-03-29 06:30:00,2019-03-29 06:45:00
27,1,1,0,0.006846522545922913,2019-03-29 06:30:00,2019-03-29 06:45:00
37,2,1,1,0.005929008834142563,2019-03-29 06:30:00,2019-03-29 06:45:00
41,3,1,2,0.006846522545922913,2019-03-29 06:30:00,2019-03-29 06:45:00
57,2,1,1,0.005929008834142563,2019-03-29 06:30:00,2019-03-29 06:45:00
58,1,0,1,0.003936417678911457,2019-03-29 06:30:00,2019-03-29 06:45:00
61,1,0,1,0.003936417678911457,2019-03-29 06:30:00,2019-03-29 06:45:00
70,2,1,1,0.0261134998969853,2019-03-29 06:30:00,2019-03-29 06:45:00
74,2,2,0,0.010628982074341774,2019-03-29 06:30:00,2019-03-29 06:45:00
88,1,0,1,0.003936417678911457,2019-03-29 06:30:00,2019-03-29 06:45:00
90,1,0,1,0.003936417678911457,2019-03-29 06:30:00,2019-03-29 06:45:00
104,1,0,1,0.003936417678911457,2019-03-29 06:30:00,2019-03-29 06:45:00
109,2,1,1,0.005929008834142563,2019-03-29 06:30:00,2019-03-29 06:45:00
110,1,0,1,0.003936417678911457,2019-03-29 06:30:00,2019-03-29 06:45:00
112,3,1,2,0.007282699876626615,2019-03-29 06:30:00,2019-03-29 06:45:00
115,1,1,0,0.007282699876626615,2019-03-29 06:30:00,2019-03-29 06:45:00
120,2,1,1,0.0261134998969853,2019-03-29 06:30:00,2019-03-29 06:45:00
126,2,0,2,0.003936417678911457,2019-03-29 06:30:00,2019-03-29 06:45:00
138,4,1,3,0.0070318950569367355,2019-03-29 06:30:00,2019-03-29 06:45:00
147,1,0,1,0.003936417678911457,2019-03-29 06:30:00,2019-03-29 06:45:00
153,1,1,0,0.007282699876626615,2019-03-29 06:30:00,2019-03-29 06:45:00
154,2,2,0,0.012322909171967851,2019-03-29 06:30:00,2019-03-29 06:45:00
156,1,0,1,0.003936417678911457,2019-03-29 06:30:00,2019-03-29 06:45:00
158,1,1,0,0.016371487669126276,2019-03-29 06:30:00,2019-03-29 06:45:00
164,1,1,0,0.007282699876626615,2019-03-29 06:30:00,2019-03-29 06:45:00
170,1,0,1,0.003936417678911457,2019-03-29 06:30:00,2019-03-29 06:45:00
172,3,2,1,0.0453804772480477,2019-03-29 06:30:00,2019-03-29 06:45:00
189,1,1,0,0.008976626974252692,2019-03-29 06:30:00,2019-03-29 06:45:00
191,1,0,1,0.003936417678911457,2019-03-29 06:30:00,2019-03-29 06:45:00
195,2,2,0,0.01207210435227797,2019-03-29 06:30:00,2019-03-29 06:45:00
203,1,1,0,0.007282699876626615,2019-03-29 06:30:00,2019-03-29 06:45:00
1,3,2,1,0.010154220760377754,2019-03-29 06:45:00,2019-03-29 07:00:00
2,1,0,1,0.0034907403117102184,2019-03-29 06:45:00,2019-03-29 07:00:00
5,3,1,2,0.0060829793882774385,2019-03-29 06:45:00,2019-03-29 07:00:00
10,6,3,3,0.0205340996862723,2019-03-29 06:45:00,2019-03-29 07:00:00
11,2,0,2,0.0034907403117102184,2019-03-29 06:45:00,2019-03-29 07:00:00
16,3,2,1,0.06179598958928084,2019-03-29 06:45:00,2019-03-29 07:00:00
18,2,1,1,0.006071408238800872,2019-03-29 06:45:00,2019-03-29 07:00:00
19,3,1,2,0.0060986367311988525,2019-03-29 06:45:00,2019-03-29 07:00:00
20,2,1,1,0.023205208441016503,2019-03-29 06:45:00,2019-03-29 07:00:00
22,2,2,0,0.009425617839150375,2019-03-29 06:45:00,2019-03-29 07:00:00
23,1,1,0,0.006122757441694548,2019-03-29 06:45:00,2019-03-29 07:00:00
28,1,0,1,0.0034907403117102184,2019-03-29 06:45:00,2019-03-29 07:00:00
37,3,2,1,0.006299721491619579,2019-03-29 06:45:00,2019-03-29 07:00:00
41,6,3,3,0.009203219490424644,2019-03-29 06:45:00,2019-03-29 07:00:00
57,2,0,2,0.0034907403117102184,2019-03-29 06:45:00,2019-03-29 07:00:00
58,3,0,3,0.0034907403117102184,2019-03-29 06:45:00,2019-03-29 07:00:00
61,1,0,1,0.0034907403117102184,2019-03-29 06:45:00,2019-03-29 07:00:00
66,2,0,2,0.0034907403117102184,2019-03-29 06:45:00,2019-03-29 07:00:00
68,5,2,3,0.009288238201066997,2019-03-29 06:45:00,2019-03-29 07:00:00
69,2,2,0,0.009090196205414625,2019-03-29 06:45:00,2019-03-29 07:00:00
70,2,1,1,0.023205208441016503,2019-03-29 06:45:00,2019-03-29 07:00:00
74,2,2,0,0.007447325330003656,2019-03-29 06:45:00,2019-03-29 07:00:00
85,1,1,0,0.0060763254825204225,2019-03-29 06:45:00,2019-03-29 07:00:00
87,2,2,0,0.007838458536229935,2019-03-29 06:45:00,2019-03-29 07:00:00
88,1,0,1,0.0034907403117102184,2019-03-29 06:45:00,2019-03-29 07:00:00
101,1,0,1,0.0034907403117102184,2019-03-29 06:45:00,2019-03-29 07:00:00
109,3,2,1,0.007783440873479618,2019-03-29 06:45:00,2019-03-29 07:00:00
110,1,0,1,0.0034907403117102184,2019-03-29 06:45:00,2019-03-29 07:00:00
112,4,2,2,0.007447325330003655,2019-03-29 06:45:00,2019-03-29 07:00:00
114,1,1,0,0.008652076165891524,2019-03-29 06:45:00,2019-03-29 07:00:00
115,1,1,0,0.006458179075430296,2019-03-29 06:45:00,2019-03-29 07:00:00
116,1,1,0,0.00481600210975954,2019-03-29 06:45:00,2019-03-29 07:00:00
120,3,1,2,0.006071408238800872,2019-03-29 06:45:00,2019-03-29 07:00:00
122,1,0,1,0.0034907403117102184,2019-03-29 06:45:00,2019-03-29 07:00:00
126,4,2,2,0.007838458536229935,2019-03-29 06:45:00,2019-03-29 07:00:00
127,1,1,0,0.0060763254825204225,2019-03-29 06:45:00,2019-03-29 07:00:00
137,1,1,0,0.006458179075430296,2019-03-29 06:45:00,2019-03-29 07:00:00
138,5,1,4,0.006235780726704566,2019-03-29 06:45:00,2019-03-29 07:00:00
147,1,0,1,0.0034907403117102184,2019-03-29 06:45:00,2019-03-29 07:00:00
153,1,1,0,0.0060986367311988525,2019-03-29 06:45:00,2019-03-29 07:00:00
154,2,2,0,0.014848352495891438,2019-03-29 06:45:00,2019-03-29 07:00:00
156,1,0,1,0.0034907403117102184,2019-03-29 06:45:00,2019-03-29 07:00:00
158,1,1,0,0.00930964819926268,2019-03-29 06:45:00,2019-03-29 07:00:00
160,1,0,1,0.0034907403117102184,2019-03-29 06:45:00,2019-03-29 07:00:00
164,4,2,2,0.006458179075430296,2019-03-29 06:45:00,2019-03-29 07:00:00
168,1,0,1,0.0034907403117102184,2019-03-29 06:45:00,2019-03-29 07:00:00
170,3,2,1,0.0070605544933742305,2019-03-29 06:45:00,2019-03-29 07:00:00
172,3,2,1,0.04052094371679796,2019-03-29 06:45:00,2019-03-29 07:00:00
177,4,1,3,0.004871019772509857,2019-03-29 06:45:00,2019-03-29 07:00:00
189,1,1,0,0.004974459693570257,2019-03-29 06:45:00,2019-03-29 07:00:00
191,3,1,2,0.006071408238800872,2019-03-29 06:45:00,2019-03-29 07:00:00
195,3,3,0,0.014598199543510007,2019-03-29 06:45:00,2019-03-29 07:00:00
203,1,1,0,0.006458179075430296,2019-03-29 06:45:00,2019-03-29 07:00:00
1,2,2,0,0.005878313334354216,2019-03-29 07:00:00,2019-03-29 07:15:00
2,1,0,1,0.003660888651186426,2019-03-29 07:00:00,2019-03-29 07:15:00
5,3,1,2,0.0044389050058969625,2019-03-29 07:00:00,2019-03-29 07:15:00
10,3,1,2,0.006367306017772997,2019-03-29 07:00:00,2019-03-29 07:15:00
11,2,0,2,0.003660888651186426,2019-03-29 07:00:00,2019-03-29 07:15:00
16,1,1,0,0.006367306017772997,2019-03-29 07:00:00,2019-03-29 07:15:00
18,6,2,4,0.007720514701066283,2019-03-29 07:00:00,2019-03-29 07:15:00
19,4,0,4,0.003660888651186426,2019-03-29 07:00:00,2019-03-29 07:15:00
20,2,1,1,0.02411718414266056,2019-03-29 07:00:00,2019-03-29 07:15:00
21,2,2,0,0.00792333872719407,2019-03-29 07:00:00,2019-03-29 07:15:00
22,2,2,0,0.008328986779449645,2019-03-29 07:00:00,2019-03-29 07:15:00
23,5,4,1,0.01618456538148187,2019-03-29 07:00:00,2019-03-29 07:15:00
28,1,0,1,0.003660888651186426,2019-03-29 07:00:00,2019-03-29 07:15:00
35,1,1,0,0.005465166895577474,2019-03-29 07:00:00,2019-03-29 07:15:00
37,3,2,1,0.009479371436615144,2019-03-29 07:00:00,2019-03-29 07:15:00
41,4,3,1,0.01477963462512754,2019-03-29 07:00:00,2019-03-29 07:15:00
57,1,0,1,0.003660888651186426,2019-03-29 07:00:00,2019-03-29 07:15:00
58,3,1,2,0.005014097334479712,2019-03-29 07:00:00,2019-03-29 07:15:00
61,1,0,1,0.003660888651186426,2019-03-29 07:00:00,2019-03-29 07:15:00
62,2,2,0,0.010076904594913179,2019-03-29 07:00:00,2019-03-29 07:15:00
66,3,1,2,0.006772954070028573,2019-03-29 07:00:00,2019-03-29 07:15:00
68,2,0,2,0.003660888651186426,2019-03-29 07:00:00,2019-03-29 07:15:00
69,3,2,1,0.008328986779449647,2019-03-29 07:00:00,2019-03-29 07:15:00
70,3,1,2,0.006367306017772997,2019-03-29 07:00:00,2019-03-29 07:15:00
74,1,1,0,0.005792113689190248,2019-03-29 07:00:00,2019-03-29 07:15:00
85,2,2,0,0.010054563765197894,2019-03-29 07:00:00,2019-03-29 07:15:00
87,3,3,0,0.020893242175786288,2019-03-29 07:00:00,2019-03-29 07:15:00
88,3,1,2,0.006367306017772997,2019-03-29 07:00:00,2019-03-29 07:15:00
89,1,1,0,0.017419492492112883,2019-03-29 07:00:00,2019-03-29 07:15:00
90,2,1,1,0.006772954070028573,2019-03-29 07:00:00,2019-03-29 07:15:00
101,1,0,1,0.003660888651186426,2019-03-29 07:00:00,2019-03-29 07:15:00
104,1,0,1,0.003660888651186426,2019-03-29 07:00:00,2019-03-29 07:15:00
108,1,1,0,0.010741305912508872,2019-03-29 07:00:00,2019-03-29 07:15:00
109,2,1,1,0.005301693498771086,2019-03-29 07:00:00,2019-03-29 07:15:00
111,1,1,0,0.004698243790800475,2019-03-29 07:00:00,2019-03-29 07:15:00
112,1,1,0,0.0044389050058969625,2019-03-29 07:00:00,2019-03-29 07:15:00
114,5,3,2,0.013708541762822171,2019-03-29 07:00:00,2019-03-29 07:15:00
115,1,1,0,0.005301693498771086,2019-03-29 07:00:00,2019-03-29 07:15:00
116,3,2,1,0.00624318325028801,2019-03-29 07:00:00,2019-03-29 07:15:00
119,2,2,0,0.010449300515190852,2019-03-29 07:00:00,2019-03-29 07:15:00
120,3,0,3,0.003660888651186426,2019-03-29 07:00:00,2019-03-29 07:15:00
126,5,1,4,0.0052169213606075,2019-03-29 07:00:00,2019-03-29 07:15:00
127,1,1,0,0.005547617347480858,2019-03-29 07:00:00,2019-03-29 07:15:00
137,4,4,0,0.021469528153909435,2019-03-29 07:00:00,2019-03-29 07:15:00
138,4,1,3,0.006367306017772997,2019-03-29 07:00:00,2019-03-29 07:15:00
147,1,0,1,0.003660888651186426,2019-03-29 07:00:00,2019-03-29 07:15:00
151,3,1,2,0.006367306017772997,2019-03-29 07:00:00,2019-03-29 07:15:00
153,5,2,3,0.008449654393851348,2019-03-29 07:00:00,2019-03-29 07:15:00
156,2,0,2,0.003660888651186426,2019-03-29 07:00:00,2019-03-29 07:15:00
158,3,1,2,0.006367306017772997,2019-03-29 07:00:00,2019-03-29 07:15:00
160,1,0,1,0.003660888651186426,2019-03-29 07:00:00,2019-03-29 07:15:00
164,3,2,1,0.009418521965015438,2019-03-29 07:00:00,2019-03-29 07:15:00
168,1,0,1,0.003660888651186426,2019-03-29 07:00:00,2019-03-29 07:15:00
169,1,1,0,0.004698243790800475,2019-03-29 07:00:00,2019-03-29 07:15:00
170,2,1,1,0.004698243790800475,2019-03-29 07:00:00,2019-03-29 07:15:00
171,1,1,0,0.006772954070028573,2019-03-29 07:00:00,2019-03-29 07:15:00
172,4,2,2,0.02411718414266056,2019-03-29 07:00:00,2019-03-29 07:15:00
173,2,2,0,0.008413758917613232,2019-03-29 07:00:00,2019-03-29 07:15:00
177,2,0,2,0.003660888651186426,2019-03-29 07:00:00,2019-03-29 07:15:00
189,1,1,0,0.007654810035024195,2019-03-29 07:00:00,2019-03-29 07:15:00
191,6,2,4,0.006367306017772997,2019-03-29 07:00:00,2019-03-29 07:15:00
195,1,1,0,0.005465166895577474,2019-03-29 07:00:00,2019-03-29 07:15:00
199,2,1,1,0.006055271522518888,2019-03-29 07:00:00,2019-03-29 07:15:00
201,1,0,1,0.003660888651186426,2019-03-29 07:00:00,2019-03-29 07:15:00
202,1,0,1,0.003660888651186426,2019-03-29 07:00:00,2019-03-29 07:15:00
1,3,2,1,0.005654538698023084,2019-03-29 07:15:00,2019-03-29 07:30:00
2,2,1,1,0.005028770534002662,2019-03-29 07:15:00,2019-03-29 07:30:00
5,1,1,0,0.007935036020147428,2019-03-29 07:15:00,2019-03-29 07:30:00
10,6,3,3,0.016579030566156613,2019-03-29 07:15:00,2019-03-29 07:30:00
11,2,0,2,0.003128210616812172,2019-03-29 07:15:00,2019-03-29 07:30:00
15,4,1,3,0.004365107697857463,2019-03-29 07:15:00,2019-03-29 07:30:00
16,2,1,1,0.007826217572448254,2019-03-29 07:15:00,2019-03-29 07:30:00
18,4,1,3,0.004782663932096268,2019-03-29 07:15:00,2019-03-29 07:30:00
19,7,2,5,0.007900662082743566,2019-03-29 07:15:00,2019-03-29 07:30:00
20,3,2,1,0.06244037457477364,2019-03-29 07:15:00,2019-03-29 07:30:00
21,1,1,0,0.005440775091623114,2019-03-29 07:15:00,2019-03-29 07:30:00
22,3,3,0,0.011105841400987668,2019-03-29 07:15:00,2019-03-29 07:30:00
23,4,3,1,0.00970405679627484,2019-03-29 07:15:00,2019-03-29 07:30:00
26,2,1,1,0.010070234762158986,2019-03-29 07:15:00,2019-03-29 07:30:00
27,1,1,0,0.004014614037276116,2019-03-29 07:15:00,2019-03-29 07:30:00
28,2,0,2,0.003128210616812172,2019-03-29 07:15:00,2019-03-29 07:30:00
30,1,0,1,0.003128210616812172,2019-03-29 07:15:00,2019-03-29 07:30:00
37,3,2,1,0.005098603518822615,2019-03-29 07:15:00,2019-03-29 07:30:00
41,4,2,2,0.005787420878204004,2019-03-29 07:15:00,2019-03-29 07:30:00
46,3,3,0,0.02048766196154497,2019-03-29 07:15:00,2019-03-29 07:30:00
57,3,0,3,0.003128210616812172,2019-03-29 07:15:00,2019-03-29 07:30:00
58,4,1,3,0.004782663932096268,2019-03-29 07:15:00,2019-03-29 07:30:00
61,1,0,1,0.003128210616812172,2019-03-29 07:15:00,2019-03-29 07:30:00
62,3,2,1,0.008166227532238442,2019-03-29 07:15:00,2019-03-29 07:30:00
66,2,1,1,0.004457815747508088,2019-03-29 07:15:00,2019-03-29 07:30:00
68,3,1,2,0.0044714645772346686,2019-03-29 07:15:00,2019-03-29 07:30:00
69,1,0,1,0.003128210616812172,2019-03-29 07:15:00,2019-03-29 07:30:00
70,5,2,3,0.010335422998612454,2019-03-29 07:15:00,2019-03-29 07:30:00
74,1,0,1,0.003128210616812172,2019-03-29 07:15:00,2019-03-29 07:30:00
75,1,1,0,0.006540942118487029,2019-03-29 07:15:00,2019-03-29 07:30:00
85,2,2,0,0.013592636859787295,2019-03-29 07:15:00,2019-03-29 07:30:00
87,4,4,0,0.008795387590988357,2019-03-29 07:15:00,2019-03-29 07:30:00
88,4,2,2,0.0212516820190944,2019-03-29 07:15:00,2019-03-29 07:30:00
89,2,1,1,0.011377518928687323,2019-03-29 07:15:00,2019-03-29 07:30:00
90,2,0,2,0.003128210616812172,2019-03-29 07:15:00,2019-03-29 07:30:00
101,1,0,1,0.003128210616812172,2019-03-29 07:15:00,2019-03-29 07:30:00
104,1,1,0,0.005787420878204004,2019-03-29 07:15:00,2019-03-29 07:30:00
108,4,2,2,0.010065904041244998,2019-03-29 07:15:00,2019-03-29 07:30:00
109,2,1,1,0.004483432658813725,2019-03-29 07:15:00,2019-03-29 07:30:00
110,2,1,1,0.004483432658813725,2019-03-29 07:15:00,2019-03-29 07:30:00
111,2,2,0,0.00490101745774006,2019-03-29 07:15:00,2019-03-29 07:30:00
112,1,1,0,0.0044714645772346686,2019-03-29 07:15:00,2019-03-29 07:30:00
114,2,1,1,0.004391374657417628,2019-03-29 07:15:00,2019-03-29 07:30:00
115,1,1,0,0.0074030873293094756,2019-03-29 07:15:00,2019-03-29 07:30:00
116,2,1,1,0.0044714645772346686,2019-03-29 07:15:00,2019-03-29 07:30:00
118,3,2,1,0.008716150096963292,2019-03-29 07:15:00,2019-03-29 07:30:00
119,3,3,0,0.010838813912300415,2019-03-29 07:15:00,2019-03-29 07:30:00
120,3,0,3,0.003128210616812172,2019-03-29 07:15:00,2019-03-29 07:30:00
122,2,1,1,0.0074030873293094756,2019-03-29 07:15:00,2019-03-29 07:30:00
126,4,1,3,0.004457815747508088,2019-03-29 07:15:00,2019-03-29 07:30:00
135,2,2,0,0.014348094293163279,2019-03-29 07:15:00,2019-03-29 07:30:00
137,7,5,2,0.019883243203432863,2019-03-29 07:15:00,2019-03-29 07:30:00
138,2,2,0,0.007711393150855556,2019-03-29 07:15:00,2019-03-29 07:30:00
140,2,0,2,0.003128210616812172,2019-03-29 07:15:00,2019-03-29 07:30:00
147,1,0,1,0.003128210616812172,2019-03-29 07:15:00,2019-03-29 07:30:00
151,3,1,2,0.005440775091623114,2019-03-29 07:15:00,2019-03-29 07:30:00
153,3,2,1,0.010485427833840086,2019-03-29 07:15:00,2019-03-29 07:30:00
154,2,2,0,0.0057083616582799595,2019-03-29 07:15:00,2019-03-29 07:30:00
156,1,0,1,0.003128210616812172,2019-03-29 07:15:00,2019-03-29 07:30:00
158,5,2,3,0.005838654700815278,2019-03-29 07:15:00,2019-03-29 07:30:00
160,1,0,1,0.003128210616812172,2019-03-29 07:15:00,2019-03-29 07:30:00
168,6,1,5,0.0037689983881266987,2019-03-29 07:15:00,2019-03-29 07:30:00
169,2,1,1,0.004014614037276116,2019-03-29 07:15:00,2019-03-29 07:30:00
170,2,1,1,0.004457815747508088,2019-03-29 07:15:00,2019-03-29 07:30:00
171,1,0,1,0.003128210616812172,2019-03-29 07:15:00,2019-03-29 07:30:00
172,3,1,2,0.005440775091623114,2019-03-29 07:15:00,2019-03-29 07:30:00
173,1,1,0,0.005787420878204004,2019-03-29 07:15:00,2019-03-29 07:30:00
177,4,1,3,0.004365107697857463,2019-03-29 07:15:00,2019-03-29 07:30:00
189,6,6,0,0.022373367877744965,2019-03-29 07:15:00,2019-03-29 07:30:00
190,1,1,0,0.004014614037276116,2019-03-29 07:15:00,2019-03-29 07:30:00
191,3,2,1,0.029575851277998083,2019-03-29 07:15:00,2019-03-29 07:30:00
195,2,1,1,0.005028770534002662,2019-03-29 07:15:00,2019-03-29 07:30:00
197,2,0,2,0.003128210616812172,2019-03-29 07:15:00,2019-03-29 07:30:00
199,3,1,2,0.01204191547701431,2019-03-29 07:15:00,2019-03-29 07:30:00
202,2,0,2,0.003128210616812172,2019-03-29 07:15:00,2019-03-29 07:30:00
1,4,2,2,0.010503722706851664,2019-03-29 07:30:00,2019-03-29 07:45:00
2,3,2,1,0.00880559428556776,2019-03-29 07:30:00,2019-03-29 07:45:00
5,4,1,3,0.007421635507311175,2019-03-29 07:30:00,2019-03-29 07:45:00
10,6,3,3,0.013193632509996368,2019-03-29 07:30:00,2019-03-29 07:45:00
11,2,0,2,0.0029569146615642645,2019-03-29 07:30:00,2019-03-29 07:45:00
16,4,0,4,0.0029569146615642645,2019-03-29 07:30:00,2019-03-29 07:45:00
18,2,1,1,0.00379478117936238,2019-03-29 07:30:00,2019-03-29 07:45:00
19,5,3,2,0.013316067150107799,2019-03-29 07:30:00,2019-03-29 07:45:00
20,3,2,1,0.07301366618588552,2019-03-29 07:30:00,2019-03-29 07:45:00
21,2,2,0,0.004423181067710967,2019-03-29 07:30:00,2019-03-29 07:45:00
22,1,1,0,0.004213714438261438,2019-03-29 07:30:00,2019-03-29 07:45:00
23,2,2,0,0.013541347118197253,2019-03-29 07:30:00,2019-03-29 07:45:00
26,4,3,1,0.021895546016296327,2019-03-29 07:30:00,2019-03-29 07:45:00
27,1,1,0,0.005330402027232315,2019-03-29 07:30:00,2019-03-29 07:45:00
28,1,0,1,0.0029569146615642645,2019-03-29 07:30:00,2019-03-29 07:45:00
35,4,2,2,0.010843427706509451,2019-03-29 07:30:00,2019-03-29 07:45:00
37,2,1,1,0.004213714438261438,2019-03-29 07:30:00,2019-03-29 07:45:00
40,1,1,0,0.0043225326911354904,2019-03-29 07:30:00,2019-03-29 07:45:00
41,3,2,1,0.005470514214958611,2019-03-29 07:30:00,2019-03-29 07:45:00
46,6,6,0,0.010776534392920065,2019-03-29 07:30:00,2019-03-29 07:45:00
50,1,0,1,0.0029569146615642645,2019-03-29 07:30:00,2019-03-29 07:45:00
57,5,1,4,0.011167859752529203,2019-03-29 07:30:00,2019-03-29 07:45:00
58,2,0,2,0.0029569146615642645,2019-03-29 07:30:00,2019-03-29 07:45:00
61,2,0,2,0.0029569146615642645,2019-03-29 07:30:00,2019-03-29 07:45:00
62,4,3,1,0.012417180580676788,2019-03-29 07:30:00,2019-03-29 07:45:00
66,1,1,0,0.00379478117936238,2019-03-29 07:30:00,2019-03-29 07:45:00
67,4,2,2,0.007710709887208844,2019-03-29 07:30:00,2019-03-29 07:45:00
68,3,1,2,0.008617020695529814,2019-03-29 07:30:00,2019-03-29 07:45:00
69,1,0,1,0.0029569146615642645,2019-03-29 07:30:00,2019-03-29 07:45:00
70,1,1,0,0.004433276064601414,2019-03-29 07:30:00,2019-03-29 07:45:00
74,1,0,1,0.0029569146615642645,2019-03-29 07:30:00,2019-03-29 07:45:00
75,1,1,0,0.005470514214958611,2019-03-29 07:30:00,2019-03-29 07:45:00
85,1,1,0,0.0035853145499128514,2019-03-29 07:30:00,2019-03-29 07:45:00
87,5,4,1,0.017165019406552594,2019-03-29 07:30:00,2019-03-29 07:45:00
88,1,0,1,0.0029569146615642645,2019-03-29 07:30:00,2019-03-29 07:45:00
90,5,2,3,0.02448813063793585,2019-03-29 07:30:00,2019-03-29 07:45:00
99,4,2,2,0.019631589448800228,2019-03-29 07:30:00,2019-03-29 07:45:00
108,6,2,4,0.00694687561799576,2019-03-29 07:30:00,2019-03-29 07:45:00
110,3,2,1,0.006727313991655785,2019-03-29 07:30:00,2019-03-29 07:45:00
111,2,2,0,0.006727313991655785,2019-03-29 07:30:00,2019-03-29 07:45:00
112,2,2,0,0.01173182558437584,2019-03-29 07:30:00,2019-03-29 07:45:00
113,1,1,0,0.004832729635192354,2019-03-29 07:30:00,2019-03-29 07:45:00
114,1,1,0,0.004213714438261438,2019-03-29 07:30:00,2019-03-29 07:45:00
115,2,2,0,0.011808256149663448,2019-03-29 07:30:00,2019-03-29 07:45:00
116,1,1,0,0.004832729635192354,2019-03-29 07:30:00,2019-03-29 07:45:00
118,3,0,3,0.0029569146615642645,2019-03-29 07:30:00,2019-03-29 07:45:00
120,1,0,1,0.0029569146615642645,2019-03-29 07:30:00,2019-03-29 07:45:00
122,2,1,1,0.009487779670941865,2019-03-29 07:30:00,2019-03-29 07:45:00
126,6,3,3,0.013316067150107797,2019-03-29 07:30:00,2019-03-29 07:45:00
129,6,2,4,0.006425620162141048,2019-03-29 07:30:00,2019-03-29 07:45:00
135,2,2,0,0.024084684265720187,2019-03-29 07:30:00,2019-03-29 07:45:00
137,3,0,3,0.0029569146615642645,2019-03-29 07:30:00,2019-03-29 07:45:00
147,3,2,1,0.008585592529299475,2019-03-29 07:30:00,2019-03-29 07:45:00
151,3,1,2,0.005142853707083284,2019-03-29 07:30:00,2019-03-29 07:45:00
153,7,5,2,0.019317452265321923,2019-03-29 07:30:00,2019-03-29 07:45:00
154,4,2,2,0.009052506659445656,2019-03-29 07:30:00,2019-03-29 07:45:00
156,2,0,2,0.0029569146615642645,2019-03-29 07:30:00,2019-03-29 07:45:00
158,2,1,1,0.006182776142353743,2019-03-29 07:30:00,2019-03-29 07:45:00
159,2,1,1,0.005142853707083284,2019-03-29 07:30:00,2019-03-29 07:45:00
160,1,0,1,0.0029569146615642645,2019-03-29 07:30:00,2019-03-29 07:45:00
162,1,0,1,0.0029569146615642645,2019-03-29 07:30:00,2019-03-29 07:45:00
164,2,1,1,0.004213714438261438,2019-03-29 07:30:00,2019-03-29 07:45:00
169,1,0,1,0.0029569146615642645,2019-03-29 07:30:00,2019-03-29 07:45:00
170,2,2,0,0.006098914103307198,2019-03-29 07:30:00,2019-03-29 07:45:00
172,5,2,3,0.007633591266609915,2019-03-29 07:30:00,2019-03-29 07:45:00
173,2,0,2,0.0029569146615642645,2019-03-29 07:30:00,2019-03-29 07:45:00
177,2,0,2,0.0029569146615642645,2019-03-29 07:30:00,2019-03-29 07:45:00
189,3,3,0,0.011407180247590848,2019-03-29 07:30:00,2019-03-29 07:45:00
190,1,1,0,0.005330402027232315,2019-03-29 07:30:00,2019-03-29 07:45:00
191,1,1,0,0.004213714438261438,2019-03-29 07:30:00,2019-03-29 07:45:00
195,4,3,1,0.007682419938838222,2019-03-29 07:30:00,2019-03-29 07:45:00
196,4,1,3,0.006619655240048741,2019-03-29 07:30:00,2019-03-29 07:45:00
197,2,0,2,0.0029569146615642645,2019-03-29 07:30:00,2019-03-29 07:45:00
199,2,0,2,0.0029569146615642645,2019-03-29 07:30:00,2019-03-29 07:45:00
201,3,1,2,0.005142853707083284,2019-03-29 07:30:00,2019-03-29 07:45:00
202,2,0,2,0.0029569146615642645,2019-03-29 07:30:00,2019-03-29 07:45:00
1,2,2,0,0.011072220456909537,2019-03-29 07:45:00,2019-03-29 08:00:00
2,2,2,0,0.006751219549142521,2019-03-29 07:45:00,2019-03-29 08:00:00
5,3,0,3,0.0032731825387979385,2019-03-29 07:45:00,2019-03-29 08:00:00
10,5,3,2,0.010710821262831072,2019-03-29 07:45:00,2019-03-29 08:00:00
15,1,0,1,0.0032731825387979385,2019-03-29 07:45:00,2019-03-29 08:00:00
16,10,3,7,0.005309134190201005,2019-03-29 07:45:00,2019-03-29 08:00:00
18,4,2,2,0.009059809387304881,2019-03-29 07:45:00,2019-03-29 08:00:00
19,10,4,6,0.008456904202975433,2019-03-29 07:45:00,2019-03-29 08:00:00
20,5,3,2,0.013911561465189638,2019-03-29 07:45:00,2019-03-29 08:00:00
21,3,3,0,0.008387225151665942,2019-03-29 07:45:00,2019-03-29 08:00:00
22,2,2,0,0.0055918738790276595,2019-03-29 07:45:00,2019-03-29 08:00:00
23,4,2,2,0.012383800064266273,2019-03-29 07:45:00,2019-03-29 08:00:00
26,3,3,0,0.019978401002278573,2019-03-29 07:45:00,2019-03-29 08:00:00
27,1,1,0,0.0070709415373897706,2019-03-29 07:45:00,2019-03-29 08:00:00
28,2,0,2,0.0032731825387979385,2019-03-29 07:45:00,2019-03-29 08:00:00
30,9,4,5,0.010230250595233763,2019-03-29 07:45:00,2019-03-29 08:00:00
35,2,1,1,0.007238257559830688,2019-03-29 07:45:00,2019-03-29 08:00:00
37,1,0,1,0.0032731825387979385,2019-03-29 07:45:00,2019-03-29 08:00:00
40,1,1,0,0.0041658975096597025,2019-03-29 07:45:00,2019-03-29 08:00:00
46,3,3,0,0.012857568385896714,2019-03-29 07:45:00,2019-03-29 08:00:00
57,5,2,3,0.013402367534473936,2019-03-29 07:45:00,2019-03-29 08:00:00
58,4,0,4,0.0032731825387979385,2019-03-29 07:45:00,2019-03-29 08:00:00
61,2,0,2,0.0032731825387979385,2019-03-29 07:45:00,2019-03-29 08:00:00
62,2,1,1,0.007825767723554459,2019-03-29 07:45:00,2019-03-29 08:00:00
66,3,3,0,0.008596071119258936,2019-03-29 07:45:00,2019-03-29 08:00:00
67,2,1,1,0.004664397342935771,2019-03-29 07:45:00,2019-03-29 08:00:00
68,4,0,4,0.0032731825387979385,2019-03-29 07:45:00,2019-03-29 08:00:00
70,1,0,1,0.0032731825387979385,2019-03-29 07:45:00,2019-03-29 08:00:00
74,3,1,2,0.005692884272813288,2019-03-29 07:45:00,2019-03-29 08:00:00
75,1,0,1,0.0032731825387979385,2019-03-29 07:45:00,2019-03-29 08:00:00
85,1,0,1,0.0032731825387979385,2019-03-29 07:45:00,2019-03-29 08:00:00
87,7,4,3,0.012096047551725202,2019-03-29 07:45:00,2019-03-29 08:00:00
88,4,0,4,0.0032731825387979385,2019-03-29 07:45:00,2019-03-29 08:00:00
90,4,1,3,0.0067007220527756164,2019-03-29 07:45:00,2019-03-29 08:00:00
99,4,2,2,0.02131250537813603,2019-03-29 07:45:00,2019-03-29 08:00:00
104,1,0,1,0.0032731825387979385,2019-03-29 07:45:00,2019-03-29 08:00:00
108,2,0,2,0.0032731825387979385,2019-03-29 07:45:00,2019-03-29 08:00:00
109,3,2,1,0.008599444128796855,2019-03-29 07:45:00,2019-03-29 08:00:00
110,3,3,0,0.007446826951211436,2019-03-29 07:45:00,2019-03-29 08:00:00
111,1,1,0,0.0067007220527756164,2019-03-29 07:45:00,2019-03-29 08:00:00
112,4,4,0,0.022267102266072696,2019-03-29 07:45:00,2019-03-29 08:00:00
114,1,0,1,0.0032731825387979385,2019-03-29 07:45:00,2019-03-29 08:00:00
115,1,1,0,0.0041658975096597025,2019-03-29 07:45:00,2019-03-29 08:00:00
116,1,1,0,0.008399543563541244,2019-03-29 07:45:00,2019-03-29 08:00:00
118,3,1,2,0.003968789940866855,2019-03-29 07:45:00,2019-03-29 08:00:00
119,1,1,0,0.004200659074889827,2019-03-29 07:45:00,2019-03-29 08:00:00
122,3,0,3,0.0032731825387979385,2019-03-29 07:45:00,2019-03-29 08:00:00
126,9,5,4,0.01834845093694875,2019-03-29 07:45:00,2019-03-29 08:00:00
129,5,1,4,0.004200659074889827,2019-03-29 07:45:00,2019-03-29 08:00:00
137,6,3,3,0.010602011532636029,2019-03-29 07:45:00,2019-03-29 08:00:00
138,6,5,1,0.01444978250874701,2019-03-29 07:45:00,2019-03-29 08:00:00
147,4,3,1,0.014767489354393086,2019-03-29 07:45:00,2019-03-29 08:00:00
151,3,1,2,0.005692884272813288,2019-03-29 07:45:00,2019-03-29 08:00:00
153,8,6,2,0.01488822565048103,2019-03-29 07:45:00,2019-03-29 08:00:00
154,3,1,2,0.0060556121470736034,2019-03-29 07:45:00,2019-03-29 08:00:00
156,3,0,3,0.0032731825387979385,2019-03-29 07:45:00,2019-03-29 08:00:00
157,2,1,1,0.004471359920747447,2019-03-29 07:45:00,2019-03-29 08:00:00
158,1,0,1,0.0032731825387979385,2019-03-29 07:45:00,2019-03-29 08:00:00
159,2,1,1,0.005692884272813288,2019-03-29 07:45:00,2019-03-29 08:00:00
162,1,0,1,0.0032731825387979385,2019-03-29 07:45:00,2019-03-29 08:00:00
164,4,4,0,0.027931257896831856,2019-03-29 07:45:00,2019-03-29 08:00:00
168,1,1,0,0.0060556121470736034,2019-03-29 07:45:00,2019-03-29 08:00:00
170,5,4,1,0.02415647658473551,2019-03-29 07:45:00,2019-03-29 08:00:00
172,4,2,2,0.007776876063876963,2019-03-29 07:45:00,2019-03-29 08:00:00
173,6,1,5,0.003943661119919474,2019-03-29 07:45:00,2019-03-29 08:00:00
177,1,0,1,0.0032731825387979385,2019-03-29 07:45:00,2019-03-29 08:00:00
189,2,2,0,0.004845395922155061,2019-03-29 07:45:00,2019-03-29 08:00:00
190,1,1,0,0.003943661119919474,2019-03-29 07:45:00,2019-03-29 08:00:00
191,2,1,1,0.009186325930505918,2019-03-29 07:45:00,2019-03-29 08:00:00
195,4,4,0,0.006948327117935367,2019-03-29 07:45:00,2019-03-29 08:00:00
196,4,3,1,0.006030483326126223,2019-03-29 07:45:00,2019-03-29 08:00:00
197,2,0,2,0.0032731825387979385,2019-03-29 07:45:00,2019-03-29 08:00:00
199,1,0,1,0.0032731825387979385,2019-03-29 07:45:00,2019-03-29 08:00:00
201,1,0,1,0.0032731825387979385,2019-03-29 07:45:00,2019-03-29 08:00:00
202,1,0,1,0.0032731825387979385,2019-03-29 07:45:00,2019-03-29 08:00:00
2,1,1,0,0.0041790826954506855,2019-03-29 08:00:00,2019-03-29 08:15:00
5,1,0,1,0.0029326020047768875,2019-03-29 08:00:00,2019-03-29 08:15:00
10,4,3,1,0.05100099017620974,2019-03-29 08:00:00,2019-03-29 08:15:00
15,2,1,1,0.008445668098703025,2019-03-29 08:00:00,2019-03-29 08:15:00
16,4,1,3,0.0050738045589830555,2019-03-29 08:00:00,2019-03-29 08:15:00
18,6,4,2,0.014144071267217093,2019-03-29 08:00:00,2019-03-29 08:15:00
19,5,2,3,0.00791852476747208,2019-03-29 08:00:00,2019-03-29 08:15:00
20,2,1,1,0.019509389479998408,2019-03-29 08:00:00,2019-03-29 08:15:00
21,1,1,0,0.005425563386124484,2019-03-29 08:00:00,2019-03-29 08:15:00
22,2,2,0,0.005539889051689614,2019-03-29 08:00:00,2019-03-29 08:15:00
23,5,1,4,0.004352277164251711,2019-03-29 08:00:00,2019-03-29 08:15:00
26,1,0,1,0.0029326020047768875,2019-03-29 08:00:00,2019-03-29 08:15:00
27,1,1,0,0.006049559872198264,2019-03-29 08:00:00,2019-03-29 08:15:00
28,3,0,3,0.0029326020047768875,2019-03-29 08:00:00,2019-03-29 08:15:00
30,2,1,1,0.003763589131892753,2019-03-29 08:00:00,2019-03-29 08:15:00
35,2,0,2,0.0029326020047768875,2019-03-29 08:00:00,2019-03-29 08:15:00
40,1,1,0,0.005425563386124484,2019-03-29 08:00:00,2019-03-29 08:15:00
41,3,0,3,0.0029326020047768875,2019-03-29 08:00:00,2019-03-29 08:15:00
46,2,2,0,0.012168397594622142,2019-03-29 08:00:00,2019-03-29 08:15:00
50,1,0,1,0.0029326020047768875,2019-03-29 08:00:00,2019-03-29 08:15:00
57,3,1,2,0.007333092753070291,2019-03-29 08:00:00,2019-03-29 08:15:00
58,1,0,1,0.0029326020047768875,2019-03-29 08:00:00,2019-03-29 08:15:00
61,1,0,1,0.0029326020047768875,2019-03-29 08:00:00,2019-03-29 08:15:00
62,2,1,1,0.019509389479998408,2019-03-29 08:00:00,2019-03-29 08:15:00
64,1,0,1,0.0029326020047768875,2019-03-29 08:00:00,2019-03-29 08:15:00
66,2,2,0,0.008764631744243686,2019-03-29 08:00:00,2019-03-29 08:15:00
67,2,1,1,0.005425563386124484,2019-03-29 08:00:00,2019-03-29 08:15:00
68,2,0,2,0.0029326020047768875,2019-03-29 08:00:00,2019-03-29 08:15:00
69,2,0,2,0.0029326020047768875,2019-03-29 08:00:00,2019-03-29 08:15:00
70,1,0,1,0.0029326020047768875,2019-03-29 08:00:00,2019-03-29 08:15:00
74,2,1,1,0.019509389479998408,2019-03-29 08:00:00,2019-03-29 08:15:00
75,1,0,1,0.0029326020047768875,2019-03-29 08:00:00,2019-03-29 08:15:00
79,1,0,1,0.0029326020047768875,2019-03-29 08:00:00,2019-03-29 08:15:00
85,1,0,1,0.0029326020047768875,2019-03-29 08:00:00,2019-03-29 08:15:00
87,2,1,1,0.005882866048385001,2019-03-29 08:00:00,2019-03-29 08:15:00
88,1,0,1,0.0029326020047768875,2019-03-29 08:00:00,2019-03-29 08:15:00
90,2,0,2,0.0029326020047768875,2019-03-29 08:00:00,2019-03-29 08:15:00
99,4,2,2,0.019509389479998408,2019-03-29 08:00:00,2019-03-29 08:15:00
104,1,0,1,0.0029326020047768875,2019-03-29 08:00:00,2019-03-29 08:15:00
108,1,0,1,0.0029326020047768875,2019-03-29 08:00:00,2019-03-29 08:15:00
109,6,4,2,0.009863011020634485,2019-03-29 08:00:00,2019-03-29 08:15:00
110,2,2,0,0.0075667659403306515,2019-03-29 08:00:00,2019-03-29 08:15:00
111,6,2,4,0.01007484717133399,2019-03-29 08:00:00,2019-03-29 08:15:00
112,9,6,3,0.026142575182046136,2019-03-29 08:00:00,2019-03-29 08:15:00
114,3,0,3,0.0029326020047768875,2019-03-29 08:00:00,2019-03-29 08:15:00
118,2,1,1,0.0041790826954506855,2019-03-29 08:00:00,2019-03-29 08:15:00
119,2,1,1,0.006485201844370608,2019-03-29 08:00:00,2019-03-29 08:15:00
120,2,1,1,0.019509389479998408,2019-03-29 08:00:00,2019-03-29 08:15:00
122,2,1,1,0.005882866048385001,2019-03-29 08:00:00,2019-03-29 08:15:00
126,5,2,3,0.005010069822566551,2019-03-29 08:00:00,2019-03-29 08:15:00
127,1,0,1,0.0029326020047768875,2019-03-29 08:00:00,2019-03-29 08:15:00
129,6,3,3,0.010411486148819676,2019-03-29 08:00:00,2019-03-29 08:15:00
135,2,2,0,0.005183264291367577,2019-03-29 08:00:00,2019-03-29 08:15:00
137,3,2,1,0.009775825126346175,2019-03-29 08:00:00,2019-03-29 08:15:00
138,10,10,0,0.025870508601022052,2019-03-29 08:00:00,2019-03-29 08:15:00
147,1,1,0,0.0038575637315001257,2019-03-29 08:00:00,2019-03-29 08:15:00
151,3,2,1,0.036086176955219935,2019-03-29 08:00:00,2019-03-29 08:15:00
153,5,5,0,0.008792471067716887,2019-03-29 08:00:00,2019-03-29 08:15:00
154,2,2,0,0.006256550513240349,2019-03-29 08:00:00,2019-03-29 08:15:00
156,3,1,2,0.0041790826954506855,2019-03-29 08:00:00,2019-03-29 08:15:00
157,2,1,1,0.005176440409554252,2019-03-29 08:00:00,2019-03-29 08:15:00
158,2,2,0,0.010241944780736255,2019-03-29 08:00:00,2019-03-29 08:15:00
162,1,0,1,0.0029326020047768875,2019-03-29 08:00:00,2019-03-29 08:15:00
164,2,2,0,0.007852033985158453,2019-03-29 08:00:00,2019-03-29 08:15:00
168,1,1,0,0.005425563386124484,2019-03-29 08:00:00,2019-03-29 08:15:00
170,5,2,3,0.008562751272267154,2019-03-29 08:00:00,2019-03-29 08:15:00
171,1,0,1,0.0029326020047768875,2019-03-29 08:00:00,2019-03-29 08:15:00
172,3,2,1,0.034424202700988206,2019-03-29 08:00:00,2019-03-29 08:15:00
173,3,0,3,0.0029326020047768875,2019-03-29 08:00:00,2019-03-29 08:15:00
177,1,0,1,0.0029326020047768875,2019-03-29 08:00:00,2019-03-29 08:15:00
190,1,1,0,0.003763589131892753,2019-03-29 08:00:00,2019-03-29 08:15:00
195,3,3,0,0.00890564665885566,2019-03-29 08:00:00,2019-03-29 08:15:00
196,2,2,0,0.011171881585895063,2019-03-29 08:00:00,2019-03-29 08:15:00
197,3,0,3,0.0029326020047768875,2019-03-29 08:00:00,2019-03-29 08:15:00
201,2,0,2,0.0029326020047768875,2019-03-29 08:00:00,2019-03-29 08:15:00
203,1,0,1,0.0029326020047768875,2019-03-29 08:00:00,2019-03-29 08:15:00
1,1,0,1,0.003063485289618549,2019-03-29 08:15:00,2019-03-29 08:30:00
10,3,2,1,0.03767144195971958,2019-03-29 08:15:00,2019-03-29 08:30:00
15,5,2,3,0.007070773896547545,2019-03-29 08:15:00,2019-03-29 08:30:00
16,3,1,2,0.006122079940571973,2019-03-29 08:15:00,2019-03-29 08:30:00
18,7,5,2,0.03511283226247806,2019-03-29 08:15:00,2019-03-29 08:30:00
19,2,1,1,0.003931553903092718,2019-03-29 08:15:00,2019-03-29 08:30:00
20,3,2,1,0.035248806704145465,2019-03-29 08:15:00,2019-03-29 08:30:00
22,2,2,0,0.0074256552836748585,2019-03-29 08:15:00,2019-03-29 08:30:00
23,6,3,3,0.007835927416531665,2019-03-29 08:15:00,2019-03-29 08:30:00
26,2,0,2,0.003063485289618549,2019-03-29 08:15:00,2019-03-29 08:30:00
27,2,1,1,0.007881516517097408,2019-03-29 08:15:00,2019-03-29 08:30:00
28,1,0,1,0.003063485289618549,2019-03-29 08:15:00,2019-03-29 08:30:00
30,1,1,0,0.00788001899895202,2019-03-29 08:15:00,2019-03-29 08:30:00
35,2,0,2,0.003063485289618549,2019-03-29 08:15:00,2019-03-29 08:30:00
37,1,1,0,0.005667691130041056,2019-03-29 08:15:00,2019-03-29 08:30:00
40,1,1,0,0.005665755882846242,2019-03-29 08:15:00,2019-03-29 08:30:00
41,2,1,1,0.005665755882846242,2019-03-29 08:15:00,2019-03-29 08:30:00
46,2,2,0,0.006586050942678836,2019-03-29 08:15:00,2019-03-29 08:30:00
50,2,0,2,0.003063485289618549,2019-03-29 08:15:00,2019-03-29 08:30:00
57,2,1,1,0.005667691130041056,2019-03-29 08:15:00,2019-03-29 08:30:00
58,2,0,2,0.003063485289618549,2019-03-29 08:15:00,2019-03-29 08:30:00
61,1,0,1,0.003063485289618549,2019-03-29 08:15:00,2019-03-29 08:30:00
62,2,1,1,0.02036746362466907,2019-03-29 08:15:00,2019-03-29 08:30:00
64,1,0,1,0.003063485289618549,2019-03-29 08:15:00,2019-03-29 08:30:00
66,1,0,1,0.003063485289618549,2019-03-29 08:15:00,2019-03-29 08:30:00
67,2,1,1,0.005667691130041056,2019-03-29 08:15:00,2019-03-29 08:30:00
68,1,1,0,0.005667691130041056,2019-03-29 08:15:00,2019-03-29 08:30:00
69,2,0,2,0.003063485289618549,2019-03-29 08:15:00,2019-03-29 08:30:00
70,1,0,1,0.003063485289618549,2019-03-29 08:15:00,2019-03-29 08:30:00
74,1,1,0,0.004365588209829803,2019-03-29 08:15:00,2019-03-29 08:30:00
79,1,0,1,0.003063485289618549,2019-03-29 08:15:00,2019-03-29 08:30:00
88,1,0,1,0.003063485289618549,2019-03-29 08:15:00,2019-03-29 08:30:00
90,2,0,2,0.003063485289618549,2019-03-29 08:15:00,2019-03-29 08:30:00
99,4,2,2,0.02036746362466907,2019-03-29 08:15:00,2019-03-29 08:30:00
104,1,0,1,0.003063485289618549,2019-03-29 08:15:00,2019-03-29 08:30:00
108,1,0,1,0.003063485289618549,2019-03-29 08:15:00,2019-03-29 08:30:00
109,2,2,0,0.00501663966993543,2019-03-29 08:15:00,2019-03-29 08:30:00
110,5,3,2,0.012913231699794706,2019-03-29 08:15:00,2019-03-29 08:30:00
111,6,1,5,0.017988704333196427,2019-03-29 08:15:00,2019-03-29 08:30:00
112,4,3,1,0.015073514086374931,2019-03-29 08:15:00,2019-03-29 08:30:00
113,1,1,0,0.005667691130041056,2019-03-29 08:15:00,2019-03-29 08:30:00
114,3,2,1,0.012367731643584373,2019-03-29 08:15:00,2019-03-29 08:30:00
115,1,1,0,0.008552534128630029,2019-03-29 08:15:00,2019-03-29 08:30:00
116,1,0,1,0.003063485289618549,2019-03-29 08:15:00,2019-03-29 08:30:00
119,1,1,0,0.005667691130041056,2019-03-29 08:15:00,2019-03-29 08:30:00
120,5,2,3,0.007373329411082551,2019-03-29 08:15:00,2019-03-29 08:30:00
126,2,0,2,0.003063485289618549,2019-03-29 08:15:00,2019-03-29 08:30:00
127,3,1,2,0.006122079940571973,2019-03-29 08:15:00,2019-03-29 08:30:00
129,2,2,0,0.006969794050252309,2019-03-29 08:15:00,2019-03-29 08:30:00
135,2,2,0,0.006606652880555534,2019-03-29 08:15:00,2019-03-29 08:30:00
137,3,3,0,0.01929080725340768,2019-03-29 08:15:00,2019-03-29 08:30:00
138,8,8,0,0.02020187150141681,2019-03-29 08:15:00,2019-03-29 08:30:00
147,1,0,1,0.003063485289618549,2019-03-29 08:15:00,2019-03-29 08:30:00
151,3,2,1,0.03767144195971958,2019-03-29 08:15:00,2019-03-29 08:30:00
153,4,4,0,0.010492359703312595,2019-03-29 08:15:00,2019-03-29 08:30:00
156,2,1,1,0.004365588209829803,2019-03-29 08:15:00,2019-03-29 08:30:00
157,1,0,1,0.003063485289618549,2019-03-29 08:15:00,2019-03-29 08:30:00
158,3,0,3,0.003063485289618549,2019-03-29 08:15:00,2019-03-29 08:30:00
164,1,1,0,0.00744394459351854,2019-03-29 08:15:00,2019-03-29 08:30:00
168,1,0,1,0.003063485289618549,2019-03-29 08:15:00,2019-03-29 08:30:00
170,5,3,2,0.009057240191672465,2019-03-29 08:15:00,2019-03-29 08:30:00
171,1,0,1,0.003063485289618549,2019-03-29 08:15:00,2019-03-29 08:30:00
172,2,1,1,0.02036746362466907,2019-03-29 08:15:00,2019-03-29 08:30:00
173,5,2,3,0.007908755800766786,2019-03-29 08:15:00,2019-03-29 08:30:00
177,1,0,1,0.003063485289618549,2019-03-29 08:15:00,2019-03-29 08:30:00
191,1,1,0,0.005667691130041056,2019-03-29 08:15:00,2019-03-29 08:30:00
195,2,2,0,0.006969794050252309,2019-03-29 08:15:00,2019-03-29 08:30:00
196,2,1,1,0.005152866678233519,2019-03-29 08:15:00,2019-03-29 08:30:00
197,4,0,4,0.003063485289618549,2019-03-29 08:15:00,2019-03-29 08:30:00
199,1,0,1,0.003063485289618549,2019-03-29 08:15:00,2019-03-29 08:30:00
201,1,0,1,0.003063485289618549,2019-03-29 08:15:00,2019-03-29 08:30:00
1,1,1,0,0.005437499653992258,2019-03-29 08:30:00,2019-03-29 08:45:00
5,1,1,0,0.003771866939090846,2019-03-29 08:30:00,2019-03-29 08:45:00
10,3,2,1,0.026273618229973487,2019-03-29 08:30:00,2019-03-29 08:45:00
15,3,1,2,0.0051118597157205495,2019-03-29 08:30:00,2019-03-29 08:45:00
16,3,1,2,0.004188275117816199,2019-03-29 08:30:00,2019-03-29 08:45:00
18,4,2,2,0.0055132930520043946,2019-03-29 08:30:00,2019-03-29 08:45:00
19,4,1,3,0.0035636628497281693,2019-03-29 08:30:00,2019-03-29 08:45:00
20,4,2,2,0.007284668849800958,2019-03-29 08:30:00,2019-03-29 08:45:00
21,2,2,0,0.0076325143231687,2019-03-29 08:30:00,2019-03-29 08:45:00
22,2,2,0,0.010095051299848492,2019-03-29 08:30:00,2019-03-29 08:45:00
23,3,2,1,0.0053050889626417175,2019-03-29 08:30:00,2019-03-29 08:45:00
26,6,1,5,0.0035411028494875224,2019-03-29 08:30:00,2019-03-29 08:45:00
27,2,1,1,0.007561449522431005,2019-03-29 08:30:00,2019-03-29 08:45:00
28,4,0,4,0.00293905058164014,2019-03-29 08:30:00,2019-03-29 08:45:00
30,6,3,3,0.009293639461019576,2019-03-29 08:30:00,2019-03-29 08:45:00
35,1,0,1,0.00293905058164014,2019-03-29 08:30:00,2019-03-29 08:45:00
37,2,1,1,0.004188275117816199,2019-03-29 08:30:00,2019-03-29 08:45:00
41,1,1,0,0.004719262584925886,2019-03-29 08:30:00,2019-03-29 08:45:00
46,4,4,0,0.016071803263496533,2019-03-29 08:30:00,2019-03-29 08:45:00
50,1,1,0,0.004052915116372317,2019-03-29 08:30:00,2019-03-29 08:45:00
57,2,1,1,0.005437499653992258,2019-03-29 08:30:00,2019-03-29 08:45:00
58,4,1,3,0.00614548294347184,2019-03-29 08:30:00,2019-03-29 08:45:00
61,1,0,1,0.00293905058164014,2019-03-29 08:30:00,2019-03-29 08:45:00
62,4,3,1,0.04231230921996448,2019-03-29 08:30:00,2019-03-29 08:45:00
64,1,0,1,0.00293905058164014,2019-03-29 08:30:00,2019-03-29 08:45:00
66,1,1,0,0.003771866939090846,2019-03-29 08:30:00,2019-03-29 08:45:00
67,2,1,1,0.0037322378469938676,2019-03-29 08:30:00,2019-03-29 08:45:00
69,1,0,1,0.00293905058164014,2019-03-29 08:30:00,2019-03-29 08:45:00
70,2,1,1,0.00649947458821163,2019-03-29 08:30:00,2019-03-29 08:45:00
74,1,1,0,0.0035411028494875224,2019-03-29 08:30:00,2019-03-29 08:45:00
85,1,1,0,0.005282480690482663,2019-03-29 08:30:00,2019-03-29 08:45:00
88,1,0,1,0.00293905058164014,2019-03-29 08:30:00,2019-03-29 08:45:00
89,2,0,2,0.00293905058164014,2019-03-29 08:30:00,2019-03-29 08:45:00
90,4,1,3,0.004101183786005882,2019-03-29 08:30:00,2019-03-29 08:45:00
99,4,2,2,0.01955747769060204,2019-03-29 08:30:00,2019-03-29 08:45:00
104,3,2,1,0.006197245729034816,2019-03-29 08:30:00,2019-03-29 08:45:00
108,1,0,1,0.00293905058164014,2019-03-29 08:30:00,2019-03-29 08:45:00
109,2,2,0,0.005012202272448443,2019-03-29 08:30:00,2019-03-29 08:45:00
110,7,2,5,0.006551364188724435,2019-03-29 08:30:00,2019-03-29 08:45:00
111,3,0,3,0.00293905058164014,2019-03-29 08:30:00,2019-03-29 08:45:00
112,2,2,0,0.00788489193483811,2019-03-29 08:30:00,2019-03-29 08:45:00
113,1,1,0,0.005437499653992258,2019-03-29 08:30:00,2019-03-29 08:45:00
114,2,1,1,0.003771866939090846,2019-03-29 08:30:00,2019-03-29 08:45:00
115,4,2,2,0.008562779511687466,2019-03-29 08:30:00,2019-03-29 08:45:00
116,2,0,2,0.00293905058164014,2019-03-29 08:30:00,2019-03-29 08:45:00
118,2,1,1,0.005437499653992258,2019-03-29 08:30:00,2019-03-29 08:45:00
119,4,2,2,0.009578133154087853,2019-03-29 08:30:00,2019-03-29 08:45:00
120,3,0,3,0.00293905058164014,2019-03-29 08:30:00,2019-03-29 08:45:00
122,1,0,1,0.00293905058164014,2019-03-29 08:30:00,2019-03-29 08:45:00
126,5,1,4,0.0037322378469938676,2019-03-29 08:30:00,2019-03-29 08:45:00
127,3,3,0,0.011027848759188358,2019-03-29 08:30:00,2019-03-29 08:45:00
129,2,2,0,0.006599632858358,2019-03-29 08:30:00,2019-03-29 08:45:00
135,3,2,1,0.004812887385904228,2019-03-29 08:30:00,2019-03-29 08:45:00
137,4,4,0,0.012975081309992422,2019-03-29 08:30:00,2019-03-29 08:45:00
138,10,8,2,0.01996155598890213,2019-03-29 08:30:00,2019-03-29 08:45:00
147,3,2,1,0.007843119001799922,2019-03-29 08:30:00,2019-03-29 08:45:00
151,2,1,1,0.01955747769060204,2019-03-29 08:30:00,2019-03-29 08:45:00
153,3,2,1,0.0053050889626417175,2019-03-29 08:30:00,2019-03-29 08:45:00
154,1,0,1,0.00293905058164014,2019-03-29 08:30:00,2019-03-29 08:45:00
156,3,2,1,0.006713851910902432,2019-03-29 08:30:00,2019-03-29 08:45:00
157,1,0,1,0.00293905058164014,2019-03-29 08:30:00,2019-03-29 08:45:00
158,4,0,4,0.00293905058164014,2019-03-29 08:30:00,2019-03-29 08:45:00
168,2,0,2,0.00293905058164014,2019-03-29 08:30:00,2019-03-29 08:45:00
170,6,4,2,0.009260123458807789,2019-03-29 08:30:00,2019-03-29 08:45:00
171,3,0,3,0.00293905058164014,2019-03-29 08:30:00,2019-03-29 08:45:00
172,3,1,2,0.0051118597157205495,2019-03-29 08:30:00,2019-03-29 08:45:00
173,2,0,2,0.00293905058164014,2019-03-29 08:30:00,2019-03-29 08:45:00
177,3,1,2,0.0051118597157205495,2019-03-29 08:30:00,2019-03-29 08:45:00
189,5,4,1,0.09006887133921031,2019-03-29 08:30:00,2019-03-29 08:45:00
191,1,1,0,0.005437499653992258,2019-03-29 08:30:00,2019-03-29 08:45:00
195,3,3,0,0.011538701191964873,2019-03-29 08:30:00,2019-03-29 08:45:00
196,4,4,0,0.01993398298305985,2019-03-29 08:30:00,2019-03-29 08:45:00
197,4,1,3,0.0051118597157205495,2019-03-29 08:30:00,2019-03-29 08:45:00
199,1,0,1,0.00293905058164014,2019-03-29 08:30:00,2019-03-29 08:45:00
203,2,1,1,0.01955747769060204,2019-03-29 08:30:00,2019-03-29 08:45:00
5,3,2,1,0.07072976501805321,2019-03-29 08:45:00,2019-03-29 09:00:00
10,3,2,1,0.02328387347181978,2019-03-29 08:45:00,2019-03-29 09:00:00
15,2,1,1,0.008085956882634858,2019-03-29 08:45:00,2019-03-29 09:00:00
16,3,1,2,0.003854762441119923,2019-03-29 08:45:00,2019-03-29 09:00:00
18,5,3,2,0.014405578585385583,2019-03-29 08:45:00,2019-03-29 09:00:00
19,2,0,2,0.0024536229114785887,2019-03-29 08:45:00,2019-03-29 09:00:00
20,3,1,2,0.00426767135731812,2019-03-29 08:45:00,2019-03-29 09:00:00
21,2,2,0,0.007511923586938788,2019-03-29 08:45:00,2019-03-29 09:00:00
23,2,0,2,0.0024536229114785887,2019-03-29 08:45:00,2019-03-29 09:00:00
26,1,0,1,0.0024536229114785887,2019-03-29 08:45:00,2019-03-29 09:00:00
27,2,1,1,0.006312709092105618,2019-03-29 08:45:00,2019-03-29 09:00:00
28,2,0,2,0.0024536229114785887,2019-03-29 08:45:00,2019-03-29 09:00:00
30,5,2,3,0.004789130954842568,2019-03-29 08:45:00,2019-03-29 09:00:00
35,3,0,3,0.0024536229114785887,2019-03-29 08:45:00,2019-03-29 09:00:00
37,7,2,5,0.006463236911327764,2019-03-29 08:45:00,2019-03-29 09:00:00
40,1,1,0,0.002858651377877716,2019-03-29 08:45:00,2019-03-29 09:00:00
41,2,2,0,0.005301502592809047,2019-03-29 08:45:00,2019-03-29 09:00:00
46,3,2,1,0.01981216504509625,2019-03-29 08:45:00,2019-03-29 09:00:00
50,1,1,0,0.004235395352581333,2019-03-29 08:45:00,2019-03-29 09:00:00
57,2,1,1,0.004539461301576378,2019-03-29 08:45:00,2019-03-29 09:00:00
58,2,1,1,0.009830383356054247,2019-03-29 08:45:00,2019-03-29 09:00:00
62,6,5,1,0.065218849076985,2019-03-29 08:45:00,2019-03-29 09:00:00
64,1,0,1,0.0024536229114785887,2019-03-29 08:45:00,2019-03-29 09:00:00
66,2,1,1,0.0034238501585689453,2019-03-29 08:45:00,2019-03-29 09:00:00
67,2,1,1,0.0029750825090030363,2019-03-29 08:45:00,2019-03-29 09:00:00
68,1,0,1,0.0024536229114785887,2019-03-29 08:45:00,2019-03-29 09:00:00
69,4,3,1,0.05199984186343963,2019-03-29 08:45:00,2019-03-29 09:00:00
70,1,1,0,0.003552555170056694,2019-03-29 08:45:00,2019-03-29 09:00:00
74,2,2,0,0.005310590552367015,2019-03-29 08:45:00,2019-03-29 09:00:00
85,1,1,0,0.008577363510805538,2019-03-29 08:45:00,2019-03-29 09:00:00
87,1,0,1,0.0024536229114785887,2019-03-29 08:45:00,2019-03-29 09:00:00
88,3,2,1,0.0046514874286348006,2019-03-29 08:45:00,2019-03-29 09:00:00
89,4,1,3,0.0034238501585689453,2019-03-29 08:45:00,2019-03-29 09:00:00
90,3,1,2,0.00426767135731812,2019-03-29 08:45:00,2019-03-29 09:00:00
99,4,2,2,0.016340456618372714,2019-03-29 08:45:00,2019-03-29 09:00:00
104,4,1,3,0.0034238501585689453,2019-03-29 08:45:00,2019-03-29 09:00:00
108,2,1,1,0.0034965421065274835,2019-03-29 08:45:00,2019-03-29 09:00:00
109,5,2,3,0.004944489767975506,2019-03-29 08:45:00,2019-03-29 09:00:00
110,5,3,2,0.004191821569893414,2019-03-29 08:45:00,2019-03-29 09:00:00
111,3,2,1,0.009620282705854431,2019-03-29 08:45:00,2019-03-29 09:00:00
113,6,4,2,0.029742176701721662,2019-03-29 08:45:00,2019-03-29 09:00:00
114,2,1,1,0.008677039479477937,2019-03-29 08:45:00,2019-03-29 09:00:00
115,3,2,1,0.0045954743651055886,2019-03-29 08:45:00,2019-03-29 09:00:00
116,1,0,1,0.0024536229114785887,2019-03-29 08:45:00,2019-03-29 09:00:00
118,1,0,1,0.0024536229114785887,2019-03-29 08:45:00,2019-03-29 09:00:00
119,3,1,2,0.004235395352581333,2019-03-29 08:45:00,2019-03-29 09:00:00
120,4,3,1,0.007320579155040098,2019-03-29 08:45:00,2019-03-29 09:00:00
126,4,0,4,0.0024536229114785887,2019-03-29 08:45:00,2019-03-29 09:00:00
127,2,2,0,0.005896597581346835,2019-03-29 08:45:00,2019-03-29 09:00:00
129,3,2,1,0.006625299691674168,2019-03-29 08:45:00,2019-03-29 09:00:00
135,2,1,1,0.0034965421065274835,2019-03-29 08:45:00,2019-03-29 09:00:00
137,5,5,0,0.016237420129663782,2019-03-29 08:45:00,2019-03-29 09:00:00
138,10,8,2,0.016181558548116374,2019-03-29 08:45:00,2019-03-29 09:00:00
140,1,0,1,0.0024536229114785887,2019-03-29 08:45:00,2019-03-29 09:00:00
141,1,1,0,0.0034965421065274835,2019-03-29 08:45:00,2019-03-29 09:00:00
147,4,2,2,0.005611068393211378,2019-03-29 08:45:00,2019-03-29 09:00:00
151,3,1,2,0.00426767135731812,2019-03-29 08:45:00,2019-03-29 09:00:00
153,2,0,2,0.0024536229114785887,2019-03-29 08:45:00,2019-03-29 09:00:00
156,1,1,0,0.004982773249208689,2019-03-29 08:45:00,2019-03-29 09:00:00
157,1,0,1,0.0024536229114785887,2019-03-29 08:45:00,2019-03-29 09:00:00
158,7,1,6,0.002858651377877716,2019-03-29 08:45:00,2019-03-29 09:00:00
162,2,0,2,0.0024536229114785887,2019-03-29 08:45:00,2019-03-29 09:00:00
164,1,1,0,0.003854762441119923,2019-03-29 08:45:00,2019-03-29 09:00:00
168,4,0,4,0.0024536229114785887,2019-03-29 08:45:00,2019-03-29 09:00:00
169,3,3,0,0.0037851394418012907,2019-03-29 08:45:00,2019-03-29 09:00:00
170,3,3,0,0.005346449285734727,2019-03-29 08:45:00,2019-03-29 09:00:00
171,1,0,1,0.0024536229114785887,2019-03-29 08:45:00,2019-03-29 09:00:00
172,3,1,2,0.00426767135731812,2019-03-29 08:45:00,2019-03-29 09:00:00
175,1,0,1,0.0024536229114785887,2019-03-29 08:45:00,2019-03-29 09:00:00
177,3,1,2,0.00426767135731812,2019-03-29 08:45:00,2019-03-29 09:00:00
189,4,3,1,0.06905399993994008,2019-03-29 08:45:00,2019-03-29 09:00:00
191,1,1,0,0.006408047000122177,2019-03-29 08:45:00,2019-03-29 09:00:00
195,2,1,1,0.0034238501585689453,2019-03-29 08:45:00,2019-03-29 09:00:00
196,4,4,0,0.016263005126044866,2019-03-29 08:45:00,2019-03-29 09:00:00
197,4,1,3,0.00426767135731812,2019-03-29 08:45:00,2019-03-29 09:00:00
199,1,0,1,0.0024536229114785887,2019-03-29 08:45:00,2019-03-29 09:00:00
202,2,0,2,0.0024536229114785887,2019-03-29 08:45:00,2019-03-29 09:00:00
203,1,0,1,0.0024536229114785887,2019-03-29 08:45:00,2019-03-29 09:00:00
1,1,1,0,0.004087614838218051,2019-03-29 09:00:00,2019-03-29 09:15:00
2,1,1,0,0.005124032415323035,2019-03-29 09:00:00,2019-03-29 09:15:00
5,2,1,1,0.019070158996155114,2019-03-29 09:00:00,2019-03-29 09:15:00
10,2,1,1,0.019070158996155114,2019-03-29 09:00:00,2019-03-29 09:15:00
15,1,1,0,0.005124032415323035,2019-03-29 09:00:00,2019-03-29 09:15:00
16,2,1,1,0.007223091632726989,2019-03-29 09:00:00,2019-03-29 09:15:00
18,9,7,2,0.03284909922253915,2019-03-29 09:00:00,2019-03-29 09:15:00
20,3,1,2,0.004988946938757324,2019-03-29 09:00:00,2019-03-29 09:15:00
21,1,1,0,0.004087614838218051,2019-03-29 09:00:00,2019-03-29 09:15:00
23,3,0,3,0.0028684275575988384,2019-03-29 09:00:00,2019-03-29 09:15:00
27,1,1,0,0.01079709466731615,2019-03-29 09:00:00,2019-03-29 09:15:00
28,1,0,1,0.0028684275575988384,2019-03-29 09:00:00,2019-03-29 09:15:00
30,2,1,1,0.004988946938757324,2019-03-29 09:00:00,2019-03-29 09:15:00
35,2,0,2,0.0028684275575988384,2019-03-29 09:00:00,2019-03-29 09:15:00
37,9,4,5,0.013641220380828942,2019-03-29 09:00:00,2019-03-29 09:15:00
46,3,2,1,0.024470736142340542,2019-03-29 09:00:00,2019-03-29 09:15:00
57,3,2,1,0.00932682380087735,2019-03-29 09:00:00,2019-03-29 09:15:00
58,1,0,1,0.0028684275575988384,2019-03-29 09:00:00,2019-03-29 09:15:00
61,2,0,2,0.0028684275575988384,2019-03-29 09:00:00,2019-03-29 09:15:00
62,3,2,1,0.035271890434711385,2019-03-29 09:00:00,2019-03-29 09:15:00
64,1,0,1,0.0028684275575988384,2019-03-29 09:00:00,2019-03-29 09:15:00
66,3,1,2,0.005306802118837264,2019-03-29 09:00:00,2019-03-29 09:15:00
67,1,1,0,0.013108367152681537,2019-03-29 09:00:00,2019-03-29 09:15:00
68,1,0,1,0.0028684275575988384,2019-03-29 09:00:00,2019-03-29 09:15:00
69,4,2,2,0.010244943114424747,2019-03-29 09:00:00,2019-03-29 09:15:00
70,1,1,0,0.005187725684311033,2019-03-29 09:00:00,2019-03-29 09:15:00
74,3,3,0,0.00774517668007569,2019-03-29 09:00:00,2019-03-29 09:15:00
86,1,0,1,0.0028684275575988384,2019-03-29 09:00:00,2019-03-29 09:15:00
87,3,2,1,0.007890510687914043,2019-03-29 09:00:00,2019-03-29 09:15:00
88,3,2,1,0.0075070238110232276,2019-03-29 09:00:00,2019-03-29 09:15:00
89,1,0,1,0.0028684275575988384,2019-03-29 09:00:00,2019-03-29 09:15:00
90,4,2,2,0.009229985701074295,2019-03-29 09:00:00,2019-03-29 09:15:00
99,4,2,2,0.019070158996155114,2019-03-29 09:00:00,2019-03-29 09:15:00
104,2,0,2,0.0028684275575988384,2019-03-29 09:00:00,2019-03-29 09:15:00
108,1,1,0,0.004087614838218051,2019-03-29 09:00:00,2019-03-29 09:15:00
109,1,1,0,0.005306802118837264,2019-03-29 09:00:00,2019-03-29 09:15:00
110,4,2,2,0.007647957080404343,2019-03-29 09:00:00,2019-03-29 09:15:00
111,4,3,1,0.0208948814671817,2019-03-29 09:00:00,2019-03-29 09:15:00
112,1,0,1,0.0028684275575988384,2019-03-29 09:00:00,2019-03-29 09:15:00
113,4,2,2,0.007109466319915809,2019-03-29 09:00:00,2019-03-29 09:15:00
114,3,2,1,0.004900406358630859,2019-03-29 09:00:00,2019-03-29 09:15:00
115,2,1,1,0.005187725684311033,2019-03-29 09:00:00,2019-03-29 09:15:00
118,1,0,1,0.0028684275575988384,2019-03-29 09:00:00,2019-03-29 09:15:00
119,1,1,0,0.012674899469597057,2019-03-29 09:00:00,2019-03-29 09:15:00
120,3,2,1,0.010795267508039904,2019-03-29 09:00:00,2019-03-29 09:15:00
126,2,1,1,0.012045462245454625,2019-03-29 09:00:00,2019-03-29 09:15:00
127,1,1,0,0.005306802118837264,2019-03-29 09:00:00,2019-03-29 09:15:00
129,3,1,2,0.005306802118837264,2019-03-29 09:00:00,2019-03-29 09:15:00
135,2,0,2,0.0028684275575988384,2019-03-29 09:00:00,2019-03-29 09:15:00
137,5,5,0,0.017943863064082625,2019-03-29 09:00:00,2019-03-29 09:15:00
138,4,4,0,0.010518990326352378,2019-03-29 09:00:00,2019-03-29 09:15:00
147,3,1,2,0.007109466319915809,2019-03-29 09:00:00,2019-03-29 09:15:00
151,3,2,1,0.033151371053552904,2019-03-29 09:00:00,2019-03-29 09:15:00
153,3,1,2,0.004087614838218051,2019-03-29 09:00:00,2019-03-29 09:15:00
154,1,1,0,0.006460277821206424,2019-03-29 09:00:00,2019-03-29 09:15:00
157,2,0,2,0.0028684275575988384,2019-03-29 09:00:00,2019-03-29 09:15:00
158,2,0,2,0.0028684275575988384,2019-03-29 09:00:00,2019-03-29 09:15:00
162,2,0,2,0.0028684275575988384,2019-03-29 09:00:00,2019-03-29 09:15:00
164,4,2,2,0.023070212702209318,2019-03-29 09:00:00,2019-03-29 09:15:00
168,8,2,6,0.006044071624879506,2019-03-29 09:00:00,2019-03-29 09:15:00
169,2,2,0,0.005306802118837264,2019-03-29 09:00:00,2019-03-29 09:15:00
170,4,1,3,0.012674899469597057,2019-03-29 09:00:00,2019-03-29 09:15:00
172,3,1,2,0.004988946938757324,2019-03-29 09:00:00,2019-03-29 09:15:00
175,1,0,1,0.0028684275575988384,2019-03-29 09:00:00,2019-03-29 09:15:00
177,2,1,1,0.019070158996155114,2019-03-29 09:00:00,2019-03-29 09:15:00
189,3,3,0,0.010908474025382484,2019-03-29 09:00:00,2019-03-29 09:15:00
195,2,1,1,0.004087614838218051,2019-03-29 09:00:00,2019-03-29 09:15:00
196,3,2,1,0.006163148059405737,2019-03-29 09:00:00,2019-03-29 09:15:00
197,2,0,2,0.0028684275575988384,2019-03-29 09:00:00,2019-03-29 09:15:00
199,1,0,1,0.0028684275575988384,2019-03-29 09:00:00,2019-03-29 09:15:00
201,1,0,1,0.0028684275575988384,2019-03-29 09:00:00,2019-03-29 09:15:00
202,2,0,2,0.0028684275575988384,2019-03-29 09:00:00,2019-03-29 09:15:00
1,5,3,2,0.010929501433957895,2019-03-29 09:15:00,2019-03-29 09:30:00
5,2,1,1,0.020103071631485895,2019-03-29 09:15:00,2019-03-29 09:30:00
10,2,1,1,0.020103071631485895,2019-03-29 09:15:00,2019-03-29 09:30:00
15,1,1,0,0.009546941093579647,2019-03-29 09:15:00,2019-03-29 09:30:00
16,3,1,2,0.005256698125138023,2019-03-29 09:15:00,2019-03-29 09:30:00
18,4,2,2,0.009574758452339807,2019-03-29 09:15:00,2019-03-29 09:30:00
19,2,1,1,0.00527605668258678,2019-03-29 09:15:00,2019-03-29 09:30:00
20,3,1,2,0.005256698125138023,2019-03-29 09:15:00,2019-03-29 09:30:00
21,2,2,0,0.006876191332374865,2019-03-29 09:15:00,2019-03-29 09:30:00
23,2,1,1,0.007674970911076322,2019-03-29 09:15:00,2019-03-29 09:30:00
27,1,1,0,0.005699532127169032,2019-03-29 09:15:00,2019-03-29 09:30:00
30,2,1,1,0.005256698125138023,2019-03-29 09:15:00,2019-03-29 09:30:00
35,2,0,2,0.0030223287920089167,2019-03-29 09:15:00,2019-03-29 09:30:00
37,6,2,4,0.007825939818715322,2019-03-29 09:15:00,2019-03-29 09:30:00
41,5,2,3,0.007953260017746894,2019-03-29 09:15:00,2019-03-29 09:30:00
46,2,1,1,0.020103071631485895,2019-03-29 09:15:00,2019-03-29 09:30:00
57,4,2,2,0.006298543622174363,2019-03-29 09:15:00,2019-03-29 09:30:00
58,3,3,0,0.009575703323523414,2019-03-29 09:15:00,2019-03-29 09:30:00
61,2,0,2,0.0030223287920089167,2019-03-29 09:15:00,2019-03-29 09:30:00
62,2,1,1,0.020103071631485895,2019-03-29 09:15:00,2019-03-29 09:30:00
64,1,0,1,0.0030223287920089167,2019-03-29 09:15:00,2019-03-29 09:30:00
66,1,0,1,0.0030223287920089167,2019-03-29 09:15:00,2019-03-29 09:30:00
67,1,1,0,0.007775698157299693,2019-03-29 09:15:00,2019-03-29 09:30:00
69,3,1,2,0.005256698125138023,2019-03-29 09:15:00,2019-03-29 09:30:00
74,2,2,0,0.005591570485586216,2019-03-29 09:15:00,2019-03-29 09:30:00
80,2,1,1,0.020103071631485895,2019-03-29 09:15:00,2019-03-29 09:30:00
85,1,1,0,0.0043272512523230625,2019-03-29 09:15:00,2019-03-29 09:30:00
86,1,0,1,0.0030223287920089167,2019-03-29 09:15:00,2019-03-29 09:30:00
87,2,2,0,0.010753420144974535,2019-03-29 09:15:00,2019-03-29 09:30:00
88,1,0,1,0.0030223287920089167,2019-03-29 09:15:00,2019-03-29 09:30:00
89,1,0,1,0.0030223287920089167,2019-03-29 09:15:00,2019-03-29 09:30:00
90,1,0,1,0.0030223287920089167,2019-03-29 09:15:00,2019-03-29 09:30:00
99,5,2,3,0.006975915112983405,2019-03-29 09:15:00,2019-03-29 09:30:00
104,1,0,1,0.0030223287920089167,2019-03-29 09:15:00,2019-03-29 09:30:00
108,1,1,0,0.004306949638797566,2019-03-29 09:15:00,2019-03-29 09:30:00
109,3,2,1,0.009741924360449593,2019-03-29 09:15:00,2019-03-29 09:30:00
110,6,3,3,0.011387753541692167,2019-03-29 09:15:00,2019-03-29 09:30:00
111,2,2,0,0.017270391835936212,2019-03-29 09:15:00,2019-03-29 09:30:00
112,5,3,2,0.03718381447096286,2019-03-29 09:15:00,2019-03-29 09:30:00
113,1,0,1,0.0030223287920089167,2019-03-29 09:15:00,2019-03-29 09:30:00
114,2,1,1,0.004306949638797566,2019-03-29 09:15:00,2019-03-29 09:30:00
115,1,0,1,0.0030223287920089167,2019-03-29 09:15:00,2019-03-29 09:30:00
118,2,0,2,0.0030223287920089167,2019-03-29 09:15:00,2019-03-29 09:30:00
119,1,0,1,0.0030223287920089167,2019-03-29 09:15:00,2019-03-29 09:30:00
120,1,0,1,0.0030223287920089167,2019-03-29 09:15:00,2019-03-29 09:30:00
126,2,1,1,0.005591570485586216,2019-03-29 09:15:00,2019-03-29 09:30:00
127,1,1,0,0.007668087426682001,2019-03-29 09:15:00,2019-03-29 09:30:00
129,1,1,0,0.005591570485586216,2019-03-29 09:15:00,2019-03-29 09:30:00
135,2,0,2,0.0030223287920089167,2019-03-29 09:15:00,2019-03-29 09:30:00
137,5,4,1,0.01296442320586992,2019-03-29 09:15:00,2019-03-29 09:30:00
138,2,2,0,0.005611872099111712,2019-03-29 09:15:00,2019-03-29 09:30:00
147,1,1,0,0.00749106745826713,2019-03-29 09:15:00,2019-03-29 09:30:00
151,3,2,1,0.03494944513783377,2019-03-29 09:15:00,2019-03-29 09:30:00
153,2,2,0,0.005611872099111712,2019-03-29 09:15:00,2019-03-29 09:30:00
154,1,1,0,0.0043272512523230625,2019-03-29 09:15:00,2019-03-29 09:30:00
156,1,0,1,0.0030223287920089167,2019-03-29 09:15:00,2019-03-29 09:30:00
157,3,1,2,0.0046855453765018385,2019-03-29 09:15:00,2019-03-29 09:30:00
158,3,1,2,0.011304109885004921,2019-03-29 09:15:00,2019-03-29 09:30:00
162,2,0,2,0.0030223287920089167,2019-03-29 09:15:00,2019-03-29 09:30:00
164,5,3,2,0.010945977155906445,2019-03-29 09:15:00,2019-03-29 09:30:00
168,3,1,2,0.005256698125138023,2019-03-29 09:15:00,2019-03-29 09:30:00
169,2,2,0,0.012632273535552319,2019-03-29 09:15:00,2019-03-29 09:30:00
170,6,1,5,0.007674970911076322,2019-03-29 09:15:00,2019-03-29 09:30:00
171,1,1,0,0.004306949638797566,2019-03-29 09:15:00,2019-03-29 09:30:00
172,3,1,2,0.005256698125138023,2019-03-29 09:15:00,2019-03-29 09:30:00
175,1,0,1,0.0030223287920089167,2019-03-29 09:15:00,2019-03-29 09:30:00
177,2,1,1,0.020103071631485895,2019-03-29 09:15:00,2019-03-29 09:30:00
189,1,1,0,0.0043272512523230625,2019-03-29 09:15:00,2019-03-29 09:30:00
190,2,1,1,0.020103071631485895,2019-03-29 09:15:00,2019-03-29 09:30:00
191,2,2,0,0.007845298376164078,2019-03-29 09:15:00,2019-03-29 09:30:00
195,2,2,0,0.006298543622174362,2019-03-29 09:15:00,2019-03-29 09:30:00
196,2,0,2,0.0030223287920089167,2019-03-29 09:15:00,2019-03-29 09:30:00
202,2,1,1,0.0046855453765018385,2019-03-29 09:15:00,2019-03-29 09:30:00
1,3,1,2,0.006229865632030096,2019-03-29 09:30:00,2019-03-29 09:45:00
2,1,0,1,0.0033673478888324522,2019-03-29 09:30:00,2019-03-29 09:45:00
5,3,1,2,0.0058567428824329556,2019-03-29 09:30:00,2019-03-29 09:45:00
10,2,1,1,0.02237894335717644,2019-03-29 09:30:00,2019-03-29 09:45:00
11,1,1,0,0.009286357531272394,2019-03-29 09:30:00,2019-03-29 09:45:00
15,1,1,0,0.004798606760431274,2019-03-29 09:30:00,2019-03-29 09:45:00
16,4,3,1,0.011926456175001814,2019-03-29 09:30:00,2019-03-29 09:45:00
18,1,0,1,0.0033673478888324522,2019-03-29 09:30:00,2019-03-29 09:45:00
19,2,2,0,0.010642497106565185,2019-03-29 09:30:00,2019-03-29 09:45:00
20,4,2,2,0.01018663698328709,2019-03-29 09:30:00,2019-03-29 09:45:00
21,1,1,0,0.006229865632030096,2019-03-29 09:30:00,2019-03-29 09:45:00
22,1,1,0,0.006229865632030096,2019-03-29 09:30:00,2019-03-29 09:45:00
23,2,0,2,0.0033673478888324522,2019-03-29 09:30:00,2019-03-29 09:45:00
27,1,1,0,0.0055912136643616415,2019-03-29 09:30:00,2019-03-29 09:45:00
30,4,2,2,0.013388043692748772,2019-03-29 09:30:00,2019-03-29 09:45:00
37,5,1,4,0.004798606760431274,2019-03-29 09:30:00,2019-03-29 09:45:00
41,4,1,3,0.0055912136643616415,2019-03-29 09:30:00,2019-03-29 09:45:00
46,2,1,1,0.02237894335717644,2019-03-29 09:30:00,2019-03-29 09:45:00
57,3,1,2,0.005232077443099024,2019-03-29 09:30:00,2019-03-29 09:45:00
58,4,4,0,0.013644091973510122,2019-03-29 09:30:00,2019-03-29 09:45:00
61,1,1,0,0.006015316342024821,2019-03-29 09:30:00,2019-03-29 09:45:00
62,1,1,0,0.0058567428824329556,2019-03-29 09:30:00,2019-03-29 09:45:00
69,3,1,2,0.0058567428824329556,2019-03-29 09:30:00,2019-03-29 09:45:00
74,1,1,0,0.006229865632030096,2019-03-29 09:30:00,2019-03-29 09:45:00
75,1,0,1,0.0033673478888324522,2019-03-29 09:30:00,2019-03-29 09:45:00
80,1,0,1,0.0033673478888324522,2019-03-29 09:30:00,2019-03-29 09:45:00
85,2,1,1,0.006229865632030096,2019-03-29 09:30:00,2019-03-29 09:45:00
86,1,0,1,0.0033673478888324522,2019-03-29 09:30:00,2019-03-29 09:45:00
87,1,0,1,0.0033673478888324522,2019-03-29 09:30:00,2019-03-29 09:45:00
88,1,1,0,0.006229865632030096,2019-03-29 09:30:00,2019-03-29 09:45:00
89,2,0,2,0.0033673478888324522,2019-03-29 09:30:00,2019-03-29 09:45:00
99,1,0,1,0.0033673478888324522,2019-03-29 09:30:00,2019-03-29 09:45:00
104,2,1,1,0.008663284795217191,2019-03-29 09:30:00,2019-03-29 09:45:00
108,1,1,0,0.006229865632030096,2019-03-29 09:30:00,2019-03-29 09:45:00
109,1,0,1,0.0033673478888324522,2019-03-29 09:30:00,2019-03-29 09:45:00
110,2,1,1,0.008005802309802489,2019-03-29 09:30:00,2019-03-29 09:45:00
111,2,2,0,0.011525802538414835,2019-03-29 09:30:00,2019-03-29 09:45:00
112,1,1,0,0.006229865632030096,2019-03-29 09:30:00,2019-03-29 09:45:00
114,2,1,1,0.006229865632030096,2019-03-29 09:30:00,2019-03-29 09:45:00
115,1,1,0,0.006229865632030096,2019-03-29 09:30:00,2019-03-29 09:45:00
118,1,0,1,0.0033673478888324522,2019-03-29 09:30:00,2019-03-29 09:45:00
119,5,2,3,0.01636871900831026,2019-03-29 09:30:00,2019-03-29 09:45:00
120,1,0,1,0.0033673478888324522,2019-03-29 09:30:00,2019-03-29 09:45:00
122,2,0,2,0.0033673478888324522,2019-03-29 09:30:00,2019-03-29 09:45:00
127,2,2,0,0.0074465752136236435,2019-03-29 09:30:00,2019-03-29 09:45:00
135,1,0,1,0.0033673478888324522,2019-03-29 09:30:00,2019-03-29 09:45:00
137,1,0,1,0.0033673478888324522,2019-03-29 09:30:00,2019-03-29 09:45:00
138,4,2,2,0.013924811952242431,2019-03-29 09:30:00,2019-03-29 09:45:00
140,1,1,0,0.004798606760431274,2019-03-29 09:30:00,2019-03-29 09:45:00
141,1,0,1,0.0033673478888324522,2019-03-29 09:30:00,2019-03-29 09:45:00
147,1,0,1,0.0033673478888324522,2019-03-29 09:30:00,2019-03-29 09:45:00
151,3,2,1,0.031219006413640577,2019-03-29 09:30:00,2019-03-29 09:45:00
153,1,1,0,0.006229865632030096,2019-03-29 09:30:00,2019-03-29 09:45:00
154,1,1,0,0.004798606760431274,2019-03-29 09:30:00,2019-03-29 09:45:00
156,1,0,1,0.0033673478888324522,2019-03-29 09:30:00,2019-03-29 09:45:00
157,3,1,2,0.00438715472003025,2019-03-29 09:30:00,2019-03-29 09:45:00
158,2,0,2,0.0033673478888324522,2019-03-29 09:30:00,2019-03-29 09:45:00
162,1,0,1,0.0033673478888324522,2019-03-29 09:30:00,2019-03-29 09:45:00
164,4,4,0,0.019319530621119945,2019-03-29 09:30:00,2019-03-29 09:45:00
168,2,1,1,0.02237894335717644,2019-03-29 09:30:00,2019-03-29 09:45:00
170,1,0,1,0.0033673478888324522,2019-03-29 09:30:00,2019-03-29 09:45:00
172,4,1,3,0.004698817244248166,2019-03-29 09:30:00,2019-03-29 09:45:00
177,3,1,2,0.0058567428824329556,2019-03-29 09:30:00,2019-03-29 09:45:00
190,4,3,1,0.051907869893794555,2019-03-29 09:30:00,2019-03-29 09:45:00
191,3,3,0,0.007714423630517532,2019-03-29 09:30:00,2019-03-29 09:45:00
195,1,1,0,0.005232077443099024,2019-03-29 09:30:00,2019-03-29 09:45:00
202,1,1,0,0.00438715472003025,2019-03-29 09:30:00,2019-03-29 09:45:00
2,1,0,1,0.0030633809678845816,2019-03-29 09:45:00,2019-03-29 10:00:00
5,3,2,1,0.026173327507307442,2019-03-29 09:45:00,2019-03-29 10:00:00
10,2,1,1,0.020395840872451734,2019-03-29 09:45:00,2019-03-29 10:00:00
11,1,1,0,0.012858243319798918,2019-03-29 09:45:00,2019-03-29 10:00:00
15,2,1,1,0.020395840872451734,2019-03-29 09:45:00,2019-03-29 10:00:00
16,4,3,1,0.11819508692489207,2019-03-29 09:45:00,2019-03-29 10:00:00
19,1,1,0,0.004365462770073644,2019-03-29 09:45:00,2019-03-29 10:00:00
20,2,1,1,0.020395840872451734,2019-03-29 09:45:00,2019-03-29 10:00:00
23,2,1,1,0.004365462770073644,2019-03-29 09:45:00,2019-03-29 10:00:00
27,1,1,0,0.004365462770073644,2019-03-29 09:45:00,2019-03-29 10:00:00
30,2,0,2,0.0030633809678845816,2019-03-29 09:45:00,2019-03-29 10:00:00
37,1,1,0,0.00393143550267729,2019-03-29 09:45:00,2019-03-29 10:00:00
40,2,1,1,0.005667544572262707,2019-03-29 09:45:00,2019-03-29 10:00:00
41,4,1,3,0.004365462770073644,2019-03-29 09:45:00,2019-03-29 10:00:00
57,2,0,2,0.0030633809678845816,2019-03-29 09:45:00,2019-03-29 10:00:00
58,2,1,1,0.006579312583470735,2019-03-29 09:45:00,2019-03-29 10:00:00
62,1,1,0,0.005328162353226652,2019-03-29 09:45:00,2019-03-29 10:00:00
69,2,1,1,0.020395840872451734,2019-03-29 09:45:00,2019-03-29 10:00:00
74,2,2,0,0.009183476187848861,2019-03-29 09:45:00,2019-03-29 10:00:00
75,1,0,1,0.0030633809678845816,2019-03-29 09:45:00,2019-03-29 10:00:00
79,1,0,1,0.0030633809678845816,2019-03-29 09:45:00,2019-03-29 10:00:00
80,1,0,1,0.0030633809678845816,2019-03-29 09:45:00,2019-03-29 10:00:00
85,1,1,0,0.00755379987037775,2019-03-29 09:45:00,2019-03-29 10:00:00
88,1,1,0,0.005667544572262707,2019-03-29 09:45:00,2019-03-29 10:00:00
89,1,0,1,0.0030633809678845816,2019-03-29 09:45:00,2019-03-29 10:00:00
104,1,1,0,0.004365462770073644,2019-03-29 09:45:00,2019-03-29 10:00:00
109,1,0,1,0.0030633809678845816,2019-03-29 09:45:00,2019-03-29 10:00:00
110,2,1,1,0.020395840872451734,2019-03-29 09:45:00,2019-03-29 10:00:00
111,1,1,0,0.0078813943856598,2019-03-29 09:45:00,2019-03-29 10:00:00
112,1,0,1,0.0030633809678845816,2019-03-29 09:45:00,2019-03-29 10:00:00
114,2,0,2,0.0030633809678845816,2019-03-29 09:45:00,2019-03-29 10:00:00
115,1,1,0,0.005667544572262707,2019-03-29 09:45:00,2019-03-29 10:00:00
116,1,0,1,0.0030633809678845816,2019-03-29 09:45:00,2019-03-29 10:00:00
119,8,4,4,0.015290488180900638,2019-03-29 09:45:00,2019-03-29 10:00:00
122,3,0,3,0.0030633809678845816,2019-03-29 09:45:00,2019-03-29 10:00:00
127,1,1,0,0.00393143550267729,2019-03-29 09:45:00,2019-03-29 10:00:00
133,3,0,3,0.0030633809678845816,2019-03-29 09:45:00,2019-03-29 10:00:00
135,1,0,1,0.0030633809678845816,2019-03-29 09:45:00,2019-03-29 10:00:00
137,7,5,2,0.010564231311296518,2019-03-29 09:45:00,2019-03-29 10:00:00
138,4,3,1,0.011521537580056165,2019-03-29 09:45:00,2019-03-29 10:00:00
140,2,1,1,0.005667544572262707,2019-03-29 09:45:00,2019-03-29 10:00:00
141,1,0,1,0.0030633809678845816,2019-03-29 09:45:00,2019-03-29 10:00:00
151,3,1,2,0.005328162353226652,2019-03-29 09:45:00,2019-03-29 10:00:00
154,1,1,0,0.006774469478961253,2019-03-29 09:45:00,2019-03-29 10:00:00
158,3,2,1,0.013474588473000128,2019-03-29 09:45:00,2019-03-29 10:00:00
159,1,1,0,0.005328162353226652,2019-03-29 09:45:00,2019-03-29 10:00:00
164,4,2,2,0.008271708176640833,2019-03-29 09:45:00,2019-03-29 10:00:00
168,2,1,1,0.020395840872451734,2019-03-29 09:45:00,2019-03-29 10:00:00
170,4,1,3,0.004274694833709264,2019-03-29 09:45:00,2019-03-29 10:00:00
172,2,1,1,0.020395840872451734,2019-03-29 09:45:00,2019-03-29 10:00:00
173,1,1,0,0.004365462770073644,2019-03-29 09:45:00,2019-03-29 10:00:00
177,3,1,2,0.005328162353226652,2019-03-29 09:45:00,2019-03-29 10:00:00
190,2,2,0,0.00690457407595493,2019-03-29 09:45:00,2019-03-29 10:00:00
191,1,1,0,0.004300410471576805,2019-03-29 09:45:00,2019-03-29 10:00:00
202,2,1,1,0.00393143550267729,2019-03-29 09:45:00,2019-03-29 10:00:00
5,3,2,1,0.026610779162473015,2019-03-29 10:00:00,2019-03-29 10:15:00
10,3,1,2,0.005477890375269523,2019-03-29 10:00:00,2019-03-29 10:15:00
11,1,1,0,0.013791762871393125,2019-03-29 10:00:00,2019-03-29 10:15:00
16,3,1,2,0.005477890375269523,2019-03-29 10:00:00,2019-03-29 10:15:00
18,1,0,1,0.0031494337035823266,2019-03-29 10:00:00,2019-03-29 10:15:00
19,1,1,0,0.00472203640592303,2019-03-29 10:00:00,2019-03-29 10:15:00
20,3,2,1,0.053897602668815894,2019-03-29 10:00:00,2019-03-29 10:15:00
23,1,1,0,0.005779746496580265,2019-03-29 10:00:00,2019-03-29 10:15:00
27,1,1,0,0.005826785141960677,2019-03-29 10:00:00,2019-03-29 10:15:00
30,1,0,1,0.0031494337035823266,2019-03-29 10:00:00,2019-03-29 10:15:00
35,1,1,0,0.005826785141960677,2019-03-29 10:00:00,2019-03-29 10:15:00
37,1,0,1,0.0031494337035823266,2019-03-29 10:00:00,2019-03-29 10:15:00
40,2,2,0,0.010371855437667488,2019-03-29 10:00:00,2019-03-29 10:15:00
41,2,0,2,0.0031494337035823266,2019-03-29 10:00:00,2019-03-29 10:15:00
46,1,1,0,0.005826785141960677,2019-03-29 10:00:00,2019-03-29 10:15:00
57,1,0,1,0.0031494337035823266,2019-03-29 10:00:00,2019-03-29 10:15:00
61,1,0,1,0.0031494337035823266,2019-03-29 10:00:00,2019-03-29 10:15:00
66,2,0,2,0.0031494337035823266,2019-03-29 10:00:00,2019-03-29 10:15:00
67,1,1,0,0.00978590895195276,2019-03-29 10:00:00,2019-03-29 10:15:00
69,2,1,1,0.020957940504786297,2019-03-29 10:00:00,2019-03-29 10:15:00
74,2,2,0,0.010134803718643916,2019-03-29 10:00:00,2019-03-29 10:15:00
75,1,0,1,0.0031494337035823266,2019-03-29 10:00:00,2019-03-29 10:15:00
79,1,0,1,0.0031494337035823266,2019-03-29 10:00:00,2019-03-29 10:15:00
80,1,0,1,0.0031494337035823266,2019-03-29 10:00:00,2019-03-29 10:15:00
87,1,1,0,0.0038187715631769143,2019-03-29 10:00:00,2019-03-29 10:15:00
89,1,0,1,0.0031494337035823266,2019-03-29 10:00:00,2019-03-29 10:15:00
90,1,1,0,0.0038187715631769143,2019-03-29 10:00:00,2019-03-29 10:15:00
104,6,2,4,0.007399387844301381,2019-03-29 10:00:00,2019-03-29 10:15:00
109,2,1,1,0.00472203640592303,2019-03-29 10:00:00,2019-03-29 10:15:00
110,5,3,2,0.010692298530570922,2019-03-29 10:00:00,2019-03-29 10:15:00
111,4,0,4,0.0031494337035823266,2019-03-29 10:00:00,2019-03-29 10:15:00
112,1,0,1,0.0031494337035823266,2019-03-29 10:00:00,2019-03-29 10:15:00
114,1,0,1,0.0031494337035823266,2019-03-29 10:00:00,2019-03-29 10:15:00
116,1,0,1,0.0031494337035823266,2019-03-29 10:00:00,2019-03-29 10:15:00
119,4,3,1,0.0473520839762396,2019-03-29 10:00:00,2019-03-29 10:15:00
120,1,1,0,0.00472203640592303,2019-03-29 10:00:00,2019-03-29 10:15:00
129,1,0,1,0.0031494337035823266,2019-03-29 10:00:00,2019-03-29 10:15:00
133,5,1,4,0.003999424531726138,2019-03-29 10:00:00,2019-03-29 10:15:00
135,1,0,1,0.0031494337035823266,2019-03-29 10:00:00,2019-03-29 10:15:00
137,5,3,2,0.0061880910790591236,2019-03-29 10:00:00,2019-03-29 10:15:00
138,4,3,1,0.012518446591254357,2019-03-29 10:00:00,2019-03-29 10:15:00
140,2,0,2,0.0031494337035823266,2019-03-29 10:00:00,2019-03-29 10:15:00
141,2,2,0,0.008504136580339028,2019-03-29 10:00:00,2019-03-29 10:15:00
151,3,2,1,0.03876644730599026,2019-03-29 10:00:00,2019-03-29 10:15:00
153,2,1,1,0.005477890375269523,2019-03-29 10:00:00,2019-03-29 10:15:00
154,2,2,0,0.005826785141960677,2019-03-29 10:00:00,2019-03-29 10:15:00
158,2,2,0,0.00515744728236609,2019-03-29 10:00:00,2019-03-29 10:15:00
164,4,2,2,0.010134803718643915,2019-03-29 10:00:00,2019-03-29 10:15:00
168,2,1,1,0.020957940504786297,2019-03-29 10:00:00,2019-03-29 10:15:00
170,2,1,1,0.00780634704695672,2019-03-29 10:00:00,2019-03-29 10:15:00
172,2,1,1,0.020957940504786297,2019-03-29 10:00:00,2019-03-29 10:15:00
173,1,1,0,0.005826785141960677,2019-03-29 10:00:00,2019-03-29 10:15:00
177,2,1,1,0.020957940504786297,2019-03-29 10:00:00,2019-03-29 10:15:00
189,2,1,1,0.020957940504786297,2019-03-29 10:00:00,2019-03-29 10:15:00
190,2,1,1,0.005826785141960677,2019-03-29 10:00:00,2019-03-29 10:15:00
195,1,1,0,0.005826785141960677,2019-03-29 10:00:00,2019-03-29 10:15:00
197,1,1,0,0.0044881094227715015,2019-03-29 10:00:00,2019-03-29 10:15:00
200,1,0,1,0.0031494337035823266,2019-03-29 10:00:00,2019-03-29 10:15:00
5,4,2,2,0.014721123830672717,2019-03-29 10:15:00,2019-03-29 10:30:00
10,5,2,3,0.006675201200397825,2019-03-29 10:15:00,2019-03-29 10:30:00
11,1,1,0,0.01106225564781076,2019-03-29 10:15:00,2019-03-29 10:30:00
15,1,0,1,0.00335685046770199,2019-03-29 10:15:00,2019-03-29 10:30:00
16,3,1,2,0.0058385420650665975,2019-03-29 10:15:00,2019-03-29 10:30:00
18,1,0,1,0.00335685046770199,2019-03-29 10:15:00,2019-03-29 10:30:00
19,2,2,0,0.0060171957045271505,2019-03-29 10:15:00,2019-03-29 10:30:00
20,3,2,1,0.05739336445676677,2019-03-29 10:15:00,2019-03-29 10:30:00
23,1,1,0,0.005996607639060037,2019-03-29 10:15:00,2019-03-29 10:30:00
27,1,1,0,0.005996607639060037,2019-03-29 10:15:00,2019-03-29 10:30:00
35,1,1,0,0.004783662220363698,2019-03-29 10:15:00,2019-03-29 10:30:00
37,1,0,1,0.00335685046770199,2019-03-29 10:15:00,2019-03-29 10:30:00
41,2,0,2,0.00335685046770199,2019-03-29 10:15:00,2019-03-29 10:30:00
46,1,1,0,0.006210473973025406,2019-03-29 10:15:00,2019-03-29 10:30:00
57,3,1,2,0.006210473973025406,2019-03-29 10:15:00,2019-03-29 10:30:00
61,1,0,1,0.00335685046770199,2019-03-29 10:15:00,2019-03-29 10:30:00
66,2,0,2,0.00335685046770199,2019-03-29 10:15:00,2019-03-29 10:30:00
67,2,2,0,0.016558253432549925,2019-03-29 10:15:00,2019-03-29 10:30:00
68,1,1,0,0.004580490969696212,2019-03-29 10:15:00,2019-03-29 10:30:00
79,1,0,1,0.00335685046770199,2019-03-29 10:15:00,2019-03-29 10:30:00
80,1,0,1,0.00335685046770199,2019-03-29 10:15:00,2019-03-29 10:30:00
85,2,1,1,0.006210473973025406,2019-03-29 10:15:00,2019-03-29 10:30:00
87,3,1,2,0.004580490969696212,2019-03-29 10:15:00,2019-03-29 10:30:00
88,1,0,1,0.00335685046770199,2019-03-29 10:15:00,2019-03-29 10:30:00
89,2,0,2,0.00335685046770199,2019-03-29 10:15:00,2019-03-29 10:30:00
90,3,3,0,0.008100167198173608,2019-03-29 10:15:00,2019-03-29 10:30:00
99,1,1,0,0.004070256344032844,2019-03-29 10:15:00,2019-03-29 10:30:00
104,4,0,4,0.00335685046770199,2019-03-29 10:15:00,2019-03-29 10:30:00
106,1,1,0,0.0058385420650665975,2019-03-29 10:15:00,2019-03-29 10:30:00
109,5,2,3,0.0052938968460270654,2019-03-29 10:15:00,2019-03-29 10:30:00
110,4,3,1,0.01119109147556941,2019-03-29 10:15:00,2019-03-29 10:30:00
111,7,1,6,0.008636364810418084,2019-03-29 10:15:00,2019-03-29 10:30:00
112,1,0,1,0.00335685046770199,2019-03-29 10:15:00,2019-03-29 10:30:00
115,2,1,1,0.004856967611147584,2019-03-29 10:15:00,2019-03-29 10:30:00
119,1,1,0,0.006210473973025406,2019-03-29 10:15:00,2019-03-29 10:30:00
120,2,2,0,0.00692387984935626,2019-03-29 10:15:00,2019-03-29 10:30:00
126,3,1,2,0.0058385420650665975,2019-03-29 10:15:00,2019-03-29 10:30:00
129,1,0,1,0.00335685046770199,2019-03-29 10:15:00,2019-03-29 10:30:00
133,3,2,1,0.006007302722357919,2019-03-29 10:15:00,2019-03-29 10:30:00
137,4,1,3,0.006210473973025406,2019-03-29 10:15:00,2019-03-29 10:30:00
138,3,2,1,0.009064097478348822,2019-03-29 10:15:00,2019-03-29 10:30:00
140,1,0,1,0.00335685046770199,2019-03-29 10:15:00,2019-03-29 10:30:00
141,3,3,0,0.018577811486553915,2019-03-29 10:15:00,2019-03-29 10:30:00
147,1,1,0,0.005303789828196297,2019-03-29 10:15:00,2019-03-29 10:30:00
151,3,2,1,0.041283608797294126,2019-03-29 10:15:00,2019-03-29 10:30:00
153,2,1,1,0.005248389447736116,2019-03-29 10:15:00,2019-03-29 10:30:00
154,2,2,0,0.006210473973025406,2019-03-29 10:15:00,2019-03-29 10:30:00
157,1,0,1,0.00335685046770199,2019-03-29 10:15:00,2019-03-29 10:30:00
158,1,0,1,0.00335685046770199,2019-03-29 10:15:00,2019-03-29 10:30:00
164,1,1,0,0.005116688581940688,2019-03-29 10:15:00,2019-03-29 10:30:00
168,2,1,1,0.022320229632498058,2019-03-29 10:15:00,2019-03-29 10:30:00
170,3,2,1,0.009318639132553623,2019-03-29 10:15:00,2019-03-29 10:30:00
172,2,1,1,0.022320229632498058,2019-03-29 10:15:00,2019-03-29 10:30:00
177,3,2,1,0.034883588639747186,2019-03-29 10:15:00,2019-03-29 10:30:00
189,2,2,0,0.011114416834433361,2019-03-29 10:15:00,2019-03-29 10:30:00
190,2,1,1,0.006210473973025406,2019-03-29 10:15:00,2019-03-29 10:30:00
195,2,1,1,0.006210473973025406,2019-03-29 10:15:00,2019-03-29 10:30:00
196,1,1,0,0.006210473973025406,2019-03-29 10:15:00,2019-03-29 10:30:00
197,1,1,0,0.004783662220363698,2019-03-29 10:15:00,2019-03-29 10:30:00
200,1,0,1,0.00335685046770199,2019-03-29 10:15:00,2019-03-29 10:30:00
203,1,0,1,0.00335685046770199,2019-03-29 10:15:00,2019-03-29 10:30:00
5,4,2,2,0.00972702753513558,2019-03-29 10:30:00,2019-03-29 10:45:00
10,2,0,2,0.0030227380089061727,2019-03-29 10:30:00,2019-03-29 10:45:00
11,5,3,2,0.04334347035448877,2019-03-29 10:30:00,2019-03-29 10:45:00
18,4,2,2,0.007324829266461087,2019-03-29 10:30:00,2019-03-29 10:45:00
19,4,3,1,0.00849043290539299,2019-03-29 10:30:00,2019-03-29 10:45:00
20,4,3,1,0.05655241745151145,2019-03-29 10:30:00,2019-03-29 10:45:00
26,1,1,0,0.010240781645221233,2019-03-29 10:30:00,2019-03-29 10:45:00
27,1,1,0,0.007193519649236995,2019-03-29 10:30:00,2019-03-29 10:45:00
37,1,1,0,0.006136292824542712,2019-03-29 10:30:00,2019-03-29 10:45:00
41,3,1,2,0.004307554689875762,2019-03-29 10:30:00,2019-03-29 10:45:00
57,4,2,2,0.009811924325698242,2019-03-29 10:30:00,2019-03-29 10:45:00
58,1,1,0,0.005592371370845352,2019-03-29 10:30:00,2019-03-29 10:45:00
61,2,1,1,0.020116882286201385,2019-03-29 10:30:00,2019-03-29 10:45:00
66,1,1,0,0.007776883776579676,2019-03-29 10:30:00,2019-03-29 10:45:00
67,1,1,0,0.00784053162042382,2019-03-29 10:30:00,2019-03-29 10:45:00
68,1,1,0,0.007221789792738933,2019-03-29 10:30:00,2019-03-29 10:45:00
69,2,1,1,0.020116882286201385,2019-03-29 10:30:00,2019-03-29 10:45:00
85,3,1,2,0.008056269239486909,2019-03-29 10:30:00,2019-03-29 10:45:00
87,2,0,2,0.0030227380089061727,2019-03-29 10:30:00,2019-03-29 10:45:00
88,1,0,1,0.0030227380089061727,2019-03-29 10:30:00,2019-03-29 10:45:00
90,5,3,2,0.0058282155749861285,2019-03-29 10:30:00,2019-03-29 10:45:00
99,1,1,0,0.004211274450824549,2019-03-29 10:30:00,2019-03-29 10:45:00
104,5,1,4,0.005592371370845352,2019-03-29 10:30:00,2019-03-29 10:45:00
106,1,1,0,0.005592371370845352,2019-03-29 10:30:00,2019-03-29 10:45:00
109,2,1,1,0.004211274450824549,2019-03-29 10:30:00,2019-03-29 10:45:00
110,2,1,1,0.005592371370845352,2019-03-29 10:30:00,2019-03-29 10:45:00
111,6,3,3,0.014817089730809358,2019-03-29 10:30:00,2019-03-29 10:45:00
112,2,0,2,0.0030227380089061727,2019-03-29 10:30:00,2019-03-29 10:45:00
113,1,0,1,0.0030227380089061727,2019-03-29 10:30:00,2019-03-29 10:45:00
114,1,0,1,0.0030227380089061727,2019-03-29 10:30:00,2019-03-29 10:45:00
115,1,0,1,0.0030227380089061727,2019-03-29 10:30:00,2019-03-29 10:45:00
120,1,1,0,0.004211274450824549,2019-03-29 10:30:00,2019-03-29 10:45:00
126,1,0,1,0.0030227380089061727,2019-03-29 10:30:00,2019-03-29 10:45:00
133,1,0,1,0.0030227380089061727,2019-03-29 10:30:00,2019-03-29 10:45:00
137,6,1,5,0.0055001066755456934,2019-03-29 10:30:00,2019-03-29 10:45:00
138,7,5,2,0.00821835081036181,2019-03-29 10:30:00,2019-03-29 10:45:00
141,3,2,1,0.005592371370845352,2019-03-29 10:30:00,2019-03-29 10:45:00
147,1,1,0,0.004307554689875762,2019-03-29 10:30:00,2019-03-29 10:45:00
151,2,1,1,0.020116882286201385,2019-03-29 10:30:00,2019-03-29 10:45:00
154,1,1,0,0.005592371370845352,2019-03-29 10:30:00,2019-03-29 10:45:00
156,2,1,1,0.020116882286201385,2019-03-29 10:30:00,2019-03-29 10:45:00
157,2,1,1,0.0059207995434538115,2019-03-29 10:30:00,2019-03-29 10:45:00
158,2,1,1,0.003957897197599492,2019-03-29 10:30:00,2019-03-29 10:45:00
164,5,1,4,0.003957897197599492,2019-03-29 10:30:00,2019-03-29 10:45:00
168,2,1,1,0.020116882286201385,2019-03-29 10:30:00,2019-03-29 10:45:00
169,1,1,0,0.007776883776579676,2019-03-29 10:30:00,2019-03-29 10:45:00
170,1,1,0,0.0055001066755456934,2019-03-29 10:30:00,2019-03-29 10:45:00
172,2,1,1,0.020116882286201385,2019-03-29 10:30:00,2019-03-29 10:45:00
173,1,1,0,0.005592371370845352,2019-03-29 10:30:00,2019-03-29 10:45:00
177,3,2,1,0.028663954424849005,2019-03-29 10:30:00,2019-03-29 10:45:00
189,7,3,4,0.01363551183226022,2019-03-29 10:30:00,2019-03-29 10:45:00
191,2,0,2,0.0030227380089061727,2019-03-29 10:30:00,2019-03-29 10:45:00
195,4,2,2,0.011333848729152612,2019-03-29 10:30:00,2019-03-29 10:45:00
196,2,2,0,0.00849043290539299,2019-03-29 10:30:00,2019-03-29 10:45:00
197,1,1,0,0.004853682791309343,2019-03-29 10:30:00,2019-03-29 10:45:00
199,1,0,1,0.0030227380089061727,2019-03-29 10:30:00,2019-03-29 10:45:00
202,2,1,1,0.020116882286201385,2019-03-29 10:30:00,2019-03-29 10:45:00
203,1,0,1,0.0030227380089061727,2019-03-29 10:30:00,2019-03-29 10:45:00
2,1,0,1,0.0022407135486382625,2019-03-29 10:45:00,2019-03-29 11:00:00
5,3,1,2,0.0038971414404245256,2019-03-29 10:45:00,2019-03-29 11:00:00
11,2,1,1,0.014924347118085077,2019-03-29 10:45:00,2019-03-29 11:00:00
15,2,1,1,0.014924347118085077,2019-03-29 10:45:00,2019-03-29 11:00:00
18,10,7,3,0.027201856639485815,2019-03-29 10:45:00,2019-03-29 11:00:00
19,2,1,1,0.00541915980426819,2019-03-29 10:45:00,2019-03-29 11:00:00
20,3,2,1,0.06289598187683917,2019-03-29 10:45:00,2019-03-29 11:00:00
23,2,1,1,0.0041454535714878,2019-03-29 10:45:00,2019-03-29 11:00:00
26,3,1,2,0.006848088285774428,2019-03-29 10:45:00,2019-03-29 11:00:00
28,1,1,0,0.005151797998534084,2019-03-29 10:45:00,2019-03-29 11:00:00
30,2,1,1,0.0035699201886323396,2019-03-29 10:45:00,2019-03-29 11:00:00
37,11,7,4,0.030493890103186698,2019-03-29 10:45:00,2019-03-29 11:00:00
40,2,0,2,0.0022407135486382625,2019-03-29 10:45:00,2019-03-29 11:00:00
41,6,2,4,0.0038971414404245256,2019-03-29 10:45:00,2019-03-29 11:00:00
46,2,1,1,0.0041454535714878,2019-03-29 10:45:00,2019-03-29 11:00:00
50,1,0,1,0.0022407135486382625,2019-03-29 10:45:00,2019-03-29 11:00:00
57,4,3,1,0.01735262848732234,2019-03-29 10:45:00,2019-03-29 11:00:00
58,2,1,1,0.0041454535714878,2019-03-29 10:45:00,2019-03-29 11:00:00
61,2,1,1,0.014924347118085077,2019-03-29 10:45:00,2019-03-29 11:00:00
66,1,1,0,0.0031930835600630313,2019-03-29 10:45:00,2019-03-29 11:00:00
67,2,0,2,0.0022407135486382625,2019-03-29 10:45:00,2019-03-29 11:00:00
75,2,0,2,0.0022407135486382625,2019-03-29 10:45:00,2019-03-29 11:00:00
85,4,2,2,0.009939752770320113,2019-03-29 10:45:00,2019-03-29 11:00:00
87,7,3,4,0.006561540176628714,2019-03-29 10:45:00,2019-03-29 11:00:00
88,2,1,1,0.003635175978952458,2019-03-29 10:45:00,2019-03-29 11:00:00
90,3,1,2,0.006488401557145593,2019-03-29 10:45:00,2019-03-29 11:00:00
99,2,2,0,0.006481004638528161,2019-03-29 10:45:00,2019-03-29 11:00:00
104,4,1,3,0.004690892740602134,2019-03-29 10:45:00,2019-03-29 11:00:00
106,1,1,0,0.01044968229990682,2019-03-29 10:45:00,2019-03-29 11:00:00
109,6,3,3,0.014733170097214754,2019-03-29 10:45:00,2019-03-29 11:00:00
110,4,0,4,0.0022407135486382625,2019-03-29 10:45:00,2019-03-29 11:00:00
111,3,1,2,0.01699353707919085,2019-03-29 10:45:00,2019-03-29 11:00:00
112,3,1,2,0.009239972286926273,2019-03-29 10:45:00,2019-03-29 11:00:00
113,3,1,2,0.00576462482960545,2019-03-29 10:45:00,2019-03-29 11:00:00
115,3,2,1,0.0041454535714878,2019-03-29 10:45:00,2019-03-29 11:00:00
118,1,1,0,0.0041454535714878,2019-03-29 10:45:00,2019-03-29 11:00:00
119,4,2,2,0.009523095426688749,2019-03-29 10:45:00,2019-03-29 11:00:00
120,4,2,2,0.016463935538798085,2019-03-29 10:45:00,2019-03-29 11:00:00
126,2,1,1,0.009655697281701825,2019-03-29 10:45:00,2019-03-29 11:00:00
127,2,1,1,0.008721859135463495,2019-03-29 10:45:00,2019-03-29 11:00:00
135,1,1,0,0.0038971414404245256,2019-03-29 10:45:00,2019-03-29 11:00:00
137,7,5,2,0.00999350628127316,2019-03-29 10:45:00,2019-03-29 11:00:00
138,6,5,1,0.006592838775498581,2019-03-29 10:45:00,2019-03-29 11:00:00
141,5,4,1,0.017450617549842992,2019-03-29 10:45:00,2019-03-29 11:00:00
151,4,3,1,0.0339497974722553,2019-03-29 10:45:00,2019-03-29 11:00:00
153,1,0,1,0.0022407135486382625,2019-03-29 10:45:00,2019-03-29 11:00:00
154,2,2,0,0.007323899827117728,2019-03-29 10:45:00,2019-03-29 11:00:00
156,3,1,2,0.0038971414404245256,2019-03-29 10:45:00,2019-03-29 11:00:00
157,1,1,0,0.00541915980426819,2019-03-29 10:45:00,2019-03-29 11:00:00
159,1,0,1,0.0022407135486382625,2019-03-29 10:45:00,2019-03-29 11:00:00
164,5,1,4,0.0041454535714878,2019-03-29 10:45:00,2019-03-29 11:00:00
168,2,1,1,0.014924347118085077,2019-03-29 10:45:00,2019-03-29 11:00:00
170,3,2,1,0.011479734835654176,2019-03-29 10:45:00,2019-03-29 11:00:00
171,1,0,1,0.0022407135486382625,2019-03-29 10:45:00,2019-03-29 11:00:00
172,2,1,1,0.014924347118085077,2019-03-29 10:45:00,2019-03-29 11:00:00
173,1,0,1,0.0022407135486382625,2019-03-29 10:45:00,2019-03-29 11:00:00
177,2,1,1,0.014924347118085077,2019-03-29 10:45:00,2019-03-29 11:00:00
189,11,4,7,0.026168051865212223,2019-03-29 10:45:00,2019-03-29 11:00:00
191,1,0,1,0.0022407135486382625,2019-03-29 10:45:00,2019-03-29 11:00:00
195,3,2,1,0.05223198541554594,2019-03-29 10:45:00,2019-03-29 11:00:00
196,3,2,1,0.03601531586119213,2019-03-29 10:45:00,2019-03-29 11:00:00
197,1,1,0,0.0041454535714878,2019-03-29 10:45:00,2019-03-29 11:00:00
199,1,0,1,0.0022407135486382625,2019-03-29 10:45:00,2019-03-29 11:00:00
202,4,2,2,0.014924347118085077,2019-03-29 10:45:00,2019-03-29 11:00:00
203,1,0,1,0.0022407135486382625,2019-03-29 10:45:00,2019-03-29 11:00:00
2,3,2,1,0.010280021270594495,2019-03-29 11:00:00,2019-03-29 11:15:00
5,2,1,1,0.01831024449558897,2019-03-29 11:00:00,2019-03-29 11:15:00
11,2,1,1,0.01831024449558897,2019-03-29 11:00:00,2019-03-29 11:15:00
15,2,0,2,0.0027513498599462264,2019-03-29 11:00:00,2019-03-29 11:15:00
16,1,1,0,0.0035309679094641866,2019-03-29 11:00:00,2019-03-29 11:15:00
18,11,7,4,0.022903602417652703,2019-03-29 11:00:00,2019-03-29 11:15:00
19,1,1,0,0.006259090279738199,2019-03-29 11:00:00,2019-03-29 11:15:00
20,3,2,1,0.05832097842924491,2019-03-29 11:00:00,2019-03-29 11:15:00
23,3,1,2,0.004910482034140335,2019-03-29 11:00:00,2019-03-29 11:15:00
26,4,0,4,0.0027513498599462264,2019-03-29 11:00:00,2019-03-29 11:15:00
28,1,1,0,0.0033360633970846965,2019-03-29 11:00:00,2019-03-29 11:15:00
30,1,0,1,0.0027513498599462264,2019-03-29 11:00:00,2019-03-29 11:15:00
35,1,1,0,0.005743240198085463,2019-03-29 11:00:00,2019-03-29 11:15:00
37,10,6,4,0.019151135801596636,2019-03-29 11:00:00,2019-03-29 11:15:00
40,4,1,3,0.004684440250377749,2019-03-29 11:00:00,2019-03-29 11:15:00
41,1,0,1,0.0027513498599462264,2019-03-29 11:00:00,2019-03-29 11:15:00
46,1,0,1,0.0027513498599462264,2019-03-29 11:00:00,2019-03-29 11:15:00
57,5,3,2,0.016560016093478555,2019-03-29 11:00:00,2019-03-29 11:15:00
61,2,1,1,0.01831024449558897,2019-03-29 11:00:00,2019-03-29 11:15:00
62,1,1,0,0.004742495348921227,2019-03-29 11:00:00,2019-03-29 11:15:00
66,1,1,0,0.003920776934223167,2019-03-29 11:00:00,2019-03-29 11:15:00
67,2,0,2,0.0027513498599462264,2019-03-29 11:00:00,2019-03-29 11:15:00
68,1,0,1,0.0027513498599462264,2019-03-29 11:00:00,2019-03-29 11:15:00
75,2,0,2,0.0027513498599462264,2019-03-29 11:00:00,2019-03-29 11:15:00
85,3,3,0,0.01563734837943386,2019-03-29 11:00:00,2019-03-29 11:15:00
87,7,2,5,0.004827027247336106,2019-03-29 11:00:00,2019-03-29 11:15:00
88,2,1,1,0.0035720414472055753,2019-03-29 11:00:00,2019-03-29 11:15:00
89,3,1,2,0.00478533201452726,2019-03-29 11:00:00,2019-03-29 11:15:00
90,3,2,1,0.007938999556878719,2019-03-29 11:00:00,2019-03-29 11:15:00
99,2,2,0,0.0056749175456385775,2019-03-29 11:00:00,2019-03-29 11:15:00
104,1,0,1,0.0027513498599462264,2019-03-29 11:00:00,2019-03-29 11:15:00
106,1,1,0,0.004742495348921227,2019-03-29 11:00:00,2019-03-29 11:15:00
109,9,4,5,0.020630383447573574,2019-03-29 11:00:00,2019-03-29 11:15:00
110,5,1,4,0.005905017402297685,2019-03-29 11:00:00,2019-03-29 11:15:00
111,2,2,0,0.005090204008500108,2019-03-29 11:00:00,2019-03-29 11:15:00
112,3,0,3,0.0027513498599462264,2019-03-29 11:00:00,2019-03-29 11:15:00
115,4,2,2,0.005406210511912894,2019-03-29 11:00:00,2019-03-29 11:15:00
116,2,1,1,0.00707844568466462,2019-03-29 11:00:00,2019-03-29 11:15:00
119,5,3,2,0.009023489600369528,2019-03-29 11:00:00,2019-03-29 11:15:00
126,3,1,2,0.004684440250377749,2019-03-29 11:00:00,2019-03-29 11:15:00
127,4,1,3,0.0068216229243847504,2019-03-29 11:00:00,2019-03-29 11:15:00
133,3,0,3,0.0027513498599462264,2019-03-29 11:00:00,2019-03-29 11:15:00
137,10,6,4,0.014838660365554947,2019-03-29 11:00:00,2019-03-29 11:15:00
138,5,5,0,0.00972910123077689,2019-03-29 11:00:00,2019-03-29 11:15:00
140,2,1,1,0.005756413652313921,2019-03-29 11:00:00,2019-03-29 11:15:00
141,4,2,2,0.007038708329256159,2019-03-29 11:00:00,2019-03-29 11:15:00
151,5,4,1,0.057207481084695824,2019-03-29 11:00:00,2019-03-29 11:15:00
153,2,1,1,0.0035309679094641866,2019-03-29 11:00:00,2019-03-29 11:15:00
154,3,3,0,0.00892470692504513,2019-03-29 11:00:00,2019-03-29 11:15:00
157,1,1,0,0.0035309679094641866,2019-03-29 11:00:00,2019-03-29 11:15:00
158,4,2,2,0.0070696142083344436,2019-03-29 11:00:00,2019-03-29 11:15:00
159,1,0,1,0.0027513498599462264,2019-03-29 11:00:00,2019-03-29 11:15:00
162,2,2,0,0.003920776934223167,2019-03-29 11:00:00,2019-03-29 11:15:00
164,5,1,4,0.005752951233888278,2019-03-29 11:00:00,2019-03-29 11:15:00
168,3,2,1,0.030945941482421375,2019-03-29 11:00:00,2019-03-29 11:15:00
169,2,2,0,0.006011870576361083,2019-03-29 11:00:00,2019-03-29 11:15:00
170,4,1,3,0.0068216229243847504,2019-03-29 11:00:00,2019-03-29 11:15:00
172,3,1,2,0.00478533201452726,2019-03-29 11:00:00,2019-03-29 11:15:00
173,1,0,1,0.0027513498599462264,2019-03-29 11:00:00,2019-03-29 11:15:00
177,2,1,1,0.01831024449558897,2019-03-29 11:00:00,2019-03-29 11:15:00
189,7,3,4,0.008946649426943436,2019-03-29 11:00:00,2019-03-29 11:15:00
191,4,1,3,0.007619199616223274,2019-03-29 11:00:00,2019-03-29 11:15:00
195,2,1,1,0.01831024449558897,2019-03-29 11:00:00,2019-03-29 11:15:00
196,2,2,0,0.0065858527764912494,2019-03-29 11:00:00,2019-03-29 11:15:00
197,2,1,1,0.005090204008500108,2019-03-29 11:00:00,2019-03-29 11:15:00
201,1,1,0,0.005905017402297685,2019-03-29 11:00:00,2019-03-29 11:15:00
202,1,1,0,0.0068216229243847504,2019-03-29 11:00:00,2019-03-29 11:15:00
203,1,0,1,0.0027513498599462264,2019-03-29 11:00:00,2019-03-29 11:15:00
1,3,3,0,0.00912407800771976,2019-03-29 11:15:00,2019-03-29 11:30:00
2,4,3,1,0.006987417323359142,2019-03-29 11:15:00,2019-03-29 11:30:00
5,4,2,2,0.01680078421701239,2019-03-29 11:15:00,2019-03-29 11:30:00
10,3,0,3,0.0025220482526982706,2019-03-29 11:15:00,2019-03-29 11:30:00
11,2,1,1,0.01680078421701239,2019-03-29 11:15:00,2019-03-29 11:30:00
13,2,2,0,0.006488551686572197,2019-03-29 11:15:00,2019-03-29 11:30:00
15,1,0,1,0.0025220482526982706,2019-03-29 11:15:00,2019-03-29 11:30:00
16,3,3,0,0.010659537054922598,2019-03-29 11:15:00,2019-03-29 11:30:00
18,4,2,2,0.004590927668136945,2019-03-29 11:15:00,2019-03-29 11:30:00
19,1,1,0,0.006294049948363981,2019-03-29 11:15:00,2019-03-29 11:30:00
20,4,3,1,0.06201000493013309,2019-03-29 11:15:00,2019-03-29 11:30:00
23,1,1,0,0.0032604845898313813,2019-03-29 11:15:00,2019-03-29 11:30:00
26,2,0,2,0.0025220482526982706,2019-03-29 11:15:00,2019-03-29 11:30:00
30,1,0,1,0.0025220482526982706,2019-03-29 11:15:00,2019-03-29 11:30:00
35,1,1,0,0.005884299215247053,2019-03-29 11:15:00,2019-03-29 11:30:00
37,5,3,2,0.007494061254171437,2019-03-29 11:15:00,2019-03-29 11:30:00
40,1,0,1,0.0025220482526982706,2019-03-29 11:15:00,2019-03-29 11:30:00
41,1,0,1,0.0025220482526982706,2019-03-29 11:15:00,2019-03-29 11:30:00
57,3,1,2,0.004386553128250707,2019-03-29 11:15:00,2019-03-29 11:30:00
58,2,1,1,0.003518958496412537,2019-03-29 11:15:00,2019-03-29 11:30:00
61,2,1,1,0.01680078421701239,2019-03-29 11:15:00,2019-03-29 11:30:00
62,3,1,2,0.005611737165820819,2019-03-29 11:15:00,2019-03-29 11:30:00
68,2,1,1,0.004665986596147086,2019-03-29 11:15:00,2019-03-29 11:30:00
74,2,1,1,0.01680078421701239,2019-03-29 11:15:00,2019-03-29 11:30:00
85,2,0,2,0.0025220482526982706,2019-03-29 11:15:00,2019-03-29 11:30:00
87,3,0,3,0.0025220482526982706,2019-03-29 11:15:00,2019-03-29 11:30:00
88,1,1,0,0.0037650515030665617,2019-03-29 11:15:00,2019-03-29 11:30:00
89,3,1,2,0.004386553128250707,2019-03-29 11:15:00,2019-03-29 11:30:00
90,4,1,3,0.004386553128250707,2019-03-29 11:15:00,2019-03-29 11:30:00
99,1,1,0,0.004665986596147086,2019-03-29 11:15:00,2019-03-29 11:30:00
104,1,0,1,0.0025220482526982706,2019-03-29 11:15:00,2019-03-29 11:30:00
109,7,4,3,0.013310701933787845,2019-03-29 11:15:00,2019-03-29 11:30:00
110,2,0,2,0.0025220482526982706,2019-03-29 11:15:00,2019-03-29 11:30:00
111,1,1,0,0.004665986596147086,2019-03-29 11:15:00,2019-03-29 11:30:00
112,4,0,4,0.0025220482526982706,2019-03-29 11:15:00,2019-03-29 11:30:00
114,2,1,1,0.013286469214224892,2019-03-29 11:15:00,2019-03-29 11:30:00
115,5,2,3,0.005821255769453774,2019-03-29 11:15:00,2019-03-29 11:30:00
116,2,1,1,0.00435341954543314,2019-03-29 11:15:00,2019-03-29 11:30:00
118,1,1,0,0.004386553128250707,2019-03-29 11:15:00,2019-03-29 11:30:00
119,7,5,2,0.01477240643508726,2019-03-29 11:15:00,2019-03-29 11:30:00
120,2,1,1,0.01680078421701239,2019-03-29 11:15:00,2019-03-29 11:30:00
126,7,4,3,0.010903232849758873,2019-03-29 11:15:00,2019-03-29 11:30:00
133,5,2,3,0.004665986596147086,2019-03-29 11:15:00,2019-03-29 11:30:00
137,7,3,4,0.008940563950455999,2019-03-29 11:15:00,2019-03-29 11:30:00
138,9,7,2,0.0253212790104723,2019-03-29 11:15:00,2019-03-29 11:30:00
140,1,1,0,0.003518958496412537,2019-03-29 11:15:00,2019-03-29 11:30:00
141,4,2,2,0.007910024027071189,2019-03-29 11:15:00,2019-03-29 11:30:00
151,4,3,1,0.1147695777318504,2019-03-29 11:15:00,2019-03-29 11:30:00
153,4,3,1,0.004487325067526351,2019-03-29 11:15:00,2019-03-29 11:30:00
154,3,1,2,0.004386553128250707,2019-03-29 11:15:00,2019-03-29 11:30:00
157,1,1,0,0.0038442160639895794,2019-03-29 11:15:00,2019-03-29 11:30:00
158,8,3,5,0.005863425802516929,2019-03-29 11:15:00,2019-03-29 11:30:00
162,4,2,2,0.004665986596147086,2019-03-29 11:15:00,2019-03-29 11:30:00
164,5,1,4,0.005513501230234948,2019-03-29 11:15:00,2019-03-29 11:30:00
168,5,4,1,0.035422130850154915,2019-03-29 11:15:00,2019-03-29 11:30:00
169,2,2,0,0.008024968333212642,2019-03-29 11:15:00,2019-03-29 11:30:00
170,3,2,1,0.003951340481664147,2019-03-29 11:15:00,2019-03-29 11:30:00
172,3,1,2,0.004386553128250707,2019-03-29 11:15:00,2019-03-29 11:30:00
173,2,0,2,0.0025220482526982706,2019-03-29 11:15:00,2019-03-29 11:30:00
177,3,2,1,0.031079520181326516,2019-03-29 11:15:00,2019-03-29 11:30:00
189,5,1,4,0.004386553128250707,2019-03-29 11:15:00,2019-03-29 11:30:00
191,8,2,6,0.005211852351205998,2019-03-29 11:15:00,2019-03-29 11:30:00
195,1,0,1,0.0025220482526982706,2019-03-29 11:15:00,2019-03-29 11:30:00
196,1,1,0,0.003454300690474489,2019-03-29 11:15:00,2019-03-29 11:30:00
197,4,2,2,0.004308663538905617,2019-03-29 11:15:00,2019-03-29 11:30:00
201,2,2,0,0.005665249512067833,2019-03-29 11:15:00,2019-03-29 11:30:00
202,2,1,1,0.00570744596796409,2019-03-29 11:15:00,2019-03-29 11:30:00
1,4,4,0,0.010277027452208293,2019-03-29 11:30:00,2019-03-29 11:45:00
2,3,3,0,0.02540927360820567,2019-03-29 11:30:00,2019-03-29 11:45:00
5,2,1,1,0.018049883758813785,2019-03-29 11:30:00,2019-03-29 11:45:00
10,3,0,3,0.0027107178234176653,2019-03-29 11:30:00,2019-03-29 11:45:00
11,2,1,1,0.018049883758813785,2019-03-29 11:30:00,2019-03-29 11:45:00
13,2,2,0,0.004247000984454249,2019-03-29 11:30:00,2019-03-29 11:45:00
15,2,2,0,0.0038629301941951032,2019-03-29 11:30:00,2019-03-29 11:45:00
16,2,2,0,0.006590177987091396,2019-03-29 11:30:00,2019-03-29 11:45:00
18,3,2,1,0.004550769242378077,2019-03-29 11:30:00,2019-03-29 11:45:00
19,1,0,1,0.0027107178234176653,2019-03-29 11:30:00,2019-03-29 11:45:00
20,3,2,1,0.033389049694209895,2019-03-29 11:30:00,2019-03-29 11:45:00
23,1,1,0,0.005994695671161541,2019-03-29 11:30:00,2019-03-29 11:45:00
37,3,0,3,0.0027107178234176653,2019-03-29 11:30:00,2019-03-29 11:45:00
41,2,0,2,0.0027107178234176653,2019-03-29 11:30:00,2019-03-29 11:45:00
46,1,0,1,0.0027107178234176653,2019-03-29 11:30:00,2019-03-29 11:45:00
57,3,2,1,0.03338904969420989,2019-03-29 11:30:00,2019-03-29 11:45:00
58,1,0,1,0.0027107178234176653,2019-03-29 11:30:00,2019-03-29 11:45:00
61,2,1,1,0.018049883758813785,2019-03-29 11:30:00,2019-03-29 11:45:00
62,2,0,2,0.0027107178234176653,2019-03-29 11:30:00,2019-03-29 11:45:00
74,2,1,1,0.018049883758813785,2019-03-29 11:30:00,2019-03-29 11:45:00
79,1,0,1,0.0027107178234176653,2019-03-29 11:30:00,2019-03-29 11:45:00
85,2,0,2,0.0027107178234176653,2019-03-29 11:30:00,2019-03-29 11:45:00
87,2,0,2,0.0027107178234176653,2019-03-29 11:30:00,2019-03-29 11:45:00
88,1,0,1,0.0027107178234176653,2019-03-29 11:30:00,2019-03-29 11:45:00
99,1,1,0,0.005015142564972541,2019-03-29 11:30:00,2019-03-29 11:45:00
104,1,0,1,0.0027107178234176653,2019-03-29 11:30:00,2019-03-29 11:45:00
109,4,0,4,0.0027107178234176653,2019-03-29 11:30:00,2019-03-29 11:45:00
110,3,2,1,0.010421485476125918,2019-03-29 11:30:00,2019-03-29 11:45:00
111,1,0,1,0.0027107178234176653,2019-03-29 11:30:00,2019-03-29 11:45:00
112,1,0,1,0.0027107178234176653,2019-03-29 11:30:00,2019-03-29 11:45:00
114,1,0,1,0.0027107178234176653,2019-03-29 11:30:00,2019-03-29 11:45:00
115,6,4,2,0.07729089595924844,2019-03-29 11:30:00,2019-03-29 11:45:00
118,1,1,0,0.005015142564972541,2019-03-29 11:30:00,2019-03-29 11:45:00
119,4,3,1,0.009623992048082293,2019-03-29 11:30:00,2019-03-29 11:45:00
120,3,1,2,0.004714897913595117,2019-03-29 11:30:00,2019-03-29 11:45:00
122,1,1,0,0.005015142564972541,2019-03-29 11:30:00,2019-03-29 11:45:00
126,1,0,1,0.0027107178234176653,2019-03-29 11:30:00,2019-03-29 11:45:00
129,1,0,1,0.0027107178234176653,2019-03-29 11:30:00,2019-03-29 11:45:00
133,5,3,2,0.007319567306527417,2019-03-29 11:30:00,2019-03-29 11:45:00
137,4,3,1,0.02032843468075748,2019-03-29 11:30:00,2019-03-29 11:45:00
138,4,2,2,0.008723258093950022,2019-03-29 11:30:00,2019-03-29 11:45:00
141,1,1,0,0.005015142564972541,2019-03-29 11:30:00,2019-03-29 11:45:00
151,3,2,1,0.04271567535907364,2019-03-29 11:30:00,2019-03-29 11:45:00
153,4,3,1,0.00811576590390661,2019-03-29 11:30:00,2019-03-29 11:45:00
154,1,0,1,0.0027107178234176653,2019-03-29 11:30:00,2019-03-29 11:45:00
157,1,0,1,0.0027107178234176653,2019-03-29 11:30:00,2019-03-29 11:45:00
158,2,1,1,0.0032868240088063843,2019-03-29 11:30:00,2019-03-29 11:45:00
162,3,0,3,0.0027107178234176653,2019-03-29 11:30:00,2019-03-29 11:45:00
164,1,1,0,0.005015142564972541,2019-03-29 11:30:00,2019-03-29 11:45:00
168,5,4,1,0.054789933839640884,2019-03-29 11:30:00,2019-03-29 11:45:00
170,4,3,1,0.005783284145490833,2019-03-29 11:30:00,2019-03-29 11:45:00
172,4,1,3,0.003782627661859786,2019-03-29 11:30:00,2019-03-29 11:45:00
173,1,0,1,0.0027107178234176653,2019-03-29 11:30:00,2019-03-29 11:45:00
177,4,3,1,0.030832522038310543,2019-03-29 11:30:00,2019-03-29 11:45:00
189,3,1,2,0.003782627661859786,2019-03-29 11:30:00,2019-03-29 11:45:00
191,2,1,1,0.0038629301941951032,2019-03-29 11:30:00,2019-03-29 11:45:00
196,2,1,1,0.018049883758813785,2019-03-29 11:30:00,2019-03-29 11:45:00
197,2,1,1,0.003478859403935957,2019-03-29 11:30:00,2019-03-29 11:45:00
199,1,0,1,0.0027107178234176653,2019-03-29 11:30:00,2019-03-29 11:45:00
1,2,2,0,0.008263320233254465,2019-03-29 11:45:00,2019-03-29 12:00:00
2,1,1,0,0.005798651815133978,2019-03-29 11:45:00,2019-03-29 12:00:00
5,2,1,1,0.02084320925637093,2019-03-29 11:45:00,2019-03-29 12:00:00
10,1,1,0,0.0066055764074255795,2019-03-29 11:45:00,2019-03-29 12:00:00
16,3,1,2,0.005451344621340488,2019-03-29 11:45:00,2019-03-29 12:00:00
18,4,2,2,0.011882678638504255,2019-03-29 11:45:00,2019-03-29 12:00:00
19,6,4,2,0.011070357796914763,2019-03-29 11:45:00,2019-03-29 12:00:00
20,4,2,2,0.010085478039317303,2019-03-29 11:45:00,2019-03-29 12:00:00
23,3,2,1,0.029697674928380345,2019-03-29 11:45:00,2019-03-29 12:00:00
40,2,0,2,0.00313427791235208,2019-03-29 11:45:00,2019-03-29 12:00:00
41,1,0,1,0.00313427791235208,2019-03-29 11:45:00,2019-03-29 12:00:00
46,5,1,4,0.004573137866292092,2019-03-29 11:45:00,2019-03-29 12:00:00
58,5,1,4,0.004466464863743028,2019-03-29 11:45:00,2019-03-29 12:00:00
62,2,0,2,0.00313427791235208,2019-03-29 11:45:00,2019-03-29 12:00:00
67,2,2,0,0.006783531572731436,2019-03-29 11:45:00,2019-03-29 12:00:00
68,2,2,0,0.009624086707228856,2019-03-29 11:45:00,2019-03-29 12:00:00
74,2,1,1,0.012612124586938542,2019-03-29 11:45:00,2019-03-29 12:00:00
79,2,0,2,0.00313427791235208,2019-03-29 11:45:00,2019-03-29 12:00:00
85,2,0,2,0.00313427791235208,2019-03-29 11:45:00,2019-03-29 12:00:00
87,1,1,0,0.004573137866292092,2019-03-29 11:45:00,2019-03-29 12:00:00
88,1,0,1,0.00313427791235208,2019-03-29 11:45:00,2019-03-29 12:00:00
90,3,3,0,0.006049944040881761,2019-03-29 11:45:00,2019-03-29 12:00:00
99,5,2,3,0.008091484124285493,2019-03-29 11:45:00,2019-03-29 12:00:00
104,1,0,1,0.00313427791235208,2019-03-29 11:45:00,2019-03-29 12:00:00
109,5,3,2,0.017619398268081045,2019-03-29 11:45:00,2019-03-29 12:00:00
110,1,1,0,0.012612124586938542,2019-03-29 11:45:00,2019-03-29 12:00:00
111,1,0,1,0.00313427791235208,2019-03-29 11:45:00,2019-03-29 12:00:00
112,1,0,1,0.00313427791235208,2019-03-29 11:45:00,2019-03-29 12:00:00
114,1,0,1,0.00313427791235208,2019-03-29 11:45:00,2019-03-29 12:00:00
115,3,2,1,0.011064674050341242,2019-03-29 11:45:00,2019-03-29 12:00:00
116,1,1,0,0.004466464863743028,2019-03-29 11:45:00,2019-03-29 12:00:00
118,3,1,2,0.005451344621340488,2019-03-29 11:45:00,2019-03-29 12:00:00
119,8,3,5,0.008463025717915875,2019-03-29 11:45:00,2019-03-29 12:00:00
122,2,2,0,0.012992951584834038,2019-03-29 11:45:00,2019-03-29 12:00:00
126,2,1,1,0.004466464863743028,2019-03-29 11:45:00,2019-03-29 12:00:00
127,1,1,0,0.007421104136535406,2019-03-29 11:45:00,2019-03-29 12:00:00
129,1,0,1,0.00313427791235208,2019-03-29 11:45:00,2019-03-29 12:00:00
133,4,3,1,0.008463025717915875,2019-03-29 11:45:00,2019-03-29 12:00:00
135,1,0,1,0.00313427791235208,2019-03-29 11:45:00,2019-03-29 12:00:00
137,6,3,3,0.021469184401592015,2019-03-29 11:45:00,2019-03-29 12:00:00
138,1,1,0,0.004466464863743028,2019-03-29 11:45:00,2019-03-29 12:00:00
141,1,1,0,0.005798651815133978,2019-03-29 11:45:00,2019-03-29 12:00:00
151,3,1,2,0.005451344621340488,2019-03-29 11:45:00,2019-03-29 12:00:00
153,2,1,1,0.008185226753288845,2019-03-29 11:45:00,2019-03-29 12:00:00
156,1,1,0,0.005798651815133978,2019-03-29 11:45:00,2019-03-29 12:00:00
157,1,0,1,0.00313427791235208,2019-03-29 11:45:00,2019-03-29 12:00:00
158,5,3,2,0.022295878088436506,2019-03-29 11:45:00,2019-03-29 12:00:00
160,1,1,0,0.005451344621340488,2019-03-29 11:45:00,2019-03-29 12:00:00
162,3,2,1,0.007719942530655112,2019-03-29 11:45:00,2019-03-29 12:00:00
164,2,1,1,0.00408349175472994,2019-03-29 11:45:00,2019-03-29 12:00:00
168,3,2,1,0.03855214060038976,2019-03-29 11:45:00,2019-03-29 12:00:00
170,1,1,0,0.005798651815133978,2019-03-29 11:45:00,2019-03-29 12:00:00
172,1,0,1,0.00313427791235208,2019-03-29 11:45:00,2019-03-29 12:00:00
175,1,0,1,0.00313427791235208,2019-03-29 11:45:00,2019-03-29 12:00:00
177,6,4,2,0.08213606380220984,2019-03-29 11:45:00,2019-03-29 12:00:00
190,1,1,0,0.007839743160768095,2019-03-29 11:45:00,2019-03-29 12:00:00
191,2,0,2,0.00313427791235208,2019-03-29 11:45:00,2019-03-29 12:00:00
196,2,0,2,0.00313427791235208,2019-03-29 11:45:00,2019-03-29 12:00:00
199,1,0,1,0.00313427791235208,2019-03-29 11:45:00,2019-03-29 12:00:00
203,1,1,0,0.004573137866292092,2019-03-29 11:45:00,2019-03-29 12:00:00
1,1,1,0,0.003975220884296233,2019-03-29 12:00:00,2019-03-29 12:15:00
5,2,1,1,0.018555978094696376,2019-03-29 12:00:00,2019-03-29 12:15:00
10,1,1,0,0.005160880514631175,2019-03-29 12:00:00,2019-03-29 12:15:00
16,5,1,4,0.00354238223038353,2019-03-29 12:00:00,2019-03-29 12:15:00
18,5,4,1,0.01021607151180145,2019-03-29 12:00:00,2019-03-29 12:15:00
19,5,2,3,0.006580790186828497,2019-03-29 12:00:00,2019-03-29 12:15:00
20,3,2,1,0.0063283321234395675,2019-03-29 12:00:00,2019-03-29 12:15:00
21,1,1,0,0.009085860755394637,2019-03-29 12:00:00,2019-03-29 12:15:00
23,2,2,0,0.006346540144966116,2019-03-29 12:00:00,2019-03-29 12:15:00
37,2,1,1,0.018555978094696376,2019-03-29 12:00:00,2019-03-29 12:15:00
40,2,0,2,0.0027895612539612924,2019-03-29 12:00:00,2019-03-29 12:15:00
41,3,2,1,0.07632879228249527,2019-03-29 12:00:00,2019-03-29 12:15:00
46,5,1,4,0.0061277247833186246,2019-03-29 12:00:00,2019-03-29 12:15:00
50,2,1,1,0.004716029396425248,2019-03-29 12:00:00,2019-03-29 12:15:00
58,3,1,2,0.004851756184946643,2019-03-29 12:00:00,2019-03-29 12:15:00
61,1,0,1,0.0027895612539612924,2019-03-29 12:00:00,2019-03-29 12:15:00
62,7,3,4,0.020454167145356753,2019-03-29 12:00:00,2019-03-29 12:15:00
67,3,3,0,0.00978133731843529,2019-03-29 12:00:00,2019-03-29 12:15:00
68,4,2,2,0.014812561017906878,2019-03-29 12:00:00,2019-03-29 12:15:00
74,3,1,2,0.008080890359388988,2019-03-29 12:00:00,2019-03-29 12:15:00
79,2,0,2,0.0027895612539612924,2019-03-29 12:00:00,2019-03-29 12:15:00
85,1,0,1,0.0027895612539612924,2019-03-29 12:00:00,2019-03-29 12:15:00
88,1,1,0,0.008206599863878816,2019-03-29 12:00:00,2019-03-29 12:15:00
90,3,3,0,0.006696516708118728,2019-03-29 12:00:00,2019-03-29 12:15:00
99,3,1,2,0.004851756184946643,2019-03-29 12:00:00,2019-03-29 12:15:00
104,3,1,2,0.004851756184946643,2019-03-29 12:00:00,2019-03-29 12:15:00
109,8,6,2,0.015893460057194123,2019-03-29 12:00:00,2019-03-29 12:15:00
110,2,0,2,0.0027895612539612924,2019-03-29 12:00:00,2019-03-29 12:15:00
111,3,2,1,0.008039517599131364,2019-03-29 12:00:00,2019-03-29 12:15:00
112,4,1,3,0.00354238223038353,2019-03-29 12:00:00,2019-03-29 12:15:00
113,1,0,1,0.0027895612539612924,2019-03-29 12:00:00,2019-03-29 12:15:00
114,3,1,2,0.003793322555857609,2019-03-29 12:00:00,2019-03-29 12:15:00
115,2,1,1,0.004091879738680438,2019-03-29 12:00:00,2019-03-29 12:15:00
116,2,2,0,0.008140584070272391,2019-03-29 12:00:00,2019-03-29 12:15:00
118,1,0,1,0.0027895612539612924,2019-03-29 12:00:00,2019-03-29 12:15:00
119,11,6,5,0.01963332038805082,2019-03-29 12:00:00,2019-03-29 12:15:00
122,6,3,3,0.019114544540316067,2019-03-29 12:00:00,2019-03-29 12:15:00
127,3,2,1,0.010231384184091436,2019-03-29 12:00:00,2019-03-29 12:15:00
133,1,0,1,0.0027895612539612924,2019-03-29 12:00:00,2019-03-29 12:15:00
137,9,3,6,0.015173464261747252,2019-03-29 12:00:00,2019-03-29 12:15:00
138,4,2,2,0.015988428452120614,2019-03-29 12:00:00,2019-03-29 12:15:00
141,2,2,0,0.010589231140497977,2019-03-29 12:00:00,2019-03-29 12:15:00
151,2,1,1,0.018555978094696376,2019-03-29 12:00:00,2019-03-29 12:15:00
153,6,3,3,0.012836671317517177,2019-03-29 12:00:00,2019-03-29 12:15:00
154,1,0,1,0.0027895612539612924,2019-03-29 12:00:00,2019-03-29 12:15:00
158,2,1,1,0.006224358427430467,2019-03-29 12:00:00,2019-03-29 12:15:00
162,4,3,1,0.010551604734087745,2019-03-29 12:00:00,2019-03-29 12:15:00
164,1,0,1,0.0027895612539612924,2019-03-29 12:00:00,2019-03-29 12:15:00
168,4,2,2,0.008976146046917342,2019-03-29 12:00:00,2019-03-29 12:15:00
170,2,2,0,0.011916444588263072,2019-03-29 12:00:00,2019-03-29 12:15:00
171,1,1,0,0.009085860755394637,2019-03-29 12:00:00,2019-03-29 12:15:00
175,1,0,1,0.0027895612539612924,2019-03-29 12:00:00,2019-03-29 12:15:00
177,3,1,2,0.004851756184946643,2019-03-29 12:00:00,2019-03-29 12:15:00
190,3,2,1,0.03094290704375736,2019-03-29 12:00:00,2019-03-29 12:15:00
191,4,1,3,0.006798586812459324,2019-03-29 12:00:00,2019-03-29 12:15:00
196,3,2,1,0.007532199775301058,2019-03-29 12:00:00,2019-03-29 12:15:00
199,1,0,1,0.0027895612539612924,2019-03-29 12:00:00,2019-03-29 12:15:00
202,2,1,1,0.018555978094696376,2019-03-29 12:00:00,2019-03-29 12:15:00
203,5,3,2,0.020081388809003516,2019-03-29 12:00:00,2019-03-29 12:15:00
5,5,2,3,0.007599590495669462,2019-03-29 12:15:00,2019-03-29 12:30:00
10,1,1,0,0.006091587365385466,2019-03-29 12:15:00,2019-03-29 12:30:00
15,1,1,0,0.006853169451910895,2019-03-29 12:15:00,2019-03-29 12:30:00
16,5,1,4,0.0041812076493300656,2019-03-29 12:15:00,2019-03-29 12:30:00
18,2,2,0,0.0070551095187746235,2019-03-29 12:15:00,2019-03-29 12:30:00
19,1,1,0,0.005446104958977992,2019-03-29 12:15:00,2019-03-29 12:30:00
20,1,1,0,0.0042256087366528364,2019-03-29 12:15:00,2019-03-29 12:30:00
21,1,1,0,0.006091587365385466,2019-03-29 12:15:00,2019-03-29 12:30:00
22,1,0,1,0.003292619422286522,2019-03-29 12:15:00,2019-03-29 12:30:00
23,3,2,1,0.007099510606097394,2019-03-29 12:15:00,2019-03-29 12:30:00
37,2,0,2,0.003292619422286522,2019-03-29 12:15:00,2019-03-29 12:30:00
41,4,2,2,0.00816084871980744,2019-03-29 12:15:00,2019-03-29 12:30:00
50,1,1,0,0.0042256087366528364,2019-03-29 12:15:00,2019-03-29 12:30:00
57,2,0,2,0.003292619422286522,2019-03-29 12:15:00,2019-03-29 12:30:00
58,2,1,1,0.00932786531858382,2019-03-29 12:15:00,2019-03-29 12:30:00
62,6,3,3,0.01060465624997634,2019-03-29 12:15:00,2019-03-29 12:30:00
67,6,3,3,0.01061222903593743,2019-03-29 12:15:00,2019-03-29 12:30:00
68,1,0,1,0.003292619422286522,2019-03-29 12:15:00,2019-03-29 12:30:00
69,1,0,1,0.003292619422286522,2019-03-29 12:15:00,2019-03-29 12:30:00
70,2,1,1,0.006091587365385466,2019-03-29 12:15:00,2019-03-29 12:30:00
74,3,1,2,0.006853169451910895,2019-03-29 12:15:00,2019-03-29 12:30:00
79,1,1,0,0.006299795444846279,2019-03-29 12:15:00,2019-03-29 12:30:00
85,1,0,1,0.003292619422286522,2019-03-29 12:15:00,2019-03-29 12:30:00
86,1,1,0,0.006299795444846279,2019-03-29 12:15:00,2019-03-29 12:30:00
87,1,0,1,0.003292619422286522,2019-03-29 12:15:00,2019-03-29 12:30:00
88,2,1,1,0.009259337709555705,2019-03-29 12:15:00,2019-03-29 12:30:00
99,2,0,2,0.003292619422286522,2019-03-29 12:15:00,2019-03-29 12:30:00
104,2,1,1,0.021782258165673193,2019-03-29 12:15:00,2019-03-29 12:30:00
109,5,2,3,0.009560332691356912,2019-03-29 12:15:00,2019-03-29 12:30:00
110,3,1,2,0.006761364748257968,2019-03-29 12:15:00,2019-03-29 12:30:00
111,2,2,0,0.010441939768564354,2019-03-29 12:15:00,2019-03-29 12:30:00
112,4,1,3,0.0041812076493300656,2019-03-29 12:15:00,2019-03-29 12:30:00
113,1,1,0,0.004692103393835994,2019-03-29 12:15:00,2019-03-29 12:30:00
114,2,1,1,0.004477403725011247,2019-03-29 12:15:00,2019-03-29 12:30:00
115,1,1,0,0.011222238593136927,2019-03-29 12:15:00,2019-03-29 12:30:00
116,1,1,0,0.004477403725011247,2019-03-29 12:15:00,2019-03-29 12:30:00
119,3,2,1,0.017376779318296315,2019-03-29 12:15:00,2019-03-29 12:30:00
122,4,1,3,0.02105748197662072,2019-03-29 12:15:00,2019-03-29 12:30:00
127,2,0,2,0.003292619422286522,2019-03-29 12:15:00,2019-03-29 12:30:00
137,5,3,2,0.016567786634926408,2019-03-29 12:15:00,2019-03-29 12:30:00
138,4,2,2,0.010820455683189869,2019-03-29 12:15:00,2019-03-29 12:30:00
140,3,2,1,0.0055806916208795375,2019-03-29 12:15:00,2019-03-29 12:30:00
141,6,3,3,0.010334296772740979,2019-03-29 12:15:00,2019-03-29 12:30:00
151,2,1,1,0.021782258165673193,2019-03-29 12:15:00,2019-03-29 12:30:00
153,7,4,3,0.011798042410317877,2019-03-29 12:15:00,2019-03-29 12:30:00
154,1,1,0,0.01361608259229243,2019-03-29 12:15:00,2019-03-29 12:30:00
157,1,1,0,0.008036659243514474,2019-03-29 12:15:00,2019-03-29 12:30:00
158,6,3,3,0.012565087014551517,2019-03-29 12:15:00,2019-03-29 12:30:00
162,3,3,0,0.009434759815130712,2019-03-29 12:15:00,2019-03-29 12:30:00
164,1,0,1,0.003292619422286522,2019-03-29 12:15:00,2019-03-29 12:30:00
168,4,2,2,0.008160848719807441,2019-03-29 12:15:00,2019-03-29 12:30:00
170,4,3,1,0.012143819003462935,2019-03-29 12:15:00,2019-03-29 12:30:00
175,1,0,1,0.003292619422286522,2019-03-29 12:15:00,2019-03-29 12:30:00
177,4,1,3,0.00459452474136258,2019-03-29 12:15:00,2019-03-29 12:30:00
189,1,1,0,0.011163551460126299,2019-03-29 12:15:00,2019-03-29 12:30:00
191,3,0,3,0.003292619422286522,2019-03-29 12:15:00,2019-03-29 12:30:00
195,1,1,0,0.008470961191493018,2019-03-29 12:15:00,2019-03-29 12:30:00
196,1,1,0,0.006001678610618745,2019-03-29 12:15:00,2019-03-29 12:30:00
202,2,1,1,0.021782258165673193,2019-03-29 12:15:00,2019-03-29 12:30:00
203,5,3,2,0.04179610547447633,2019-03-29 12:15:00,2019-03-29 12:30:00
1,1,0,1,0.002906521303233138,2019-03-29 12:30:00,2019-03-29 12:45:00
5,2,1,1,0.019339098524830334,2019-03-29 12:30:00,2019-03-29 12:45:00
10,1,0,1,0.002906521303233138,2019-03-29 12:30:00,2019-03-29 12:45:00
15,1,1,0,0.004573889722991489,2019-03-29 12:30:00,2019-03-29 12:45:00
16,3,1,2,0.00505536746741011,2019-03-29 12:30:00,2019-03-29 12:45:00
18,2,2,0,0.0064182932243412325,2019-03-29 12:30:00,2019-03-29 12:45:00
19,1,1,0,0.006021726936227802,2019-03-29 12:30:00,2019-03-29 12:45:00
20,3,1,2,0.005377362783971058,2019-03-29 12:30:00,2019-03-29 12:45:00
21,2,2,0,0.008492568416965723,2019-03-29 12:30:00,2019-03-29 12:45:00
22,1,0,1,0.002906521303233138,2019-03-29 12:30:00,2019-03-29 12:45:00
23,1,0,1,0.002906521303233138,2019-03-29 12:30:00,2019-03-29 12:45:00
28,1,0,1,0.002906521303233138,2019-03-29 12:30:00,2019-03-29 12:45:00
35,2,1,1,0.00747789215527358,2019-03-29 12:30:00,2019-03-29 12:45:00
37,3,1,2,0.00505536746741011,2019-03-29 12:30:00,2019-03-29 12:45:00
41,1,0,1,0.002906521303233138,2019-03-29 12:30:00,2019-03-29 12:45:00
46,1,1,0,0.009263672804069742,2019-03-29 12:30:00,2019-03-29 12:45:00
50,1,1,0,0.006882218315026132,2019-03-29 12:30:00,2019-03-29 12:45:00
57,1,0,1,0.002906521303233138,2019-03-29 12:30:00,2019-03-29 12:45:00
58,2,2,0,0.013055078283870545,2019-03-29 12:30:00,2019-03-29 12:45:00
61,1,0,1,0.002906521303233138,2019-03-29 12:30:00,2019-03-29 12:45:00
62,6,4,2,0.05220425296802472,2019-03-29 12:30:00,2019-03-29 12:45:00
67,6,2,4,0.006828661079622882,2019-03-29 12:30:00,2019-03-29 12:45:00
68,1,0,1,0.002906521303233138,2019-03-29 12:30:00,2019-03-29 12:45:00
70,1,0,1,0.002906521303233138,2019-03-29 12:30:00,2019-03-29 12:45:00
74,3,2,1,0.005809310463360449,2019-03-29 12:30:00,2019-03-29 12:45:00
79,1,1,0,0.004357819598884961,2019-03-29 12:30:00,2019-03-29 12:45:00
85,1,0,1,0.002906521303233138,2019-03-29 12:30:00,2019-03-29 12:45:00
86,1,1,0,0.004357819598884961,2019-03-29 12:30:00,2019-03-29 12:45:00
87,2,1,1,0.006021726936227802,2019-03-29 12:30:00,2019-03-29 12:45:00
88,2,1,1,0.019339098524830334,2019-03-29 12:30:00,2019-03-29 12:45:00
89,1,1,0,0.004291920208179451,2019-03-29 12:30:00,2019-03-29 12:45:00
90,2,2,0,0.00641185897121375,2019-03-29 12:30:00,2019-03-29 12:45:00
99,2,0,2,0.002906521303233138,2019-03-29 12:30:00,2019-03-29 12:45:00
101,1,1,0,0.0041419420436020985,2019-03-29 12:30:00,2019-03-29 12:45:00
104,2,1,1,0.005377362783971058,2019-03-29 12:30:00,2019-03-29 12:45:00
109,7,3,4,0.00824652617118194,2019-03-29 12:30:00,2019-03-29 12:45:00
110,8,3,5,0.008148160593863685,2019-03-29 12:30:00,2019-03-29 12:45:00
111,3,3,0,0.007230493894524499,2019-03-29 12:30:00,2019-03-29 12:45:00
112,2,0,2,0.002906521303233138,2019-03-29 12:30:00,2019-03-29 12:45:00
114,4,4,0,0.008898514219663553,2019-03-29 12:30:00,2019-03-29 12:45:00
119,4,0,4,0.002906521303233138,2019-03-29 12:30:00,2019-03-29 12:45:00
120,1,0,1,0.002906521303233138,2019-03-29 12:30:00,2019-03-29 12:45:00
122,2,1,1,0.0041419420436020985,2019-03-29 12:30:00,2019-03-29 12:45:00
126,1,0,1,0.002906521303233138,2019-03-29 12:30:00,2019-03-29 12:45:00
137,9,5,4,0.01465729569313803,2019-03-29 12:30:00,2019-03-29 12:45:00
138,5,2,3,0.007503735800132839,2019-03-29 12:30:00,2019-03-29 12:45:00
140,3,2,1,0.007204213631587081,2019-03-29 12:30:00,2019-03-29 12:45:00
141,1,1,0,0.0041419420436020985,2019-03-29 12:30:00,2019-03-29 12:45:00
151,3,2,1,0.03577167574642752,2019-03-29 12:30:00,2019-03-29 12:45:00
153,4,2,2,0.009353059795764052,2019-03-29 12:30:00,2019-03-29 12:45:00
154,1,1,0,0.004430311587246619,2019-03-29 12:30:00,2019-03-29 12:45:00
156,1,0,1,0.002906521303233138,2019-03-29 12:30:00,2019-03-29 12:45:00
157,2,1,1,0.009031064479203103,2019-03-29 12:30:00,2019-03-29 12:45:00
158,5,1,4,0.007845173803863372,2019-03-29 12:30:00,2019-03-29 12:45:00
162,2,2,0,0.005377362783971058,2019-03-29 12:30:00,2019-03-29 12:45:00
164,2,2,0,0.009411244752158487,2019-03-29 12:30:00,2019-03-29 12:45:00
168,4,2,2,0.019339098524830334,2019-03-29 12:30:00,2019-03-29 12:45:00
170,4,1,3,0.005377362783971058,2019-03-29 12:30:00,2019-03-29 12:45:00
173,1,1,0,0.00747789215527358,2019-03-29 12:30:00,2019-03-29 12:45:00
175,1,0,1,0.002906521303233138,2019-03-29 12:30:00,2019-03-29 12:45:00
177,1,0,1,0.002906521303233138,2019-03-29 12:30:00,2019-03-29 12:45:00
189,2,0,2,0.002906521303233138,2019-03-29 12:30:00,2019-03-29 12:45:00
190,1,0,1,0.002906521303233138,2019-03-29 12:30:00,2019-03-29 12:45:00
191,8,6,2,0.08259856593048119,2019-03-29 12:30:00,2019-03-29 12:45:00
195,2,2,0,0.006828661079622882,2019-03-29 12:30:00,2019-03-29 12:45:00
196,7,4,3,0.014604282168735744,2019-03-29 12:30:00,2019-03-29 12:45:00
199,2,1,1,0.005377362783971058,2019-03-29 12:30:00,2019-03-29 12:45:00
201,3,1,2,0.00505536746741011,2019-03-29 12:30:00,2019-03-29 12:45:00
202,3,2,1,0.029470536178982484,2019-03-29 12:30:00,2019-03-29 12:45:00
203,2,0,2,0.002906521303233138,2019-03-29 12:30:00,2019-03-29 12:45:00
1,3,2,1,0.010454808144289639,2019-03-29 12:45:00,2019-03-29 13:00:00
2,1,1,0,0.00935474051433511,2019-03-29 12:45:00,2019-03-29 13:00:00
5,2,1,1,0.021607400113022823,2019-03-29 12:45:00,2019-03-29 13:00:00
10,3,0,3,0.003317887172155955,2019-03-29 12:45:00,2019-03-29 13:00:00
13,1,0,1,0.003317887172155955,2019-03-29 12:45:00,2019-03-29 13:00:00
15,1,0,1,0.003317887172155955,2019-03-29 12:45:00,2019-03-29 13:00:00
18,2,2,0,0.011398030488499541,2019-03-29 12:45:00,2019-03-29 13:00:00
20,4,4,0,0.015362952702960168,2019-03-29 12:45:00,2019-03-29 13:00:00
21,2,2,0,0.00869548089089037,2019-03-29 12:45:00,2019-03-29 13:00:00
22,1,0,1,0.003317887172155955,2019-03-29 12:45:00,2019-03-29 13:00:00
23,1,0,1,0.003317887172155955,2019-03-29 12:45:00,2019-03-29 13:00:00
26,1,0,1,0.003317887172155955,2019-03-29 12:45:00,2019-03-29 13:00:00
27,1,1,0,0.005030269238002802,2019-03-29 12:45:00,2019-03-29 13:00:00
28,3,2,1,0.005535314271247909,2019-03-29 12:45:00,2019-03-29 13:00:00
35,1,1,0,0.006138319723406883,2019-03-29 12:45:00,2019-03-29 13:00:00
37,3,0,3,0.003317887172155955,2019-03-29 12:45:00,2019-03-29 13:00:00
40,1,1,0,0.007676817241709792,2019-03-29 12:45:00,2019-03-29 13:00:00
46,2,1,1,0.006138319723406883,2019-03-29 12:45:00,2019-03-29 13:00:00
50,1,1,0,0.006860202972894688,2019-03-29 12:45:00,2019-03-29 13:00:00
57,2,1,1,0.005875048339639442,2019-03-29 12:45:00,2019-03-29 13:00:00
58,2,1,1,0.006907568482558336,2019-03-29 12:45:00,2019-03-29 13:00:00
62,2,1,1,0.007634375593038711,2019-03-29 12:45:00,2019-03-29 13:00:00
66,3,0,3,0.003317887172155955,2019-03-29 12:45:00,2019-03-29 13:00:00
67,3,1,2,0.00831220343434198,2019-03-29 12:45:00,2019-03-29 13:00:00
68,1,0,1,0.003317887172155955,2019-03-29 12:45:00,2019-03-29 13:00:00
70,2,1,1,0.006138319723406883,2019-03-29 12:45:00,2019-03-29 13:00:00
74,3,1,2,0.004187558936335358,2019-03-29 12:45:00,2019-03-29 13:00:00
79,1,1,0,0.006850953809975224,2019-03-29 12:45:00,2019-03-29 13:00:00
85,1,0,1,0.003317887172155955,2019-03-29 12:45:00,2019-03-29 13:00:00
87,3,2,1,0.007248585073869565,2019-03-29 12:45:00,2019-03-29 13:00:00
88,4,2,2,0.00843220950712293,2019-03-29 12:45:00,2019-03-29 13:00:00
89,3,2,1,0.007101425017448739,2019-03-29 12:45:00,2019-03-29 13:00:00
90,2,2,0,0.006742651303849648,2019-03-29 12:45:00,2019-03-29 13:00:00
99,3,1,2,0.006138319723406883,2019-03-29 12:45:00,2019-03-29 13:00:00
101,1,1,0,0.004728103447781419,2019-03-29 12:45:00,2019-03-29 13:00:00
104,1,1,0,0.006138319723406883,2019-03-29 12:45:00,2019-03-29 13:00:00
109,6,2,4,0.008057473565120201,2019-03-29 12:45:00,2019-03-29 13:00:00
110,6,2,4,0.0057706405277745485,2019-03-29 12:45:00,2019-03-29 13:00:00
111,9,5,4,0.009699716690101478,2019-03-29 12:45:00,2019-03-29 13:00:00
112,2,0,2,0.003317887172155955,2019-03-29 12:45:00,2019-03-29 13:00:00
113,1,0,1,0.003317887172155955,2019-03-29 12:45:00,2019-03-29 13:00:00
114,4,4,0,0.008784047487163328,2019-03-29 12:45:00,2019-03-29 13:00:00
115,1,0,1,0.003317887172155955,2019-03-29 12:45:00,2019-03-29 13:00:00
119,6,1,5,0.005187201257654133,2019-03-29 12:45:00,2019-03-29 13:00:00
120,1,0,1,0.003317887172155955,2019-03-29 12:45:00,2019-03-29 13:00:00
122,1,1,0,0.004728103447781419,2019-03-29 12:45:00,2019-03-29 13:00:00
126,6,3,3,0.015232985356721148,2019-03-29 12:45:00,2019-03-29 13:00:00
127,3,2,1,0.005127703120085667,2019-03-29 12:45:00,2019-03-29 13:00:00
133,1,1,0,0.004222795146120811,2019-03-29 12:45:00,2019-03-29 13:00:00
137,12,6,6,0.018048498789967705,2019-03-29 12:45:00,2019-03-29 13:00:00
138,4,4,0,0.027396894295389843,2019-03-29 12:45:00,2019-03-29 13:00:00
140,5,1,4,0.004258031355906264,2019-03-29 12:45:00,2019-03-29 13:00:00
141,2,2,0,0.007285264615264906,2019-03-29 12:45:00,2019-03-29 13:00:00
147,1,0,1,0.003317887172155955,2019-03-29 12:45:00,2019-03-29 13:00:00
151,4,2,2,0.010676147239011736,2019-03-29 12:45:00,2019-03-29 13:00:00
153,6,3,3,0.012501068075396544,2019-03-29 12:45:00,2019-03-29 13:00:00
156,1,0,1,0.003317887172155955,2019-03-29 12:45:00,2019-03-29 13:00:00
157,2,1,1,0.004222795146120811,2019-03-29 12:45:00,2019-03-29 13:00:00
158,5,3,2,0.008939001713316725,2019-03-29 12:45:00,2019-03-29 13:00:00
162,3,3,0,0.011356350308483299,2019-03-29 12:45:00,2019-03-29 13:00:00
164,4,3,1,0.0179398712388204,2019-03-29 12:45:00,2019-03-29 13:00:00
168,8,4,4,0.008795858871511117,2019-03-29 12:45:00,2019-03-29 13:00:00
169,2,1,1,0.004199796426741437,2019-03-29 12:45:00,2019-03-29 13:00:00
170,2,1,1,0.00918985701928542,2019-03-29 12:45:00,2019-03-29 13:00:00
171,1,0,1,0.003317887172155955,2019-03-29 12:45:00,2019-03-29 13:00:00
189,7,1,6,0.006138319723406883,2019-03-29 12:45:00,2019-03-29 13:00:00
190,2,1,1,0.004426600721701932,2019-03-29 12:45:00,2019-03-29 13:00:00
191,10,3,7,0.00912969317510398,2019-03-29 12:45:00,2019-03-29 13:00:00
195,2,2,0,0.01206898439505164,2019-03-29 12:45:00,2019-03-29 13:00:00
196,9,5,4,0.034036426378152455,2019-03-29 12:45:00,2019-03-29 13:00:00
197,1,1,0,0.004258031355906264,2019-03-29 12:45:00,2019-03-29 13:00:00
199,1,0,1,0.003317887172155955,2019-03-29 12:45:00,2019-03-29 13:00:00
201,1,1,0,0.004258031355906264,2019-03-29 12:45:00,2019-03-29 13:00:00
202,3,3,0,0.013010324408948202,2019-03-29 12:45:00,2019-03-29 13:00:00
203,2,0,2,0.003317887172155955,2019-03-29 12:45:00,2019-03-29 13:00:00
1,4,2,2,0.012071119991466197,2019-03-29 13:00:00,2019-03-29 13:15:00
2,1,1,0,0.005696606021904064,2019-03-29 13:00:00,2019-03-29 13:15:00
5,3,2,1,0.025529148291145082,2019-03-29 13:00:00,2019-03-29 13:15:00
10,6,1,5,0.0038421773604918026,2019-03-29 13:00:00,2019-03-29 13:15:00
13,1,0,1,0.0031889456159844105,2019-03-29 13:00:00,2019-03-29 13:15:00
15,2,1,1,0.009492920495902644,2019-03-29 13:00:00,2019-03-29 13:15:00
16,2,0,2,0.0031889456159844105,2019-03-29 13:00:00,2019-03-29 13:15:00
18,5,4,1,0.008492854442358169,2019-03-29 13:00:00,2019-03-29 13:15:00
19,1,0,1,0.0031889456159844105,2019-03-29 13:00:00,2019-03-29 13:15:00
20,3,2,1,0.00922341239812451,2019-03-29 13:00:00,2019-03-29 13:15:00
21,2,2,0,0.0069645973320119825,2019-03-29 13:00:00,2019-03-29 13:15:00
22,1,0,1,0.0031889456159844105,2019-03-29 13:00:00,2019-03-29 13:15:00
23,2,2,0,0.010915115092960472,2019-03-29 13:00:00,2019-03-29 13:15:00
27,1,1,0,0.005993308282911684,2019-03-29 13:00:00,2019-03-29 13:15:00
28,2,2,0,0.004996178059408913,2019-03-29 13:00:00,2019-03-29 13:15:00
35,1,0,1,0.0031889456159844105,2019-03-29 13:00:00,2019-03-29 13:15:00
37,1,0,1,0.0031889456159844105,2019-03-29 13:00:00,2019-03-29 13:15:00
40,1,1,0,0.006064081094433703,2019-03-29 13:00:00,2019-03-29 13:15:00
41,1,0,1,0.0031889456159844105,2019-03-29 13:00:00,2019-03-29 13:15:00
46,2,1,1,0.02119175410501443,2019-03-29 13:00:00,2019-03-29 13:15:00
57,2,2,0,0.005318551717766047,2019-03-29 13:00:00,2019-03-29 13:15:00
58,1,1,0,0.004367687192703161,2019-03-29 13:00:00,2019-03-29 13:15:00
62,1,0,1,0.0031889456159844105,2019-03-29 13:00:00,2019-03-29 13:15:00
66,3,0,3,0.0031889456159844105,2019-03-29 13:00:00,2019-03-29 13:15:00
68,1,0,1,0.0031889456159844105,2019-03-29 13:00:00,2019-03-29 13:15:00
69,2,0,2,0.0031889456159844105,2019-03-29 13:00:00,2019-03-29 13:15:00
70,1,1,0,0.005696606021904064,2019-03-29 13:00:00,2019-03-29 13:15:00
74,3,1,2,0.009492920495902644,2019-03-29 13:00:00,2019-03-29 13:15:00
79,1,1,0,0.004544369948552788,2019-03-29 13:00:00,2019-03-29 13:15:00
85,1,0,1,0.0031889456159844105,2019-03-29 13:00:00,2019-03-29 13:15:00
87,3,2,1,0.005360316272619909,2019-03-29 13:00:00,2019-03-29 13:15:00
88,4,1,3,0.004367687192703161,2019-03-29 13:00:00,2019-03-29 13:15:00
89,1,1,0,0.0042537486668752286,2019-03-29 13:00:00,2019-03-29 13:15:00
90,2,2,0,0.01263624034249956,2019-03-29 13:00:00,2019-03-29 13:15:00
99,2,2,0,0.00820426642782372,2019-03-29 13:00:00,2019-03-29 13:15:00
101,1,1,0,0.005899794281121164,2019-03-29 13:00:00,2019-03-29 13:15:00
104,1,1,0,0.005899794281121164,2019-03-29 13:00:00,2019-03-29 13:15:00
106,1,1,0,0.004544369948552788,2019-03-29 13:00:00,2019-03-29 13:15:00
109,11,5,6,0.019792997456086956,2019-03-29 13:00:00,2019-03-29 13:15:00
110,6,2,4,0.005546428769421912,2019-03-29 13:00:00,2019-03-29 13:15:00
111,7,3,4,0.0063516023919772905,2019-03-29 13:00:00,2019-03-29 13:15:00
112,2,1,1,0.004544369948552788,2019-03-29 13:00:00,2019-03-29 13:15:00
113,1,0,1,0.0031889456159844105,2019-03-29 13:00:00,2019-03-29 13:15:00
114,2,2,0,0.013740662890044822,2019-03-29 13:00:00,2019-03-29 13:15:00
115,3,1,2,0.005899794281121164,2019-03-29 13:00:00,2019-03-29 13:15:00
116,4,2,2,0.02119175410501443,2019-03-29 13:00:00,2019-03-29 13:15:00
118,2,1,1,0.005899794281121164,2019-03-29 13:00:00,2019-03-29 13:15:00
119,2,1,1,0.0040104663968808085,2019-03-29 13:00:00,2019-03-29 13:15:00
126,7,5,2,0.014519035177012671,2019-03-29 13:00:00,2019-03-29 13:15:00
127,5,2,3,0.010146152240410036,2019-03-29 13:00:00,2019-03-29 13:15:00
137,13,4,9,0.01127294260717621,2019-03-29 13:00:00,2019-03-29 13:15:00
138,6,5,1,0.06911242062226432,2019-03-29 13:00:00,2019-03-29 13:15:00
140,3,0,3,0.0031889456159844105,2019-03-29 13:00:00,2019-03-29 13:15:00
141,6,4,2,0.011113178825498093,2019-03-29 13:00:00,2019-03-29 13:15:00
147,1,0,1,0.0031889456159844105,2019-03-29 13:00:00,2019-03-29 13:15:00
151,2,0,2,0.0031889456159844105,2019-03-29 13:00:00,2019-03-29 13:15:00
153,2,0,2,0.0031889456159844105,2019-03-29 13:00:00,2019-03-29 13:15:00
157,1,1,0,0.0042537486668752286,2019-03-29 13:00:00,2019-03-29 13:15:00
158,3,3,0,0.01260889186967118,2019-03-29 13:00:00,2019-03-29 13:15:00
162,3,1,2,0.005899794281121164,2019-03-29 13:00:00,2019-03-29 13:15:00
164,2,1,1,0.0042537486668752286,2019-03-29 13:00:00,2019-03-29 13:15:00
168,7,2,5,0.004831987177777206,2019-03-29 13:00:00,2019-03-29 13:15:00
169,2,1,1,0.0065981719007937815,2019-03-29 13:00:00,2019-03-29 13:15:00
170,1,1,0,0.005993308282911684,2019-03-29 13:00:00,2019-03-29 13:15:00
189,7,4,3,0.02224632784068083,2019-03-29 13:00:00,2019-03-29 13:15:00
191,3,0,3,0.0031889456159844105,2019-03-29 13:00:00,2019-03-29 13:15:00
196,3,1,2,0.004544369948552788,2019-03-29 13:00:00,2019-03-29 13:15:00
197,2,2,0,0.010013503070836836,2019-03-29 13:00:00,2019-03-29 13:15:00
201,1,1,0,0.005899794281121164,2019-03-29 13:00:00,2019-03-29 13:15:00
202,4,4,0,0.010746449016307497,2019-03-29 13:00:00,2019-03-29 13:15:00
203,1,0,1,0.0031889456159844105,2019-03-29 13:00:00,2019-03-29 13:15:00
1,3,1,2,0.006663440940883776,2019-03-29 13:15:00,2019-03-29 13:30:00
2,1,1,0,0.007695690030517478,2019-03-29 13:15:00,2019-03-29 13:30:00
5,5,4,1,0.047081746272768316,2019-03-29 13:15:00,2019-03-29 13:30:00
10,8,2,6,0.006332015333348982,2019-03-29 13:15:00,2019-03-29 13:30:00
15,1,1,0,0.004473600708154211,2019-03-29 13:15:00,2019-03-29 13:30:00
16,3,1,2,0.0055426868599770755,2019-03-29 13:15:00,2019-03-29 13:30:00
18,9,6,3,0.024305838167249037,2019-03-29 13:15:00,2019-03-29 13:30:00
19,3,0,3,0.0031867683764078393,2019-03-29 13:15:00,2019-03-29 13:30:00
20,2,0,2,0.0031867683764078393,2019-03-29 13:15:00,2019-03-29 13:30:00
21,1,1,0,0.0064747519967071265,2019-03-29 13:15:00,2019-03-29 13:30:00
23,3,2,1,0.006735180626413741,2019-03-29 13:15:00,2019-03-29 13:30:00
26,1,1,0,0.006377677840555913,2019-03-29 13:15:00,2019-03-29 13:30:00
27,1,1,0,0.005446145396713905,2019-03-29 13:15:00,2019-03-29 13:30:00
28,1,1,0,0.005434859696191041,2019-03-29 13:15:00,2019-03-29 13:30:00
35,1,1,0,0.005434859696191041,2019-03-29 13:15:00,2019-03-29 13:30:00
40,2,2,0,0.004824445256998636,2019-03-29 13:15:00,2019-03-29 13:30:00
41,4,2,2,0.004981079650723724,2019-03-29 13:15:00,2019-03-29 13:30:00
46,2,1,1,0.021161748433330536,2019-03-29 13:15:00,2019-03-29 13:30:00
57,3,1,2,0.010074568601789914,2019-03-29 13:15:00,2019-03-29 13:30:00
58,3,2,1,0.009553489745956387,2019-03-29 13:15:00,2019-03-29 13:30:00
66,2,0,2,0.0031867683764078393,2019-03-29 13:15:00,2019-03-29 13:30:00
68,2,1,1,0.0038678015364381857,2019-03-29 13:15:00,2019-03-29 13:30:00
69,3,1,2,0.00485742513891739,2019-03-29 13:15:00,2019-03-29 13:30:00
74,2,0,2,0.0031867683764078393,2019-03-29 13:15:00,2019-03-29 13:30:00
79,1,1,0,0.00485742513891739,2019-03-29 13:15:00,2019-03-29 13:30:00
87,2,1,1,0.004541280227882629,2019-03-29 13:15:00,2019-03-29 13:30:00
88,5,2,3,0.015780469567313774,2019-03-29 13:15:00,2019-03-29 13:30:00
89,1,1,0,0.007658707398512962,2019-03-29 13:15:00,2019-03-29 13:30:00
90,2,2,0,0.010349221371455507,2019-03-29 13:15:00,2019-03-29 13:30:00
99,3,3,0,0.006714630519652817,2019-03-29 13:15:00,2019-03-29 13:30:00
101,4,3,1,0.039136728490253236,2019-03-29 13:15:00,2019-03-29 13:30:00
106,1,1,0,0.005251402494480696,2019-03-29 13:15:00,2019-03-29 13:30:00
109,10,4,6,0.01594597722602875,2019-03-29 13:15:00,2019-03-29 13:30:00
110,5,2,3,0.007355386349480769,2019-03-29 13:15:00,2019-03-29 13:30:00
111,1,0,1,0.0031867683764078393,2019-03-29 13:15:00,2019-03-29 13:30:00
112,4,2,2,0.006897198711451865,2019-03-29 13:15:00,2019-03-29 13:30:00
113,2,1,1,0.004089776277391033,2019-03-29 13:15:00,2019-03-29 13:30:00
114,1,1,0,0.004541280227882629,2019-03-29 13:15:00,2019-03-29 13:30:00
115,2,1,1,0.005303985251190054,2019-03-29 13:15:00,2019-03-29 13:30:00
116,5,2,3,0.007355386349480769,2019-03-29 13:15:00,2019-03-29 13:30:00
118,5,1,4,0.006118423506121844,2019-03-29 13:15:00,2019-03-29 13:30:00
119,8,4,4,0.010577744856421416,2019-03-29 13:15:00,2019-03-29 13:30:00
126,4,2,2,0.007507116715897606,2019-03-29 13:15:00,2019-03-29 13:30:00
127,6,1,5,0.0038395619157028747,2019-03-29 13:15:00,2019-03-29 13:30:00
129,2,1,1,0.021161748433330536,2019-03-29 13:15:00,2019-03-29 13:30:00
137,10,2,8,0.007705522417019971,2019-03-29 13:15:00,2019-03-29 13:30:00
138,5,5,0,0.012239637203883954,2019-03-29 13:15:00,2019-03-29 13:30:00
140,3,2,1,0.00529243914844961,2019-03-29 13:15:00,2019-03-29 13:30:00
141,5,3,2,0.008425327306307795,2019-03-29 13:15:00,2019-03-29 13:30:00
151,4,1,3,0.005895792079357419,2019-03-29 13:15:00,2019-03-29 13:30:00
153,6,5,1,0.015950718381557906,2019-03-29 13:15:00,2019-03-29 13:30:00
154,1,1,0,0.0038678015364381857,2019-03-29 13:15:00,2019-03-29 13:30:00
156,1,0,1,0.0031867683764078393,2019-03-29 13:15:00,2019-03-29 13:30:00
157,1,1,0,0.004005606816703238,2019-03-29 13:15:00,2019-03-29 13:30:00
158,3,3,0,0.0065768252393877645,2019-03-29 13:15:00,2019-03-29 13:30:00
162,2,0,2,0.0031867683764078393,2019-03-29 13:15:00,2019-03-29 13:30:00
164,6,1,5,0.004005606816703238,2019-03-29 13:15:00,2019-03-29 13:30:00
168,4,2,2,0.01225733709130444,2019-03-29 13:15:00,2019-03-29 13:30:00
169,2,0,2,0.0031867683764078393,2019-03-29 13:15:00,2019-03-29 13:30:00
170,2,2,0,0.006732977728460277,2019-03-29 13:15:00,2019-03-29 13:30:00
173,1,1,0,0.016746981222830526,2019-03-29 13:15:00,2019-03-29 13:30:00
177,1,1,0,0.004083924013565781,2019-03-29 13:15:00,2019-03-29 13:30:00
189,4,1,3,0.004541280227882629,2019-03-29 13:15:00,2019-03-29 13:30:00
195,1,0,1,0.0031867683764078393,2019-03-29 13:15:00,2019-03-29 13:30:00
196,4,1,3,0.005251402494480696,2019-03-29 13:15:00,2019-03-29 13:30:00
197,2,2,0,0.008461986827092378,2019-03-29 13:15:00,2019-03-29 13:30:00
202,4,4,0,0.007201379157947489,2019-03-29 13:15:00,2019-03-29 13:30:00
203,2,0,2,0.0031867683764078393,2019-03-29 13:15:00,2019-03-29 13:30:00
1,4,3,1,0.0492272980609743,2019-03-29 13:30:00,2019-03-29 13:45:00
5,4,3,1,0.04063662895532954,2019-03-29 13:30:00,2019-03-29 13:45:00
10,4,1,3,0.003747836388198732,2019-03-29 13:30:00,2019-03-29 13:45:00
11,1,0,1,0.002872669274714405,2019-03-29 13:30:00,2019-03-29 13:45:00
15,2,1,1,0.0034831704757512794,2019-03-29 13:30:00,2019-03-29 13:45:00
16,1,1,0,0.005314674078861903,2019-03-29 13:30:00,2019-03-29 13:45:00
18,6,4,2,0.010055325159903776,2019-03-29 13:30:00,2019-03-29 13:45:00
19,2,0,2,0.002872669274714405,2019-03-29 13:30:00,2019-03-29 13:45:00
20,3,1,2,0.004093671676788154,2019-03-29 13:30:00,2019-03-29 13:45:00
21,2,1,1,0.009455732708923944,2019-03-29 13:30:00,2019-03-29 13:45:00
23,3,3,0,0.015104558335578102,2019-03-29 13:30:00,2019-03-29 13:45:00
26,2,1,1,0.003686670876096904,2019-03-29 13:30:00,2019-03-29 13:45:00
28,3,3,0,0.006668643283146397,2019-03-29 13:30:00,2019-03-29 13:45:00
35,1,1,0,0.003747836388198732,2019-03-29 13:30:00,2019-03-29 13:45:00
41,4,2,2,0.005115496916866389,2019-03-29 13:30:00,2019-03-29 13:45:00
57,3,2,1,0.009875959701234841,2019-03-29 13:30:00,2019-03-29 13:45:00
58,2,1,1,0.004683824291242061,2019-03-29 13:30:00,2019-03-29 13:45:00
66,3,1,2,0.007146725650842683,2019-03-29 13:30:00,2019-03-29 13:45:00
67,2,1,1,0.006801788918297316,2019-03-29 13:30:00,2019-03-29 13:45:00
68,3,2,1,0.00774362235148162,2019-03-29 13:30:00,2019-03-29 13:45:00
69,4,2,2,0.008925497067540788,2019-03-29 13:30:00,2019-03-29 13:45:00
70,4,2,2,0.019118169752251873,2019-03-29 13:30:00,2019-03-29 13:45:00
74,2,0,2,0.002872669274714405,2019-03-29 13:30:00,2019-03-29 13:45:00
85,2,0,2,0.002872669274714405,2019-03-29 13:30:00,2019-03-29 13:45:00
87,3,1,2,0.006802730260314024,2019-03-29 13:30:00,2019-03-29 13:45:00
88,2,1,1,0.006854384992155382,2019-03-29 13:30:00,2019-03-29 13:45:00
89,1,1,0,0.008699619701525892,2019-03-29 13:30:00,2019-03-29 13:45:00
90,3,2,1,0.005649383920198713,2019-03-29 13:30:00,2019-03-29 13:45:00
99,3,3,0,0.006615530449276326,2019-03-29 13:30:00,2019-03-29 13:45:00
101,4,2,2,0.009243793722444814,2019-03-29 13:30:00,2019-03-29 13:45:00
109,1,1,0,0.005314674078861903,2019-03-29 13:30:00,2019-03-29 13:45:00
110,1,1,0,0.005047022985081551,2019-03-29 13:30:00,2019-03-29 13:45:00
111,1,0,1,0.002872669274714405,2019-03-29 13:30:00,2019-03-29 13:45:00
112,7,5,2,0.008610265373984108,2019-03-29 13:30:00,2019-03-29 13:45:00
114,2,1,1,0.005367532301129182,2019-03-29 13:30:00,2019-03-29 13:45:00
115,3,1,2,0.004261026597456559,2019-03-29 13:30:00,2019-03-29 13:45:00
116,4,2,2,0.007050280674159566,2019-03-29 13:30:00,2019-03-29 13:45:00
118,4,0,4,0.002872669274714405,2019-03-29 13:30:00,2019-03-29 13:45:00
119,11,4,7,0.007206189239326796,2019-03-29 13:30:00,2019-03-29 13:45:00
120,1,0,1,0.002872669274714405,2019-03-29 13:30:00,2019-03-29 13:45:00
122,7,2,5,0.006945030397365586,2019-03-29 13:30:00,2019-03-29 13:45:00
126,3,0,3,0.002872669274714405,2019-03-29 13:30:00,2019-03-29 13:45:00
127,3,1,2,0.004173525645128828,2019-03-29 13:30:00,2019-03-29 13:45:00
129,4,2,2,0.013349974321646559,2019-03-29 13:30:00,2019-03-29 13:45:00
135,1,1,0,0.006006657833101616,2019-03-29 13:30:00,2019-03-29 13:45:00
137,8,2,6,0.009181296282310299,2019-03-29 13:30:00,2019-03-29 13:45:00
138,4,4,0,0.007146177681972527,2019-03-29 13:30:00,2019-03-29 13:45:00
140,3,2,1,0.005984680661656484,2019-03-29 13:30:00,2019-03-29 13:45:00
141,5,1,4,0.006532541154901074,2019-03-29 13:30:00,2019-03-29 13:45:00
151,3,1,2,0.005314674078861903,2019-03-29 13:30:00,2019-03-29 13:45:00
153,5,4,1,0.052621829487872626,2019-03-29 13:30:00,2019-03-29 13:45:00
154,3,2,1,0.027161989896221143,2019-03-29 13:30:00,2019-03-29 13:45:00
156,1,0,1,0.002872669274714405,2019-03-29 13:30:00,2019-03-29 13:45:00
157,1,1,0,0.007435664741236941,2019-03-29 13:30:00,2019-03-29 13:45:00
158,3,3,0,0.0065257552754424495,2019-03-29 13:30:00,2019-03-29 13:45:00
159,1,1,0,0.010911309404947889,2019-03-29 13:30:00,2019-03-29 13:45:00
162,2,0,2,0.002872669274714405,2019-03-29 13:30:00,2019-03-29 13:45:00
164,7,1,6,0.008547359059683433,2019-03-29 13:30:00,2019-03-29 13:45:00
168,3,2,1,0.03833891394365065,2019-03-29 13:30:00,2019-03-29 13:45:00
169,3,2,1,0.0046230035016830585,2019-03-29 13:30:00,2019-03-29 13:45:00
170,2,2,0,0.004871527798493434,2019-03-29 13:30:00,2019-03-29 13:45:00
173,1,0,1,0.002872669274714405,2019-03-29 13:30:00,2019-03-29 13:45:00
177,2,2,0,0.006429543266087034,2019-03-29 13:30:00,2019-03-29 13:45:00
189,4,0,4,0.002872669274714405,2019-03-29 13:30:00,2019-03-29 13:45:00
195,1,0,1,0.002872669274714405,2019-03-29 13:30:00,2019-03-29 13:45:00
196,2,2,0,0.007277020235144344,2019-03-29 13:30:00,2019-03-29 13:45:00
197,3,1,2,0.005869463996965434,2019-03-29 13:30:00,2019-03-29 13:45:00
202,4,4,0,0.012496104795044052,2019-03-29 13:30:00,2019-03-29 13:45:00
203,1,0,1,0.002872669274714405,2019-03-29 13:30:00,2019-03-29 13:45:00
1,3,2,1,0.0052370548617478255,2019-03-29 13:45:00,2019-03-29 14:00:00
5,2,1,1,0.018706371724894637,2019-03-29 13:45:00,2019-03-29 14:00:00
10,2,1,1,0.003559946346194657,2019-03-29 13:45:00,2019-03-29 14:00:00
11,1,0,1,0.0028307565845964674,2019-03-29 13:45:00,2019-03-29 14:00:00
15,1,0,1,0.0028307565845964674,2019-03-29 13:45:00,2019-03-29 14:00:00
16,4,2,2,0.006440204000323504,2019-03-29 13:45:00,2019-03-29 14:00:00
18,7,4,3,0.013605231217081501,2019-03-29 13:45:00,2019-03-29 14:00:00
19,3,2,1,0.01581716449045566,2019-03-29 13:45:00,2019-03-29 14:00:00
20,2,1,1,0.016277360652892123,2019-03-29 13:45:00,2019-03-29 14:00:00
21,2,1,1,0.008347379884709719,2019-03-29 13:45:00,2019-03-29 14:00:00
23,2,2,0,0.005966244623346015,2019-03-29 13:45:00,2019-03-29 14:00:00
26,1,0,1,0.0028307565845964674,2019-03-29 13:45:00,2019-03-29 14:00:00
28,6,3,3,0.022233391928861836,2019-03-29 13:45:00,2019-03-29 14:00:00
30,1,1,0,0.011796380417039594,2019-03-29 13:45:00,2019-03-29 14:00:00
35,3,2,1,0.014491294614724034,2019-03-29 13:45:00,2019-03-29 14:00:00
37,1,0,1,0.0028307565845964674,2019-03-29 13:45:00,2019-03-29 14:00:00
40,2,0,2,0.0028307565845964674,2019-03-29 13:45:00,2019-03-29 14:00:00
41,3,2,1,0.006859017715046548,2019-03-29 13:45:00,2019-03-29 14:00:00
46,2,1,1,0.012858770272114739,2019-03-29 13:45:00,2019-03-29 14:00:00
57,4,3,1,0.02594891848896673,2019-03-29 13:45:00,2019-03-29 14:00:00
58,1,0,1,0.0028307565845964674,2019-03-29 13:45:00,2019-03-29 14:00:00
61,1,0,1,0.0028307565845964674,2019-03-29 13:45:00,2019-03-29 14:00:00
66,1,1,0,0.006686016634919379,2019-03-29 13:45:00,2019-03-29 14:00:00
67,3,2,1,0.018483549708497117,2019-03-29 13:45:00,2019-03-29 14:00:00
68,2,1,1,0.006489272055253446,2019-03-29 13:45:00,2019-03-29 14:00:00
69,2,1,1,0.0052370548617478255,2019-03-29 13:45:00,2019-03-29 14:00:00
74,2,0,2,0.0028307565845964674,2019-03-29 13:45:00,2019-03-29 14:00:00
85,3,1,2,0.02489044305271906,2019-03-29 13:45:00,2019-03-29 14:00:00
87,2,0,2,0.0028307565845964674,2019-03-29 13:45:00,2019-03-29 14:00:00
88,1,0,1,0.0028307565845964674,2019-03-29 13:45:00,2019-03-29 14:00:00
90,1,0,1,0.0028307565845964674,2019-03-29 13:45:00,2019-03-29 14:00:00
99,3,3,0,0.007517273995787026,2019-03-29 13:45:00,2019-03-29 14:00:00
101,4,2,2,0.026351004277439687,2019-03-29 13:45:00,2019-03-29 14:00:00
108,1,0,1,0.0028307565845964674,2019-03-29 13:45:00,2019-03-29 14:00:00
109,2,0,2,0.0028307565845964674,2019-03-29 13:45:00,2019-03-29 14:00:00
110,7,4,3,0.01928665267194526,2019-03-29 13:45:00,2019-03-29 14:00:00
111,6,3,3,0.01252696564939626,2019-03-29 13:45:00,2019-03-29 14:00:00
112,6,3,3,0.01291067147559639,2019-03-29 13:45:00,2019-03-29 14:00:00
114,5,3,2,0.016634434728874443,2019-03-29 13:45:00,2019-03-29 14:00:00
115,1,0,1,0.0028307565845964674,2019-03-29 13:45:00,2019-03-29 14:00:00
116,4,2,2,0.006859017715046548,2019-03-29 13:45:00,2019-03-29 14:00:00
118,2,2,0,0.006480463834130361,2019-03-29 13:45:00,2019-03-29 14:00:00
119,8,2,6,0.005146857391984899,2019-03-29 13:45:00,2019-03-29 14:00:00
120,1,0,1,0.0028307565845964674,2019-03-29 13:45:00,2019-03-29 14:00:00
122,6,2,4,0.0052370548617478255,2019-03-29 13:45:00,2019-03-29 14:00:00
126,2,0,2,0.0028307565845964674,2019-03-29 13:45:00,2019-03-29 14:00:00
127,3,1,2,0.005110975718635669,2019-03-29 13:45:00,2019-03-29 14:00:00
129,3,2,1,0.007643353138899182,2019-03-29 13:45:00,2019-03-29 14:00:00
135,1,1,0,0.0052370548617478255,2019-03-29 13:45:00,2019-03-29 14:00:00
137,6,1,5,0.013410866213304302,2019-03-29 13:45:00,2019-03-29 14:00:00
138,5,2,3,0.006440204000323504,2019-03-29 13:45:00,2019-03-29 14:00:00
140,2,2,0,0.007517273995787025,2019-03-29 13:45:00,2019-03-29 14:00:00
141,1,1,0,0.006489272055253446,2019-03-29 13:45:00,2019-03-29 14:00:00
154,2,1,1,0.011796380417039594,2019-03-29 13:45:00,2019-03-29 14:00:00
157,1,1,0,0.009901262579958998,2019-03-29 13:45:00,2019-03-29 14:00:00
158,2,2,0,0.0052370548617478255,2019-03-29 13:45:00,2019-03-29 14:00:00
159,1,1,0,0.00992697134775526,2019-03-29 13:45:00,2019-03-29 14:00:00
162,2,0,2,0.0028307565845964674,2019-03-29 13:45:00,2019-03-29 14:00:00
164,5,3,2,0.021093393323679776,2019-03-29 13:45:00,2019-03-29 14:00:00
168,4,3,1,0.03337883772661713,2019-03-29 13:45:00,2019-03-29 14:00:00
169,2,2,0,0.004289136107792847,2019-03-29 13:45:00,2019-03-29 14:00:00
170,3,1,2,0.008295813747477957,2019-03-29 13:45:00,2019-03-29 14:00:00
173,2,2,0,0.007692421193829124,2019-03-29 13:45:00,2019-03-29 14:00:00
177,2,2,0,0.007060066543484596,2019-03-29 13:45:00,2019-03-29 14:00:00
189,5,1,4,0.0052370548617478255,2019-03-29 13:45:00,2019-03-29 14:00:00
196,1,1,0,0.0039437082534092205,2019-03-29 13:45:00,2019-03-29 14:00:00
197,2,0,2,0.0028307565845964674,2019-03-29 13:45:00,2019-03-29 14:00:00
201,1,1,0,0.005568037021746887,2019-03-29 13:45:00,2019-03-29 14:00:00
202,2,2,0,0.007175603411267441,2019-03-29 13:45:00,2019-03-29 14:00:00
203,1,1,0,0.005568037021746887,2019-03-29 13:45:00,2019-03-29 14:00:00
1,1,0,1,0.0029814652188482247,2019-03-29 14:00:00,2019-03-29 14:15:00
2,1,1,0,0.008985298337598778,2019-03-29 14:00:00,2019-03-29 14:15:00
5,2,1,1,0.019768071476071764,2019-03-29 14:00:00,2019-03-29 14:15:00
10,2,1,1,0.0034974265472393,2019-03-29 14:00:00,2019-03-29 14:15:00
11,1,0,1,0.0029814652188482247,2019-03-29 14:00:00,2019-03-29 14:15:00
15,1,1,0,0.003972493031680187,2019-03-29 14:00:00,2019-03-29 14:15:00
16,4,1,3,0.0034974265472393,2019-03-29 14:00:00,2019-03-29 14:15:00
18,3,2,1,0.008046864654647974,2019-03-29 14:00:00,2019-03-29 14:15:00
19,5,4,1,0.07012789024774238,2019-03-29 14:00:00,2019-03-29 14:15:00
21,4,1,3,0.009758105349017512,2019-03-29 14:00:00,2019-03-29 14:15:00
22,1,0,1,0.0029814652188482247,2019-03-29 14:00:00,2019-03-29 14:15:00
23,2,2,0,0.01001547664215218,2019-03-29 14:00:00,2019-03-29 14:15:00
26,1,1,0,0.00895117300228308,2019-03-29 14:00:00,2019-03-29 14:15:00
27,1,0,1,0.0029814652188482247,2019-03-29 14:00:00,2019-03-29 14:15:00
28,5,2,3,0.006783166903891471,2019-03-29 14:00:00,2019-03-29 14:15:00
30,2,1,1,0.007022250368280549,2019-03-29 14:00:00,2019-03-29 14:15:00
35,3,2,1,0.009090320076008258,2019-03-29 14:00:00,2019-03-29 14:15:00
40,2,0,2,0.0029814652188482247,2019-03-29 14:00:00,2019-03-29 14:15:00
41,1,1,0,0.0042486991138626405,2019-03-29 14:00:00,2019-03-29 14:15:00
46,4,2,2,0.009351134336525534,2019-03-29 14:00:00,2019-03-29 14:15:00
57,6,4,2,0.02461726922163671,2019-03-29 14:00:00,2019-03-29 14:15:00
58,4,2,2,0.009110034007365507,2019-03-29 14:00:00,2019-03-29 14:15:00
61,1,0,1,0.0029814652188482247,2019-03-29 14:00:00,2019-03-29 14:15:00
62,1,0,1,0.0029814652188482247,2019-03-29 14:00:00,2019-03-29 14:15:00
67,2,2,0,0.014873910001585125,2019-03-29 14:00:00,2019-03-29 14:15:00
68,2,1,1,0.007971526557306216,2019-03-29 14:00:00,2019-03-29 14:15:00
69,4,1,3,0.005515933008877056,2019-03-29 14:00:00,2019-03-29 14:15:00
70,2,1,1,0.004544462154663632,2019-03-29 14:00:00,2019-03-29 14:15:00
74,5,2,3,0.011123652188964994,2019-03-29 14:00:00,2019-03-29 14:15:00
85,1,0,1,0.0029814652188482247,2019-03-29 14:00:00,2019-03-29 14:15:00
87,3,0,3,0.0029814652188482247,2019-03-29 14:00:00,2019-03-29 14:15:00
88,2,1,1,0.0034974265472393,2019-03-29 14:00:00,2019-03-29 14:15:00
89,1,0,1,0.0029814652188482247,2019-03-29 14:00:00,2019-03-29 14:15:00
90,1,1,0,0.007022250368280549,2019-03-29 14:00:00,2019-03-29 14:15:00
99,1,1,0,0.004333256505494563,2019-03-29 14:00:00,2019-03-29 14:15:00
101,4,2,2,0.018626861247910836,2019-03-29 14:00:00,2019-03-29 14:15:00
108,1,0,1,0.0029814652188482247,2019-03-29 14:00:00,2019-03-29 14:15:00
109,1,0,1,0.0029814652188482247,2019-03-29 14:00:00,2019-03-29 14:15:00
110,4,2,2,0.008576681258877785,2019-03-29 14:00:00,2019-03-29 14:15:00
111,9,5,4,0.014418545431474219,2019-03-29 14:00:00,2019-03-29 14:15:00
112,10,6,4,0.02347976236235446,2019-03-29 14:00:00,2019-03-29 14:15:00
113,3,3,0,0.009022247312940785,2019-03-29 14:00:00,2019-03-29 14:15:00
114,5,2,3,0.0068256334296181685,2019-03-29 14:00:00,2019-03-29 14:15:00
118,2,2,0,0.005864591376925684,2019-03-29 14:00:00,2019-03-29 14:15:00
119,8,1,7,0.0042486991138626405,2019-03-29 14:00:00,2019-03-29 14:15:00
120,2,1,1,0.006579054433437328,2019-03-29 14:00:00,2019-03-29 14:15:00
122,2,0,2,0.0029814652188482247,2019-03-29 14:00:00,2019-03-29 14:15:00
126,3,1,2,0.005515933008877056,2019-03-29 14:00:00,2019-03-29 14:15:00
127,4,2,2,0.007536723978974034,2019-03-29 14:00:00,2019-03-29 14:15:00
129,1,1,0,0.006853689035729686,2019-03-29 14:00:00,2019-03-29 14:15:00
137,7,3,4,0.006360755605553332,2019-03-29 14:00:00,2019-03-29 14:15:00
138,6,2,4,0.006783166903891472,2019-03-29 14:00:00,2019-03-29 14:15:00
140,1,1,0,0.004333256505494563,2019-03-29 14:00:00,2019-03-29 14:15:00
141,2,2,0,0.010505994347335047,2019-03-29 14:00:00,2019-03-29 14:15:00
147,1,1,0,0.005746620544441148,2019-03-29 14:00:00,2019-03-29 14:15:00
151,1,1,0,0.005746620544441148,2019-03-29 14:00:00,2019-03-29 14:15:00
153,1,1,0,0.006184932692327696,2019-03-29 14:00:00,2019-03-29 14:15:00
154,4,2,2,0.00846381344731928,2019-03-29 14:00:00,2019-03-29 14:15:00
156,1,1,0,0.005515933008877056,2019-03-29 14:00:00,2019-03-29 14:15:00
158,3,3,0,0.013260514973327192,2019-03-29 14:00:00,2019-03-29 14:15:00
159,1,1,0,0.005746620544441148,2019-03-29 14:00:00,2019-03-29 14:15:00
164,7,3,4,0.019012801204306738,2019-03-29 14:00:00,2019-03-29 14:15:00
168,5,3,2,0.014124756049494655,2019-03-29 14:00:00,2019-03-29 14:15:00
169,7,4,3,0.011239007583901355,2019-03-29 14:00:00,2019-03-29 14:15:00
170,3,1,2,0.005954548657344112,2019-03-29 14:00:00,2019-03-29 14:15:00
171,1,1,0,0.0038262878155245015,2019-03-29 14:00:00,2019-03-29 14:15:00
173,5,3,2,0.015334399248895373,2019-03-29 14:00:00,2019-03-29 14:15:00
189,2,0,2,0.0029814652188482247,2019-03-29 14:00:00,2019-03-29 14:15:00
196,1,0,1,0.0029814652188482247,2019-03-29 14:00:00,2019-03-29 14:15:00
199,4,3,1,0.009384192683551121,2019-03-29 14:00:00,2019-03-29 14:15:00
201,1,1,0,0.003972493031680187,2019-03-29 14:00:00,2019-03-29 14:15:00
202,2,0,2,0.0029814652188482247,2019-03-29 14:00:00,2019-03-29 14:15:00
203,3,1,2,0.003972493031680187,2019-03-29 14:00:00,2019-03-29 14:15:00
1,1,0,1,0.002756150733348218,2019-03-29 14:15:00,2019-03-29 14:30:00
2,1,1,0,0.010310081468174203,2019-03-29 14:15:00,2019-03-29 14:30:00
5,8,3,5,0.00562550920428247,2019-03-29 14:15:00,2019-03-29 14:30:00
10,1,0,1,0.002756150733348218,2019-03-29 14:15:00,2019-03-29 14:30:00
11,1,0,1,0.002756150733348218,2019-03-29 14:15:00,2019-03-29 14:30:00
16,3,1,2,0.0032247400170763046,2019-03-29 14:15:00,2019-03-29 14:30:00
18,5,3,2,0.006352531381204739,2019-03-29 14:15:00,2019-03-29 14:30:00
19,7,6,1,0.10899133459550567,2019-03-29 14:15:00,2019-03-29 14:30:00
20,1,1,0,0.004558797782369669,2019-03-29 14:15:00,2019-03-29 14:30:00
21,4,1,3,0.006484573662015331,2019-03-29 14:15:00,2019-03-29 14:30:00
23,6,5,1,0.01214377528228299,2019-03-29 14:15:00,2019-03-29 14:30:00
26,1,1,0,0.005099097151988651,2019-03-29 14:15:00,2019-03-29 14:30:00
27,4,1,3,0.003917697280981541,2019-03-29 14:15:00,2019-03-29 14:30:00
28,1,1,0,0.005099097151988651,2019-03-29 14:15:00,2019-03-29 14:30:00
30,1,0,1,0.002756150733348218,2019-03-29 14:15:00,2019-03-29 14:30:00
35,5,2,3,0.0044998250638596995,2019-03-29 14:15:00,2019-03-29 14:30:00
40,1,0,1,0.002756150733348218,2019-03-29 14:15:00,2019-03-29 14:30:00
41,5,2,3,0.006361444831391119,2019-03-29 14:15:00,2019-03-29 14:30:00
46,5,2,3,0.0083731033631008,2019-03-29 14:15:00,2019-03-29 14:30:00
57,2,1,1,0.0070908288051652136,2019-03-29 14:15:00,2019-03-29 14:30:00
58,6,3,3,0.029413861898841244,2019-03-29 14:15:00,2019-03-29 14:30:00
62,3,1,2,0.003917697280981541,2019-03-29 14:15:00,2019-03-29 14:30:00
67,3,3,0,0.009351158011441723,2019-03-29 14:15:00,2019-03-29 14:30:00
68,2,1,1,0.004385873442431382,2019-03-29 14:15:00,2019-03-29 14:30:00
69,12,4,8,0.007485315451567968,2019-03-29 14:15:00,2019-03-29 14:30:00
70,1,0,1,0.002756150733348218,2019-03-29 14:15:00,2019-03-29 14:30:00
74,6,2,4,0.005569547835648097,2019-03-29 14:15:00,2019-03-29 14:30:00
85,1,0,1,0.002756150733348218,2019-03-29 14:15:00,2019-03-29 14:30:00
86,1,1,0,0.0035515568332079904,2019-03-29 14:15:00,2019-03-29 14:30:00
87,7,1,6,0.003211100681259374,2019-03-29 14:15:00,2019-03-29 14:30:00
88,3,2,1,0.020021481286680163,2019-03-29 14:15:00,2019-03-29 14:30:00
89,3,2,1,0.007828976939894778,2019-03-29 14:15:00,2019-03-29 14:30:00
90,2,1,1,0.005670186049031084,2019-03-29 14:15:00,2019-03-29 14:30:00
99,2,1,1,0.004703593908743395,2019-03-29 14:15:00,2019-03-29 14:30:00
101,2,1,1,0.004031235780131613,2019-03-29 14:15:00,2019-03-29 14:30:00
108,1,0,1,0.002756150733348218,2019-03-29 14:15:00,2019-03-29 14:30:00
109,5,2,3,0.006951983054125842,2019-03-29 14:15:00,2019-03-29 14:30:00
110,3,2,1,0.00431811501244184,2019-03-29 14:15:00,2019-03-29 14:30:00
111,4,2,2,0.0049357436464875695,2019-03-29 14:15:00,2019-03-29 14:30:00
112,12,6,6,0.011502485758121768,2019-03-29 14:15:00,2019-03-29 14:30:00
113,4,3,1,0.007026687004010042,2019-03-29 14:15:00,2019-03-29 14:30:00
114,2,0,2,0.002756150733348218,2019-03-29 14:15:00,2019-03-29 14:30:00
115,2,1,1,0.0197723232404788,2019-03-29 14:15:00,2019-03-29 14:30:00
118,2,2,0,0.012147241914817631,2019-03-29 14:15:00,2019-03-29 14:30:00
119,5,0,5,0.002756150733348218,2019-03-29 14:15:00,2019-03-29 14:30:00
120,3,3,0,0.008498605076839659,2019-03-29 14:15:00,2019-03-29 14:30:00
126,7,2,5,0.006831732596664407,2019-03-29 14:15:00,2019-03-29 14:30:00
135,2,1,1,0.01833865212446755,2019-03-29 14:15:00,2019-03-29 14:30:00
137,4,2,2,0.004581747055897247,2019-03-29 14:15:00,2019-03-29 14:30:00
138,2,2,0,0.007442043570629084,2019-03-29 14:15:00,2019-03-29 14:30:00
140,3,0,3,0.002756150733348218,2019-03-29 14:15:00,2019-03-29 14:30:00
141,2,2,0,0.011041368545186439,2019-03-29 14:15:00,2019-03-29 14:30:00
147,3,3,0,0.008120289533487212,2019-03-29 14:15:00,2019-03-29 14:30:00
151,1,1,0,0.004593668721630063,2019-03-29 14:15:00,2019-03-29 14:30:00
153,2,1,1,0.008729578250503432,2019-03-29 14:15:00,2019-03-29 14:30:00
154,4,2,2,0.006451168188577895,2019-03-29 14:15:00,2019-03-29 14:30:00
156,1,0,1,0.002756150733348218,2019-03-29 14:15:00,2019-03-29 14:30:00
157,1,0,1,0.002756150733348218,2019-03-29 14:15:00,2019-03-29 14:30:00
158,6,5,1,0.009409097535590012,2019-03-29 14:15:00,2019-03-29 14:30:00
159,1,1,0,0.004593668721630063,2019-03-29 14:15:00,2019-03-29 14:30:00
162,2,1,1,0.004421360327510765,2019-03-29 14:15:00,2019-03-29 14:30:00
164,7,3,4,0.013711373226372649,2019-03-29 14:15:00,2019-03-29 14:30:00
168,7,4,3,0.02665429524213909,2019-03-29 14:15:00,2019-03-29 14:30:00
169,5,3,2,0.006607364616487256,2019-03-29 14:15:00,2019-03-29 14:30:00
170,10,4,6,0.008868802751282455,2019-03-29 14:15:00,2019-03-29 14:30:00
171,1,1,0,0.003211100681259374,2019-03-29 14:15:00,2019-03-29 14:30:00
173,5,3,2,0.007515916373028852,2019-03-29 14:15:00,2019-03-29 14:30:00
175,1,1,0,0.004726108223973366,2019-03-29 14:15:00,2019-03-29 14:30:00
177,2,2,0,0.008179930826963333,2019-03-29 14:15:00,2019-03-29 14:30:00
189,2,1,1,0.005099097151988651,2019-03-29 14:15:00,2019-03-29 14:30:00
196,2,0,2,0.002756150733348218,2019-03-29 14:15:00,2019-03-29 14:30:00
197,2,1,1,0.01833865212446755,2019-03-29 14:15:00,2019-03-29 14:30:00
199,4,4,0,0.011797712967802241,2019-03-29 14:15:00,2019-03-29 14:30:00
201,1,1,0,0.007576410701830173,2019-03-29 14:15:00,2019-03-29 14:30:00
203,4,1,3,0.0038459471899178936,2019-03-29 14:15:00,2019-03-29 14:30:00
1,2,1,1,0.008931268406537754,2019-03-29 14:30:00,2019-03-29 14:45:00
2,1,1,0,0.0036287828433648585,2019-03-29 14:30:00,2019-03-29 14:45:00
5,4,1,3,0.0037361330479944548,2019-03-29 14:30:00,2019-03-29 14:45:00
10,2,1,1,0.0037361330479944548,2019-03-29 14:30:00,2019-03-29 14:45:00
11,1,0,1,0.002677462586440364,2019-03-29 14:30:00,2019-03-29 14:45:00
15,5,2,3,0.00665976855028441,2019-03-29 14:30:00,2019-03-29 14:45:00
16,1,0,1,0.002677462586440364,2019-03-29 14:30:00,2019-03-29 14:45:00
18,6,5,1,0.023512856123966565,2019-03-29 14:30:00,2019-03-29 14:45:00
19,7,5,2,0.012035725680260918,2019-03-29 14:30:00,2019-03-29 14:45:00
20,3,3,0,0.007931018032896156,2019-03-29 14:30:00,2019-03-29 14:45:00
21,3,1,2,0.0034361423627584267,2019-03-29 14:30:00,2019-03-29 14:45:00
23,6,3,3,0.0075343527233287105,2019-03-29 14:30:00,2019-03-29 14:45:00
27,4,1,3,0.0045539402871414385,2019-03-29 14:30:00,2019-03-29 14:45:00
30,1,1,0,0.01140847186528972,2019-03-29 14:30:00,2019-03-29 14:45:00
35,1,1,0,0.003970906533566637,2019-03-29 14:30:00,2019-03-29 14:45:00
37,1,1,0,0.0036287828433648585,2019-03-29 14:30:00,2019-03-29 14:45:00
41,4,1,3,0.0037361330479944548,2019-03-29 14:30:00,2019-03-29 14:45:00
46,4,2,2,0.004953501915394553,2019-03-29 14:30:00,2019-03-29 14:45:00
50,5,3,2,0.011007494754585602,2019-03-29 14:30:00,2019-03-29 14:45:00
57,3,1,2,0.0048182406442010845,2019-03-29 14:30:00,2019-03-29 14:45:00
58,8,3,5,0.012115606138594168,2019-03-29 14:30:00,2019-03-29 14:45:00
61,2,1,1,0.017802165615871772,2019-03-29 14:30:00,2019-03-29 14:45:00
62,3,0,3,0.002677462586440364,2019-03-29 14:30:00,2019-03-29 14:45:00
67,5,4,1,0.054199306003108225,2019-03-29 14:30:00,2019-03-29 14:45:00
68,3,0,3,0.002677462586440364,2019-03-29 14:30:00,2019-03-29 14:45:00
69,6,3,3,0.009229774622572035,2019-03-29 14:30:00,2019-03-29 14:45:00
70,2,1,1,0.017802165615871772,2019-03-29 14:30:00,2019-03-29 14:45:00
74,5,1,4,0.0034000362763107906,2019-03-29 14:30:00,2019-03-29 14:45:00
85,1,0,1,0.002677462586440364,2019-03-29 14:30:00,2019-03-29 14:45:00
86,1,1,0,0.00529283383918297,2019-03-29 14:30:00,2019-03-29 14:45:00
87,7,3,4,0.00561512850722742,2019-03-29 14:30:00,2019-03-29 14:45:00
88,4,1,3,0.0036526752455197636,2019-03-29 14:30:00,2019-03-29 14:45:00
89,2,2,0,0.024771662692273173,2019-03-29 14:30:00,2019-03-29 14:45:00
90,1,1,0,0.004564609130514607,2019-03-29 14:30:00,2019-03-29 14:45:00
99,2,1,1,0.004700912037969553,2019-03-29 14:30:00,2019-03-29 14:45:00
104,2,1,1,0.010270174446026476,2019-03-29 14:30:00,2019-03-29 14:45:00
108,1,0,1,0.002677462586440364,2019-03-29 14:30:00,2019-03-29 14:45:00
109,8,6,2,0.01300539008635428,2019-03-29 14:30:00,2019-03-29 14:45:00
110,5,3,2,0.005146142396000983,2019-03-29 14:30:00,2019-03-29 14:45:00
111,6,3,3,0.0075548443473706945,2019-03-29 14:30:00,2019-03-29 14:45:00
112,7,2,5,0.010437809445184423,2019-03-29 14:30:00,2019-03-29 14:45:00
115,7,2,5,0.005735937444907619,2019-03-29 14:30:00,2019-03-29 14:45:00
116,2,1,1,0.007356345074045067,2019-03-29 14:30:00,2019-03-29 14:45:00
118,4,2,2,0.012104107624529428,2019-03-29 14:30:00,2019-03-29 14:45:00
119,4,1,3,0.004564609130514607,2019-03-29 14:30:00,2019-03-29 14:45:00
120,2,2,0,0.008350812407460308,2019-03-29 14:30:00,2019-03-29 14:45:00
122,1,0,1,0.002677462586440364,2019-03-29 14:30:00,2019-03-29 14:45:00
126,4,1,3,0.006622069540853181,2019-03-29 14:30:00,2019-03-29 14:45:00
127,2,1,1,0.017802165615871772,2019-03-29 14:30:00,2019-03-29 14:45:00
129,2,0,2,0.002677462586440364,2019-03-29 14:30:00,2019-03-29 14:45:00
133,1,0,1,0.002677462586440364,2019-03-29 14:30:00,2019-03-29 14:45:00
135,2,1,1,0.017802165615871772,2019-03-29 14:30:00,2019-03-29 14:45:00
137,5,2,3,0.007140841536717801,2019-03-29 14:30:00,2019-03-29 14:45:00
138,6,5,1,0.012089373220348127,2019-03-29 14:30:00,2019-03-29 14:45:00
140,3,0,3,0.002677462586440364,2019-03-29 14:30:00,2019-03-29 14:45:00
141,3,3,0,0.006838841737465287,2019-03-29 14:30:00,2019-03-29 14:45:00
147,2,2,0,0.00567607560526498,2019-03-29 14:30:00,2019-03-29 14:45:00
153,5,2,3,0.013758086270474187,2019-03-29 14:30:00,2019-03-29 14:45:00
154,3,3,0,0.008439419778725336,2019-03-29 14:30:00,2019-03-29 14:45:00
156,2,1,1,0.004137954742460266,2019-03-29 14:30:00,2019-03-29 14:45:00
157,2,0,2,0.002677462586440364,2019-03-29 14:30:00,2019-03-29 14:45:00
158,10,6,4,0.009369123535688516,2019-03-29 14:30:00,2019-03-29 14:45:00
159,1,1,0,0.004137954742460266,2019-03-29 14:30:00,2019-03-29 14:45:00
162,2,1,1,0.0034361423627584267,2019-03-29 14:30:00,2019-03-29 14:45:00
164,6,4,2,0.009280333815737014,2019-03-29 14:30:00,2019-03-29 14:45:00
168,11,4,7,0.00783337836023179,2019-03-29 14:30:00,2019-03-29 14:45:00
169,2,0,2,0.002677462586440364,2019-03-29 14:30:00,2019-03-29 14:45:00
170,8,3,5,0.008227517916748984,2019-03-29 14:30:00,2019-03-29 14:45:00
171,1,1,0,0.003870816172033096,2019-03-29 14:30:00,2019-03-29 14:45:00
172,1,1,0,0.0045539402871414385,2019-03-29 14:30:00,2019-03-29 14:45:00
173,3,2,1,0.026369522639049462,2019-03-29 14:30:00,2019-03-29 14:45:00
175,2,2,0,0.00960426106991589,2019-03-29 14:30:00,2019-03-29 14:45:00
177,2,2,0,0.006357126674798231,2019-03-29 14:30:00,2019-03-29 14:45:00
189,3,2,1,0.004850507657855526,2019-03-29 14:30:00,2019-03-29 14:45:00
190,1,1,0,0.006800794508397557,2019-03-29 14:30:00,2019-03-29 14:45:00
191,1,1,0,0.007793303206718925,2019-03-29 14:30:00,2019-03-29 14:45:00
195,4,1,3,0.0037361330479944548,2019-03-29 14:30:00,2019-03-29 14:45:00
196,2,1,1,0.004737384260790069,2019-03-29 14:30:00,2019-03-29 14:45:00
197,2,1,1,0.017802165615871772,2019-03-29 14:30:00,2019-03-29 14:45:00
199,3,2,1,0.008448322743302239,2019-03-29 14:30:00,2019-03-29 14:45:00
201,1,0,1,0.002677462586440364,2019-03-29 14:30:00,2019-03-29 14:45:00
202,1,1,0,0.004953501915394553,2019-03-29 14:30:00,2019-03-29 14:45:00
203,8,4,4,0.009180625795274205,2019-03-29 14:30:00,2019-03-29 14:45:00
2,1,1,0,0.006056230823631298,2019-03-29 14:45:00,2019-03-29 15:00:00
5,1,1,0,0.00841024185285954,2019-03-29 14:45:00,2019-03-29 15:00:00
10,1,1,0,0.004301145254277115,2019-03-29 14:45:00,2019-03-29 15:00:00
11,2,1,1,0.004301145254277115,2019-03-29 14:45:00,2019-03-29 15:00:00
15,4,3,1,0.00816814529247013,2019-03-29 14:45:00,2019-03-29 15:00:00
16,2,1,1,0.008623067311823635,2019-03-29 14:45:00,2019-03-29 15:00:00
18,6,4,2,0.010277451935551896,2019-03-29 14:45:00,2019-03-29 15:00:00
19,7,5,2,0.019756913440655235,2019-03-29 14:45:00,2019-03-29 15:00:00
20,3,2,1,0.009296654069745978,2019-03-29 14:45:00,2019-03-29 15:00:00
21,2,1,1,0.004029287296142483,2019-03-29 14:45:00,2019-03-29 15:00:00
23,6,2,4,0.004857145786265448,2019-03-29 14:45:00,2019-03-29 15:00:00
26,2,1,1,0.018723230949270142,2019-03-29 14:45:00,2019-03-29 15:00:00
27,1,1,0,0.004706552956683556,2019-03-29 14:45:00,2019-03-29 15:00:00
28,1,1,0,0.004055958298661661,2019-03-29 14:45:00,2019-03-29 15:00:00
35,1,1,0,0.0063403316774428235,2019-03-29 14:45:00,2019-03-29 15:00:00
37,1,0,1,0.0028275060647368023,2019-03-29 14:45:00,2019-03-29 15:00:00
41,8,3,5,0.008667555554567361,2019-03-29 14:45:00,2019-03-29 15:00:00
46,1,1,0,0.0036286935523405896,2019-03-29 14:45:00,2019-03-29 15:00:00
50,3,1,2,0.0036837981994934394,2019-03-29 14:45:00,2019-03-29 15:00:00
57,3,0,3,0.0028275060647368023,2019-03-29 14:45:00,2019-03-29 15:00:00
58,6,3,3,0.010208805066254626,2019-03-29 14:45:00,2019-03-29 15:00:00
61,2,1,1,0.018723230949270142,2019-03-29 14:45:00,2019-03-29 15:00:00
62,2,0,2,0.0028275060647368023,2019-03-29 14:45:00,2019-03-29 15:00:00
66,1,0,1,0.0028275060647368023,2019-03-29 14:45:00,2019-03-29 15:00:00
67,9,5,4,0.015677170198252512,2019-03-29 14:45:00,2019-03-29 15:00:00
68,2,0,2,0.0028275060647368023,2019-03-29 14:45:00,2019-03-29 15:00:00
69,3,2,1,0.006432849758953846,2019-03-29 14:45:00,2019-03-29 15:00:00
70,6,2,4,0.004917721979760675,2019-03-29 14:45:00,2019-03-29 15:00:00
74,5,2,3,0.005140359882496799,2019-03-29 14:45:00,2019-03-29 15:00:00
85,1,0,1,0.0028275060647368023,2019-03-29 14:45:00,2019-03-29 15:00:00
86,1,0,1,0.0028275060647368023,2019-03-29 14:45:00,2019-03-29 15:00:00
87,11,3,8,0.017682749557057585,2019-03-29 14:45:00,2019-03-29 15:00:00
88,1,0,1,0.0028275060647368023,2019-03-29 14:45:00,2019-03-29 15:00:00
89,1,1,0,0.007195951179881102,2019-03-29 14:45:00,2019-03-29 15:00:00
90,3,2,1,0.010999635037792539,2019-03-29 14:45:00,2019-03-29 15:00:00
99,1,1,0,0.008623067311823635,2019-03-29 14:45:00,2019-03-29 15:00:00
104,2,2,0,0.010527673585913753,2019-03-29 14:45:00,2019-03-29 15:00:00
109,10,6,4,0.010491631086491003,2019-03-29 14:45:00,2019-03-29 15:00:00
110,3,1,2,0.006056230823631298,2019-03-29 14:45:00,2019-03-29 15:00:00
111,7,6,1,0.010899743763703323,2019-03-29 14:45:00,2019-03-29 15:00:00
112,5,1,4,0.004029287296142483,2019-03-29 14:45:00,2019-03-29 15:00:00
113,1,0,1,0.0028275060647368023,2019-03-29 14:45:00,2019-03-29 15:00:00
114,3,0,3,0.0028275060647368023,2019-03-29 14:45:00,2019-03-29 15:00:00
115,3,0,3,0.0028275060647368023,2019-03-29 14:45:00,2019-03-29 15:00:00
116,3,2,1,0.005194433562762776,2019-03-29 14:45:00,2019-03-29 15:00:00
118,2,0,2,0.0028275060647368023,2019-03-29 14:45:00,2019-03-29 15:00:00
119,3,1,2,0.008264410940139456,2019-03-29 14:45:00,2019-03-29 15:00:00
120,1,1,0,0.00505089337235767,2019-03-29 14:45:00,2019-03-29 15:00:00
122,1,0,1,0.0028275060647368023,2019-03-29 14:45:00,2019-03-29 15:00:00
126,3,0,3,0.0028275060647368023,2019-03-29 14:45:00,2019-03-29 15:00:00
127,4,4,0,0.012567370926645585,2019-03-29 14:45:00,2019-03-29 15:00:00
129,2,0,2,0.0028275060647368023,2019-03-29 14:45:00,2019-03-29 15:00:00
133,1,0,1,0.0028275060647368023,2019-03-29 14:45:00,2019-03-29 15:00:00
137,11,6,5,0.03408656715949722,2019-03-29 14:45:00,2019-03-29 15:00:00
138,14,9,5,0.03168695101550809,2019-03-29 14:45:00,2019-03-29 15:00:00
140,1,0,1,0.0028275060647368023,2019-03-29 14:45:00,2019-03-29 15:00:00
141,10,4,6,0.008670344217311807,2019-03-29 14:45:00,2019-03-29 15:00:00
153,3,1,2,0.005231068527548165,2019-03-29 14:45:00,2019-03-29 15:00:00
154,6,6,0,0.015332532783839089,2019-03-29 14:45:00,2019-03-29 15:00:00
156,1,1,0,0.0034283966804396432,2019-03-29 14:45:00,2019-03-29 15:00:00
157,1,0,1,0.0028275060647368023,2019-03-29 14:45:00,2019-03-29 15:00:00
158,7,3,4,0.008144191893554885,2019-03-29 14:45:00,2019-03-29 15:00:00
159,1,1,0,0.006252674603763351,2019-03-29 14:45:00,2019-03-29 15:00:00
160,4,2,2,0.018723230949270142,2019-03-29 14:45:00,2019-03-29 15:00:00
164,1,1,0,0.008623067311823635,2019-03-29 14:45:00,2019-03-29 15:00:00
168,13,6,7,0.026586482619775184,2019-03-29 14:45:00,2019-03-29 15:00:00
169,1,0,1,0.0028275060647368023,2019-03-29 14:45:00,2019-03-29 15:00:00
170,3,1,2,0.004917721979760675,2019-03-29 14:45:00,2019-03-29 15:00:00
172,3,3,0,0.007472979823183309,2019-03-29 14:45:00,2019-03-29 15:00:00
173,2,2,0,0.007191471600375979,2019-03-29 14:45:00,2019-03-29 15:00:00
175,2,2,0,0.0071474095154302015,2019-03-29 14:45:00,2019-03-29 15:00:00
177,1,1,0,0.0036286935523405896,2019-03-29 14:45:00,2019-03-29 15:00:00
189,4,2,2,0.013134227014162649,2019-03-29 14:45:00,2019-03-29 15:00:00
190,1,1,0,0.00841024185285954,2019-03-29 14:45:00,2019-03-29 15:00:00
191,4,2,2,0.01279104004969078,2019-03-29 14:45:00,2019-03-29 15:00:00
195,4,0,4,0.0028275060647368023,2019-03-29 14:45:00,2019-03-29 15:00:00
196,4,1,3,0.0057202771754867356,2019-03-29 14:45:00,2019-03-29 15:00:00
197,2,1,1,0.018723230949270142,2019-03-29 14:45:00,2019-03-29 15:00:00
199,1,0,1,0.0028275060647368023,2019-03-29 14:45:00,2019-03-29 15:00:00
200,1,1,0,0.005231068527548165,2019-03-29 14:45:00,2019-03-29 15:00:00
201,2,1,1,0.004055958298661661,2019-03-29 14:45:00,2019-03-29 15:00:00
202,1,1,0,0.006275407865686108,2019-03-29 14:45:00,2019-03-29 15:00:00
203,4,3,1,0.007634630990359528,2019-03-29 14:45:00,2019-03-29 15:00:00
1,2,2,0,0.015999961705554278,2019-03-29 15:00:00,2019-03-29 15:15:00
2,1,1,0,0.004689851872177369,2019-03-29 15:00:00,2019-03-29 15:15:00
5,1,1,0,0.004923986540869698,2019-03-29 15:00:00,2019-03-29 15:15:00
10,2,1,1,0.009423675339911173,2019-03-29 15:00:00,2019-03-29 15:15:00
11,1,1,0,0.006254110466372758,2019-03-29 15:00:00,2019-03-29 15:15:00
15,1,1,0,0.0034182367130133054,2019-03-29 15:00:00,2019-03-29 15:15:00
16,5,4,1,0.004888942766295289,2019-03-29 15:00:00,2019-03-29 15:15:00
18,10,7,3,0.01086516151670487,2019-03-29 15:00:00,2019-03-29 15:15:00
19,9,6,3,0.012255434160461447,2019-03-29 15:00:00,2019-03-29 15:15:00
20,5,3,2,0.015884143321858224,2019-03-29 15:00:00,2019-03-29 15:15:00
21,2,1,1,0.004943364338699672,2019-03-29 15:00:00,2019-03-29 15:15:00
23,5,2,3,0.0060134099178241855,2019-03-29 15:00:00,2019-03-29 15:15:00
26,3,0,3,0.0026719859098355914,2019-03-29 15:00:00,2019-03-29 15:15:00
27,2,2,0,0.004664366736194577,2019-03-29 15:00:00,2019-03-29 15:15:00
28,1,1,0,0.003429112052790285,2019-03-29 15:00:00,2019-03-29 15:15:00
30,4,2,2,0.0065902526329476695,2019-03-29 15:00:00,2019-03-29 15:15:00
35,1,1,0,0.00429039195359129,2019-03-29 15:00:00,2019-03-29 15:15:00
40,1,0,1,0.0026719859098355914,2019-03-29 15:00:00,2019-03-29 15:15:00
41,7,3,4,0.016854661827700707,2019-03-29 15:00:00,2019-03-29 15:15:00
46,7,3,4,0.008597845804811873,2019-03-29 15:00:00,2019-03-29 15:15:00
50,3,1,2,0.007508641890506655,2019-03-29 15:00:00,2019-03-29 15:15:00
57,1,1,0,0.002878474857914144,2019-03-29 15:00:00,2019-03-29 15:15:00
58,4,3,1,0.008384578223293577,2019-03-29 15:00:00,2019-03-29 15:15:00
61,4,3,1,0.032718471562406114,2019-03-29 15:00:00,2019-03-29 15:15:00
62,1,0,1,0.0026719859098355914,2019-03-29 15:00:00,2019-03-29 15:15:00
66,6,3,3,0.013714444067922837,2019-03-29 15:00:00,2019-03-29 15:15:00
67,9,4,5,0.010862353724168874,2019-03-29 15:00:00,2019-03-29 15:15:00
68,1,0,1,0.0026719859098355914,2019-03-29 15:00:00,2019-03-29 15:15:00
69,2,2,0,0.008829641924691977,2019-03-29 15:00:00,2019-03-29 15:15:00
70,4,1,3,0.003728487129398189,2019-03-29 15:00:00,2019-03-29 15:15:00
71,1,0,1,0.0026719859098355914,2019-03-29 15:00:00,2019-03-29 15:15:00
74,6,3,3,0.006856865604011512,2019-03-29 15:00:00,2019-03-29 15:15:00
75,3,2,1,0.01913946824796923,2019-03-29 15:00:00,2019-03-29 15:15:00
85,2,0,2,0.0026719859098355914,2019-03-29 15:00:00,2019-03-29 15:15:00
86,1,0,1,0.0026719859098355914,2019-03-29 15:00:00,2019-03-29 15:15:00
87,8,1,7,0.006144817034539654,2019-03-29 15:00:00,2019-03-29 15:15:00
88,1,1,0,0.004923986540869698,2019-03-29 15:00:00,2019-03-29 15:15:00
89,2,2,0,0.0070247135858603725,2019-03-29 15:00:00,2019-03-29 15:15:00
90,2,2,0,0.009685623142135946,2019-03-29 15:00:00,2019-03-29 15:15:00
99,1,1,0,0.004034912874742556,2019-03-29 15:00:00,2019-03-29 15:15:00
104,2,2,0,0.007597687248474539,2019-03-29 15:00:00,2019-03-29 15:15:00
109,11,0,11,0.0026719859098355914,2019-03-29 15:00:00,2019-03-29 15:15:00
110,5,3,2,0.007058280860666096,2019-03-29 15:00:00,2019-03-29 15:15:00
111,12,9,3,0.020255124284851683,2019-03-29 15:00:00,2019-03-29 15:15:00
112,4,1,3,0.00527785406407442,2019-03-29 15:00:00,2019-03-29 15:15:00
113,1,0,1,0.0026719859098355914,2019-03-29 15:00:00,2019-03-29 15:15:00
114,5,2,3,0.009120013524530408,2019-03-29 15:00:00,2019-03-29 15:15:00
115,1,0,1,0.0026719859098355914,2019-03-29 15:00:00,2019-03-29 15:15:00
116,5,1,4,0.00586350212791137,2019-03-29 15:00:00,2019-03-29 15:15:00
118,3,1,2,0.004518826336561066,2019-03-29 15:00:00,2019-03-29 15:15:00
119,3,1,2,0.0038076751242676317,2019-03-29 15:00:00,2019-03-29 15:15:00
126,4,1,3,0.00919571801289238,2019-03-29 15:00:00,2019-03-29 15:15:00
127,7,5,2,0.015347544978290122,2019-03-29 15:00:00,2019-03-29 15:15:00
129,4,1,3,0.00449557173663486,2019-03-29 15:00:00,2019-03-29 15:15:00
133,1,0,1,0.0026719859098355914,2019-03-29 15:00:00,2019-03-29 15:15:00
135,3,2,1,0.0054356614567954604,2019-03-29 15:00:00,2019-03-29 15:15:00
137,16,8,8,0.012826155634778798,2019-03-29 15:00:00,2019-03-29 15:15:00
138,11,5,6,0.0070968303940835,2019-03-29 15:00:00,2019-03-29 15:15:00
141,3,0,3,0.0026719859098355914,2019-03-29 15:00:00,2019-03-29 15:15:00
147,1,1,0,0.004615017299186523,2019-03-29 15:00:00,2019-03-29 15:15:00
151,1,1,0,0.003113037905231219,2019-03-29 15:00:00,2019-03-29 15:15:00
153,6,5,1,0.07506867945999716,2019-03-29 15:00:00,2019-03-29 15:15:00
154,3,2,1,0.005689615141877386,2019-03-29 15:00:00,2019-03-29 15:15:00
156,5,2,3,0.004943364338699672,2019-03-29 15:00:00,2019-03-29 15:15:00
158,4,3,1,0.005027995195343629,2019-03-29 15:00:00,2019-03-29 15:15:00
159,1,1,0,0.006874231655994306,2019-03-29 15:00:00,2019-03-29 15:15:00
160,4,2,2,0.017767178053124763,2019-03-29 15:00:00,2019-03-29 15:15:00
162,1,1,0,0.00586350212791137,2019-03-29 15:00:00,2019-03-29 15:15:00
164,6,5,1,0.012201343517284233,2019-03-29 15:00:00,2019-03-29 15:15:00
168,14,6,8,0.018988733324948156,2019-03-29 15:00:00,2019-03-29 15:15:00
169,1,0,1,0.0026719859098355914,2019-03-29 15:00:00,2019-03-29 15:15:00
170,7,1,6,0.003113037905231219,2019-03-29 15:00:00,2019-03-29 15:15:00
171,1,1,0,0.008411756378024639,2019-03-29 15:00:00,2019-03-29 15:15:00
172,2,1,1,0.006254110466372758,2019-03-29 15:00:00,2019-03-29 15:15:00
173,2,2,0,0.005764956359742338,2019-03-29 15:00:00,2019-03-29 15:15:00
175,2,2,0,0.0033195268533097715,2019-03-29 15:00:00,2019-03-29 15:15:00
177,1,1,0,0.00527785406407442,2019-03-29 15:00:00,2019-03-29 15:15:00
189,7,2,5,0.013245275632245096,2019-03-29 15:00:00,2019-03-29 15:15:00
190,1,1,0,0.004923986540869698,2019-03-29 15:00:00,2019-03-29 15:15:00
191,2,0,2,0.0026719859098355914,2019-03-29 15:00:00,2019-03-29 15:15:00
195,2,0,2,0.0026719859098355914,2019-03-29 15:00:00,2019-03-29 15:15:00
196,5,1,4,0.005256283774869492,2019-03-29 15:00:00,2019-03-29 15:15:00
199,2,2,0,0.0041862381957449785,2019-03-29 15:00:00,2019-03-29 15:15:00
200,1,1,0,0.004943364338699672,2019-03-29 15:00:00,2019-03-29 15:15:00
201,2,1,1,0.00449557173663486,2019-03-29 15:00:00,2019-03-29 15:15:00
203,3,1,2,0.00429039195359129,2019-03-29 15:00:00,2019-03-29 15:15:00
1,4,3,1,0.0528395771009008,2019-03-29 15:15:00,2019-03-29 15:30:00
2,8,4,4,0.014663690823835389,2019-03-29 15:15:00,2019-03-29 15:30:00
5,3,3,0,0.007811145480331428,2019-03-29 15:15:00,2019-03-29 15:30:00
10,3,2,1,0.007947104687069035,2019-03-29 15:15:00,2019-03-29 15:30:00
11,1,1,0,0.005653424877386464,2019-03-29 15:15:00,2019-03-29 15:30:00
16,5,4,1,0.007971515118522515,2019-03-29 15:15:00,2019-03-29 15:30:00
18,7,5,2,0.009564897945399276,2019-03-29 15:15:00,2019-03-29 15:30:00
19,6,3,3,0.009445131229550135,2019-03-29 15:15:00,2019-03-29 15:30:00
20,7,4,3,0.009730634911010179,2019-03-29 15:15:00,2019-03-29 15:30:00
21,5,3,2,0.015205056424010694,2019-03-29 15:15:00,2019-03-29 15:30:00
22,1,0,1,0.0024322206664362427,2019-03-29 15:15:00,2019-03-29 15:30:00
23,4,1,3,0.002974012643610837,2019-03-29 15:15:00,2019-03-29 15:30:00
26,3,0,3,0.0024322206664362427,2019-03-29 15:15:00,2019-03-29 15:30:00
27,3,2,1,0.0051350743485776475,2019-03-29 15:15:00,2019-03-29 15:30:00
28,3,3,0,0.010869578931418423,2019-03-29 15:15:00,2019-03-29 15:30:00
30,1,0,1,0.0024322206664362427,2019-03-29 15:15:00,2019-03-29 15:30:00
35,3,3,0,0.0055805055933045265,2019-03-29 15:15:00,2019-03-29 15:30:00
37,1,1,0,0.005548844388386192,2019-03-29 15:15:00,2019-03-29 15:30:00
41,7,4,3,0.011367412918397605,2019-03-29 15:15:00,2019-03-29 15:30:00
46,10,3,7,0.005943297415150069,2019-03-29 15:15:00,2019-03-29 15:30:00
50,3,1,2,0.003646598923470761,2019-03-29 15:15:00,2019-03-29 15:30:00
57,6,2,4,0.007925572337163542,2019-03-29 15:15:00,2019-03-29 15:30:00
58,9,6,3,0.016899126280938193,2019-03-29 15:15:00,2019-03-29 15:30:00
61,4,3,1,0.03526506849254991,2019-03-29 15:15:00,2019-03-29 15:30:00
62,1,0,1,0.0024322206664362427,2019-03-29 15:15:00,2019-03-29 15:30:00
64,2,2,0,0.005202824425069174,2019-03-29 15:15:00,2019-03-29 15:30:00
66,3,2,1,0.00458122744535929,2019-03-29 15:15:00,2019-03-29 15:30:00
67,9,4,5,0.0070009983477845065,2019-03-29 15:15:00,2019-03-29 15:30:00
68,3,2,1,0.00459234574917115,2019-03-29 15:15:00,2019-03-29 15:30:00
69,4,2,2,0.008394265080100412,2019-03-29 15:15:00,2019-03-29 15:30:00
70,1,1,0,0.006000188177656191,2019-03-29 15:15:00,2019-03-29 15:30:00
71,1,0,1,0.0024322206664362427,2019-03-29 15:15:00,2019-03-29 15:30:00
74,8,2,6,0.0038240175563413093,2019-03-29 15:15:00,2019-03-29 15:30:00
75,3,2,1,0.020861216087183852,2019-03-29 15:15:00,2019-03-29 15:30:00
85,2,0,2,0.0024322206664362427,2019-03-29 15:15:00,2019-03-29 15:30:00
87,5,1,4,0.003999545607186154,2019-03-29 15:15:00,2019-03-29 15:30:00
88,4,3,1,0.00930360103085175,2019-03-29 15:15:00,2019-03-29 15:30:00
89,2,1,1,0.00649781239561719,2019-03-29 15:15:00,2019-03-29 15:30:00
90,3,3,0,0.012678647556297176,2019-03-29 15:15:00,2019-03-29 15:30:00
99,1,1,0,0.003317044485043076,2019-03-29 15:15:00,2019-03-29 15:30:00
101,2,0,2,0.0024322206664362427,2019-03-29 15:15:00,2019-03-29 15:30:00
104,4,2,2,0.004715868369461102,2019-03-29 15:15:00,2019-03-29 15:30:00
106,1,0,1,0.0024322206664362427,2019-03-29 15:15:00,2019-03-29 15:30:00
108,1,1,0,0.006000188177656191,2019-03-29 15:15:00,2019-03-29 15:30:00
109,9,2,7,0.005801113719970764,2019-03-29 15:15:00,2019-03-29 15:30:00
110,5,2,3,0.0033836689350928784,2019-03-29 15:15:00,2019-03-29 15:30:00
111,16,9,7,0.018011139111122183,2019-03-29 15:15:00,2019-03-29 15:30:00
112,4,1,3,0.007704711731530758,2019-03-29 15:15:00,2019-03-29 15:30:00
113,2,1,1,0.004285069435847175,2019-03-29 15:15:00,2019-03-29 15:30:00
114,6,2,4,0.004563856832520805,2019-03-29 15:15:00,2019-03-29 15:30:00
116,7,3,4,0.00871823439763093,2019-03-29 15:15:00,2019-03-29 15:30:00
118,8,3,5,0.007000256059213137,2019-03-29 15:15:00,2019-03-29 15:30:00
119,7,2,5,0.011095472888646145,2019-03-29 15:15:00,2019-03-29 15:30:00
120,2,2,0,0.0044997817104795446,2019-03-29 15:15:00,2019-03-29 15:30:00
122,3,3,0,0.007093308320376699,2019-03-29 15:15:00,2019-03-29 15:30:00
126,3,2,1,0.006202077130930008,2019-03-29 15:15:00,2019-03-29 15:30:00
127,10,4,6,0.0077167313041586515,2019-03-29 15:15:00,2019-03-29 15:30:00
129,1,0,1,0.0024322206664362427,2019-03-29 15:15:00,2019-03-29 15:30:00
133,1,0,1,0.0024322206664362427,2019-03-29 15:15:00,2019-03-29 15:30:00
135,3,1,2,0.003317044485043076,2019-03-29 15:15:00,2019-03-29 15:30:00
137,7,2,5,0.005204305185645227,2019-03-29 15:15:00,2019-03-29 15:30:00
138,9,3,6,0.004452796800443427,2019-03-29 15:15:00,2019-03-29 15:30:00
141,1,0,1,0.0024322206664362427,2019-03-29 15:15:00,2019-03-29 15:30:00
147,2,2,0,0.005041573687654139,2019-03-29 15:15:00,2019-03-29 15:30:00
151,6,3,3,0.008489909626019436,2019-03-29 15:15:00,2019-03-29 15:30:00
153,9,6,3,0.011539201435188096,2019-03-29 15:15:00,2019-03-29 15:30:00
154,6,2,4,0.005714159967514063,2019-03-29 15:15:00,2019-03-29 15:30:00
156,3,1,2,0.0044997817104795446,2019-03-29 15:15:00,2019-03-29 15:30:00
157,2,1,1,0.004116667193203503,2019-03-29 15:15:00,2019-03-29 15:30:00
158,7,3,4,0.005908088966856249,2019-03-29 15:15:00,2019-03-29 15:30:00
159,1,1,0,0.008895347428106142,2019-03-29 15:15:00,2019-03-29 15:30:00
160,4,2,2,0.016183550991999883,2019-03-29 15:15:00,2019-03-29 15:30:00
162,1,1,0,0.003982173787268242,2019-03-29 15:15:00,2019-03-29 15:30:00
164,12,9,3,0.01986264400108236,2019-03-29 15:15:00,2019-03-29 15:30:00
168,12,3,9,0.003393919592074964,2019-03-29 15:15:00,2019-03-29 15:30:00
169,1,0,1,0.0024322206664362427,2019-03-29 15:15:00,2019-03-29 15:30:00
170,8,4,4,0.007454772770214258,2019-03-29 15:15:00,2019-03-29 15:30:00
171,2,2,0,0.005341410220487152,2019-03-29 15:15:00,2019-03-29 15:30:00
172,3,2,1,0.05056096224252118,2019-03-29 15:15:00,2019-03-29 15:30:00
173,2,2,0,0.005475371281377798,2019-03-29 15:15:00,2019-03-29 15:30:00
175,1,1,0,0.004016578620962609,2019-03-29 15:15:00,2019-03-29 15:30:00
177,4,2,2,0.0032592450840535636,2019-03-29 15:15:00,2019-03-29 15:30:00
189,5,1,4,0.00737459213263158,2019-03-29 15:15:00,2019-03-29 15:30:00
191,1,1,0,0.0051896626767526394,2019-03-29 15:15:00,2019-03-29 15:30:00
195,1,0,1,0.0024322206664362427,2019-03-29 15:15:00,2019-03-29 15:30:00
196,5,5,0,0.009774715947331952,2019-03-29 15:15:00,2019-03-29 15:30:00
197,5,0,5,0.0024322206664362427,2019-03-29 15:15:00,2019-03-29 15:30:00
199,3,2,1,0.003810594695798444,2019-03-29 15:15:00,2019-03-29 15:30:00
200,1,1,0,0.004837990627449768,2019-03-29 15:15:00,2019-03-29 15:30:00
201,4,2,2,0.0116274689256359,2019-03-29 15:15:00,2019-03-29 15:30:00
203,2,1,1,0.004318741673083735,2019-03-29 15:15:00,2019-03-29 15:30:00
1,4,1,3,0.0032819074711109477,2019-03-29 15:30:00,2019-03-29 15:45:00
2,5,2,3,0.013182379764092332,2019-03-29 15:30:00,2019-03-29 15:45:00
5,5,5,0,0.015490870756894804,2019-03-29 15:30:00,2019-03-29 15:45:00
10,1,0,1,0.002613548239189757,2019-03-29 15:30:00,2019-03-29 15:45:00
11,4,2,2,0.017355474031707743,2019-03-29 15:30:00,2019-03-29 15:45:00
15,4,2,2,0.004373973755438401,2019-03-29 15:30:00,2019-03-29 15:45:00
16,6,3,3,0.004411464347471568,2019-03-29 15:30:00,2019-03-29 15:45:00
18,7,3,4,0.01492154015779395,2019-03-29 15:30:00,2019-03-29 15:45:00
19,9,2,7,0.009890448128320972,2019-03-29 15:30:00,2019-03-29 15:45:00
20,4,3,1,0.003446687333717364,2019-03-29 15:30:00,2019-03-29 15:45:00
21,3,2,1,0.01109786754771975,2019-03-29 15:30:00,2019-03-29 15:45:00
22,1,0,1,0.002613548239189757,2019-03-29 15:30:00,2019-03-29 15:45:00
23,5,3,2,0.007680382043472597,2019-03-29 15:30:00,2019-03-29 15:45:00
26,1,1,0,0.003096569885041736,2019-03-29 15:30:00,2019-03-29 15:45:00
27,5,2,3,0.006032167330677275,2019-03-29 15:30:00,2019-03-29 15:45:00
28,3,2,1,0.004231956892348121,2019-03-29 15:30:00,2019-03-29 15:45:00
35,3,1,2,0.0037083312490510862,2019-03-29 15:30:00,2019-03-29 15:45:00
37,1,1,0,0.006349136371334265,2019-03-29 15:30:00,2019-03-29 15:45:00
41,4,3,1,0.04709070829769832,2019-03-29 15:30:00,2019-03-29 15:45:00
46,9,2,7,0.005503611723184567,2019-03-29 15:30:00,2019-03-29 15:45:00
50,2,0,2,0.002613548239189757,2019-03-29 15:30:00,2019-03-29 15:45:00
57,4,1,3,0.003988728299267871,2019-03-29 15:30:00,2019-03-29 15:45:00
58,4,1,3,0.004853058074814785,2019-03-29 15:30:00,2019-03-29 15:45:00
61,1,1,0,0.0038146773292157717,2019-03-29 15:30:00,2019-03-29 15:45:00
62,2,2,0,0.007161038423122294,2019-03-29 15:30:00,2019-03-29 15:45:00
64,2,2,0,0.005119581465520696,2019-03-29 15:30:00,2019-03-29 15:45:00
66,1,1,0,0.004853058074814785,2019-03-29 15:30:00,2019-03-29 15:45:00
67,6,4,2,0.0068147248716443655,2019-03-29 15:30:00,2019-03-29 15:45:00
68,5,4,1,0.006858405584633104,2019-03-29 15:30:00,2019-03-29 15:45:00
69,4,2,2,0.007056956743336996,2019-03-29 15:30:00,2019-03-29 15:45:00
70,3,3,0,0.008268343772808794,2019-03-29 15:30:00,2019-03-29 15:45:00
71,1,0,1,0.002613548239189757,2019-03-29 15:30:00,2019-03-29 15:45:00
74,7,2,5,0.004041180305459299,2019-03-29 15:30:00,2019-03-29 15:45:00
75,3,2,1,0.024222562880705158,2019-03-29 15:30:00,2019-03-29 15:45:00
80,3,3,0,0.006340265505246335,2019-03-29 15:30:00,2019-03-29 15:45:00
86,1,0,1,0.002613548239189757,2019-03-29 15:30:00,2019-03-29 15:45:00
87,3,0,3,0.002613548239189757,2019-03-29 15:30:00,2019-03-29 15:45:00
88,6,5,1,0.01145360940803997,2019-03-29 15:30:00,2019-03-29 15:45:00
89,6,3,3,0.008045814938425206,2019-03-29 15:30:00,2019-03-29 15:45:00
90,6,3,3,0.009402659866980488,2019-03-29 15:30:00,2019-03-29 15:45:00
99,1,1,0,0.00344536748276236,2019-03-29 15:30:00,2019-03-29 15:45:00
101,2,0,2,0.002613548239189757,2019-03-29 15:30:00,2019-03-29 15:45:00
104,2,1,1,0.003096569885041736,2019-03-29 15:30:00,2019-03-29 15:45:00
106,1,0,1,0.002613548239189757,2019-03-29 15:30:00,2019-03-29 15:45:00
108,2,2,0,0.00850961787954143,2019-03-29 15:30:00,2019-03-29 15:45:00
109,6,2,4,0.00487405286327083,2019-03-29 15:30:00,2019-03-29 15:45:00
110,4,2,2,0.005268851315716657,2019-03-29 15:30:00,2019-03-29 15:45:00
111,12,3,9,0.00983108591631448,2019-03-29 15:30:00,2019-03-29 15:45:00
112,4,0,4,0.002613548239189757,2019-03-29 15:30:00,2019-03-29 15:45:00
113,2,1,1,0.009644931155329911,2019-03-29 15:30:00,2019-03-29 15:45:00
114,10,3,7,0.005669036502030981,2019-03-29 15:30:00,2019-03-29 15:45:00
115,1,0,1,0.002613548239189757,2019-03-29 15:30:00,2019-03-29 15:45:00
116,5,4,1,0.008271269268391966,2019-03-29 15:30:00,2019-03-29 15:45:00
118,7,3,4,0.008176435617140092,2019-03-29 15:30:00,2019-03-29 15:45:00
119,4,1,3,0.003863579339101166,2019-03-29 15:30:00,2019-03-29 15:45:00
120,4,4,0,0.007473168309683176,2019-03-29 15:30:00,2019-03-29 15:45:00
122,4,4,0,0.015054078769201566,2019-03-29 15:30:00,2019-03-29 15:45:00
126,3,3,0,0.01555320487059433,2019-03-29 15:30:00,2019-03-29 15:45:00
127,12,4,8,0.004545634822597673,2019-03-29 15:30:00,2019-03-29 15:45:00
133,1,0,1,0.002613548239189757,2019-03-29 15:30:00,2019-03-29 15:45:00
135,2,2,0,0.013687408326625638,2019-03-29 15:30:00,2019-03-29 15:45:00
137,8,2,6,0.005871093135433686,2019-03-29 15:30:00,2019-03-29 15:45:00
138,10,6,4,0.009880573158158577,2019-03-29 15:30:00,2019-03-29 15:45:00
140,1,1,0,0.00402239325971292,2019-03-29 15:30:00,2019-03-29 15:45:00
141,2,2,0,0.006311382247083256,2019-03-29 15:30:00,2019-03-29 15:45:00
147,4,1,3,0.003646944054151971,2019-03-29 15:30:00,2019-03-29 15:45:00
151,4,2,2,0.00624409751178654,2019-03-29 15:30:00,2019-03-29 15:45:00
153,9,7,2,0.021402293660920852,2019-03-29 15:30:00,2019-03-29 15:45:00
154,6,2,4,0.010174881372407733,2019-03-29 15:30:00,2019-03-29 15:45:00
156,3,0,3,0.002613548239189757,2019-03-29 15:30:00,2019-03-29 15:45:00
158,5,4,1,0.0069424086726757196,2019-03-29 15:30:00,2019-03-29 15:45:00
159,2,1,1,0.012047874204273537,2019-03-29 15:30:00,2019-03-29 15:45:00
162,1,1,0,0.0037244003652265665,2019-03-29 15:30:00,2019-03-29 15:45:00
164,8,5,3,0.009499264532932093,2019-03-29 15:30:00,2019-03-29 15:45:00
168,7,3,4,0.007211434279213266,2019-03-29 15:30:00,2019-03-29 15:45:00
169,4,2,2,0.0089561306452661,2019-03-29 15:30:00,2019-03-29 15:45:00
170,7,2,5,0.008286314550985215,2019-03-29 15:30:00,2019-03-29 15:45:00
171,1,1,0,0.0032819074711109477,2019-03-29 15:30:00,2019-03-29 15:45:00
172,4,2,2,0.004473464434118431,2019-03-29 15:30:00,2019-03-29 15:45:00
173,7,4,3,0.014671876889335772,2019-03-29 15:30:00,2019-03-29 15:45:00
175,2,1,1,0.017355474031707743,2019-03-29 15:30:00,2019-03-29 15:45:00
177,6,3,3,0.004421990915373632,2019-03-29 15:30:00,2019-03-29 15:45:00
189,4,0,4,0.002613548239189757,2019-03-29 15:30:00,2019-03-29 15:45:00
190,3,2,1,0.0050158064192417865,2019-03-29 15:30:00,2019-03-29 15:45:00
191,1,1,0,0.0055434926154091235,2019-03-29 15:30:00,2019-03-29 15:45:00
195,2,0,2,0.002613548239189757,2019-03-29 15:30:00,2019-03-29 15:45:00
196,13,11,2,0.025996936642688716,2019-03-29 15:30:00,2019-03-29 15:45:00
197,8,0,8,0.002613548239189757,2019-03-29 15:30:00,2019-03-29 15:45:00
199,1,0,1,0.002613548239189757,2019-03-29 15:30:00,2019-03-29 15:45:00
200,1,1,0,0.0052675670182008895,2019-03-29 15:30:00,2019-03-29 15:45:00
201,1,1,0,0.008726238746213866,2019-03-29 15:30:00,2019-03-29 15:45:00
202,6,4,2,0.008894597704492767,2019-03-29 15:30:00,2019-03-29 15:45:00
203,4,3,1,0.007190551891132516,2019-03-29 15:30:00,2019-03-29 15:45:00
1,4,1,3,0.0030968905474973653,2019-03-29 15:45:00,2019-03-29 16:00:00
2,3,1,2,0.004581874335376223,2019-03-29 15:45:00,2019-03-29 16:00:00
5,7,7,0,0.009061698696077267,2019-03-29 15:45:00,2019-03-29 16:00:00
10,2,1,1,0.004058974602379679,2019-03-29 15:45:00,2019-03-29 16:00:00
11,12,6,6,0.014180529891584602,2019-03-29 15:45:00,2019-03-29 16:00:00
15,4,2,2,0.007847754628235814,2019-03-29 15:45:00,2019-03-29 16:00:00
16,5,1,4,0.0025596987411154975,2019-03-29 15:45:00,2019-03-29 16:00:00
18,12,6,6,0.013616310272978062,2019-03-29 15:45:00,2019-03-29 16:00:00
19,15,8,7,0.01506648849977285,2019-03-29 15:45:00,2019-03-29 16:00:00
20,3,1,2,0.0027399141058343434,2019-03-29 15:45:00,2019-03-29 16:00:00
21,2,1,1,0.003663828408867597,2019-03-29 15:45:00,2019-03-29 16:00:00
22,2,0,2,0.002129718267674334,2019-03-29 15:45:00,2019-03-29 16:00:00
23,6,4,2,0.007532632652209105,2019-03-29 15:45:00,2019-03-29 16:00:00
26,1,1,0,0.002971795920350047,2019-03-29 15:45:00,2019-03-29 16:00:00
27,3,1,2,0.003704103599661275,2019-03-29 15:45:00,2019-03-29 16:00:00
28,3,2,1,0.004048794161579011,2019-03-29 15:45:00,2019-03-29 16:00:00
30,1,1,0,0.004488721857338011,2019-03-29 15:45:00,2019-03-29 16:00:00
35,4,2,2,0.007141260723682603,2019-03-29 15:45:00,2019-03-29 16:00:00
37,1,1,0,0.0040772705785336125,2019-03-29 15:45:00,2019-03-29 16:00:00
41,4,3,1,0.03884955367240212,2019-03-29 15:45:00,2019-03-29 16:00:00
46,10,3,7,0.00796416003185895,2019-03-29 15:45:00,2019-03-29 16:00:00
50,2,0,2,0.002129718267674334,2019-03-29 15:45:00,2019-03-29 16:00:00
57,3,0,3,0.002129718267674334,2019-03-29 15:45:00,2019-03-29 16:00:00
58,5,3,2,0.006872858450855843,2019-03-29 15:45:00,2019-03-29 16:00:00
61,2,2,0,0.005789250174667866,2019-03-29 15:45:00,2019-03-29 16:00:00
62,5,3,2,0.019144925065664054,2019-03-29 15:45:00,2019-03-29 16:00:00
64,2,2,0,0.004028298187820695,2019-03-29 15:45:00,2019-03-29 16:00:00
66,5,4,1,0.008081679844220108,2019-03-29 15:45:00,2019-03-29 16:00:00
67,5,3,2,0.005788282840855823,2019-03-29 15:45:00,2019-03-29 16:00:00
68,4,2,2,0.003609367033724079,2019-03-29 15:45:00,2019-03-29 16:00:00
69,5,4,1,0.09398507282794835,2019-03-29 15:45:00,2019-03-29 16:00:00
70,7,2,5,0.0042641997752670465,2019-03-29 15:45:00,2019-03-29 16:00:00
71,1,0,1,0.002129718267674334,2019-03-29 15:45:00,2019-03-29 16:00:00
74,7,1,6,0.0030349155912597374,2019-03-29 15:45:00,2019-03-29 16:00:00
75,3,2,1,0.017801196850546878,2019-03-29 15:45:00,2019-03-29 16:00:00
80,3,3,0,0.005279366278699698,2019-03-29 15:45:00,2019-03-29 16:00:00
87,3,0,3,0.002129718267674334,2019-03-29 15:45:00,2019-03-29 16:00:00
88,4,3,1,0.003595993841827355,2019-03-29 15:45:00,2019-03-29 16:00:00
89,6,3,3,0.010652627362668907,2019-03-29 15:45:00,2019-03-29 16:00:00
90,9,6,3,0.023722620794961513,2019-03-29 15:45:00,2019-03-29 16:00:00
99,2,2,0,0.008376992264402725,2019-03-29 15:45:00,2019-03-29 16:00:00
101,2,0,2,0.002129718267674334,2019-03-29 15:45:00,2019-03-29 16:00:00
104,4,2,2,0.005549800873517502,2019-03-29 15:45:00,2019-03-29 16:00:00
106,1,0,1,0.002129718267674334,2019-03-29 15:45:00,2019-03-29 16:00:00
108,1,1,0,0.004589953836497407,2019-03-29 15:45:00,2019-03-29 16:00:00
109,4,2,2,0.003336648032454872,2019-03-29 15:45:00,2019-03-29 16:00:00
110,2,1,1,0.0033590024516816437,2019-03-29 15:45:00,2019-03-29 16:00:00
111,4,0,4,0.002129718267674334,2019-03-29 15:45:00,2019-03-29 16:00:00
112,2,0,2,0.002129718267674334,2019-03-29 15:45:00,2019-03-29 16:00:00
113,1,0,1,0.002129718267674334,2019-03-29 15:45:00,2019-03-29 16:00:00
114,7,3,4,0.004122872531646646,2019-03-29 15:45:00,2019-03-29 16:00:00
115,2,0,2,0.002129718267674334,2019-03-29 15:45:00,2019-03-29 16:00:00
116,6,4,2,0.00845742738652432,2019-03-29 15:45:00,2019-03-29 16:00:00
118,1,0,1,0.002129718267674334,2019-03-29 15:45:00,2019-03-29 16:00:00
119,2,1,1,0.005042479616464349,2019-03-29 15:45:00,2019-03-29 16:00:00
120,4,4,0,0.005967096908624783,2019-03-29 15:45:00,2019-03-29 16:00:00
122,3,3,0,0.008140407006643058,2019-03-29 15:45:00,2019-03-29 16:00:00
126,3,2,1,0.014891178156256001,2019-03-29 15:45:00,2019-03-29 16:00:00
127,4,1,3,0.002971795920350047,2019-03-29 15:45:00,2019-03-29 16:00:00
129,1,0,1,0.002129718267674334,2019-03-29 15:45:00,2019-03-29 16:00:00
133,1,0,1,0.002129718267674334,2019-03-29 15:45:00,2019-03-29 16:00:00
135,3,2,1,0.026231341515494874,2019-03-29 15:45:00,2019-03-29 16:00:00
137,6,3,3,0.013721038740792085,2019-03-29 15:45:00,2019-03-29 16:00:00
138,13,5,8,0.011567885501549248,2019-03-29 15:45:00,2019-03-29 16:00:00
140,1,0,1,0.002129718267674334,2019-03-29 15:45:00,2019-03-29 16:00:00
141,5,4,1,0.011403847747013912,2019-03-29 15:45:00,2019-03-29 16:00:00
147,3,0,3,0.002129718267674334,2019-03-29 15:45:00,2019-03-29 16:00:00
151,5,5,0,0.009852590011547431,2019-03-29 15:45:00,2019-03-29 16:00:00
153,11,7,4,0.008220532383922048,2019-03-29 15:45:00,2019-03-29 16:00:00
154,5,2,3,0.00773110125064924,2019-03-29 15:45:00,2019-03-29 16:00:00
156,1,0,1,0.002129718267674334,2019-03-29 15:45:00,2019-03-29 16:00:00
157,4,2,2,0.006852874263635156,2019-03-29 15:45:00,2019-03-29 16:00:00
158,4,2,2,0.005789250174667866,2019-03-29 15:45:00,2019-03-29 16:00:00
159,1,0,1,0.002129718267674334,2019-03-29 15:45:00,2019-03-29 16:00:00
162,5,5,0,0.023854958995778417,2019-03-29 15:45:00,2019-03-29 16:00:00
164,9,2,7,0.0046200528529472965,2019-03-29 15:45:00,2019-03-29 16:00:00
168,7,5,2,0.036977001566259535,2019-03-29 15:45:00,2019-03-29 16:00:00
169,4,2,2,0.005988230937085024,2019-03-29 15:45:00,2019-03-29 16:00:00
170,6,2,4,0.004907285194668172,2019-03-29 15:45:00,2019-03-29 16:00:00
171,5,2,3,0.004915423632889597,2019-03-29 15:45:00,2019-03-29 16:00:00
172,5,2,3,0.004400101501624783,2019-03-29 15:45:00,2019-03-29 16:00:00
173,6,3,3,0.007004702656801041,2019-03-29 15:45:00,2019-03-29 16:00:00
175,4,3,1,0.023019447011897735,2019-03-29 15:45:00,2019-03-29 16:00:00
177,5,2,3,0.0033501099439943527,2019-03-29 15:45:00,2019-03-29 16:00:00
189,2,0,2,0.002129718267674334,2019-03-29 15:45:00,2019-03-29 16:00:00
190,1,0,1,0.002129718267674334,2019-03-29 15:45:00,2019-03-29 16:00:00
195,2,0,2,0.002129718267674334,2019-03-29 15:45:00,2019-03-29 16:00:00
196,6,5,1,0.013980728539389142,2019-03-29 15:45:00,2019-03-29 16:00:00
197,8,2,6,0.004306786768058415,2019-03-29 15:45:00,2019-03-29 16:00:00
201,3,1,2,0.005768934108904634,2019-03-29 15:45:00,2019-03-29 16:00:00
202,7,4,3,0.00988340790051356,2019-03-29 15:45:00,2019-03-29 16:00:00
203,5,3,2,0.008561553098170999,2019-03-29 15:45:00,2019-03-29 16:00:00
1,4,2,2,0.0035868942367562016,2019-03-29 16:00:00,2019-03-29 16:15:00
2,4,2,2,0.005938260922034521,2019-03-29 16:00:00,2019-03-29 16:15:00
5,8,6,2,0.008788174160105256,2019-03-29 16:00:00,2019-03-29 16:15:00
10,10,8,2,0.025209606400540294,2019-03-29 16:00:00,2019-03-29 16:15:00
11,4,2,2,0.014670014319632075,2019-03-29 16:00:00,2019-03-29 16:15:00
15,4,1,3,0.006968745589592429,2019-03-29 16:00:00,2019-03-29 16:15:00
16,10,5,5,0.008741404952292777,2019-03-29 16:00:00,2019-03-29 16:15:00
18,16,11,5,0.015795985920875926,2019-03-29 16:00:00,2019-03-29 16:15:00
19,12,9,3,0.01680866058507655,2019-03-29 16:00:00,2019-03-29 16:15:00
20,1,0,1,0.0022058007211504757,2019-03-29 16:00:00,2019-03-29 16:15:00
21,4,2,2,0.003114178184676956,2019-03-29 16:00:00,2019-03-29 16:15:00
22,1,0,1,0.0022058007211504757,2019-03-29 16:00:00,2019-03-29 16:15:00
23,6,4,2,0.006037914620252574,2019-03-29 16:00:00,2019-03-29 16:15:00
26,2,2,0,0.0071463827411447425,2019-03-29 16:00:00,2019-03-29 16:15:00
27,2,1,1,0.014670014319632075,2019-03-29 16:00:00,2019-03-29 16:15:00
28,2,2,0,0.0031123401655588218,2019-03-29 16:00:00,2019-03-29 16:15:00
30,2,1,1,0.003806651933622945,2019-03-29 16:00:00,2019-03-29 16:15:00
35,4,3,1,0.0060433219292723725,2019-03-29 16:00:00,2019-03-29 16:15:00
37,2,2,0,0.00532524359847826,2019-03-29 16:00:00,2019-03-29 16:15:00
41,4,4,0,0.021293495267336232,2019-03-29 16:00:00,2019-03-29 16:15:00
46,11,4,7,0.004830838439319789,2019-03-29 16:00:00,2019-03-29 16:15:00
50,4,2,2,0.004953133326965681,2019-03-29 16:00:00,2019-03-29 16:15:00
57,4,2,2,0.007593765753112138,2019-03-29 16:00:00,2019-03-29 16:15:00
58,3,0,3,0.0022058007211504757,2019-03-29 16:00:00,2019-03-29 16:15:00
61,1,1,0,0.006968745589592429,2019-03-29 16:00:00,2019-03-29 16:15:00
62,7,3,4,0.007532671862993277,2019-03-29 16:00:00,2019-03-29 16:15:00
64,3,3,0,0.009397797185206391,2019-03-29 16:00:00,2019-03-29 16:15:00
66,9,2,7,0.0054741072640077885,2019-03-29 16:00:00,2019-03-29 16:15:00
67,5,3,2,0.004437804197392843,2019-03-29 16:00:00,2019-03-29 16:15:00
68,6,1,5,0.002792452419117588,2019-03-29 16:00:00,2019-03-29 16:15:00
69,4,4,0,0.011686631048511963,2019-03-29 16:00:00,2019-03-29 16:15:00
70,9,4,5,0.0044026085431315325,2019-03-29 16:00:00,2019-03-29 16:15:00
71,1,1,0,0.0035351285083036832,2019-03-29 16:00:00,2019-03-29 16:15:00
74,9,1,8,0.004080861211709603,2019-03-29 16:00:00,2019-03-29 16:15:00
75,3,2,1,0.02454196447413422,2019-03-29 16:00:00,2019-03-29 16:15:00
79,2,1,1,0.006672825106491925,2019-03-29 16:00:00,2019-03-29 16:15:00
80,5,3,2,0.007641239023595025,2019-03-29 16:00:00,2019-03-29 16:15:00
87,3,0,3,0.0022058007211504757,2019-03-29 16:00:00,2019-03-29 16:15:00
88,2,0,2,0.0022058007211504757,2019-03-29 16:00:00,2019-03-29 16:15:00
89,4,2,2,0.005315590789670511,2019-03-29 16:00:00,2019-03-29 16:15:00
90,4,2,2,0.004705881375229312,2019-03-29 16:00:00,2019-03-29 16:15:00
99,5,3,2,0.027360732767503386,2019-03-29 16:00:00,2019-03-29 16:15:00
101,2,0,2,0.0022058007211504757,2019-03-29 16:00:00,2019-03-29 16:15:00
104,4,2,2,0.003127596326394015,2019-03-29 16:00:00,2019-03-29 16:15:00
106,1,1,0,0.006249432796948843,2019-03-29 16:00:00,2019-03-29 16:15:00
108,3,2,1,0.004756798671870744,2019-03-29 16:00:00,2019-03-29 16:15:00
109,8,7,1,0.019058061640432455,2019-03-29 16:00:00,2019-03-29 16:15:00
110,8,3,5,0.004502046459779849,2019-03-29 16:00:00,2019-03-29 16:15:00
113,5,3,2,0.0058032357263696835,2019-03-29 16:00:00,2019-03-29 16:15:00
114,5,3,2,0.005773565126418165,2019-03-29 16:00:00,2019-03-29 16:15:00
115,3,0,3,0.0022058007211504757,2019-03-29 16:00:00,2019-03-29 16:15:00
116,4,2,2,0.018505880368951476,2019-03-29 16:00:00,2019-03-29 16:15:00
118,1,0,1,0.0022058007211504757,2019-03-29 16:00:00,2019-03-29 16:15:00
119,9,4,5,0.014258613457452697,2019-03-29 16:00:00,2019-03-29 16:15:00
120,2,2,0,0.004080861211709603,2019-03-29 16:00:00,2019-03-29 16:15:00
122,5,4,1,0.008532294415680668,2019-03-29 16:00:00,2019-03-29 16:15:00
126,6,2,4,0.005367597010020501,2019-03-29 16:00:00,2019-03-29 16:15:00
127,4,2,2,0.005820481546141386,2019-03-29 16:00:00,2019-03-29 16:15:00
129,1,0,1,0.0022058007211504757,2019-03-29 16:00:00,2019-03-29 16:15:00
133,1,0,1,0.0022058007211504757,2019-03-29 16:00:00,2019-03-29 16:15:00
135,2,1,1,0.014670014319632075,2019-03-29 16:00:00,2019-03-29 16:15:00
137,8,5,3,0.043035048292549304,2019-03-29 16:00:00,2019-03-29 16:15:00
138,21,4,17,0.004624620140910134,2019-03-29 16:00:00,2019-03-29 16:15:00
140,1,1,0,0.0030779531716008134,2019-03-29 16:00:00,2019-03-29 16:15:00
147,2,0,2,0.0022058007211504757,2019-03-29 16:00:00,2019-03-29 16:15:00
151,3,2,1,0.005254891813505257,2019-03-29 16:00:00,2019-03-29 16:15:00
153,16,6,10,0.00700439489438068,2019-03-29 16:00:00,2019-03-29 16:15:00
154,4,1,3,0.002437049568591152,2019-03-29 16:00:00,2019-03-29 16:15:00
156,1,0,1,0.0022058007211504757,2019-03-29 16:00:00,2019-03-29 16:15:00
157,2,1,1,0.004080861211709603,2019-03-29 16:00:00,2019-03-29 16:15:00
158,1,0,1,0.0022058007211504757,2019-03-29 16:00:00,2019-03-29 16:15:00
162,3,3,0,0.013274047719292591,2019-03-29 16:00:00,2019-03-29 16:15:00
164,8,5,3,0.008892476955871056,2019-03-29 16:00:00,2019-03-29 16:15:00
168,8,6,2,0.06688651412657057,2019-03-29 16:00:00,2019-03-29 16:15:00
169,4,2,2,0.0075769820223486,2019-03-29 16:00:00,2019-03-29 16:15:00
170,8,3,5,0.00397196520404247,2019-03-29 16:00:00,2019-03-29 16:15:00
171,4,2,2,0.007097618136445497,2019-03-29 16:00:00,2019-03-29 16:15:00
172,6,3,3,0.008879367347481173,2019-03-29 16:00:00,2019-03-29 16:15:00
173,4,3,1,0.01669660246762879,2019-03-29 16:00:00,2019-03-29 16:15:00
175,4,3,1,0.025873590230039815,2019-03-29 16:00:00,2019-03-29 16:15:00
177,6,2,4,0.0048339683730980534,2019-03-29 16:00:00,2019-03-29 16:15:00
190,4,1,3,0.0033465266643707497,2019-03-29 16:00:00,2019-03-29 16:15:00
191,1,1,0,0.004465119868164187,2019-03-29 16:00:00,2019-03-29 16:15:00
195,8,2,6,0.0030779531716008134,2019-03-29 16:00:00,2019-03-29 16:15:00
196,6,3,3,0.005946235635515938,2019-03-29 16:00:00,2019-03-29 16:15:00
197,4,2,2,0.003234854840562156,2019-03-29 16:00:00,2019-03-29 16:15:00
201,3,1,2,0.0030779531716008134,2019-03-29 16:00:00,2019-03-29 16:15:00
202,4,2,2,0.00423861096143568,2019-03-29 16:00:00,2019-03-29 16:15:00
203,4,1,3,0.0030779531716008134,2019-03-29 16:00:00,2019-03-29 16:15:00
1,6,3,3,0.00645092886068527,2019-03-29 16:15:00,2019-03-29 16:30:00
2,5,2,3,0.004109096766699742,2019-03-29 16:15:00,2019-03-29 16:30:00
5,5,4,1,0.003537112423526111,2019-03-29 16:15:00,2019-03-29 16:30:00
10,7,6,1,0.006733470967713968,2019-03-29 16:15:00,2019-03-29 16:30:00
11,4,2,2,0.011974314303722046,2019-03-29 16:15:00,2019-03-29 16:30:00
15,7,3,4,0.005638994754309342,2019-03-29 16:15:00,2019-03-29 16:30:00
16,16,10,6,0.01341614818138228,2019-03-29 16:15:00,2019-03-29 16:30:00
18,14,6,8,0.009492212776704395,2019-03-29 16:15:00,2019-03-29 16:30:00
19,9,5,4,0.011145899126307795,2019-03-29 16:15:00,2019-03-29 16:30:00
20,6,1,5,0.006754299872292037,2019-03-29 16:15:00,2019-03-29 16:30:00
21,3,2,1,0.002870030394991293,2019-03-29 16:15:00,2019-03-29 16:30:00
23,9,5,4,0.01229929285945309,2019-03-29 16:15:00,2019-03-29 16:30:00
26,2,2,0,0.006665190883487444,2019-03-29 16:15:00,2019-03-29 16:30:00
27,5,2,3,0.0038875947201612165,2019-03-29 16:15:00,2019-03-29 16:30:00
28,5,4,1,0.03478250778029733,2019-03-29 16:15:00,2019-03-29 16:30:00
30,6,3,3,0.005129602714228862,2019-03-29 16:15:00,2019-03-29 16:30:00
35,4,3,1,0.0030906777047148264,2019-03-29 16:15:00,2019-03-29 16:30:00
37,4,2,2,0.0035101144861865944,2019-03-29 16:15:00,2019-03-29 16:30:00
41,8,6,2,0.0183333039812885,2019-03-29 16:15:00,2019-03-29 16:30:00
46,9,3,6,0.002902589738891535,2019-03-29 16:15:00,2019-03-29 16:30:00
50,3,1,2,0.002071696359538572,2019-03-29 16:15:00,2019-03-29 16:30:00
57,6,2,4,0.006405342612800279,2019-03-29 16:15:00,2019-03-29 16:30:00
58,10,6,4,0.030964229121212734,2019-03-29 16:15:00,2019-03-29 16:30:00
61,1,1,0,0.0029455063926381586,2019-03-29 16:15:00,2019-03-29 16:30:00
62,6,2,4,0.004188017162482734,2019-03-29 16:15:00,2019-03-29 16:30:00
64,9,7,2,0.10281113771168475,2019-03-29 16:15:00,2019-03-29 16:30:00
66,6,0,6,0.0017971335911866047,2019-03-29 16:15:00,2019-03-29 16:30:00
67,8,5,3,0.013772262122603235,2019-03-29 16:15:00,2019-03-29 16:30:00
68,8,3,5,0.005026779707906275,2019-03-29 16:15:00,2019-03-29 16:30:00
69,3,3,0,0.003724694542656357,2019-03-29 16:15:00,2019-03-29 16:30:00
70,8,5,3,0.0031691873348405042,2019-03-29 16:15:00,2019-03-29 16:30:00
71,2,2,0,0.007196009249875997,2019-03-29 16:15:00,2019-03-29 16:30:00
74,7,0,7,0.0017971335911866047,2019-03-29 16:15:00,2019-03-29 16:30:00
75,1,1,0,0.0036980091364602822,2019-03-29 16:15:00,2019-03-29 16:30:00
79,3,1,2,0.0031255708276073683,2019-03-29 16:15:00,2019-03-29 16:30:00
80,3,0,3,0.0017971335911866047,2019-03-29 16:15:00,2019-03-29 16:30:00
85,2,1,1,0.011974314303722046,2019-03-29 16:15:00,2019-03-29 16:30:00
88,2,1,1,0.004056031954285301,2019-03-29 16:15:00,2019-03-29 16:30:00
89,4,0,4,0.0017971335911866047,2019-03-29 16:15:00,2019-03-29 16:30:00
90,4,1,3,0.002179040739430948,2019-03-29 16:15:00,2019-03-29 16:30:00
99,4,2,2,0.007399613848151628,2019-03-29 16:15:00,2019-03-29 16:30:00
101,4,2,2,0.0029873267880574836,2019-03-29 16:15:00,2019-03-29 16:30:00
104,6,4,2,0.010587830040044634,2019-03-29 16:15:00,2019-03-29 16:30:00
106,3,2,1,0.02359308703618384,2019-03-29 16:15:00,2019-03-29 16:30:00
108,2,1,1,0.0020517383566828334,2019-03-29 16:15:00,2019-03-29 16:30:00
109,9,7,2,0.019636563549236766,2019-03-29 16:15:00,2019-03-29 16:30:00
110,15,9,6,0.032351122242976746,2019-03-29 16:15:00,2019-03-29 16:30:00
111,1,1,0,0.004036490675341025,2019-03-29 16:15:00,2019-03-29 16:30:00
113,6,4,2,0.005314410573442379,2019-03-29 16:15:00,2019-03-29 16:30:00
114,8,3,5,0.005816234123392506,2019-03-29 16:15:00,2019-03-29 16:30:00
115,1,0,1,0.0017971335911866047,2019-03-29 16:15:00,2019-03-29 16:30:00
116,8,5,3,0.01227938633652746,2019-03-29 16:15:00,2019-03-29 16:30:00
118,1,0,1,0.0017971335911866047,2019-03-29 16:15:00,2019-03-29 16:30:00
119,12,4,8,0.007381254766208599,2019-03-29 16:15:00,2019-03-29 16:30:00
120,6,4,2,0.011662499311224117,2019-03-29 16:15:00,2019-03-29 16:30:00
122,6,2,4,0.0037542502323800065,2019-03-29 16:15:00,2019-03-29 16:30:00
126,8,5,3,0.012701567752130098,2019-03-29 16:15:00,2019-03-29 16:30:00
127,3,2,1,0.006385469170927331,2019-03-29 16:15:00,2019-03-29 16:30:00
129,1,1,0,0.002595036505670429,2019-03-29 16:15:00,2019-03-29 16:30:00
135,5,1,4,0.0022821025513740083,2019-03-29 16:15:00,2019-03-29 16:30:00
137,9,6,3,0.013465079948590196,2019-03-29 16:15:00,2019-03-29 16:30:00
138,18,4,14,0.004521697441516185,2019-03-29 16:15:00,2019-03-29 16:30:00
140,1,1,0,0.002560947887675292,2019-03-29 16:15:00,2019-03-29 16:30:00
141,1,1,0,0.002414555925362414,2019-03-29 16:15:00,2019-03-29 16:30:00
147,5,1,4,0.002006400547862178,2019-03-29 16:15:00,2019-03-29 16:30:00
151,2,2,0,0.0054531825330724,2019-03-29 16:15:00,2019-03-29 16:30:00
153,13,5,8,0.005163491743128711,2019-03-29 16:15:00,2019-03-29 16:30:00
154,4,1,3,0.002071696359538572,2019-03-29 16:15:00,2019-03-29 16:30:00
157,1,1,0,0.0023063431221790626,2019-03-29 16:15:00,2019-03-29 16:30:00
158,2,1,1,0.0036980091364602822,2019-03-29 16:15:00,2019-03-29 16:30:00
162,1,0,1,0.0017971335911866047,2019-03-29 16:15:00,2019-03-29 16:30:00
164,10,6,4,0.010535969677236955,2019-03-29 16:15:00,2019-03-29 16:30:00
168,7,5,2,0.031275626726774336,2019-03-29 16:15:00,2019-03-29 16:30:00
169,5,3,2,0.004978929404747978,2019-03-29 16:15:00,2019-03-29 16:30:00
170,10,4,6,0.012014932402249512,2019-03-29 16:15:00,2019-03-29 16:30:00
171,4,3,1,0.048058710886428956,2019-03-29 16:15:00,2019-03-29 16:30:00
172,2,1,1,0.005396591713663747,2019-03-29 16:15:00,2019-03-29 16:30:00
173,5,3,2,0.006138179004472095,2019-03-29 16:15:00,2019-03-29 16:30:00
175,4,3,1,0.020796745174834482,2019-03-29 16:15:00,2019-03-29 16:30:00
177,4,1,3,0.002687185288071362,2019-03-29 16:15:00,2019-03-29 16:30:00
190,2,0,2,0.0017971335911866047,2019-03-29 16:15:00,2019-03-29 16:30:00
191,8,6,2,0.011536856352057309,2019-03-29 16:15:00,2019-03-29 16:30:00
195,11,2,9,0.002215667504537751,2019-03-29 16:15:00,2019-03-29 16:30:00
196,6,2,4,0.01197821047431771,2019-03-29 16:15:00,2019-03-29 16:30:00
197,3,2,1,0.004561391947445467,2019-03-29 16:15:00,2019-03-29 16:30:00
201,1,0,1,0.0017971335911866047,2019-03-29 16:15:00,2019-03-29 16:30:00
202,2,2,0,0.003080436280337074,2019-03-29 16:15:00,2019-03-29 16:30:00
203,2,0,2,0.0017971335911866047,2019-03-29 16:15:00,2019-03-29 16:30:00
1,10,5,5,0.012860174622717397,2019-03-29 16:30:00,2019-03-29 16:45:00
2,7,2,5,0.0043037538056872136,2019-03-29 16:30:00,2019-03-29 16:45:00
5,12,7,5,0.015541476564630126,2019-03-29 16:30:00,2019-03-29 16:45:00
10,8,6,2,0.010229602213957908,2019-03-29 16:30:00,2019-03-29 16:45:00
11,4,2,2,0.010943344674213483,2019-03-29 16:30:00,2019-03-29 16:45:00
15,5,3,2,0.005420186435105283,2019-03-29 16:30:00,2019-03-29 16:45:00
16,13,6,7,0.01683198396009397,2019-03-29 16:30:00,2019-03-29 16:45:00
18,14,5,9,0.015404049028028546,2019-03-29 16:30:00,2019-03-29 16:45:00
19,8,3,5,0.010371946773290574,2019-03-29 16:30:00,2019-03-29 16:45:00
20,4,2,2,0.010333126656248108,2019-03-29 16:30:00,2019-03-29 16:45:00
21,2,0,2,0.0016421505300475109,2019-03-29 16:30:00,2019-03-29 16:45:00
22,1,0,1,0.0016421505300475109,2019-03-29 16:30:00,2019-03-29 16:45:00
23,6,2,4,0.012039072694601409,2019-03-29 16:30:00,2019-03-29 16:45:00
26,3,2,1,0.004184733412987779,2019-03-29 16:30:00,2019-03-29 16:45:00
27,4,2,2,0.005736206280476319,2019-03-29 16:30:00,2019-03-29 16:45:00
28,5,4,1,0.05338551539021324,2019-03-29 16:30:00,2019-03-29 16:45:00
30,4,2,2,0.005736206280476319,2019-03-29 16:30:00,2019-03-29 16:45:00
35,4,3,1,0.005860494281532708,2019-03-29 16:30:00,2019-03-29 16:45:00
37,5,3,2,0.0033963954957222345,2019-03-29 16:30:00,2019-03-29 16:45:00
41,5,4,1,0.008072030759828305,2019-03-29 16:30:00,2019-03-29 16:45:00
46,10,5,5,0.012997140683176032,2019-03-29 16:30:00,2019-03-29 16:45:00
50,1,0,1,0.0016421505300475109,2019-03-29 16:30:00,2019-03-29 16:45:00
57,9,4,5,0.015598999923214027,2019-03-29 16:30:00,2019-03-29 16:45:00
58,14,10,4,0.028375507944442945,2019-03-29 16:30:00,2019-03-29 16:45:00
61,1,1,0,0.00603434960366412,2019-03-29 16:30:00,2019-03-29 16:45:00
62,8,4,4,0.007539715146738131,2019-03-29 16:30:00,2019-03-29 16:45:00
64,10,7,3,0.02225223821967123,2019-03-29 16:30:00,2019-03-29 16:45:00
66,2,0,2,0.0016421505300475109,2019-03-29 16:30:00,2019-03-29 16:45:00
67,12,6,6,0.03081369033209881,2019-03-29 16:30:00,2019-03-29 16:45:00
68,7,4,3,0.013184758394811083,2019-03-29 16:30:00,2019-03-29 16:45:00
69,5,4,1,0.007629177704079849,2019-03-29 16:30:00,2019-03-29 16:45:00
70,10,3,7,0.002694318117139368,2019-03-29 16:30:00,2019-03-29 16:45:00
71,2,2,0,0.004245345483325918,2019-03-29 16:30:00,2019-03-29 16:45:00
74,5,1,4,0.006008367813360746,2019-03-29 16:30:00,2019-03-29 16:45:00
75,1,1,0,0.003200887916009459,2019-03-29 16:30:00,2019-03-29 16:45:00
79,5,3,2,0.010044215990194326,2019-03-29 16:30:00,2019-03-29 16:45:00
80,3,0,3,0.0016421505300475109,2019-03-29 16:30:00,2019-03-29 16:45:00
85,3,1,2,0.00285595754727225,2019-03-29 16:30:00,2019-03-29 16:45:00
88,3,2,1,0.004861953680288113,2019-03-29 16:30:00,2019-03-29 16:45:00
89,2,1,1,0.003792490275299262,2019-03-29 16:30:00,2019-03-29 16:45:00
90,8,2,6,0.0036085009759078057,2019-03-29 16:30:00,2019-03-29 16:45:00
99,1,0,1,0.0016421505300475109,2019-03-29 16:30:00,2019-03-29 16:45:00
101,4,2,2,0.003356443708357716,2019-03-29 16:30:00,2019-03-29 16:45:00
104,7,4,3,0.00803227136298941,2019-03-29 16:30:00,2019-03-29 16:45:00
106,2,1,1,0.010943344674213483,2019-03-29 16:30:00,2019-03-29 16:45:00
108,1,1,0,0.002340076534276491,2019-03-29 16:30:00,2019-03-29 16:45:00
109,8,3,5,0.008223935734867134,2019-03-29 16:30:00,2019-03-29 16:45:00
110,18,12,6,0.08779701702785962,2019-03-29 16:30:00,2019-03-29 16:45:00
111,4,3,1,0.004892107344599264,2019-03-29 16:30:00,2019-03-29 16:45:00
112,1,1,0,0.004204334783908881,2019-03-29 16:30:00,2019-03-29 16:45:00
113,3,1,2,0.0042848962968622464,2019-03-29 16:30:00,2019-03-29 16:45:00
114,5,2,3,0.005843801339774583,2019-03-29 16:30:00,2019-03-29 16:45:00
115,2,1,1,0.002958623386445862,2019-03-29 16:30:00,2019-03-29 16:45:00
116,6,3,3,0.004842052456092305,2019-03-29 16:30:00,2019-03-29 16:45:00
118,2,1,1,0.0030141737685641665,2019-03-29 16:30:00,2019-03-29 16:45:00
119,8,3,5,0.008058039126799673,2019-03-29 16:30:00,2019-03-29 16:45:00
120,5,3,2,0.006258842682678449,2019-03-29 16:30:00,2019-03-29 16:45:00
122,3,1,2,0.004200940098230371,2019-03-29 16:30:00,2019-03-29 16:45:00
126,6,4,2,0.008215809719591259,2019-03-29 16:30:00,2019-03-29 16:45:00
127,2,1,1,0.0032980863167626465,2019-03-29 16:30:00,2019-03-29 16:45:00
129,6,5,1,0.011778671397622176,2019-03-29 16:30:00,2019-03-29 16:45:00
133,1,0,1,0.0016421505300475109,2019-03-29 16:30:00,2019-03-29 16:45:00
135,3,0,3,0.0016421505300475109,2019-03-29 16:30:00,2019-03-29 16:45:00
137,16,9,7,0.017706185955897333,2019-03-29 16:30:00,2019-03-29 16:45:00
138,23,7,16,0.005512174657644024,2019-03-29 16:30:00,2019-03-29 16:45:00
140,1,1,0,0.004309946032921453,2019-03-29 16:30:00,2019-03-29 16:45:00
141,5,3,2,0.0062762964787817475,2019-03-29 16:30:00,2019-03-29 16:45:00
147,6,1,5,0.002340076534276491,2019-03-29 16:30:00,2019-03-29 16:45:00
151,6,3,3,0.007292100992579367,2019-03-29 16:30:00,2019-03-29 16:45:00
153,19,9,10,0.02002393453656761,2019-03-29 16:30:00,2019-03-29 16:45:00
154,4,2,2,0.004450023111266535,2019-03-29 16:30:00,2019-03-29 16:45:00
157,1,1,0,0.002107434532866831,2019-03-29 16:30:00,2019-03-29 16:45:00
158,2,1,1,0.003686362810097086,2019-03-29 16:30:00,2019-03-29 16:45:00
159,2,2,0,0.003735928542734452,2019-03-29 16:30:00,2019-03-29 16:45:00
160,4,2,2,0.010943344674213483,2019-03-29 16:30:00,2019-03-29 16:45:00
162,4,2,2,0.005410851389759299,2019-03-29 16:30:00,2019-03-29 16:45:00
164,13,8,5,0.030849895701575883,2019-03-29 16:30:00,2019-03-29 16:45:00
168,5,2,3,0.00550080794618488,2019-03-29 16:30:00,2019-03-29 16:45:00
169,1,1,0,0.002373868434946332,2019-03-29 16:30:00,2019-03-29 16:45:00
170,5,3,2,0.006611831559560466,2019-03-29 16:30:00,2019-03-29 16:45:00
171,2,1,1,0.010943344674213483,2019-03-29 16:30:00,2019-03-29 16:45:00
172,2,1,1,0.002085280832373195,2019-03-29 16:30:00,2019-03-29 16:45:00
173,7,4,3,0.007939117210499594,2019-03-29 16:30:00,2019-03-29 16:45:00
175,3,3,0,0.003098862389448187,2019-03-29 16:30:00,2019-03-29 16:45:00
177,5,1,4,0.002085280832373195,2019-03-29 16:30:00,2019-03-29 16:45:00
190,1,0,1,0.0016421505300475109,2019-03-29 16:30:00,2019-03-29 16:45:00
191,11,6,5,0.017050123117263335,2019-03-29 16:30:00,2019-03-29 16:45:00
195,4,0,4,0.0016421505300475109,2019-03-29 16:30:00,2019-03-29 16:45:00
196,11,3,8,0.009142645624115356,2019-03-29 16:30:00,2019-03-29 16:45:00
197,4,3,1,0.008238984704214884,2019-03-29 16:30:00,2019-03-29 16:45:00
201,3,2,1,0.004524208180198084,2019-03-29 16:30:00,2019-03-29 16:45:00
202,4,2,2,0.003390103591111588,2019-03-29 16:30:00,2019-03-29 16:45:00
203,3,1,2,0.0030972374455198546,2019-03-29 16:30:00,2019-03-29 16:45:00
1,7,3,4,0.006684825951690746,2019-03-29 16:45:00,2019-03-29 17:00:00
2,7,3,4,0.00763982168075091,2019-03-29 16:45:00,2019-03-29 17:00:00
5,9,3,6,0.006180414376133033,2019-03-29 16:45:00,2019-03-29 17:00:00
10,14,6,8,0.007740195388150478,2019-03-29 16:45:00,2019-03-29 17:00:00
11,8,5,3,0.010710680543266038,2019-03-29 16:45:00,2019-03-29 17:00:00
13,1,0,1,0.0020134758441530958,2019-03-29 16:45:00,2019-03-29 17:00:00
15,11,6,5,0.009786130665245312,2019-03-29 16:45:00,2019-03-29 17:00:00
16,9,4,5,0.009494916872072325,2019-03-29 16:45:00,2019-03-29 17:00:00
18,19,8,11,0.012209319439401144,2019-03-29 16:45:00,2019-03-29 17:00:00
19,6,3,3,0.009856510640068279,2019-03-29 16:45:00,2019-03-29 17:00:00
20,3,2,1,0.00910024668736049,2019-03-29 16:45:00,2019-03-29 17:00:00
21,1,0,1,0.0020134758441530958,2019-03-29 16:45:00,2019-03-29 17:00:00
22,1,0,1,0.0020134758441530958,2019-03-29 16:45:00,2019-03-29 17:00:00
23,8,5,3,0.013284356524953076,2019-03-29 16:45:00,2019-03-29 17:00:00
26,3,1,2,0.0024397444807143314,2019-03-29 16:45:00,2019-03-29 17:00:00
27,3,2,1,0.03632420851149475,2019-03-29 16:45:00,2019-03-29 17:00:00
28,5,2,3,0.00451124487016164,2019-03-29 16:45:00,2019-03-29 17:00:00
30,2,1,1,0.013353014994730098,2019-03-29 16:45:00,2019-03-29 17:00:00
35,2,2,0,0.007545868753025292,2019-03-29 16:45:00,2019-03-29 17:00:00
37,4,3,1,0.007701476460439288,2019-03-29 16:45:00,2019-03-29 17:00:00
41,7,7,0,0.015294490703514884,2019-03-29 16:45:00,2019-03-29 17:00:00
46,12,8,4,0.03152208833636169,2019-03-29 16:45:00,2019-03-29 17:00:00
50,4,1,3,0.002869249584873753,2019-03-29 16:45:00,2019-03-29 17:00:00
57,5,2,3,0.004543149218253354,2019-03-29 16:45:00,2019-03-29 17:00:00
58,12,8,4,0.025895266854206806,2019-03-29 16:45:00,2019-03-29 17:00:00
61,2,1,1,0.013353014994730098,2019-03-29 16:45:00,2019-03-29 17:00:00
62,9,4,5,0.010125814403702561,2019-03-29 16:45:00,2019-03-29 17:00:00
64,7,4,3,0.012796858871162362,2019-03-29 16:45:00,2019-03-29 17:00:00
66,1,0,1,0.0020134758441530958,2019-03-29 16:45:00,2019-03-29 17:00:00
67,8,4,4,0.013101767345066271,2019-03-29 16:45:00,2019-03-29 17:00:00
68,3,2,1,0.00408884754287727,2019-03-29 16:45:00,2019-03-29 17:00:00
69,4,2,2,0.003384919735764333,2019-03-29 16:45:00,2019-03-29 17:00:00
70,10,3,7,0.004726929561264386,2019-03-29 16:45:00,2019-03-29 17:00:00
71,2,2,0,0.004611459387745355,2019-03-29 16:45:00,2019-03-29 17:00:00
74,2,0,2,0.0020134758441530958,2019-03-29 16:45:00,2019-03-29 17:00:00
75,1,1,0,0.010073338329099594,2019-03-29 16:45:00,2019-03-29 17:00:00
79,6,3,3,0.006545087104026997,2019-03-29 16:45:00,2019-03-29 17:00:00
80,1,1,0,0.005048584932210897,2019-03-29 16:45:00,2019-03-29 17:00:00
86,3,2,1,0.01371306745704404,2019-03-29 16:45:00,2019-03-29 17:00:00
87,1,1,0,0.0028891380184855424,2019-03-29 16:45:00,2019-03-29 17:00:00
88,6,3,3,0.007159167937332013,2019-03-29 16:45:00,2019-03-29 17:00:00
89,2,1,1,0.0024397444807143314,2019-03-29 16:45:00,2019-03-29 17:00:00
90,12,6,6,0.014342306339293075,2019-03-29 16:45:00,2019-03-29 17:00:00
99,1,0,1,0.0020134758441530958,2019-03-29 16:45:00,2019-03-29 17:00:00
101,2,0,2,0.0020134758441530958,2019-03-29 16:45:00,2019-03-29 17:00:00
104,4,2,2,0.0047619761858823245,2019-03-29 16:45:00,2019-03-29 17:00:00
106,1,0,1,0.0020134758441530958,2019-03-29 16:45:00,2019-03-29 17:00:00
109,12,7,5,0.010384133178326288,2019-03-29 16:45:00,2019-03-29 17:00:00
110,16,8,8,0.018993917350924885,2019-03-29 16:45:00,2019-03-29 17:00:00
111,9,4,5,0.015651826836330388,2019-03-29 16:45:00,2019-03-29 17:00:00
112,1,1,0,0.0024413627145134244,2019-03-29 16:45:00,2019-03-29 17:00:00
113,7,3,4,0.0063600042572567565,2019-03-29 16:45:00,2019-03-29 17:00:00
114,2,0,2,0.0020134758441530958,2019-03-29 16:45:00,2019-03-29 17:00:00
115,3,1,2,0.0026191945662070405,2019-03-29 16:45:00,2019-03-29 17:00:00
116,4,2,2,0.003597456873678188,2019-03-29 16:45:00,2019-03-29 17:00:00
118,3,2,1,0.010242122720410207,2019-03-29 16:45:00,2019-03-29 17:00:00
119,9,6,3,0.00974228926576707,2019-03-29 16:45:00,2019-03-29 17:00:00
120,4,2,2,0.003725023325594411,2019-03-29 16:45:00,2019-03-29 17:00:00
122,1,1,0,0.005777878520082549,2019-03-29 16:45:00,2019-03-29 17:00:00
126,6,5,1,0.012069983423554115,2019-03-29 16:45:00,2019-03-29 17:00:00
127,2,1,1,0.0031267057045110693,2019-03-29 16:45:00,2019-03-29 17:00:00
129,8,7,1,0.00971303361841949,2019-03-29 16:45:00,2019-03-29 17:00:00
133,1,0,1,0.0020134758441530958,2019-03-29 16:45:00,2019-03-29 17:00:00
135,2,0,2,0.0020134758441530958,2019-03-29 16:45:00,2019-03-29 17:00:00
137,21,11,10,0.032602921240637774,2019-03-29 16:45:00,2019-03-29 17:00:00
138,12,3,9,0.004513118278589016,2019-03-29 16:45:00,2019-03-29 17:00:00
140,2,1,1,0.010720672787333966,2019-03-29 16:45:00,2019-03-29 17:00:00
141,4,2,2,0.0051430225595406175,2019-03-29 16:45:00,2019-03-29 17:00:00
147,4,0,4,0.0020134758441530958,2019-03-29 16:45:00,2019-03-29 17:00:00
151,5,2,3,0.004723833187688423,2019-03-29 16:45:00,2019-03-29 17:00:00
153,14,6,8,0.017813996986481836,2019-03-29 16:45:00,2019-03-29 17:00:00
154,2,1,1,0.0024397444807143314,2019-03-29 16:45:00,2019-03-29 17:00:00
157,2,0,2,0.0020134758441530958,2019-03-29 16:45:00,2019-03-29 17:00:00
159,2,2,0,0.0054365708070357255,2019-03-29 16:45:00,2019-03-29 17:00:00
160,4,2,2,0.013353014994730098,2019-03-29 16:45:00,2019-03-29 17:00:00
162,5,4,1,0.018614269605482518,2019-03-29 16:45:00,2019-03-29 17:00:00
164,11,5,6,0.019593137790842225,2019-03-29 16:45:00,2019-03-29 17:00:00
168,7,4,3,0.028442262255530704,2019-03-29 16:45:00,2019-03-29 17:00:00
169,3,3,0,0.009180612381021672,2019-03-29 16:45:00,2019-03-29 17:00:00
170,4,1,3,0.005777878520082549,2019-03-29 16:45:00,2019-03-29 17:00:00
171,2,1,1,0.013353014994730098,2019-03-29 16:45:00,2019-03-29 17:00:00
172,2,1,1,0.004728621813629963,2019-03-29 16:45:00,2019-03-29 17:00:00
173,3,1,2,0.002869249584873753,2019-03-29 16:45:00,2019-03-29 17:00:00
175,3,3,0,0.004639088210341501,2019-03-29 16:45:00,2019-03-29 17:00:00
177,2,1,1,0.003194061580540089,2019-03-29 16:45:00,2019-03-29 17:00:00
189,2,2,0,0.0065010861175565735,2019-03-29 16:45:00,2019-03-29 17:00:00
190,7,3,4,0.005555233053314075,2019-03-29 16:45:00,2019-03-29 17:00:00
191,10,3,7,0.006348483043630535,2019-03-29 16:45:00,2019-03-29 17:00:00
196,11,4,7,0.005242685790002078,2019-03-29 16:45:00,2019-03-29 17:00:00
197,3,2,1,0.00549715609786236,2019-03-29 16:45:00,2019-03-29 17:00:00
199,1,1,0,0.0037351107316521918,2019-03-29 16:45:00,2019-03-29 17:00:00
201,1,0,1,0.0020134758441530958,2019-03-29 16:45:00,2019-03-29 17:00:00
202,1,1,0,0.0024397444807143314,2019-03-29 16:45:00,2019-03-29 17:00:00
203,7,2,5,0.003562751587457949,2019-03-29 16:45:00,2019-03-29 17:00:00
1,7,3,4,0.006999356942804994,2019-03-29 17:00:00,2019-03-29 17:15:00
2,8,3,5,0.004158655695815616,2019-03-29 17:00:00,2019-03-29 17:15:00
5,10,5,5,0.008704946547432348,2019-03-29 17:00:00,2019-03-29 17:15:00
10,8,2,6,0.00289305058551841,2019-03-29 17:00:00,2019-03-29 17:15:00
11,9,4,5,0.007847657150085436,2019-03-29 17:00:00,2019-03-29 17:15:00
13,1,0,1,0.0020733024910080753,2019-03-29 17:00:00,2019-03-29 17:15:00
15,9,5,4,0.009769159846177095,2019-03-29 17:00:00,2019-03-29 17:15:00
16,13,9,4,0.02173092203777391,2019-03-29 17:00:00,2019-03-29 17:15:00
18,18,9,9,0.01250521387974921,2019-03-29 17:00:00,2019-03-29 17:15:00
19,7,2,5,0.0037937335133764955,2019-03-29 17:00:00,2019-03-29 17:15:00
23,14,4,10,0.008005168804283598,2019-03-29 17:00:00,2019-03-29 17:15:00
26,1,0,1,0.0020733024910080753,2019-03-29 17:00:00,2019-03-29 17:15:00
27,4,3,1,0.044310918914100765,2019-03-29 17:00:00,2019-03-29 17:15:00
28,4,3,1,0.03275787728827723,2019-03-29 17:00:00,2019-03-29 17:15:00
30,4,2,2,0.004913582884132602,2019-03-29 17:00:00,2019-03-29 17:15:00
35,6,3,3,0.006995204623024715,2019-03-29 17:00:00,2019-03-29 17:15:00
37,3,1,2,0.00278033809026784,2019-03-29 17:00:00,2019-03-29 17:15:00
41,6,6,0,0.016171750518708713,2019-03-29 17:00:00,2019-03-29 17:15:00
46,16,6,10,0.011391951975164448,2019-03-29 17:00:00,2019-03-29 17:15:00
50,6,1,5,0.0024979850386169337,2019-03-29 17:00:00,2019-03-29 17:15:00
57,4,1,3,0.003468865357576683,2019-03-29 17:00:00,2019-03-29 17:15:00
58,13,8,5,0.04694994473101294,2019-03-29 17:00:00,2019-03-29 17:15:00
61,3,2,1,0.02690203787113017,2019-03-29 17:00:00,2019-03-29 17:15:00
62,11,5,6,0.009281849931835055,2019-03-29 17:00:00,2019-03-29 17:15:00
64,6,3,3,0.016464685705995786,2019-03-29 17:00:00,2019-03-29 17:15:00
66,1,0,1,0.0020733024910080753,2019-03-29 17:00:00,2019-03-29 17:15:00
67,11,6,5,0.022460120334970093,2019-03-29 17:00:00,2019-03-29 17:15:00
68,7,5,2,0.009563272093571589,2019-03-29 17:00:00,2019-03-29 17:15:00
69,3,1,2,0.0032544681655262593,2019-03-29 17:00:00,2019-03-29 17:15:00
70,7,2,5,0.0044231784901856645,2019-03-29 17:00:00,2019-03-29 17:15:00
71,7,4,3,0.010283289653898407,2019-03-29 17:00:00,2019-03-29 17:15:00
74,6,3,3,0.007077783782938355,2019-03-29 17:00:00,2019-03-29 17:15:00
79,1,0,1,0.0020733024910080753,2019-03-29 17:00:00,2019-03-29 17:15:00
80,1,1,0,0.0034075727414427104,2019-03-29 17:00:00,2019-03-29 17:15:00
86,2,1,1,0.009265221485074197,2019-03-29 17:00:00,2019-03-29 17:15:00
87,6,6,0,0.016507341382432032,2019-03-29 17:00:00,2019-03-29 17:15:00
88,3,0,3,0.0020733024910080753,2019-03-29 17:00:00,2019-03-29 17:15:00
89,2,1,1,0.002825122647145502,2019-03-29 17:00:00,2019-03-29 17:15:00
90,10,6,4,0.010989887701841249,2019-03-29 17:00:00,2019-03-29 17:15:00
99,1,1,0,0.002611427256586571,2019-03-29 17:00:00,2019-03-29 17:15:00
101,2,0,2,0.0020733024910080753,2019-03-29 17:00:00,2019-03-29 17:15:00
104,3,1,2,0.003835709490391267,2019-03-29 17:00:00,2019-03-29 17:15:00
106,1,0,1,0.0020733024910080753,2019-03-29 17:00:00,2019-03-29 17:15:00
109,16,11,5,0.029757756816229067,2019-03-29 17:00:00,2019-03-29 17:15:00
110,9,4,5,0.008208009569498924,2019-03-29 17:00:00,2019-03-29 17:15:00
111,5,1,4,0.003835709490391267,2019-03-29 17:00:00,2019-03-29 17:15:00
112,1,1,0,0.0026607714908024726,2019-03-29 17:00:00,2019-03-29 17:15:00
113,6,3,3,0.004435340634731454,2019-03-29 17:00:00,2019-03-29 17:15:00
114,1,0,1,0.0020733024910080753,2019-03-29 17:00:00,2019-03-29 17:15:00
115,2,0,2,0.0020733024910080753,2019-03-29 17:00:00,2019-03-29 17:15:00
116,2,1,1,0.0024979850386169337,2019-03-29 17:00:00,2019-03-29 17:15:00
118,5,2,3,0.005955607213675421,2019-03-29 17:00:00,2019-03-29 17:15:00
119,9,6,3,0.007841538465422926,2019-03-29 17:00:00,2019-03-29 17:15:00
120,3,3,0,0.0045162633859821225,2019-03-29 17:00:00,2019-03-29 17:15:00
122,1,1,0,0.004295365988102262,2019-03-29 17:00:00,2019-03-29 17:15:00
126,7,6,1,0.00846026646629255,2019-03-29 17:00:00,2019-03-29 17:15:00
127,2,2,0,0.004436835513491973,2019-03-29 17:00:00,2019-03-29 17:15:00
129,6,5,1,0.01007114284563921,2019-03-29 17:00:00,2019-03-29 17:15:00
133,1,0,1,0.0020733024910080753,2019-03-29 17:00:00,2019-03-29 17:15:00
135,2,0,2,0.0020733024910080753,2019-03-29 17:00:00,2019-03-29 17:15:00
137,25,13,12,0.02897356739462524,2019-03-29 17:00:00,2019-03-29 17:15:00
138,15,5,10,0.008843968022040601,2019-03-29 17:00:00,2019-03-29 17:15:00
140,1,1,0,0.0037608905252381085,2019-03-29 17:00:00,2019-03-29 17:15:00
141,4,1,3,0.00289305058551841,2019-03-29 17:00:00,2019-03-29 17:15:00
147,3,0,3,0.0020733024910080753,2019-03-29 17:00:00,2019-03-29 17:15:00
151,5,2,3,0.005352294869049414,2019-03-29 17:00:00,2019-03-29 17:15:00
153,11,4,7,0.01220595375014393,2019-03-29 17:00:00,2019-03-29 17:15:00
154,1,0,1,0.0020733024910080753,2019-03-29 17:00:00,2019-03-29 17:15:00
157,2,0,2,0.0020733024910080753,2019-03-29 17:00:00,2019-03-29 17:15:00
158,1,0,1,0.0020733024910080753,2019-03-29 17:00:00,2019-03-29 17:15:00
160,4,2,2,0.013784981325302204,2019-03-29 17:00:00,2019-03-29 17:15:00
162,5,4,1,0.014710867716876031,2019-03-29 17:00:00,2019-03-29 17:15:00
164,12,3,9,0.020623058399931858,2019-03-29 17:00:00,2019-03-29 17:15:00
168,6,5,1,0.018007535784484607,2019-03-29 17:00:00,2019-03-29 17:15:00
169,10,4,6,0.007566128346326743,2019-03-29 17:00:00,2019-03-29 17:15:00
170,4,2,2,0.007813440301890202,2019-03-29 17:00:00,2019-03-29 17:15:00
171,3,3,0,0.006460729160160561,2019-03-29 17:00:00,2019-03-29 17:15:00
172,1,1,0,0.004869149727244952,2019-03-29 17:00:00,2019-03-29 17:15:00
173,4,3,1,0.004114964177780641,2019-03-29 17:00:00,2019-03-29 17:15:00
175,4,3,1,0.004119794554138049,2019-03-29 17:00:00,2019-03-29 17:15:00
177,2,1,1,0.0032889844184941374,2019-03-29 17:00:00,2019-03-29 17:15:00
189,5,5,0,0.009881916274424944,2019-03-29 17:00:00,2019-03-29 17:15:00
190,7,3,4,0.005720348273466262,2019-03-29 17:00:00,2019-03-29 17:15:00
191,8,2,6,0.00289305058551841,2019-03-29 17:00:00,2019-03-29 17:15:00
195,1,1,0,0.002825122647145502,2019-03-29 17:00:00,2019-03-29 17:15:00
196,13,5,8,0.005064366314864313,2019-03-29 17:00:00,2019-03-29 17:15:00
197,5,4,1,0.0072989518823148155,2019-03-29 17:00:00,2019-03-29 17:15:00
199,4,4,0,0.004775924592314776,2019-03-29 17:00:00,2019-03-29 17:15:00
201,3,2,1,0.0049077342621578,2019-03-29 17:00:00,2019-03-29 17:15:00
202,1,0,1,0.0020733024910080753,2019-03-29 17:00:00,2019-03-29 17:15:00
203,5,2,3,0.0049420561997562925,2019-03-29 17:00:00,2019-03-29 17:15:00
1,6,3,3,0.006535537591414402,2019-03-29 17:15:00,2019-03-29 17:30:00
2,6,3,3,0.005803825683258134,2019-03-29 17:15:00,2019-03-29 17:30:00
5,6,4,2,0.006266526691862109,2019-03-29 17:15:00,2019-03-29 17:30:00
10,7,3,4,0.007390501272548781,2019-03-29 17:15:00,2019-03-29 17:30:00
11,4,0,4,0.0020457485010107112,2019-03-29 17:15:00,2019-03-29 17:30:00
15,10,4,6,0.005698837661829972,2019-03-29 17:15:00,2019-03-29 17:30:00
16,10,6,4,0.007799892298992857,2019-03-29 17:15:00,2019-03-29 17:30:00
18,12,6,6,0.015550152985270014,2019-03-29 17:15:00,2019-03-29 17:30:00
19,13,5,8,0.008495398110088984,2019-03-29 17:15:00,2019-03-29 17:30:00
20,2,2,0,0.004411180759855732,2019-03-29 17:15:00,2019-03-29 17:30:00
21,2,2,0,0.004612847499851731,2019-03-29 17:15:00,2019-03-29 17:30:00
23,11,4,7,0.008140865572003796,2019-03-29 17:15:00,2019-03-29 17:30:00
26,2,0,2,0.0020457485010107112,2019-03-29 17:15:00,2019-03-29 17:30:00
27,4,3,1,0.030334920824469924,2019-03-29 17:15:00,2019-03-29 17:30:00
28,5,4,1,0.048357644737750165,2019-03-29 17:15:00,2019-03-29 17:30:00
30,1,1,0,0.003417118314324911,2019-03-29 17:15:00,2019-03-29 17:30:00
35,5,2,3,0.007462193346291289,2019-03-29 17:15:00,2019-03-29 17:30:00
37,1,1,0,0.003690401071874251,2019-03-29 17:15:00,2019-03-29 17:30:00
41,14,6,8,0.009354287739974777,2019-03-29 17:15:00,2019-03-29 17:30:00
46,12,3,9,0.005745243625901645,2019-03-29 17:15:00,2019-03-29 17:30:00
50,4,1,3,0.0038140824514580306,2019-03-29 17:15:00,2019-03-29 17:30:00
57,6,3,3,0.005772885844078894,2019-03-29 17:15:00,2019-03-29 17:30:00
58,5,2,3,0.005929232499781955,2019-03-29 17:15:00,2019-03-29 17:30:00
61,4,3,1,0.042299491583136326,2019-03-29 17:15:00,2019-03-29 17:30:00
62,6,3,3,0.01362171148178392,2019-03-29 17:15:00,2019-03-29 17:30:00
64,6,3,3,0.008800873362410398,2019-03-29 17:15:00,2019-03-29 17:30:00
67,11,4,7,0.012996280118557756,2019-03-29 17:15:00,2019-03-29 17:30:00
68,6,3,3,0.006702943680915412,2019-03-29 17:15:00,2019-03-29 17:30:00
69,6,3,3,0.004892642646244806,2019-03-29 17:15:00,2019-03-29 17:30:00
70,5,3,2,0.005523738697214251,2019-03-29 17:15:00,2019-03-29 17:30:00
71,6,3,3,0.009872472666839223,2019-03-29 17:15:00,2019-03-29 17:30:00
74,7,3,4,0.007915710455028344,2019-03-29 17:15:00,2019-03-29 17:30:00
79,1,0,1,0.0020457485010107112,2019-03-29 17:15:00,2019-03-29 17:30:00
80,1,1,0,0.0024804972755361537,2019-03-29 17:15:00,2019-03-29 17:30:00
86,2,1,1,0.004066467069419126,2019-03-29 17:15:00,2019-03-29 17:30:00
87,8,6,2,0.011403643403504395,2019-03-29 17:15:00,2019-03-29 17:30:00
88,2,0,2,0.0020457485010107112,2019-03-29 17:15:00,2019-03-29 17:30:00
90,3,1,2,0.0035580214901249478,2019-03-29 17:15:00,2019-03-29 17:30:00
99,1,1,0,0.0026607951245584925,2019-03-29 17:15:00,2019-03-29 17:30:00
101,2,0,2,0.0020457485010107112,2019-03-29 17:15:00,2019-03-29 17:30:00
104,2,1,1,0.0026254135337113013,2019-03-29 17:15:00,2019-03-29 17:30:00
106,2,0,2,0.0020457485010107112,2019-03-29 17:15:00,2019-03-29 17:30:00
108,1,1,0,0.003624149201760126,2019-03-29 17:15:00,2019-03-29 17:30:00
109,19,10,9,0.01870601324731537,2019-03-29 17:15:00,2019-03-29 17:30:00
110,8,4,4,0.009041376540166183,2019-03-29 17:15:00,2019-03-29 17:30:00
111,9,5,4,0.011440534518664567,2019-03-29 17:15:00,2019-03-29 17:30:00
112,7,5,2,0.01101977685593224,2019-03-29 17:15:00,2019-03-29 17:30:00
113,12,4,8,0.01716289254504343,2019-03-29 17:15:00,2019-03-29 17:30:00
114,3,2,1,0.005479832320989075,2019-03-29 17:15:00,2019-03-29 17:30:00
115,2,2,0,0.005579743534658727,2019-03-29 17:15:00,2019-03-29 17:30:00
116,4,2,2,0.005437882051732899,2019-03-29 17:15:00,2019-03-29 17:30:00
118,3,1,2,0.004843236456851781,2019-03-29 17:15:00,2019-03-29 17:30:00
119,7,5,2,0.009516268212342796,2019-03-29 17:15:00,2019-03-29 17:30:00
120,3,3,0,0.004773441897204086,2019-03-29 17:15:00,2019-03-29 17:30:00
122,2,1,1,0.0026940035702137915,2019-03-29 17:15:00,2019-03-29 17:30:00
126,5,3,2,0.004754036908247175,2019-03-29 17:15:00,2019-03-29 17:30:00
127,1,1,0,0.003039810946541532,2019-03-29 17:15:00,2019-03-29 17:30:00
129,4,4,0,0.014642020767985455,2019-03-29 17:15:00,2019-03-29 17:30:00
133,1,0,1,0.0020457485010107112,2019-03-29 17:15:00,2019-03-29 17:30:00
135,1,0,1,0.0020457485010107112,2019-03-29 17:15:00,2019-03-29 17:30:00
137,16,7,9,0.01303021168812125,2019-03-29 17:15:00,2019-03-29 17:30:00
138,16,7,9,0.014518535329852731,2019-03-29 17:15:00,2019-03-29 17:30:00
141,4,2,2,0.00730953477062784,2019-03-29 17:15:00,2019-03-29 17:30:00
147,2,0,2,0.0020457485010107112,2019-03-29 17:15:00,2019-03-29 17:30:00
151,5,3,2,0.005353106929904676,2019-03-29 17:15:00,2019-03-29 17:30:00
153,4,2,2,0.0059518769559259435,2019-03-29 17:15:00,2019-03-29 17:30:00
154,3,0,3,0.0020457485010107112,2019-03-29 17:15:00,2019-03-29 17:30:00
157,1,0,1,0.0020457485010107112,2019-03-29 17:15:00,2019-03-29 17:30:00
158,2,1,1,0.0038127460178347195,2019-03-29 17:15:00,2019-03-29 17:30:00
159,2,1,1,0.01362171148178392,2019-03-29 17:15:00,2019-03-29 17:30:00
160,4,2,2,0.01362171148178392,2019-03-29 17:15:00,2019-03-29 17:30:00
162,3,2,1,0.0366081436300187,2019-03-29 17:15:00,2019-03-29 17:30:00
164,11,5,6,0.009724455416016603,2019-03-29 17:15:00,2019-03-29 17:30:00
168,9,9,0,0.01109463160470895,2019-03-29 17:15:00,2019-03-29 17:30:00
169,9,3,6,0.0054960324479500205,2019-03-29 17:15:00,2019-03-29 17:30:00
170,6,1,5,0.0038127460178347195,2019-03-29 17:15:00,2019-03-29 17:30:00
171,7,4,3,0.00956354454892713,2019-03-29 17:15:00,2019-03-29 17:30:00
172,2,1,1,0.004321035035661502,2019-03-29 17:15:00,2019-03-29 17:30:00
173,5,4,1,0.01134605425966817,2019-03-29 17:15:00,2019-03-29 17:30:00
175,5,3,2,0.009153669228606828,2019-03-29 17:15:00,2019-03-29 17:30:00
189,7,3,4,0.005344077698002125,2019-03-29 17:15:00,2019-03-29 17:30:00
190,13,6,7,0.014560632430278858,2019-03-29 17:15:00,2019-03-29 17:30:00
191,8,5,3,0.026821913274572527,2019-03-29 17:15:00,2019-03-29 17:30:00
195,1,1,0,0.003417118314324911,2019-03-29 17:15:00,2019-03-29 17:30:00
196,8,2,6,0.004340988127775225,2019-03-29 17:15:00,2019-03-29 17:30:00
197,10,5,5,0.011088851637575711,2019-03-29 17:15:00,2019-03-29 17:30:00
199,3,3,0,0.00482236005673208,2019-03-29 17:15:00,2019-03-29 17:30:00
201,4,4,0,0.007317715141594992,2019-03-29 17:15:00,2019-03-29 17:30:00
203,9,4,5,0.008377238098039013,2019-03-29 17:15:00,2019-03-29 17:30:00
1,16,9,7,0.03150785237125845,2019-03-29 17:30:00,2019-03-29 17:45:00
2,8,5,3,0.01304119405590036,2019-03-29 17:30:00,2019-03-29 17:45:00
5,8,6,2,0.012813165542801966,2019-03-29 17:30:00,2019-03-29 17:45:00
10,7,4,3,0.009219970621071466,2019-03-29 17:30:00,2019-03-29 17:45:00
11,3,0,3,0.001910707740361492,2019-03-29 17:30:00,2019-03-29 17:45:00
15,9,4,5,0.010556681074148595,2019-03-29 17:30:00,2019-03-29 17:45:00
16,10,6,4,0.009825350782180931,2019-03-29 17:30:00,2019-03-29 17:45:00
18,12,6,6,0.011946728253904125,2019-03-29 17:30:00,2019-03-29 17:45:00
19,12,7,5,0.01026180513408766,2019-03-29 17:30:00,2019-03-29 17:45:00
20,4,2,2,0.006602978576759653,2019-03-29 17:30:00,2019-03-29 17:45:00
21,2,1,1,0.004389501245920548,2019-03-29 17:30:00,2019-03-29 17:45:00
23,8,4,4,0.011663333970490835,2019-03-29 17:30:00,2019-03-29 17:45:00
26,3,2,1,0.004958469166200444,2019-03-29 17:30:00,2019-03-29 17:45:00
27,4,2,2,0.004825502164461886,2019-03-29 17:30:00,2019-03-29 17:45:00
28,4,1,3,0.005377528559884402,2019-03-29 17:30:00,2019-03-29 17:45:00
35,6,2,4,0.0071935001213960514,2019-03-29 17:30:00,2019-03-29 17:45:00
37,1,1,0,0.005606255188626522,2019-03-29 17:30:00,2019-03-29 17:45:00
41,14,7,7,0.010090786505718059,2019-03-29 17:30:00,2019-03-29 17:45:00
46,15,4,11,0.004955342250300726,2019-03-29 17:30:00,2019-03-29 17:45:00
50,6,1,5,0.002452099561512356,2019-03-29 17:30:00,2019-03-29 17:45:00
57,9,4,5,0.007461126331589721,2019-03-29 17:30:00,2019-03-29 17:45:00
58,6,3,3,0.00894476206226854,2019-03-29 17:30:00,2019-03-29 17:45:00
61,3,2,1,0.00513215069803273,2019-03-29 17:30:00,2019-03-29 17:45:00
62,4,1,3,0.0026661561585153127,2019-03-29 17:30:00,2019-03-29 17:45:00
64,6,3,3,0.005955485989825926,2019-03-29 17:30:00,2019-03-29 17:45:00
66,1,1,0,0.0022936655823622793,2019-03-29 17:30:00,2019-03-29 17:45:00
67,19,7,12,0.008030655452232383,2019-03-29 17:30:00,2019-03-29 17:45:00
68,3,2,1,0.005031515814926847,2019-03-29 17:30:00,2019-03-29 17:45:00
69,9,4,5,0.009008089605801607,2019-03-29 17:30:00,2019-03-29 17:45:00
70,4,2,2,0.006501842205264608,2019-03-29 17:30:00,2019-03-29 17:45:00
71,5,2,3,0.004409691404209314,2019-03-29 17:30:00,2019-03-29 17:45:00
74,4,2,2,0.006955072731473217,2019-03-29 17:30:00,2019-03-29 17:45:00
80,1,1,0,0.00942981655442576,2019-03-29 17:30:00,2019-03-29 17:45:00
86,5,2,3,0.0030485036953804626,2019-03-29 17:30:00,2019-03-29 17:45:00
87,6,5,1,0.012448095371234405,2019-03-29 17:30:00,2019-03-29 17:45:00
88,2,0,2,0.001910707740361492,2019-03-29 17:30:00,2019-03-29 17:45:00
90,5,0,5,0.001910707740361492,2019-03-29 17:30:00,2019-03-29 17:45:00
99,2,2,0,0.0028434717604823396,2019-03-29 17:30:00,2019-03-29 17:45:00
101,4,2,2,0.00363832511051665,2019-03-29 17:30:00,2019-03-29 17:45:00
104,1,1,0,0.005239354312291575,2019-03-29 17:30:00,2019-03-29 17:45:00
106,1,0,1,0.001910707740361492,2019-03-29 17:30:00,2019-03-29 17:45:00
108,1,1,0,0.0024796057178709772,2019-03-29 17:30:00,2019-03-29 17:45:00
109,9,3,6,0.004726924474646434,2019-03-29 17:30:00,2019-03-29 17:45:00
110,6,3,3,0.012714876386205016,2019-03-29 17:30:00,2019-03-29 17:45:00
111,10,7,3,0.010611723614359905,2019-03-29 17:30:00,2019-03-29 17:45:00
112,7,3,4,0.007471746975902836,2019-03-29 17:30:00,2019-03-29 17:45:00
113,7,2,5,0.006312608466419168,2019-03-29 17:30:00,2019-03-29 17:45:00
114,1,1,0,0.003499967943084722,2019-03-29 17:30:00,2019-03-29 17:45:00
115,9,6,3,0.0444883666925675,2019-03-29 17:30:00,2019-03-29 17:45:00
116,6,2,4,0.002955703203933113,2019-03-29 17:30:00,2019-03-29 17:45:00
118,3,2,1,0.00468900700193191,2019-03-29 17:30:00,2019-03-29 17:45:00
119,7,4,3,0.011273797597790364,2019-03-29 17:30:00,2019-03-29 17:45:00
120,2,2,0,0.005003494479348756,2019-03-29 17:30:00,2019-03-29 17:45:00
122,2,1,1,0.0033042275513185996,2019-03-29 17:30:00,2019-03-29 17:45:00
126,6,1,5,0.002302079939331476,2019-03-29 17:30:00,2019-03-29 17:45:00
127,3,2,1,0.004868348696164477,2019-03-29 17:30:00,2019-03-29 17:45:00
129,7,6,1,0.03188182662744683,2019-03-29 17:30:00,2019-03-29 17:45:00
133,1,0,1,0.001910707740361492,2019-03-29 17:30:00,2019-03-29 17:45:00
137,11,4,7,0.013086604704083002,2019-03-29 17:30:00,2019-03-29 17:45:00
138,21,10,11,0.04485620570459684,2019-03-29 17:30:00,2019-03-29 17:45:00
140,5,1,4,0.003499967943084722,2019-03-29 17:30:00,2019-03-29 17:45:00
141,6,5,1,0.007191850195951805,2019-03-29 17:30:00,2019-03-29 17:45:00
147,2,0,2,0.001910707740361492,2019-03-29 17:30:00,2019-03-29 17:45:00
151,5,3,2,0.008933082740268291,2019-03-29 17:30:00,2019-03-29 17:45:00
153,2,1,1,0.0025388264314162435,2019-03-29 17:30:00,2019-03-29 17:45:00
154,2,0,2,0.001910707740361492,2019-03-29 17:30:00,2019-03-29 17:45:00
157,2,1,1,0.004445417265880314,2019-03-29 17:30:00,2019-03-29 17:45:00
158,3,2,1,0.008844349379407312,2019-03-29 17:30:00,2019-03-29 17:45:00
159,2,1,1,0.012714876386205016,2019-03-29 17:30:00,2019-03-29 17:45:00
160,1,0,1,0.001910707740361492,2019-03-29 17:30:00,2019-03-29 17:45:00
162,2,1,1,0.012714876386205016,2019-03-29 17:30:00,2019-03-29 17:45:00
164,5,2,3,0.006113055653829037,2019-03-29 17:30:00,2019-03-29 17:45:00
168,8,8,0,0.008394522504179934,2019-03-29 17:30:00,2019-03-29 17:45:00
169,7,5,2,0.010161052465149013,2019-03-29 17:30:00,2019-03-29 17:45:00
170,4,1,3,0.004917751062628211,2019-03-29 17:30:00,2019-03-29 17:45:00
171,5,1,4,0.002426327131230903,2019-03-29 17:30:00,2019-03-29 17:45:00
172,2,1,1,0.0057077103617051055,2019-03-29 17:30:00,2019-03-29 17:45:00
173,5,3,2,0.007831273499602824,2019-03-29 17:30:00,2019-03-29 17:45:00
175,3,2,1,0.00548636055974407,2019-03-29 17:30:00,2019-03-29 17:45:00
177,5,2,3,0.003720297629359655,2019-03-29 17:30:00,2019-03-29 17:45:00
189,3,0,3,0.001910707740361492,2019-03-29 17:30:00,2019-03-29 17:45:00
190,7,4,3,0.04489271861669209,2019-03-29 17:30:00,2019-03-29 17:45:00
191,13,9,4,0.033249459395186975,2019-03-29 17:30:00,2019-03-29 17:45:00
196,3,0,3,0.001910707740361492,2019-03-29 17:30:00,2019-03-29 17:45:00
197,6,3,3,0.010678550229909869,2019-03-29 17:30:00,2019-03-29 17:45:00
199,2,2,0,0.0027444612853952306,2019-03-29 17:30:00,2019-03-29 17:45:00
201,4,4,0,0.015153117197790097,2019-03-29 17:30:00,2019-03-29 17:45:00
202,8,3,5,0.0038996411768319242,2019-03-29 17:30:00,2019-03-29 17:45:00
203,15,9,6,0.03013833745233785,2019-03-29 17:30:00,2019-03-29 17:45:00
1,12,7,5,0.020090911320733748,2019-03-29 17:45:00,2019-03-29 18:00:00
2,6,3,3,0.00894705048346432,2019-03-29 17:45:00,2019-03-29 18:00:00
5,7,6,1,0.012228119087637164,2019-03-29 17:45:00,2019-03-29 18:00:00
10,5,3,2,0.02664678607236586,2019-03-29 17:45:00,2019-03-29 18:00:00
11,3,0,3,0.0020954189171202044,2019-03-29 17:45:00,2019-03-29 18:00:00
15,8,3,5,0.014256629306027052,2019-03-29 17:45:00,2019-03-29 18:00:00
16,3,1,2,0.0036182383267533975,2019-03-29 17:45:00,2019-03-29 18:00:00
18,12,8,4,0.014526320151811167,2019-03-29 17:45:00,2019-03-29 18:00:00
19,6,3,3,0.005374039476710748,2019-03-29 17:45:00,2019-03-29 18:00:00
20,2,0,2,0.0020954189171202044,2019-03-29 17:45:00,2019-03-29 18:00:00
21,1,0,1,0.0020954189171202044,2019-03-29 17:45:00,2019-03-29 18:00:00
23,11,6,5,0.021808084732794684,2019-03-29 17:45:00,2019-03-29 18:00:00
26,1,1,0,0.002986022704713356,2019-03-29 17:45:00,2019-03-29 18:00:00
27,5,2,3,0.004527655623490537,2019-03-29 17:45:00,2019-03-29 18:00:00
28,2,0,2,0.0020954189171202044,2019-03-29 17:45:00,2019-03-29 18:00:00
35,3,0,3,0.0020954189171202044,2019-03-29 17:45:00,2019-03-29 18:00:00
37,2,2,0,0.00696519058188381,2019-03-29 17:45:00,2019-03-29 18:00:00
41,12,7,5,0.019794966909500052,2019-03-29 17:45:00,2019-03-29 18:00:00
46,9,3,6,0.004794286677901932,2019-03-29 17:45:00,2019-03-29 18:00:00
50,5,0,5,0.0020954189171202044,2019-03-29 17:45:00,2019-03-29 18:00:00
57,4,0,4,0.0020954189171202044,2019-03-29 17:45:00,2019-03-29 18:00:00
58,6,4,2,0.007437552844664382,2019-03-29 17:45:00,2019-03-29 18:00:00
61,4,3,1,0.0070593430004652616,2019-03-29 17:45:00,2019-03-29 18:00:00
62,7,2,5,0.0066403680059810375,2019-03-29 17:45:00,2019-03-29 18:00:00
64,5,3,2,0.02938180437903199,2019-03-29 17:45:00,2019-03-29 18:00:00
66,1,0,1,0.0020954189171202044,2019-03-29 17:45:00,2019-03-29 18:00:00
67,18,7,11,0.012684980990732755,2019-03-29 17:45:00,2019-03-29 18:00:00
68,4,2,2,0.006839680597929887,2019-03-29 17:45:00,2019-03-29 18:00:00
69,9,6,3,0.01762649846169865,2019-03-29 17:45:00,2019-03-29 18:00:00
70,3,2,1,0.005538174226152852,2019-03-29 17:45:00,2019-03-29 18:00:00
71,5,2,3,0.0048360715436578505,2019-03-29 17:45:00,2019-03-29 18:00:00
74,1,1,0,0.00363331026692437,2019-03-29 17:45:00,2019-03-29 18:00:00
80,3,2,1,0.0386504443532296,2019-03-29 17:45:00,2019-03-29 18:00:00
86,5,2,3,0.004056009884917673,2019-03-29 17:45:00,2019-03-29 18:00:00
87,7,5,2,0.015419733000069677,2019-03-29 17:45:00,2019-03-29 18:00:00
88,6,3,3,0.014038097805582864,2019-03-29 17:45:00,2019-03-29 18:00:00
89,4,2,2,0.007780405561397544,2019-03-29 17:45:00,2019-03-29 18:00:00
90,5,0,5,0.0020954189171202044,2019-03-29 17:45:00,2019-03-29 18:00:00
99,1,1,0,0.004015535371342435,2019-03-29 17:45:00,2019-03-29 18:00:00
101,4,2,2,0.004394018121899997,2019-03-29 17:45:00,2019-03-29 18:00:00
104,1,1,0,0.004986491572903791,2019-03-29 17:45:00,2019-03-29 18:00:00
109,9,4,5,0.007591621908377769,2019-03-29 17:45:00,2019-03-29 18:00:00
110,6,2,4,0.010984373938679223,2019-03-29 17:45:00,2019-03-29 18:00:00
111,10,10,0,0.019280441533376692,2019-03-29 17:45:00,2019-03-29 18:00:00
112,6,2,4,0.004056009884917673,2019-03-29 17:45:00,2019-03-29 18:00:00
113,2,0,2,0.0020954189171202044,2019-03-29 17:45:00,2019-03-29 18:00:00
114,2,2,0,0.006051895750162018,2019-03-29 17:45:00,2019-03-29 18:00:00
115,6,2,4,0.0041183194626498365,2019-03-29 17:45:00,2019-03-29 18:00:00
116,2,1,1,0.0024516604321574652,2019-03-29 17:45:00,2019-03-29 18:00:00
118,4,1,3,0.0034657452303890274,2019-03-29 17:45:00,2019-03-29 18:00:00
119,4,2,2,0.01720275960190621,2019-03-29 17:45:00,2019-03-29 18:00:00
120,2,2,0,0.00583063371310245,2019-03-29 17:45:00,2019-03-29 18:00:00
122,4,2,2,0.004751878064744492,2019-03-29 17:45:00,2019-03-29 18:00:00
126,6,3,3,0.00677585316346462,2019-03-29 17:45:00,2019-03-29 18:00:00
127,7,3,4,0.006995778999722112,2019-03-29 17:45:00,2019-03-29 18:00:00
129,8,5,3,0.026654650108815472,2019-03-29 17:45:00,2019-03-29 18:00:00
133,1,0,1,0.0020954189171202044,2019-03-29 17:45:00,2019-03-29 18:00:00
137,10,6,4,0.014292113978445351,2019-03-29 17:45:00,2019-03-29 18:00:00
138,10,2,8,0.010799357016057394,2019-03-29 17:45:00,2019-03-29 18:00:00
140,1,0,1,0.0020954189171202044,2019-03-29 17:45:00,2019-03-29 18:00:00
141,5,2,3,0.0041267196913462745,2019-03-29 17:45:00,2019-03-29 18:00:00
147,1,0,1,0.0020954189171202044,2019-03-29 17:45:00,2019-03-29 18:00:00
151,6,4,2,0.011072264448103641,2019-03-29 17:45:00,2019-03-29 18:00:00
153,12,5,7,0.014053298211654151,2019-03-29 17:45:00,2019-03-29 18:00:00
154,2,1,1,0.002774670969804361,2019-03-29 17:45:00,2019-03-29 18:00:00
157,6,3,3,0.005863816278609469,2019-03-29 17:45:00,2019-03-29 18:00:00
158,3,2,1,0.004390716863303501,2019-03-29 17:45:00,2019-03-29 18:00:00
159,2,1,1,0.013937990654380674,2019-03-29 17:45:00,2019-03-29 18:00:00
160,1,0,1,0.0020954189171202044,2019-03-29 17:45:00,2019-03-29 18:00:00
162,2,1,1,0.013937990654380674,2019-03-29 17:45:00,2019-03-29 18:00:00
164,1,1,0,0.0033861977568325295,2019-03-29 17:45:00,2019-03-29 18:00:00
168,12,8,4,0.020314971848763214,2019-03-29 17:45:00,2019-03-29 18:00:00
169,8,4,4,0.012701731240909757,2019-03-29 17:45:00,2019-03-29 18:00:00
170,1,0,1,0.0020954189171202044,2019-03-29 17:45:00,2019-03-29 18:00:00
171,5,2,3,0.004059481088784462,2019-03-29 17:45:00,2019-03-29 18:00:00
172,1,1,0,0.006801709439914385,2019-03-29 17:45:00,2019-03-29 18:00:00
173,3,1,2,0.006801709439914385,2019-03-29 17:45:00,2019-03-29 18:00:00
177,3,1,2,0.0032244308376246237,2019-03-29 17:45:00,2019-03-29 18:00:00
189,1,1,0,0.00363331026692437,2019-03-29 17:45:00,2019-03-29 18:00:00
190,4,2,2,0.013937990654380674,2019-03-29 17:45:00,2019-03-29 18:00:00
191,9,5,4,0.012955231984483463,2019-03-29 17:45:00,2019-03-29 18:00:00
196,4,1,3,0.0032430678902118527,2019-03-29 17:45:00,2019-03-29 18:00:00
199,2,2,0,0.0028079019471947257,2019-03-29 17:45:00,2019-03-29 18:00:00
201,4,4,0,0.00913767683049484,2019-03-29 17:45:00,2019-03-29 18:00:00
202,2,0,2,0.0020954189171202044,2019-03-29 17:45:00,2019-03-29 18:00:00
203,14,10,4,0.031069652959418333,2019-03-29 17:45:00,2019-03-29 18:00:00
1,8,3,5,0.009364371778567823,2019-03-29 18:00:00,2019-03-29 18:15:00
2,5,3,2,0.03032881899800314,2019-03-29 18:00:00,2019-03-29 18:15:00
5,3,2,1,0.0031993133646017473,2019-03-29 18:00:00,2019-03-29 18:15:00
10,6,2,4,0.003348791022115094,2019-03-29 18:00:00,2019-03-29 18:15:00
11,4,1,3,0.003348791022115094,2019-03-29 18:00:00,2019-03-29 18:15:00
15,4,1,3,0.0035622146205611877,2019-03-29 18:00:00,2019-03-29 18:15:00
16,11,5,6,0.011154117349616723,2019-03-29 18:00:00,2019-03-29 18:15:00
18,12,6,6,0.01477547707831794,2019-03-29 18:00:00,2019-03-29 18:15:00
20,1,0,1,0.001925485970810411,2019-03-29 18:00:00,2019-03-29 18:15:00
23,11,6,5,0.01342323349057809,2019-03-29 18:00:00,2019-03-29 18:15:00
27,4,1,3,0.002686771474349304,2019-03-29 18:00:00,2019-03-29 18:15:00
35,1,0,1,0.001925485970810411,2019-03-29 18:00:00,2019-03-29 18:15:00
37,1,1,0,0.004560920144803594,2019-03-29 18:00:00,2019-03-29 18:15:00
41,6,4,2,0.008314526612094393,2019-03-29 18:00:00,2019-03-29 18:15:00
46,4,2,2,0.005616898235748235,2019-03-29 18:00:00,2019-03-29 18:15:00
50,4,0,4,0.001925485970810411,2019-03-29 18:00:00,2019-03-29 18:15:00
57,8,4,4,0.010760336214732692,2019-03-29 18:00:00,2019-03-29 18:15:00
58,8,5,3,0.01268600941560569,2019-03-29 18:00:00,2019-03-29 18:15:00
61,3,2,1,0.004323500124100081,2019-03-29 18:00:00,2019-03-29 18:15:00
62,5,2,3,0.0046023759014223705,2019-03-29 18:00:00,2019-03-29 18:15:00
64,5,3,2,0.03032881899800314,2019-03-29 18:00:00,2019-03-29 18:15:00
66,1,0,1,0.001925485970810411,2019-03-29 18:00:00,2019-03-29 18:15:00
67,16,7,9,0.01439120218656738,2019-03-29 18:00:00,2019-03-29 18:15:00
68,5,3,2,0.00863140379695036,2019-03-29 18:00:00,2019-03-29 18:15:00
69,6,3,3,0.010346540299519914,2019-03-29 18:00:00,2019-03-29 18:15:00
70,4,3,1,0.005070178641921729,2019-03-29 18:00:00,2019-03-29 18:15:00
71,4,2,2,0.012827310817400458,2019-03-29 18:00:00,2019-03-29 18:15:00
79,2,1,1,0.004097186735007309,2019-03-29 18:00:00,2019-03-29 18:15:00
80,3,2,1,0.02950541133054251,2019-03-29 18:00:00,2019-03-29 18:15:00
86,1,1,0,0.0024380278610628544,2019-03-29 18:00:00,2019-03-29 18:15:00
87,9,4,5,0.0074917270803896985,2019-03-29 18:00:00,2019-03-29 18:15:00
88,7,2,5,0.00636893710360867,2019-03-29 18:00:00,2019-03-29 18:15:00
89,3,3,0,0.010199967027518301,2019-03-29 18:00:00,2019-03-29 18:15:00
90,8,4,4,0.008636923835415138,2019-03-29 18:00:00,2019-03-29 18:15:00
99,1,1,0,0.0030103354047822553,2019-03-29 18:00:00,2019-03-29 18:15:00
104,2,1,1,0.004018919399342062,2019-03-29 18:00:00,2019-03-29 18:15:00
109,7,4,3,0.011968492560670136,2019-03-29 18:00:00,2019-03-29 18:15:00
110,11,5,6,0.0185997911052459,2019-03-29 18:00:00,2019-03-29 18:15:00
111,15,10,5,0.02699642150313504,2019-03-29 18:00:00,2019-03-29 18:15:00
112,3,2,1,0.004644082791776293,2019-03-29 18:00:00,2019-03-29 18:15:00
113,1,1,0,0.0043932601525270695,2019-03-29 18:00:00,2019-03-29 18:15:00
114,3,1,2,0.003348791022115094,2019-03-29 18:00:00,2019-03-29 18:15:00
115,5,1,4,0.0024380278610628544,2019-03-29 18:00:00,2019-03-29 18:15:00
116,1,1,0,0.002334668133248105,2019-03-29 18:00:00,2019-03-29 18:15:00
119,8,4,4,0.02941944053067399,2019-03-29 18:00:00,2019-03-29 18:15:00
120,1,0,1,0.001925485970810411,2019-03-29 18:00:00,2019-03-29 18:15:00
122,6,4,2,0.00901588877052051,2019-03-29 18:00:00,2019-03-29 18:15:00
126,6,3,3,0.003828699729657644,2019-03-29 18:00:00,2019-03-29 18:15:00
127,4,0,4,0.001925485970810411,2019-03-29 18:00:00,2019-03-29 18:15:00
129,7,5,2,0.02312430577703308,2019-03-29 18:00:00,2019-03-29 18:15:00
133,1,0,1,0.001925485970810411,2019-03-29 18:00:00,2019-03-29 18:15:00
135,1,0,1,0.001925485970810411,2019-03-29 18:00:00,2019-03-29 18:15:00
137,21,11,10,0.02902749399537542,2019-03-29 18:00:00,2019-03-29 18:15:00
138,14,3,11,0.006631483352375482,2019-03-29 18:00:00,2019-03-29 18:15:00
140,1,1,0,0.0029348248661619095,2019-03-29 18:00:00,2019-03-29 18:15:00
141,4,3,1,0.009315160506087428,2019-03-29 18:00:00,2019-03-29 18:15:00
147,1,0,1,0.001925485970810411,2019-03-29 18:00:00,2019-03-29 18:15:00
151,2,2,0,0.006712381888487223,2019-03-29 18:00:00,2019-03-29 18:15:00
153,10,4,6,0.018356720838631012,2019-03-29 18:00:00,2019-03-29 18:15:00
154,1,1,0,0.00431281799471984,2019-03-29 18:00:00,2019-03-29 18:15:00
157,5,3,2,0.01627480148736697,2019-03-29 18:00:00,2019-03-29 18:15:00
158,3,2,1,0.002950569751315298,2019-03-29 18:00:00,2019-03-29 18:15:00
159,5,3,2,0.023729135663990514,2019-03-29 18:00:00,2019-03-29 18:15:00
160,4,2,2,0.005109566964090642,2019-03-29 18:00:00,2019-03-29 18:15:00
162,4,2,2,0.012827310817400458,2019-03-29 18:00:00,2019-03-29 18:15:00
164,5,3,2,0.010313887394245552,2019-03-29 18:00:00,2019-03-29 18:15:00
168,16,10,6,0.01568079405407678,2019-03-29 18:00:00,2019-03-29 18:15:00
169,12,4,8,0.008697202880943604,2019-03-29 18:00:00,2019-03-29 18:15:00
170,1,0,1,0.001925485970810411,2019-03-29 18:00:00,2019-03-29 18:15:00
172,1,0,1,0.001925485970810411,2019-03-29 18:00:00,2019-03-29 18:15:00
173,6,4,2,0.004679697237242926,2019-03-29 18:00:00,2019-03-29 18:15:00
177,3,1,2,0.0032295662118388053,2019-03-29 18:00:00,2019-03-29 18:15:00
189,1,1,0,0.0035058930620917405,2019-03-29 18:00:00,2019-03-29 18:15:00
190,5,3,2,0.05042751055668034,2019-03-29 18:00:00,2019-03-29 18:15:00
191,8,5,3,0.020044190779139468,2019-03-29 18:00:00,2019-03-29 18:15:00
195,1,1,0,0.003914500279367645,2019-03-29 18:00:00,2019-03-29 18:15:00
196,7,3,4,0.0037468812470234972,2019-03-29 18:00:00,2019-03-29 18:15:00
197,3,1,2,0.003348791022115094,2019-03-29 18:00:00,2019-03-29 18:15:00
199,2,2,0,0.0027438502956857996,2019-03-29 18:00:00,2019-03-29 18:15:00
201,5,3,2,0.008564006925586561,2019-03-29 18:00:00,2019-03-29 18:15:00
202,2,0,2,0.001925485970810411,2019-03-29 18:00:00,2019-03-29 18:15:00
203,9,5,4,0.019449126565524933,2019-03-29 18:00:00,2019-03-29 18:15:00
1,7,3,4,0.011281113356967054,2019-03-29 18:15:00,2019-03-29 18:30:00
2,11,7,4,0.022714595745426513,2019-03-29 18:15:00,2019-03-29 18:30:00
5,3,2,1,0.02134659403859166,2019-03-29 18:15:00,2019-03-29 18:30:00
10,6,2,4,0.0036953342494064094,2019-03-29 18:15:00,2019-03-29 18:30:00
11,2,2,0,0.003804856833452328,2019-03-29 18:15:00,2019-03-29 18:30:00
15,10,4,6,0.0042341004666966876,2019-03-29 18:15:00,2019-03-29 18:30:00
16,15,8,7,0.008405140102119672,2019-03-29 18:15:00,2019-03-29 18:30:00
18,14,4,10,0.011512142026555186,2019-03-29 18:15:00,2019-03-29 18:30:00
19,6,3,3,0.014854584210649297,2019-03-29 18:15:00,2019-03-29 18:30:00
20,7,7,0,0.014216606863417733,2019-03-29 18:15:00,2019-03-29 18:30:00
21,1,0,1,0.00212470383958944,2019-03-29 18:15:00,2019-03-29 18:30:00
23,11,5,6,0.007163244419700746,2019-03-29 18:15:00,2019-03-29 18:30:00
26,1,0,1,0.00212470383958944,2019-03-29 18:15:00,2019-03-29 18:30:00
27,4,3,1,0.028326292862207954,2019-03-29 18:15:00,2019-03-29 18:30:00
28,1,0,1,0.00212470383958944,2019-03-29 18:15:00,2019-03-29 18:30:00
35,1,0,1,0.00212470383958944,2019-03-29 18:15:00,2019-03-29 18:30:00
40,2,2,0,0.003034288129565582,2019-03-29 18:15:00,2019-03-29 18:30:00
41,6,2,4,0.0036047711147449268,2019-03-29 18:15:00,2019-03-29 18:30:00
46,2,1,1,0.014148152889497456,2019-03-29 18:15:00,2019-03-29 18:30:00
50,3,0,3,0.00212470383958944,2019-03-29 18:15:00,2019-03-29 18:30:00
57,11,4,7,0.005191755587032871,2019-03-29 18:15:00,2019-03-29 18:30:00
58,11,6,5,0.008230096006142867,2019-03-29 18:15:00,2019-03-29 18:30:00
61,4,2,2,0.006836595069040349,2019-03-29 18:15:00,2019-03-29 18:30:00
62,4,1,3,0.0033311668419310396,2019-03-29 18:15:00,2019-03-29 18:30:00
64,5,3,2,0.04101814458731094,2019-03-29 18:15:00,2019-03-29 18:30:00
67,11,5,6,0.007287127049223235,2019-03-29 18:15:00,2019-03-29 18:30:00
68,6,3,3,0.006433208562655387,2019-03-29 18:15:00,2019-03-29 18:30:00
69,5,3,2,0.005671642008805848,2019-03-29 18:15:00,2019-03-29 18:30:00
70,4,3,1,0.006854313398020494,2019-03-29 18:15:00,2019-03-29 18:30:00
75,1,1,0,0.005429597883283772,2019-03-29 18:15:00,2019-03-29 18:30:00
79,3,2,1,0.010912692834638714,2019-03-29 18:15:00,2019-03-29 18:30:00
80,4,1,3,0.0029647803365208843,2019-03-29 18:15:00,2019-03-29 18:30:00
86,2,2,0,0.009034315774651693,2019-03-29 18:15:00,2019-03-29 18:30:00
87,4,0,4,0.00212470383958944,2019-03-29 18:15:00,2019-03-29 18:30:00
88,6,1,5,0.0041663257748657855,2019-03-29 18:15:00,2019-03-29 18:30:00
89,5,5,0,0.006197292721551303,2019-03-29 18:15:00,2019-03-29 18:30:00
90,8,5,3,0.0072048828754873034,2019-03-29 18:15:00,2019-03-29 18:30:00
99,1,0,1,0.00212470383958944,2019-03-29 18:15:00,2019-03-29 18:30:00
104,1,1,0,0.003103418804651801,2019-03-29 18:15:00,2019-03-29 18:30:00
109,5,4,1,0.01502029735382657,2019-03-29 18:15:00,2019-03-29 18:30:00
110,11,6,5,0.02383340904571099,2019-03-29 18:15:00,2019-03-29 18:30:00
111,13,2,11,0.005884390028271843,2019-03-29 18:15:00,2019-03-29 18:30:00
113,7,6,1,0.06886103544052603,2019-03-29 18:15:00,2019-03-29 18:30:00
114,1,0,1,0.00212470383958944,2019-03-29 18:15:00,2019-03-29 18:30:00
116,3,2,1,0.004532846026866341,2019-03-29 18:15:00,2019-03-29 18:30:00
119,6,3,3,0.005102876774250182,2019-03-29 18:15:00,2019-03-29 18:30:00
120,3,1,2,0.0036953342494064094,2019-03-29 18:15:00,2019-03-29 18:30:00
122,6,5,1,0.015416170805928298,2019-03-29 18:15:00,2019-03-29 18:30:00
126,9,4,5,0.007096138169117627,2019-03-29 18:15:00,2019-03-29 18:30:00
127,1,0,1,0.00212470383958944,2019-03-29 18:15:00,2019-03-29 18:30:00
129,8,5,3,0.008602829947875177,2019-03-29 18:15:00,2019-03-29 18:30:00
133,1,0,1,0.00212470383958944,2019-03-29 18:15:00,2019-03-29 18:30:00
135,1,0,1,0.00212470383958944,2019-03-29 18:15:00,2019-03-29 18:30:00
137,21,11,10,0.03887230265453822,2019-03-29 18:15:00,2019-03-29 18:30:00
138,9,4,5,0.0063695254744993235,2019-03-29 18:15:00,2019-03-29 18:30:00
140,2,2,0,0.006920431045470444,2019-03-29 18:15:00,2019-03-29 18:30:00
141,8,4,4,0.005451495026677796,2019-03-29 18:15:00,2019-03-29 18:30:00
151,2,2,0,0.012345322348652843,2019-03-29 18:15:00,2019-03-29 18:30:00
153,16,5,11,0.009009305371922224,2019-03-29 18:15:00,2019-03-29 18:30:00
154,1,0,1,0.00212470383958944,2019-03-29 18:15:00,2019-03-29 18:30:00
157,4,2,2,0.014148152889497456,2019-03-29 18:15:00,2019-03-29 18:30:00
158,6,4,2,0.009870850170897536,2019-03-29 18:15:00,2019-03-29 18:30:00
159,4,2,2,0.006836595069040349,2019-03-29 18:15:00,2019-03-29 18:30:00
160,3,2,1,0.006919597050830692,2019-03-29 18:15:00,2019-03-29 18:30:00
162,10,4,6,0.004903712120577449,2019-03-29 18:15:00,2019-03-29 18:30:00
164,8,5,3,0.01854522197009989,2019-03-29 18:15:00,2019-03-29 18:30:00
168,10,8,2,0.013891862367262527,2019-03-29 18:15:00,2019-03-29 18:30:00
169,2,0,2,0.00212470383958944,2019-03-29 18:15:00,2019-03-29 18:30:00
171,1,0,1,0.00212470383958944,2019-03-29 18:15:00,2019-03-29 18:30:00
172,1,0,1,0.00212470383958944,2019-03-29 18:15:00,2019-03-29 18:30:00
173,6,2,4,0.005013763143078673,2019-03-29 18:15:00,2019-03-29 18:30:00
177,1,1,0,0.003068612122556115,2019-03-29 18:15:00,2019-03-29 18:30:00
190,5,3,2,0.01924615575931197,2019-03-29 18:15:00,2019-03-29 18:30:00
191,7,5,2,0.011237120880049288,2019-03-29 18:15:00,2019-03-29 18:30:00
195,1,1,0,0.003190218666433311,2019-03-29 18:15:00,2019-03-29 18:30:00
196,4,2,2,0.0050305514494456,2019-03-29 18:15:00,2019-03-29 18:30:00
197,4,1,3,0.0029647803365208843,2019-03-29 18:15:00,2019-03-29 18:30:00
199,3,2,1,0.011678022451131639,2019-03-29 18:15:00,2019-03-29 18:30:00
201,5,1,4,0.00469224215393207,2019-03-29 18:15:00,2019-03-29 18:30:00
203,8,4,4,0.012081120668458921,2019-03-29 18:15:00,2019-03-29 18:30:00
1,6,5,1,0.08778076821983924,2019-03-29 18:30:00,2019-03-29 18:45:00
2,6,4,2,0.01592559878394325,2019-03-29 18:30:00,2019-03-29 18:45:00
5,4,1,3,0.0027575719663748633,2019-03-29 18:30:00,2019-03-29 18:45:00
10,3,1,2,0.002760677367278698,2019-03-29 18:30:00,2019-03-29 18:45:00
11,4,3,1,0.03607977423747916,2019-03-29 18:30:00,2019-03-29 18:45:00
15,7,2,5,0.003923320900366906,2019-03-29 18:30:00,2019-03-29 18:45:00
16,17,12,5,0.025336339654401248,2019-03-29 18:30:00,2019-03-29 18:45:00
18,11,5,6,0.009724276911662224,2019-03-29 18:30:00,2019-03-29 18:45:00
19,8,3,5,0.012228076068901618,2019-03-29 18:30:00,2019-03-29 18:45:00
20,18,14,4,0.024813368425265072,2019-03-29 18:30:00,2019-03-29 18:45:00
21,1,0,1,0.00197620817369708,2019-03-29 18:30:00,2019-03-29 18:45:00
23,12,5,7,0.006522928285737873,2019-03-29 18:30:00,2019-03-29 18:45:00
27,4,3,1,0.020623202701610673,2019-03-29 18:30:00,2019-03-29 18:45:00
28,1,0,1,0.00197620817369708,2019-03-29 18:30:00,2019-03-29 18:45:00
35,4,2,2,0.003096126276159859,2019-03-29 18:30:00,2019-03-29 18:45:00
37,2,0,2,0.00197620817369708,2019-03-29 18:30:00,2019-03-29 18:45:00
40,1,0,1,0.00197620817369708,2019-03-29 18:30:00,2019-03-29 18:45:00
41,9,2,7,0.0029848860326546277,2019-03-29 18:30:00,2019-03-29 18:45:00
46,2,1,1,0.013164404890445233,2019-03-29 18:30:00,2019-03-29 18:45:00
50,4,1,3,0.0027684194832353574,2019-03-29 18:30:00,2019-03-29 18:45:00
57,8,3,5,0.006907888988594617,2019-03-29 18:30:00,2019-03-29 18:45:00
58,9,6,3,0.01882670766100221,2019-03-29 18:30:00,2019-03-29 18:45:00
61,3,2,1,0.004608086755894268,2019-03-29 18:30:00,2019-03-29 18:45:00
62,1,1,0,0.0027684194832353574,2019-03-29 18:30:00,2019-03-29 18:45:00
64,5,3,2,0.02962430429376517,2019-03-29 18:30:00,2019-03-29 18:45:00
66,1,1,0,0.0036560853273912486,2019-03-29 18:30:00,2019-03-29 18:45:00
67,6,3,3,0.00896230380133185,2019-03-29 18:30:00,2019-03-29 18:45:00
68,4,1,3,0.0050840874701457775,2019-03-29 18:30:00,2019-03-29 18:45:00
69,4,2,2,0.006195625107699099,2019-03-29 18:30:00,2019-03-29 18:45:00
70,5,3,2,0.006509345037875557,2019-03-29 18:30:00,2019-03-29 18:45:00
75,2,2,0,0.005664132259735461,2019-03-29 18:30:00,2019-03-29 18:45:00
79,2,1,1,0.002509514025177408,2019-03-29 18:30:00,2019-03-29 18:45:00
80,2,0,2,0.00197620817369708,2019-03-29 18:30:00,2019-03-29 18:45:00
86,2,2,0,0.006615836248620305,2019-03-29 18:30:00,2019-03-29 18:45:00
87,4,0,4,0.00197620817369708,2019-03-29 18:30:00,2019-03-29 18:45:00
88,5,0,5,0.00197620817369708,2019-03-29 18:30:00,2019-03-29 18:45:00
89,3,3,0,0.005166581984751924,2019-03-29 18:30:00,2019-03-29 18:45:00
90,12,5,7,0.013497919388696177,2019-03-29 18:30:00,2019-03-29 18:45:00
99,1,0,1,0.00197620817369708,2019-03-29 18:30:00,2019-03-29 18:45:00
104,2,2,0,0.01252433981962725,2019-03-29 18:30:00,2019-03-29 18:45:00
106,1,1,0,0.0028161467505441644,2019-03-29 18:30:00,2019-03-29 18:45:00
109,7,6,1,0.012996490041981777,2019-03-29 18:30:00,2019-03-29 18:45:00
110,4,1,3,0.008746160716928374,2019-03-29 18:30:00,2019-03-29 18:45:00
111,9,4,5,0.0057258552032473185,2019-03-29 18:30:00,2019-03-29 18:45:00
112,1,0,1,0.00197620817369708,2019-03-29 18:30:00,2019-03-29 18:45:00
113,5,4,1,0.00496400453745371,2019-03-29 18:30:00,2019-03-29 18:45:00
114,2,1,1,0.0036560853273912486,2019-03-29 18:30:00,2019-03-29 18:45:00
115,2,2,0,0.005254940769181084,2019-03-29 18:30:00,2019-03-29 18:45:00
116,2,1,1,0.0028161467505441644,2019-03-29 18:30:00,2019-03-29 18:45:00
119,6,2,4,0.004731957921472449,2019-03-29 18:30:00,2019-03-29 18:45:00
120,1,0,1,0.00197620817369708,2019-03-29 18:30:00,2019-03-29 18:45:00
122,4,3,1,0.007031983012214282,2019-03-29 18:30:00,2019-03-29 18:45:00
126,6,1,5,0.00238100437096176,2019-03-29 18:30:00,2019-03-29 18:45:00
127,2,2,0,0.0034514198565444975,2019-03-29 18:30:00,2019-03-29 18:45:00
129,5,3,2,0.005288337105754092,2019-03-29 18:30:00,2019-03-29 18:45:00
133,1,0,1,0.00197620817369708,2019-03-29 18:30:00,2019-03-29 18:45:00
135,2,2,0,0.0030428198766577364,2019-03-29 18:30:00,2019-03-29 18:45:00
137,13,6,7,0.016533745413134456,2019-03-29 18:30:00,2019-03-29 18:45:00
138,8,4,4,0.008812123420949546,2019-03-29 18:30:00,2019-03-29 18:45:00
140,1,1,0,0.002665769431581106,2019-03-29 18:30:00,2019-03-29 18:45:00
141,3,2,1,0.005023678781609397,2019-03-29 18:30:00,2019-03-29 18:45:00
151,5,1,4,0.002509514025177408,2019-03-29 18:30:00,2019-03-29 18:45:00
153,9,3,6,0.005205772006327534,2019-03-29 18:30:00,2019-03-29 18:45:00
154,2,0,2,0.00197620817369708,2019-03-29 18:30:00,2019-03-29 18:45:00
157,5,3,2,0.048613805869225396,2019-03-29 18:30:00,2019-03-29 18:45:00
158,6,1,5,0.004055488726338503,2019-03-29 18:30:00,2019-03-29 18:45:00
159,2,1,1,0.013164404890445233,2019-03-29 18:30:00,2019-03-29 18:45:00
160,1,1,0,0.0041094315796183925,2019-03-29 18:30:00,2019-03-29 18:45:00
162,10,4,6,0.004561009283775374,2019-03-29 18:30:00,2019-03-29 18:45:00
164,7,4,3,0.013207332761798021,2019-03-29 18:30:00,2019-03-29 18:45:00
168,13,9,4,0.015299543451316728,2019-03-29 18:30:00,2019-03-29 18:45:00
169,2,0,2,0.00197620817369708,2019-03-29 18:30:00,2019-03-29 18:45:00
170,1,1,0,0.004515747954004931,2019-03-29 18:30:00,2019-03-29 18:45:00
171,3,0,3,0.00197620817369708,2019-03-29 18:30:00,2019-03-29 18:45:00
172,2,2,0,0.0027011633365730276,2019-03-29 18:30:00,2019-03-29 18:45:00
173,3,0,3,0.00197620817369708,2019-03-29 18:30:00,2019-03-29 18:45:00
177,4,2,2,0.013164404890445233,2019-03-29 18:30:00,2019-03-29 18:45:00
189,1,0,1,0.00197620817369708,2019-03-29 18:30:00,2019-03-29 18:45:00
190,5,3,2,0.015577941000632823,2019-03-29 18:30:00,2019-03-29 18:45:00
191,15,9,6,0.030403773075075812,2019-03-29 18:30:00,2019-03-29 18:45:00
195,1,0,1,0.00197620817369708,2019-03-29 18:30:00,2019-03-29 18:45:00
196,1,0,1,0.00197620817369708,2019-03-29 18:30:00,2019-03-29 18:45:00
197,3,1,2,0.004055488726338503,2019-03-29 18:30:00,2019-03-29 18:45:00
199,4,2,2,0.010592674711577413,2019-03-29 18:30:00,2019-03-29 18:45:00
201,4,2,2,0.005254940769181084,2019-03-29 18:30:00,2019-03-29 18:45:00
203,7,4,3,0.01671745599859657,2019-03-29 18:30:00,2019-03-29 18:45:00
1,5,2,3,0.004912321971354489,2019-03-29 18:45:00,2019-03-29 19:00:00
2,7,3,4,0.0073115862695541335,2019-03-29 18:45:00,2019-03-29 19:00:00
5,5,1,4,0.003137082464124404,2019-03-29 18:45:00,2019-03-29 19:00:00
10,1,1,0,0.004717174720300537,2019-03-29 18:45:00,2019-03-29 19:00:00
11,4,2,2,0.01643321853802048,2019-03-29 18:45:00,2019-03-29 19:00:00
15,4,2,2,0.003383501969724866,2019-03-29 18:45:00,2019-03-29 19:00:00
16,8,6,2,0.027017483853149324,2019-03-29 18:45:00,2019-03-29 19:00:00
18,12,5,7,0.011825484659312605,2019-03-29 18:45:00,2019-03-29 19:00:00
19,6,1,5,0.003137082464124404,2019-03-29 18:45:00,2019-03-29 19:00:00
20,20,14,6,0.02860675490490383,2019-03-29 18:45:00,2019-03-29 19:00:00
23,6,2,4,0.004296595379270334,2019-03-29 18:45:00,2019-03-29 19:00:00
28,2,1,1,0.0038623330381978124,2019-03-29 18:45:00,2019-03-29 19:00:00
35,5,2,3,0.004570386426492752,2019-03-29 18:45:00,2019-03-29 19:00:00
37,1,0,1,0.002470408560179398,2019-03-29 18:45:00,2019-03-29 19:00:00
40,1,0,1,0.002470408560179398,2019-03-29 18:45:00,2019-03-29 19:00:00
41,8,2,6,0.0034471739246494347,2019-03-29 18:45:00,2019-03-29 19:00:00
46,3,1,2,0.004296595379270334,2019-03-29 18:45:00,2019-03-29 19:00:00
50,3,1,2,0.00528576687172521,2019-03-29 18:45:00,2019-03-29 19:00:00
57,5,3,2,0.008612839050821205,2019-03-29 18:45:00,2019-03-29 19:00:00
58,8,3,5,0.009667434062798914,2019-03-29 18:45:00,2019-03-29 19:00:00
61,2,2,0,0.005060470408970752,2019-03-29 18:45:00,2019-03-29 19:00:00
62,1,1,0,0.003383501969724866,2019-03-29 18:45:00,2019-03-29 19:00:00
64,1,1,0,0.0039065618693279874,2019-03-29 18:45:00,2019-03-29 19:00:00
66,1,1,0,0.004570386426492752,2019-03-29 18:45:00,2019-03-29 19:00:00
67,6,1,5,0.004771743662301533,2019-03-29 18:45:00,2019-03-29 19:00:00
68,1,0,1,0.002470408560179398,2019-03-29 18:45:00,2019-03-29 19:00:00
69,3,1,2,0.004570386426492752,2019-03-29 18:45:00,2019-03-29 19:00:00
70,3,2,1,0.011301133124243665,2019-03-29 18:45:00,2019-03-29 19:00:00
74,1,1,0,0.012077938702136281,2019-03-29 18:45:00,2019-03-29 19:00:00
75,1,1,0,0.004570386426492752,2019-03-29 18:45:00,2019-03-29 19:00:00
79,1,0,1,0.002470408560179398,2019-03-29 18:45:00,2019-03-29 19:00:00
80,2,0,2,0.002470408560179398,2019-03-29 18:45:00,2019-03-29 19:00:00
86,2,2,0,0.004092998068499813,2019-03-29 18:45:00,2019-03-29 19:00:00
88,4,1,3,0.004024291046122897,2019-03-29 18:45:00,2019-03-29 19:00:00
89,2,1,1,0.0036107260560701146,2019-03-29 18:45:00,2019-03-29 19:00:00
90,6,2,4,0.006056193582507207,2019-03-29 18:45:00,2019-03-29 19:00:00
99,1,0,1,0.002470408560179398,2019-03-29 18:45:00,2019-03-29 19:00:00
104,4,3,1,0.07019937368240815,2019-03-29 18:45:00,2019-03-29 19:00:00
106,7,4,3,0.02569935297803989,2019-03-29 18:45:00,2019-03-29 19:00:00
109,11,8,3,0.049543673271955024,2019-03-29 18:45:00,2019-03-29 19:00:00
110,1,0,1,0.002470408560179398,2019-03-29 18:45:00,2019-03-29 19:00:00
111,11,9,2,0.01934978607790791,2019-03-29 18:45:00,2019-03-29 19:00:00
113,1,0,1,0.002470408560179398,2019-03-29 18:45:00,2019-03-29 19:00:00
114,3,2,1,0.005107890133430541,2019-03-29 18:45:00,2019-03-29 19:00:00
115,3,3,0,0.006094536822272676,2019-03-29 18:45:00,2019-03-29 19:00:00
116,1,1,0,0.0030037476833354028,2019-03-29 18:45:00,2019-03-29 19:00:00
118,1,1,0,0.006812483454368527,2019-03-29 18:45:00,2019-03-29 19:00:00
119,12,4,8,0.004296595379270334,2019-03-29 18:45:00,2019-03-29 19:00:00
126,1,0,1,0.002470408560179398,2019-03-29 18:45:00,2019-03-29 19:00:00
127,3,3,0,0.009744772794986641,2019-03-29 18:45:00,2019-03-29 19:00:00
129,7,3,4,0.005090650642628815,2019-03-29 18:45:00,2019-03-29 19:00:00
133,1,0,1,0.002470408560179398,2019-03-29 18:45:00,2019-03-29 19:00:00
135,2,2,0,0.004423939289119471,2019-03-29 18:45:00,2019-03-29 19:00:00
137,12,6,6,0.015135458418484581,2019-03-29 18:45:00,2019-03-29 19:00:00
138,7,3,4,0.026100418440563312,2019-03-29 18:45:00,2019-03-29 19:00:00
140,1,1,0,0.004614805756610787,2019-03-29 18:45:00,2019-03-29 19:00:00
141,1,0,1,0.002470408560179398,2019-03-29 18:45:00,2019-03-29 19:00:00
151,4,1,3,0.0034471739246494347,2019-03-29 18:45:00,2019-03-29 19:00:00
153,6,3,3,0.009934836088222014,2019-03-29 18:45:00,2019-03-29 19:00:00
154,3,1,2,0.0032817033143396055,2019-03-29 18:45:00,2019-03-29 19:00:00
157,2,1,1,0.004114056171895016,2019-03-29 18:45:00,2019-03-29 19:00:00
158,4,0,4,0.002470408560179398,2019-03-29 18:45:00,2019-03-29 19:00:00
159,1,1,0,0.0063555013333664295,2019-03-29 18:45:00,2019-03-29 19:00:00
160,2,1,1,0.004570386426492752,2019-03-29 18:45:00,2019-03-29 19:00:00
162,7,3,4,0.006816091288023321,2019-03-29 18:45:00,2019-03-29 19:00:00
164,11,5,6,0.01624223000470158,2019-03-29 18:45:00,2019-03-29 19:00:00
168,14,9,5,0.023775623172038997,2019-03-29 18:45:00,2019-03-29 19:00:00
169,2,0,2,0.002470408560179398,2019-03-29 18:45:00,2019-03-29 19:00:00
170,2,2,0,0.00558303841646174,2019-03-29 18:45:00,2019-03-29 19:00:00
171,2,0,2,0.002470408560179398,2019-03-29 18:45:00,2019-03-29 19:00:00
172,2,0,2,0.002470408560179398,2019-03-29 18:45:00,2019-03-29 19:00:00
173,3,1,2,0.00801791714362526,2019-03-29 18:45:00,2019-03-29 19:00:00
177,4,2,2,0.01643321853802048,2019-03-29 18:45:00,2019-03-29 19:00:00
189,1,0,1,0.002470408560179398,2019-03-29 18:45:00,2019-03-29 19:00:00
190,4,2,2,0.01643321853802048,2019-03-29 18:45:00,2019-03-29 19:00:00
191,5,3,2,0.009101221733056225,2019-03-29 18:45:00,2019-03-29 19:00:00
196,1,1,0,0.004024291046122897,2019-03-29 18:45:00,2019-03-29 19:00:00
197,3,3,0,0.011109965780544968,2019-03-29 18:45:00,2019-03-29 19:00:00
201,13,7,6,0.0143414002191969,2019-03-29 18:45:00,2019-03-29 19:00:00
203,2,2,0,0.0063555013333664295,2019-03-29 18:45:00,2019-03-29 19:00:00
1,8,5,3,0.008156749977098473,2019-03-29 19:00:00,2019-03-29 19:15:00
2,2,0,2,0.0026100181789217316,2019-03-29 19:00:00,2019-03-29 19:15:00
5,8,2,6,0.0036420115207318714,2019-03-29 19:00:00,2019-03-29 19:15:00
10,5,1,4,0.0033143846420929457,2019-03-29 19:00:00,2019-03-29 19:15:00
15,5,2,3,0.004422178562817565,2019-03-29 19:00:00,2019-03-29 19:15:00
16,5,3,2,0.007830182563863038,2019-03-29 19:00:00,2019-03-29 19:15:00
18,9,2,7,0.0038125782725278792,2019-03-29 19:00:00,2019-03-29 19:15:00
19,3,2,1,0.0056408532880631865,2019-03-29 19:00:00,2019-03-29 19:15:00
20,9,3,6,0.007047403617463125,2019-03-29 19:00:00,2019-03-29 19:15:00
23,4,2,2,0.0046451407383568365,2019-03-29 19:00:00,2019-03-29 19:15:00
26,2,0,2,0.0026100181789217316,2019-03-29 19:00:00,2019-03-29 19:15:00
28,1,0,1,0.0026100181789217316,2019-03-29 19:00:00,2019-03-29 19:15:00
30,2,0,2,0.0026100181789217316,2019-03-29 19:00:00,2019-03-29 19:15:00
35,2,0,2,0.0026100181789217316,2019-03-29 19:00:00,2019-03-29 19:15:00
37,1,0,1,0.0026100181789217316,2019-03-29 19:00:00,2019-03-29 19:15:00
40,1,0,1,0.0026100181789217316,2019-03-29 19:00:00,2019-03-29 19:15:00
41,2,1,1,0.017362482489989454,2019-03-29 19:00:00,2019-03-29 19:15:00
46,12,7,5,0.024527006002352802,2019-03-29 19:00:00,2019-03-29 19:15:00
57,7,5,2,0.014042341184608724,2019-03-29 19:00:00,2019-03-29 19:15:00
58,10,5,5,0.014791375871164712,2019-03-29 19:00:00,2019-03-29 19:15:00
61,2,2,0,0.009788944415796943,2019-03-29 19:00:00,2019-03-29 19:15:00
62,5,5,0,0.007025152484511812,2019-03-29 19:00:00,2019-03-29 19:15:00
64,1,1,0,0.0030730140327709806,2019-03-29 19:00:00,2019-03-29 19:15:00
67,9,4,5,0.014742114752318571,2019-03-29 19:00:00,2019-03-29 19:15:00
69,3,1,2,0.004584426216359244,2019-03-29 19:00:00,2019-03-29 19:15:00
70,4,1,3,0.005833237159875354,2019-03-29 19:00:00,2019-03-29 19:15:00
74,2,1,1,0.004262995227485724,2019-03-29 19:00:00,2019-03-29 19:15:00
75,1,1,0,0.004828710898192428,2019-03-29 19:00:00,2019-03-29 19:15:00
80,2,0,2,0.0026100181789217316,2019-03-29 19:00:00,2019-03-29 19:15:00
85,1,1,0,0.008095373670127786,2019-03-29 19:00:00,2019-03-29 19:15:00
86,3,2,1,0.007623025105779417,2019-03-29 19:00:00,2019-03-29 19:15:00
88,8,5,3,0.017940776946830907,2019-03-29 19:00:00,2019-03-29 19:15:00
89,1,1,0,0.007693915190262189,2019-03-29 19:00:00,2019-03-29 19:15:00
90,5,4,1,0.007988029829890381,2019-03-29 19:00:00,2019-03-29 19:15:00
104,1,1,0,0.0030730140327709806,2019-03-29 19:00:00,2019-03-29 19:15:00
106,9,4,5,0.021445275994232724,2019-03-29 19:00:00,2019-03-29 19:15:00
109,13,6,7,0.012508673531055989,2019-03-29 19:00:00,2019-03-29 19:15:00
110,1,0,1,0.0026100181789217316,2019-03-29 19:00:00,2019-03-29 19:15:00
111,12,9,3,0.019357213748202567,2019-03-29 19:00:00,2019-03-29 19:15:00
112,2,1,1,0.0033143846420929457,2019-03-29 19:00:00,2019-03-29 19:15:00
114,3,2,1,0.007335214361621271,2019-03-29 19:00:00,2019-03-29 19:15:00
115,3,1,2,0.00371936453855708,2019-03-29 19:00:00,2019-03-29 19:15:00
116,4,4,0,0.015622917540399215,2019-03-29 19:00:00,2019-03-29 19:15:00
118,2,2,0,0.007886952509145758,2019-03-29 19:00:00,2019-03-29 19:15:00
119,11,3,8,0.008526943028434441,2019-03-29 19:00:00,2019-03-29 19:15:00
126,2,2,0,0.009056456140828976,2019-03-29 19:00:00,2019-03-29 19:15:00
127,2,1,1,0.004828710898192428,2019-03-29 19:00:00,2019-03-29 19:15:00
129,3,1,2,0.003516098370869648,2019-03-29 19:00:00,2019-03-29 19:15:00
133,1,0,1,0.0026100181789217316,2019-03-29 19:00:00,2019-03-29 19:15:00
137,8,4,4,0.00931436738066204,2019-03-29 19:00:00,2019-03-29 19:15:00
138,10,5,5,0.018957252254530606,2019-03-29 19:00:00,2019-03-29 19:15:00
140,2,1,1,0.004589527998839316,2019-03-29 19:00:00,2019-03-29 19:15:00
141,2,2,0,0.01095107674077212,2019-03-29 19:00:00,2019-03-29 19:15:00
151,3,2,1,0.06037199368383006,2019-03-29 19:00:00,2019-03-29 19:15:00
153,3,2,1,0.0071400015932378096,2019-03-29 19:00:00,2019-03-29 19:15:00
154,3,2,1,0.009287050923275768,2019-03-29 19:00:00,2019-03-29 19:15:00
157,3,0,3,0.0026100181789217316,2019-03-29 19:00:00,2019-03-29 19:15:00
158,1,0,1,0.0026100181789217316,2019-03-29 19:00:00,2019-03-29 19:15:00
162,6,3,3,0.017362482489989454,2019-03-29 19:00:00,2019-03-29 19:15:00
164,4,1,3,0.008578716234143831,2019-03-29 19:00:00,2019-03-29 19:15:00
168,12,7,5,0.018604406918492463,2019-03-29 19:00:00,2019-03-29 19:15:00
169,2,0,2,0.0026100181789217316,2019-03-29 19:00:00,2019-03-29 19:15:00
170,4,3,1,0.05013802084268103,2019-03-29 19:00:00,2019-03-29 19:15:00
172,2,0,2,0.0026100181789217316,2019-03-29 19:00:00,2019-03-29 19:15:00
173,2,1,1,0.005833237159875354,2019-03-29 19:00:00,2019-03-29 19:15:00
177,4,2,2,0.017362482489989454,2019-03-29 19:00:00,2019-03-29 19:15:00
190,1,0,1,0.0026100181789217316,2019-03-29 19:00:00,2019-03-29 19:15:00
191,2,1,1,0.005773214978791531,2019-03-29 19:00:00,2019-03-29 19:15:00
196,1,1,0,0.00371936453855708,2019-03-29 19:00:00,2019-03-29 19:15:00
197,2,2,0,0.0046069635829094156,2019-03-29 19:00:00,2019-03-29 19:15:00
201,10,4,6,0.007812847933250131,2019-03-29 19:00:00,2019-03-29 19:15:00
203,3,3,0,0.010408677778019097,2019-03-29 19:00:00,2019-03-29 19:15:00
1,4,2,2,0.004899197110633223,2019-03-29 19:15:00,2019-03-29 19:30:00
2,2,1,1,0.006184258326239645,2019-03-29 19:15:00,2019-03-29 19:30:00
5,4,0,4,0.0026481136642423414,2019-03-29 19:15:00,2019-03-29 19:30:00
10,3,0,3,0.0026481136642423414,2019-03-29 19:15:00,2019-03-29 19:30:00
11,1,1,0,0.003210884525840062,2019-03-29 19:15:00,2019-03-29 19:30:00
15,6,1,5,0.007353699067993435,2019-03-29 19:15:00,2019-03-29 19:30:00
16,5,4,1,0.008392892477908712,2019-03-29 19:15:00,2019-03-29 19:30:00
18,4,2,2,0.016522177636576697,2019-03-29 19:15:00,2019-03-29 19:30:00
19,4,4,0,0.01284423831518562,2019-03-29 19:15:00,2019-03-29 19:30:00
20,5,0,5,0.0026481136642423414,2019-03-29 19:15:00,2019-03-29 19:30:00
23,5,3,2,0.013881838616358952,2019-03-29 19:15:00,2019-03-29 19:30:00
26,2,0,2,0.0026481136642423414,2019-03-29 19:15:00,2019-03-29 19:30:00
28,1,0,1,0.0026481136642423414,2019-03-29 19:15:00,2019-03-29 19:30:00
35,2,0,2,0.0026481136642423414,2019-03-29 19:15:00,2019-03-29 19:30:00
41,2,1,1,0.003098330353520518,2019-03-29 19:15:00,2019-03-29 19:30:00
46,9,5,4,0.008973113442245198,2019-03-29 19:15:00,2019-03-29 19:30:00
50,1,1,0,0.005281919723348162,2019-03-29 19:15:00,2019-03-29 19:30:00
57,5,2,3,0.006142274319745268,2019-03-29 19:15:00,2019-03-29 19:30:00
58,8,3,5,0.008303876183648232,2019-03-29 19:15:00,2019-03-29 19:30:00
61,1,1,0,0.0037736553874377823,2019-03-29 19:15:00,2019-03-29 19:30:00
62,11,8,3,0.020666607378625346,2019-03-29 19:15:00,2019-03-29 19:30:00
64,1,1,0,0.009671008754812077,2019-03-29 19:15:00,2019-03-29 19:30:00
66,2,1,1,0.01761020957525736,2019-03-29 19:15:00,2019-03-29 19:30:00
67,7,4,3,0.010948271307223777,2019-03-29 19:15:00,2019-03-29 19:30:00
69,1,1,0,0.008548711753260538,2019-03-29 19:15:00,2019-03-29 19:30:00
70,2,0,2,0.0026481136642423414,2019-03-29 19:15:00,2019-03-29 19:30:00
74,1,0,1,0.0026481136642423414,2019-03-29 19:15:00,2019-03-29 19:30:00
86,3,2,1,0.008852813319629092,2019-03-29 19:15:00,2019-03-29 19:30:00
88,7,4,3,0.01436936607767059,2019-03-29 19:15:00,2019-03-29 19:30:00
89,1,1,0,0.0067200600464498534,2019-03-29 19:15:00,2019-03-29 19:30:00
90,3,3,0,0.012999850510963607,2019-03-29 19:15:00,2019-03-29 19:30:00
104,3,1,2,0.009671008754812077,2019-03-29 19:15:00,2019-03-29 19:30:00
106,2,0,2,0.0026481136642423414,2019-03-29 19:15:00,2019-03-29 19:30:00
109,10,3,7,0.004165797267538624,2019-03-29 19:15:00,2019-03-29 19:30:00
110,1,0,1,0.0026481136642423414,2019-03-29 19:15:00,2019-03-29 19:30:00
111,7,5,2,0.008749002811036615,2019-03-29 19:15:00,2019-03-29 19:30:00
112,5,3,2,0.008060161198232047,2019-03-29 19:15:00,2019-03-29 19:30:00
113,2,0,2,0.0026481136642423414,2019-03-29 19:15:00,2019-03-29 19:30:00
114,3,1,2,0.004899197110633223,2019-03-29 19:15:00,2019-03-29 19:30:00
115,3,1,2,0.011293885120847068,2019-03-29 19:15:00,2019-03-29 19:30:00
116,4,0,4,0.0026481136642423414,2019-03-29 19:15:00,2019-03-29 19:30:00
118,3,2,1,0.006024738833828664,2019-03-29 19:15:00,2019-03-29 19:30:00
119,4,1,3,0.003695174545743028,2019-03-29 19:15:00,2019-03-29 19:30:00
122,1,0,1,0.0026481136642423414,2019-03-29 19:15:00,2019-03-29 19:30:00
126,2,2,0,0.012059284471744529,2019-03-29 19:15:00,2019-03-29 19:30:00
127,2,0,2,0.0026481136642423414,2019-03-29 19:15:00,2019-03-29 19:30:00
129,1,1,0,0.003695174545743028,2019-03-29 19:15:00,2019-03-29 19:30:00
133,1,0,1,0.0026481136642423414,2019-03-29 19:15:00,2019-03-29 19:30:00
137,13,8,5,0.020797856399225375,2019-03-29 19:15:00,2019-03-29 19:30:00
138,12,8,4,0.022141063901798076,2019-03-29 19:15:00,2019-03-29 19:30:00
140,2,0,2,0.0026481136642423414,2019-03-29 19:15:00,2019-03-29 19:30:00
141,3,3,0,0.006968012348259902,2019-03-29 19:15:00,2019-03-29 19:30:00
151,4,2,2,0.01769568636150548,2019-03-29 19:15:00,2019-03-29 19:30:00
153,7,6,1,0.013870824965245658,2019-03-29 19:15:00,2019-03-29 19:30:00
154,5,4,1,0.01294153475686023,2019-03-29 19:15:00,2019-03-29 19:30:00
157,3,1,2,0.004605749479888156,2019-03-29 19:15:00,2019-03-29 19:30:00
159,2,1,1,0.01761020957525736,2019-03-29 19:15:00,2019-03-29 19:30:00
162,4,3,1,0.09528958304268571,2019-03-29 19:15:00,2019-03-29 19:30:00
164,4,1,3,0.004388604552356601,2019-03-29 19:15:00,2019-03-29 19:30:00
168,8,4,4,0.024044729882856934,2019-03-29 19:15:00,2019-03-29 19:30:00
169,1,1,0,0.0063669173761569196,2019-03-29 19:15:00,2019-03-29 19:30:00
172,2,1,1,0.010169909697281328,2019-03-29 19:15:00,2019-03-29 19:30:00
173,2,1,1,0.004388604552356601,2019-03-29 19:15:00,2019-03-29 19:30:00
177,7,3,4,0.007306828817378637,2019-03-29 19:15:00,2019-03-29 19:30:00
189,3,1,2,0.004605749479888156,2019-03-29 19:15:00,2019-03-29 19:30:00
190,1,1,0,0.009243703939557485,2019-03-29 19:15:00,2019-03-29 19:30:00
191,2,1,1,0.007758378722159505,2019-03-29 19:15:00,2019-03-29 19:30:00
196,3,1,2,0.007905443595326541,2019-03-29 19:15:00,2019-03-29 19:30:00
197,2,2,0,0.0035485470427986943,2019-03-29 19:15:00,2019-03-29 19:30:00
201,3,0,3,0.0026481136642423414,2019-03-29 19:15:00,2019-03-29 19:30:00
202,2,1,1,0.004555115739035075,2019-03-29 19:15:00,2019-03-29 19:30:00
203,2,2,0,0.005017217265037512,2019-03-29 19:15:00,2019-03-29 19:30:00
1,7,1,6,0.0035085949565131676,2019-03-29 19:30:00,2019-03-29 19:45:00
2,1,1,0,0.0076618897067205465,2019-03-29 19:30:00,2019-03-29 19:45:00
5,2,0,2,0.00301150374590888,2019-03-29 19:30:00,2019-03-29 19:45:00
10,2,0,2,0.00301150374590888,2019-03-29 19:30:00,2019-03-29 19:45:00
11,1,1,0,0.0037571405618153112,2019-03-29 19:30:00,2019-03-29 19:45:00
13,2,2,0,0.012952417905587623,2019-03-29 19:30:00,2019-03-29 19:45:00
15,4,1,3,0.005571482914515816,2019-03-29 19:30:00,2019-03-29 19:45:00
16,6,5,1,0.006894206318757175,2019-03-29 19:30:00,2019-03-29 19:45:00
18,2,1,1,0.005108498443683389,2019-03-29 19:30:00,2019-03-29 19:45:00
19,1,1,0,0.005571482914515816,2019-03-29 19:30:00,2019-03-29 19:45:00
20,5,0,5,0.00301150374590888,2019-03-29 19:30:00,2019-03-29 19:45:00
23,3,1,2,0.008872097904596839,2019-03-29 19:30:00,2019-03-29 19:45:00
28,1,0,1,0.00301150374590888,2019-03-29 19:30:00,2019-03-29 19:45:00
35,2,1,1,0.016651617203188473,2019-03-29 19:30:00,2019-03-29 19:45:00
41,2,1,1,0.003523499579630267,2019-03-29 19:30:00,2019-03-29 19:45:00
46,5,4,1,0.008131462083122754,2019-03-29 19:30:00,2019-03-29 19:45:00
50,1,1,0,0.006006719873455661,2019-03-29 19:30:00,2019-03-29 19:45:00
57,3,1,2,0.005204447037160318,2019-03-29 19:30:00,2019-03-29 19:45:00
58,3,1,2,0.005159320167935997,2019-03-29 19:30:00,2019-03-29 19:45:00
61,1,1,0,0.017167377854492107,2019-03-29 19:30:00,2019-03-29 19:45:00
62,9,7,2,0.018121503999400802,2019-03-29 19:30:00,2019-03-29 19:45:00
64,1,1,0,0.007354162806669232,2019-03-29 19:30:00,2019-03-29 19:45:00
66,2,1,1,0.019904579510728555,2019-03-29 19:30:00,2019-03-29 19:45:00
67,3,2,1,0.005728839845123499,2019-03-29 19:30:00,2019-03-29 19:45:00
79,1,0,1,0.00301150374590888,2019-03-29 19:30:00,2019-03-29 19:45:00
85,1,1,0,0.009566090702160052,2019-03-29 19:30:00,2019-03-29 19:45:00
86,1,0,1,0.00301150374590888,2019-03-29 19:30:00,2019-03-29 19:45:00
88,5,2,3,0.01612067765841122,2019-03-29 19:30:00,2019-03-29 19:45:00
89,1,1,0,0.007579606660011567,2019-03-29 19:30:00,2019-03-29 19:45:00
90,1,1,0,0.007747667709215035,2019-03-29 19:30:00,2019-03-29 19:45:00
104,1,0,1,0.00301150374590888,2019-03-29 19:30:00,2019-03-29 19:45:00
106,2,0,2,0.00301150374590888,2019-03-29 19:30:00,2019-03-29 19:45:00
109,1,0,1,0.00301150374590888,2019-03-29 19:30:00,2019-03-29 19:45:00
110,1,0,1,0.00301150374590888,2019-03-29 19:30:00,2019-03-29 19:45:00
111,4,0,4,0.00301150374590888,2019-03-29 19:30:00,2019-03-29 19:45:00
112,3,2,1,0.008941879291024014,2019-03-29 19:30:00,2019-03-29 19:45:00
113,2,0,2,0.00301150374590888,2019-03-29 19:30:00,2019-03-29 19:45:00
115,2,1,1,0.013205527518490058,2019-03-29 19:30:00,2019-03-29 19:45:00
116,5,1,4,0.0035085949565131676,2019-03-29 19:30:00,2019-03-29 19:45:00
118,1,1,0,0.013205527518490058,2019-03-29 19:30:00,2019-03-29 19:45:00
119,2,0,2,0.00301150374590888,2019-03-29 19:30:00,2019-03-29 19:45:00
120,2,0,2,0.00301150374590888,2019-03-29 19:30:00,2019-03-29 19:45:00
122,1,0,1,0.00301150374590888,2019-03-29 19:30:00,2019-03-29 19:45:00
126,3,2,1,0.01604509401363166,2019-03-29 19:30:00,2019-03-29 19:45:00
127,2,2,0,0.007205493141457898,2019-03-29 19:30:00,2019-03-29 19:45:00
129,1,1,0,0.004291493330212348,2019-03-29 19:30:00,2019-03-29 19:45:00
133,1,0,1,0.00301150374590888,2019-03-29 19:30:00,2019-03-29 19:45:00
137,6,4,2,0.010941033032705506,2019-03-29 19:30:00,2019-03-29 19:45:00
138,12,8,4,0.0306635785181419,2019-03-29 19:30:00,2019-03-29 19:45:00
140,1,1,0,0.007579606660011567,2019-03-29 19:30:00,2019-03-29 19:45:00
141,2,1,1,0.005571482914515816,2019-03-29 19:30:00,2019-03-29 19:45:00
151,5,2,3,0.007774444826398469,2019-03-29 19:30:00,2019-03-29 19:45:00
153,8,4,4,0.009867115758570051,2019-03-29 19:30:00,2019-03-29 19:45:00
154,4,3,1,0.018510500550225018,2019-03-29 19:30:00,2019-03-29 19:45:00
157,1,1,0,0.005571482914515816,2019-03-29 19:30:00,2019-03-29 19:45:00
159,3,2,1,0.03441618473530344,2019-03-29 19:30:00,2019-03-29 19:45:00
162,7,3,4,0.023387109818911875,2019-03-29 19:30:00,2019-03-29 19:45:00
164,3,1,2,0.004291493330212348,2019-03-29 19:30:00,2019-03-29 19:45:00
168,6,3,3,0.023131153935767375,2019-03-29 19:30:00,2019-03-29 19:45:00
169,1,1,0,0.003651498538060614,2019-03-29 19:30:00,2019-03-29 19:45:00
172,6,4,2,0.023982734641987396,2019-03-29 19:30:00,2019-03-29 19:45:00
173,3,1,2,0.005223611221894464,2019-03-29 19:30:00,2019-03-29 19:45:00
177,3,2,1,0.010541939994355189,2019-03-29 19:30:00,2019-03-29 19:45:00
189,1,0,1,0.00301150374590888,2019-03-29 19:30:00,2019-03-29 19:45:00
191,1,1,0,0.004291493330212348,2019-03-29 19:30:00,2019-03-29 19:45:00
195,1,1,0,0.003651498538060614,2019-03-29 19:30:00,2019-03-29 19:45:00
196,4,1,3,0.007579606660011567,2019-03-29 19:30:00,2019-03-29 19:45:00
197,2,2,0,0.004035495413351655,2019-03-29 19:30:00,2019-03-29 19:45:00
199,1,0,1,0.00301150374590888,2019-03-29 19:30:00,2019-03-29 19:45:00
201,1,1,0,0.005571482914515816,2019-03-29 19:30:00,2019-03-29 19:45:00
202,2,1,1,0.009923852503914254,2019-03-29 19:30:00,2019-03-29 19:45:00
203,1,1,0,0.004835539528887153,2019-03-29 19:30:00,2019-03-29 19:45:00
1,2,0,2,0.003145494233537005,2019-03-29 19:45:00,2019-03-29 20:00:00
2,1,0,1,0.003145494233537005,2019-03-29 19:45:00,2019-03-29 20:00:00
10,2,0,2,0.003145494233537005,2019-03-29 19:45:00,2019-03-29 20:00:00
11,1,1,0,0.005819393594094879,2019-03-29 19:45:00,2019-03-29 20:00:00
13,2,2,0,0.0049280938072422545,2019-03-29 19:45:00,2019-03-29 20:00:00
15,2,1,1,0.004482443913815942,2019-03-29 19:45:00,2019-03-29 20:00:00
16,4,4,0,0.022740968216223394,2019-03-29 19:45:00,2019-03-29 20:00:00
18,2,0,2,0.003145494233537005,2019-03-29 19:45:00,2019-03-29 20:00:00
19,3,1,2,0.0054708268324414125,2019-03-29 19:45:00,2019-03-29 20:00:00
20,1,0,1,0.003145494233537005,2019-03-29 19:45:00,2019-03-29 20:00:00
23,7,2,5,0.015312429840941756,2019-03-29 19:45:00,2019-03-29 20:00:00
28,2,0,2,0.003145494233537005,2019-03-29 19:45:00,2019-03-29 20:00:00
30,1,1,0,0.007546691994392464,2019-03-29 19:45:00,2019-03-29 20:00:00
35,2,1,1,0.00992678096503683,2019-03-29 19:45:00,2019-03-29 20:00:00
41,2,2,0,0.006496684632754075,2019-03-29 19:45:00,2019-03-29 20:00:00
46,6,3,3,0.009210979077496212,2019-03-29 19:45:00,2019-03-29 20:00:00
50,2,2,0,0.005819393594094879,2019-03-29 19:45:00,2019-03-29 20:00:00
57,2,0,2,0.003145494233537005,2019-03-29 19:45:00,2019-03-29 20:00:00
58,4,2,2,0.010863186159544262,2019-03-29 19:45:00,2019-03-29 20:00:00
61,1,1,0,0.01158437762255931,2019-03-29 19:45:00,2019-03-29 20:00:00
62,3,3,0,0.006496684632754075,2019-03-29 19:45:00,2019-03-29 20:00:00
66,6,3,3,0.03182481658593296,2019-03-29 19:45:00,2019-03-29 20:00:00
67,2,1,1,0.004482443913815942,2019-03-29 19:45:00,2019-03-29 20:00:00
68,2,2,0,0.008073456127660935,2019-03-29 19:45:00,2019-03-29 20:00:00
69,1,0,1,0.003145494233537005,2019-03-29 19:45:00,2019-03-29 20:00:00
79,1,0,1,0.003145494233537005,2019-03-29 19:45:00,2019-03-29 20:00:00
85,2,1,1,0.005177367349514591,2019-03-29 19:45:00,2019-03-29 20:00:00
86,1,0,1,0.003145494233537005,2019-03-29 19:45:00,2019-03-29 20:00:00
88,3,1,2,0.013769957868776043,2019-03-29 19:45:00,2019-03-29 20:00:00
89,1,1,0,0.008998607739434686,2019-03-29 19:45:00,2019-03-29 20:00:00
90,5,2,3,0.006117346328668572,2019-03-29 19:45:00,2019-03-29 20:00:00
106,2,0,2,0.003145494233537005,2019-03-29 19:45:00,2019-03-29 20:00:00
109,3,2,1,0.012497581074295407,2019-03-29 19:45:00,2019-03-29 20:00:00
110,1,0,1,0.003145494233537005,2019-03-29 19:45:00,2019-03-29 20:00:00
111,5,2,3,0.016708067696536655,2019-03-29 19:45:00,2019-03-29 20:00:00
112,7,4,3,0.038429515735835744,2019-03-29 19:45:00,2019-03-29 20:00:00
113,5,3,2,0.007979353411622269,2019-03-29 19:45:00,2019-03-29 20:00:00
114,4,2,2,0.020787504984686365,2019-03-29 19:45:00,2019-03-29 20:00:00
115,1,0,1,0.003145494233537005,2019-03-29 19:45:00,2019-03-29 20:00:00
116,1,0,1,0.003145494233537005,2019-03-29 19:45:00,2019-03-29 20:00:00
118,2,1,1,0.012518765395926088,2019-03-29 19:45:00,2019-03-29 20:00:00
119,7,2,5,0.006934545804441311,2019-03-29 19:45:00,2019-03-29 20:00:00
122,2,0,2,0.003145494233537005,2019-03-29 19:45:00,2019-03-29 20:00:00
126,9,6,3,0.023930835593771255,2019-03-29 19:45:00,2019-03-29 20:00:00
127,8,5,3,0.008179990987078193,2019-03-29 19:45:00,2019-03-29 20:00:00
129,1,1,0,0.0043244938208303555,2019-03-29 19:45:00,2019-03-29 20:00:00
133,1,0,1,0.003145494233537005,2019-03-29 19:45:00,2019-03-29 20:00:00
137,4,3,1,0.008493292954652754,2019-03-29 19:45:00,2019-03-29 20:00:00
138,4,3,1,0.009766395257984771,2019-03-29 19:45:00,2019-03-29 20:00:00
140,2,1,1,0.005819393594094879,2019-03-29 19:45:00,2019-03-29 20:00:00
141,1,1,0,0.004482443913815942,2019-03-29 19:45:00,2019-03-29 20:00:00
151,4,2,2,0.010121492030250227,2019-03-29 19:45:00,2019-03-29 20:00:00
153,7,1,6,0.004780396648389635,2019-03-29 19:45:00,2019-03-29 20:00:00
154,2,2,0,0.011573380776739204,2019-03-29 19:45:00,2019-03-29 20:00:00
159,2,1,1,0.007447592669692353,2019-03-29 19:45:00,2019-03-29 20:00:00
162,3,0,3,0.003145494233537005,2019-03-29 19:45:00,2019-03-29 20:00:00
164,7,3,4,0.007692819251128543,2019-03-29 19:45:00,2019-03-29 20:00:00
168,3,1,2,0.004780396648389635,2019-03-29 19:45:00,2019-03-29 20:00:00
170,1,1,0,0.011447783100031798,2019-03-29 19:45:00,2019-03-29 20:00:00
172,4,3,1,0.011026176103139983,2019-03-29 19:45:00,2019-03-29 20:00:00
173,2,0,2,0.003145494233537005,2019-03-29 19:45:00,2019-03-29 20:00:00
177,2,2,0,0.006710693380947504,2019-03-29 19:45:00,2019-03-29 20:00:00
191,7,4,3,0.013431531228343386,2019-03-29 19:45:00,2019-03-29 20:00:00
195,1,1,0,0.007880116706032583,2019-03-29 19:45:00,2019-03-29 20:00:00
196,4,2,2,0.010177607326728037,2019-03-29 19:45:00,2019-03-29 20:00:00
197,1,1,0,0.006951563050661258,2019-03-29 19:45:00,2019-03-29 20:00:00
199,1,0,1,0.003145494233537005,2019-03-29 19:45:00,2019-03-29 20:00:00
201,1,1,0,0.005819393594094879,2019-03-29 19:45:00,2019-03-29 20:00:00
203,2,2,0,0.0066123402644281196,2019-03-29 19:45:00,2019-03-29 20:00:00
1,4,1,3,0.007041728586952094,2019-03-29 20:00:00,2019-03-29 20:15:00
2,1,0,1,0.003012654493638455,2019-03-29 20:00:00,2019-03-29 20:15:00
5,1,1,0,0.004372632233521868,2019-03-29 20:00:00,2019-03-29 20:15:00
11,1,1,0,0.007269929951319976,2019-03-29 20:00:00,2019-03-29 20:15:00
16,5,4,1,0.015149077261347987,2019-03-29 20:00:00,2019-03-29 20:15:00
18,4,3,1,0.013312588165247382,2019-03-29 20:00:00,2019-03-29 20:15:00
19,5,2,3,0.006394077294048473,2019-03-29 20:00:00,2019-03-29 20:15:00
20,6,0,6,0.003012654493638455,2019-03-29 20:00:00,2019-03-29 20:15:00
23,5,3,2,0.01713074849036074,2019-03-29 20:00:00,2019-03-29 20:15:00
26,2,2,0,0.007003412909806073,2019-03-29 20:00:00,2019-03-29 20:15:00
28,2,1,1,0.009026370159835106,2019-03-29 20:00:00,2019-03-29 20:15:00
30,1,1,0,0.005573632470761071,2019-03-29 20:00:00,2019-03-29 20:15:00
35,1,0,1,0.003012654493638455,2019-03-29 20:00:00,2019-03-29 20:15:00
37,1,1,0,0.004582229251549245,2019-03-29 20:00:00,2019-03-29 20:15:00
41,5,2,3,0.0047994618963756374,2019-03-29 20:00:00,2019-03-29 20:15:00
46,5,1,4,0.008125622624728018,2019-03-29 20:00:00,2019-03-29 20:15:00
57,2,0,2,0.003012654493638455,2019-03-29 20:00:00,2019-03-29 20:15:00
58,6,2,4,0.007385480513260299,2019-03-29 20:00:00,2019-03-29 20:15:00
61,1,1,0,0.005573632470761071,2019-03-29 20:00:00,2019-03-29 20:15:00
62,4,2,2,0.019946600090801868,2019-03-29 20:00:00,2019-03-29 20:15:00
66,7,3,4,0.007466923141815208,2019-03-29 20:00:00,2019-03-29 20:15:00
67,4,2,2,0.005573632470761071,2019-03-29 20:00:00,2019-03-29 20:15:00
68,2,2,0,0.024824524345135754,2019-03-29 20:00:00,2019-03-29 20:15:00
69,1,0,1,0.003012654493638455,2019-03-29 20:00:00,2019-03-29 20:15:00
70,1,1,0,0.005381671145805938,2019-03-29 20:00:00,2019-03-29 20:15:00
74,1,0,1,0.003012654493638455,2019-03-29 20:00:00,2019-03-29 20:15:00
79,1,0,1,0.003012654493638455,2019-03-29 20:00:00,2019-03-29 20:15:00
85,1,0,1,0.003012654493638455,2019-03-29 20:00:00,2019-03-29 20:15:00
86,1,0,1,0.003012654493638455,2019-03-29 20:00:00,2019-03-29 20:15:00
88,2,1,1,0.005573632470761071,2019-03-29 20:00:00,2019-03-29 20:15:00
89,1,1,0,0.00775068779797342,2019-03-29 20:00:00,2019-03-29 20:15:00
90,5,2,3,0.009033685261238964,2019-03-29 20:00:00,2019-03-29 20:15:00
104,2,0,2,0.003012654493638455,2019-03-29 20:00:00,2019-03-29 20:15:00
109,1,0,1,0.003012654493638455,2019-03-29 20:00:00,2019-03-29 20:15:00
110,1,1,0,0.005573632470761071,2019-03-29 20:00:00,2019-03-29 20:15:00
111,4,3,1,0.017418665223988394,2019-03-29 20:00:00,2019-03-29 20:15:00
112,2,1,1,0.005573632470761071,2019-03-29 20:00:00,2019-03-29 20:15:00
113,4,2,2,0.012028999869378273,2019-03-29 20:00:00,2019-03-29 20:15:00
114,4,2,2,0.019946600090801868,2019-03-29 20:00:00,2019-03-29 20:15:00
115,1,0,1,0.003012654493638455,2019-03-29 20:00:00,2019-03-29 20:15:00
116,2,1,1,0.005008033701722264,2019-03-29 20:00:00,2019-03-29 20:15:00
118,2,0,2,0.003012654493638455,2019-03-29 20:00:00,2019-03-29 20:15:00
119,4,1,3,0.004739567243679925,2019-03-29 20:00:00,2019-03-29 20:15:00
122,1,0,1,0.003012654493638455,2019-03-29 20:00:00,2019-03-29 20:15:00
126,8,4,4,0.027867035671323225,2019-03-29 20:00:00,2019-03-29 20:15:00
127,4,3,1,0.02362566216697197,2019-03-29 20:00:00,2019-03-29 20:15:00
129,1,1,0,0.004355679191409668,2019-03-29 20:00:00,2019-03-29 20:15:00
133,1,0,1,0.003012654493638455,2019-03-29 20:00:00,2019-03-29 20:15:00
135,2,1,1,0.019946600090801868,2019-03-29 20:00:00,2019-03-29 20:15:00
137,5,3,2,0.008134610447883685,2019-03-29 20:00:00,2019-03-29 20:15:00
138,12,9,3,0.017790169108741486,2019-03-29 20:00:00,2019-03-29 20:15:00
140,2,1,1,0.005573632470761071,2019-03-29 20:00:00,2019-03-29 20:15:00
141,1,0,1,0.003012654493638455,2019-03-29 20:00:00,2019-03-29 20:15:00
151,5,3,2,0.014148326114080336,2019-03-29 20:00:00,2019-03-29 20:15:00
153,2,1,1,0.019946600090801868,2019-03-29 20:00:00,2019-03-29 20:15:00
154,1,1,0,0.005381671145805938,2019-03-29 20:00:00,2019-03-29 20:15:00
158,1,0,1,0.003012654493638455,2019-03-29 20:00:00,2019-03-29 20:15:00
159,1,0,1,0.003012654493638455,2019-03-29 20:00:00,2019-03-29 20:15:00
164,8,3,5,0.020349948622576344,2019-03-29 20:00:00,2019-03-29 20:15:00
168,2,1,1,0.006472707284116348,2019-03-29 20:00:00,2019-03-29 20:15:00
169,1,0,1,0.003012654493638455,2019-03-29 20:00:00,2019-03-29 20:15:00
170,1,1,0,0.008053848655494238,2019-03-29 20:00:00,2019-03-29 20:15:00
172,1,1,0,0.005573632470761071,2019-03-29 20:00:00,2019-03-29 20:15:00
173,2,0,2,0.003012654493638455,2019-03-29 20:00:00,2019-03-29 20:15:00
177,2,2,0,0.006854121459322378,2019-03-29 20:00:00,2019-03-29 20:15:00
190,2,1,1,0.004739567243679925,2019-03-29 20:00:00,2019-03-29 20:15:00
191,7,3,4,0.008312656610124465,2019-03-29 20:00:00,2019-03-29 20:15:00
195,1,1,0,0.01782052489275779,2019-03-29 20:00:00,2019-03-29 20:15:00
196,3,2,1,0.009093712495744633,2019-03-29 20:00:00,2019-03-29 20:15:00
197,4,4,0,0.009278449121505453,2019-03-29 20:00:00,2019-03-29 20:15:00
199,1,0,1,0.003012654493638455,2019-03-29 20:00:00,2019-03-29 20:15:00
201,2,2,0,0.009031176786534728,2019-03-29 20:00:00,2019-03-29 20:15:00
203,2,2,0,0.008132418256857482,2019-03-29 20:00:00,2019-03-29 20:15:00
1,5,2,3,0.009480862499766884,2019-03-29 20:15:00,2019-03-29 20:30:00
10,1,1,0,0.003672963581607392,2019-03-29 20:15:00,2019-03-29 20:30:00
15,2,1,1,0.00526857641539427,2019-03-29 20:15:00,2019-03-29 20:30:00
16,2,1,1,0.005112251084905019,2019-03-29 20:15:00,2019-03-29 20:30:00
18,1,1,0,0.005112251084905019,2019-03-29 20:15:00,2019-03-29 20:30:00
19,6,3,3,0.011728901198923815,2019-03-29 20:15:00,2019-03-29 20:30:00
20,6,1,5,0.00526857641539427,2019-03-29 20:15:00,2019-03-29 20:30:00
23,4,2,2,0.007082079140477877,2019-03-29 20:15:00,2019-03-29 20:30:00
26,2,2,0,0.008402321981369143,2019-03-29 20:15:00,2019-03-29 20:30:00
28,4,2,2,0.008370028947428205,2019-03-29 20:15:00,2019-03-29 20:30:00
35,2,0,2,0.003029202527283767,2019-03-29 20:15:00,2019-03-29 20:30:00
37,1,1,0,0.005604246744578268,2019-03-29 20:15:00,2019-03-29 20:30:00
41,3,1,2,0.00526857641539427,2019-03-29 20:15:00,2019-03-29 20:30:00
46,5,1,4,0.006586873193814041,2019-03-29 20:15:00,2019-03-29 20:30:00
57,1,1,0,0.011928210978300867,2019-03-29 20:15:00,2019-03-29 20:30:00
58,4,1,3,0.006352812270241801,2019-03-29 20:15:00,2019-03-29 20:30:00
61,1,1,0,0.004316724635931017,2019-03-29 20:15:00,2019-03-29 20:30:00
62,7,3,4,0.008694858539371712,2019-03-29 20:15:00,2019-03-29 20:30:00
64,2,1,1,0.020144565671519312,2019-03-29 20:15:00,2019-03-29 20:30:00
66,3,1,2,0.00526857641539427,2019-03-29 20:15:00,2019-03-29 20:30:00
67,6,3,3,0.0076919206679736335,2019-03-29 20:15:00,2019-03-29 20:30:00
68,1,0,1,0.003029202527283767,2019-03-29 20:15:00,2019-03-29 20:30:00
69,2,2,0,0.010905816972970987,2019-03-29 20:15:00,2019-03-29 20:30:00
70,1,1,0,0.004429073749691958,2019-03-29 20:15:00,2019-03-29 20:30:00
74,1,0,1,0.003029202527283767,2019-03-29 20:15:00,2019-03-29 20:30:00
79,1,0,1,0.003029202527283767,2019-03-29 20:15:00,2019-03-29 20:30:00
80,1,1,0,0.006236452751757365,2019-03-29 20:15:00,2019-03-29 20:30:00
88,2,0,2,0.003029202527283767,2019-03-29 20:15:00,2019-03-29 20:30:00
89,3,3,0,0.008718608304600025,2019-03-29 20:15:00,2019-03-29 20:30:00
90,4,2,2,0.007327017530254808,2019-03-29 20:15:00,2019-03-29 20:30:00
104,2,0,2,0.003029202527283767,2019-03-29 20:15:00,2019-03-29 20:30:00
109,6,4,2,0.00754564111696315,2019-03-29 20:15:00,2019-03-29 20:30:00
110,9,7,2,0.07588319886787867,2019-03-29 20:15:00,2019-03-29 20:30:00
111,4,4,0,0.011131923015835904,2019-03-29 20:15:00,2019-03-29 20:30:00
112,1,1,0,0.004316724635931017,2019-03-29 20:15:00,2019-03-29 20:30:00
113,1,1,0,0.006698754876098896,2019-03-29 20:15:00,2019-03-29 20:30:00
114,4,2,2,0.020144565671519312,2019-03-29 20:15:00,2019-03-29 20:30:00
116,1,0,1,0.003029202527283767,2019-03-29 20:15:00,2019-03-29 20:30:00
119,2,0,2,0.003029202527283767,2019-03-29 20:15:00,2019-03-29 20:30:00
126,8,2,6,0.013902783203485869,2019-03-29 20:15:00,2019-03-29 20:30:00
127,6,5,1,0.011276270420775284,2019-03-29 20:15:00,2019-03-29 20:30:00
129,1,1,0,0.004316724635931017,2019-03-29 20:15:00,2019-03-29 20:30:00
135,3,2,1,0.04376753988841666,2019-03-29 20:15:00,2019-03-29 20:30:00
137,1,0,1,0.003029202527283767,2019-03-29 20:15:00,2019-03-29 20:30:00
138,18,13,5,0.05233522316002387,2019-03-29 20:15:00,2019-03-29 20:30:00
141,3,0,3,0.003029202527283767,2019-03-29 20:15:00,2019-03-29 20:30:00
151,4,2,2,0.009747324191615277,2019-03-29 20:15:00,2019-03-29 20:30:00
153,11,5,6,0.012227525255373739,2019-03-29 20:15:00,2019-03-29 20:30:00
159,2,0,2,0.003029202527283767,2019-03-29 20:15:00,2019-03-29 20:30:00
164,9,4,5,0.012251393969275524,2019-03-29 20:15:00,2019-03-29 20:30:00
168,1,0,1,0.003029202527283767,2019-03-29 20:15:00,2019-03-29 20:30:00
169,1,0,1,0.003029202527283767,2019-03-29 20:15:00,2019-03-29 20:30:00
172,1,1,0,0.006352812270241801,2019-03-29 20:15:00,2019-03-29 20:30:00
173,4,1,3,0.004226951500391197,2019-03-29 20:15:00,2019-03-29 20:30:00
177,2,2,0,0.006891768853225519,2019-03-29 20:15:00,2019-03-29 20:30:00
190,2,1,1,0.004429073749691958,2019-03-29 20:15:00,2019-03-29 20:30:00
191,4,0,4,0.003029202527283767,2019-03-29 20:15:00,2019-03-29 20:30:00
195,2,1,1,0.006236452751757365,2019-03-29 20:15:00,2019-03-29 20:30:00
196,2,1,1,0.004316724635931017,2019-03-29 20:15:00,2019-03-29 20:30:00
197,2,2,0,0.006629566791705385,2019-03-29 20:15:00,2019-03-29 20:30:00
201,4,1,3,0.005604246744578268,2019-03-29 20:15:00,2019-03-29 20:30:00
203,1,1,0,0.005208865817836039,2019-03-29 20:15:00,2019-03-29 20:30:00
1,4,2,2,0.006172701473073162,2019-03-29 20:30:00,2019-03-29 20:45:00
2,1,1,0,0.007662531657581269,2019-03-29 20:30:00,2019-03-29 20:45:00
10,1,1,0,0.003549032732203562,2019-03-29 20:30:00,2019-03-29 20:45:00
11,2,1,1,0.02055492180534971,2019-03-29 20:30:00,2019-03-29 20:45:00
15,1,1,0,0.00573382005672923,2019-03-29 20:30:00,2019-03-29 20:45:00
16,7,2,5,0.005691648649907153,2019-03-29 20:30:00,2019-03-29 20:45:00
18,2,1,1,0.005596083749004596,2019-03-29 20:30:00,2019-03-29 20:45:00
19,7,6,1,0.016887753542702,2019-03-29 20:30:00,2019-03-29 20:45:00
23,4,2,2,0.004447679459698245,2019-03-29 20:30:00,2019-03-29 20:45:00
26,1,1,0,0.003812791996751151,2019-03-29 20:30:00,2019-03-29 20:45:00
28,3,1,2,0.005390380969495696,2019-03-29 20:30:00,2019-03-29 20:45:00
35,2,0,2,0.0030992417591123875,2019-03-29 20:30:00,2019-03-29 20:45:00
37,1,1,0,0.005477833304386688,2019-03-29 20:30:00,2019-03-29 20:45:00
46,4,3,1,0.022863984357955693,2019-03-29 20:30:00,2019-03-29 20:45:00
50,1,0,1,0.0030992417591123875,2019-03-29 20:30:00,2019-03-29 20:45:00
57,3,1,2,0.005874256138337113,2019-03-29 20:30:00,2019-03-29 20:45:00
58,7,1,6,0.003610819209074997,2019-03-29 20:30:00,2019-03-29 20:45:00
61,1,1,0,0.004416530907920809,2019-03-29 20:30:00,2019-03-29 20:45:00
62,3,0,3,0.0030992417591123875,2019-03-29 20:30:00,2019-03-29 20:45:00
64,4,2,2,0.02055492180534971,2019-03-29 20:30:00,2019-03-29 20:45:00
66,1,0,1,0.0030992417591123875,2019-03-29 20:30:00,2019-03-29 20:45:00
67,5,2,3,0.005366629159624161,2019-03-29 20:30:00,2019-03-29 20:45:00
68,2,0,2,0.0030992417591123875,2019-03-29 20:30:00,2019-03-29 20:45:00
69,3,2,1,0.00843228440783407,2019-03-29 20:30:00,2019-03-29 20:45:00
70,2,2,0,0.02515990331626111,2019-03-29 20:30:00,2019-03-29 20:45:00
80,1,1,0,0.0047239740253366014,2019-03-29 20:30:00,2019-03-29 20:45:00
86,2,2,0,0.014610251858435692,2019-03-29 20:30:00,2019-03-29 20:45:00
87,1,1,0,0.004416530907920809,2019-03-29 20:30:00,2019-03-29 20:45:00
88,2,1,1,0.003936102009735636,2019-03-29 20:30:00,2019-03-29 20:45:00
89,4,2,2,0.0077625260650427,2019-03-29 20:30:00,2019-03-29 20:45:00
90,7,5,2,0.010736008143687654,2019-03-29 20:30:00,2019-03-29 20:45:00
104,5,1,4,0.003935639998067459,2019-03-29 20:30:00,2019-03-29 20:45:00
109,4,1,3,0.00573382005672923,2019-03-29 20:30:00,2019-03-29 20:45:00
110,14,9,5,0.05124085429544406,2019-03-29 20:30:00,2019-03-29 20:45:00
111,3,3,0,0.015324678290247832,2019-03-29 20:30:00,2019-03-29 20:45:00
112,1,1,0,0.00573382005672923,2019-03-29 20:30:00,2019-03-29 20:45:00
113,2,0,2,0.0030992417591123875,2019-03-29 20:30:00,2019-03-29 20:45:00
114,4,2,2,0.02055492180534971,2019-03-29 20:30:00,2019-03-29 20:45:00
116,3,2,1,0.004772038237022531,2019-03-29 20:30:00,2019-03-29 20:45:00
119,3,1,2,0.005390380969495696,2019-03-29 20:30:00,2019-03-29 20:45:00
120,1,0,1,0.0030992417591123875,2019-03-29 20:30:00,2019-03-29 20:45:00
122,1,0,1,0.0030992417591123875,2019-03-29 20:30:00,2019-03-29 20:45:00
126,5,5,0,0.006814496236961103,2019-03-29 20:30:00,2019-03-29 20:45:00
127,12,5,7,0.005875715153663438,2019-03-29 20:30:00,2019-03-29 20:45:00
129,2,2,0,0.008689779875326896,2019-03-29 20:30:00,2019-03-29 20:45:00
135,1,0,1,0.0030992417591123875,2019-03-29 20:30:00,2019-03-29 20:45:00
137,5,4,1,0.026249430409524183,2019-03-29 20:30:00,2019-03-29 20:45:00
138,11,7,4,0.013057308630989903,2019-03-29 20:30:00,2019-03-29 20:45:00
141,2,1,1,0.02055492180534971,2019-03-29 20:30:00,2019-03-29 20:45:00
151,2,1,1,0.02055492180534971,2019-03-29 20:30:00,2019-03-29 20:45:00
153,11,5,6,0.008001783038436402,2019-03-29 20:30:00,2019-03-29 20:45:00
159,1,0,1,0.0030992417591123875,2019-03-29 20:30:00,2019-03-29 20:45:00
162,1,1,0,0.006444834714932674,2019-03-29 20:30:00,2019-03-29 20:45:00
164,9,3,6,0.005906655960614771,2019-03-29 20:30:00,2019-03-29 20:45:00
168,3,1,2,0.005596083749004596,2019-03-29 20:30:00,2019-03-29 20:45:00
172,2,1,1,0.017455460011148838,2019-03-29 20:30:00,2019-03-29 20:45:00
173,4,2,2,0.010217105423530975,2019-03-29 20:30:00,2019-03-29 20:45:00
177,2,1,1,0.003935639998067459,2019-03-29 20:30:00,2019-03-29 20:45:00
191,9,1,8,0.0042329354593682745,2019-03-29 20:30:00,2019-03-29 20:45:00
195,2,1,1,0.0047239740253366014,2019-03-29 20:30:00,2019-03-29 20:45:00
196,1,0,1,0.0030992417591123875,2019-03-29 20:30:00,2019-03-29 20:45:00
197,3,3,0,0.006756974956654449,2019-03-29 20:30:00,2019-03-29 20:45:00
201,3,0,3,0.0030992417591123875,2019-03-29 20:30:00,2019-03-29 20:45:00
203,1,1,0,0.004619934183059703,2019-03-29 20:30:00,2019-03-29 20:45:00
1,5,1,4,0.003691190545681548,2019-03-29 20:45:00,2019-03-29 21:00:00
2,2,1,1,0.009117302210215797,2019-03-29 20:45:00,2019-03-29 21:00:00
10,4,2,2,0.019142833587465016,2019-03-29 20:45:00,2019-03-29 21:00:00
11,3,2,1,0.033841540095758,2019-03-29 20:45:00,2019-03-29 21:00:00
16,4,1,3,0.005201700885764207,2019-03-29 20:45:00,2019-03-29 21:00:00
18,4,2,2,0.008391030624738498,2019-03-29 20:45:00,2019-03-29 21:00:00
19,3,3,0,0.007990409817325394,2019-03-29 20:45:00,2019-03-29 21:00:00
26,1,1,0,0.0034874415844070423,2019-03-29 20:45:00,2019-03-29 21:00:00
28,3,1,2,0.005002482757394537,2019-03-29 20:45:00,2019-03-29 21:00:00
35,1,0,1,0.0028761947005835242,2019-03-29 20:45:00,2019-03-29 21:00:00
41,1,0,1,0.0028761947005835242,2019-03-29 20:45:00,2019-03-29 21:00:00
46,6,6,0,0.01305992507300872,2019-03-29 20:45:00,2019-03-29 21:00:00
50,1,0,1,0.0028761947005835242,2019-03-29 20:45:00,2019-03-29 21:00:00
57,2,0,2,0.0028761947005835242,2019-03-29 20:45:00,2019-03-29 21:00:00
58,2,1,1,0.005471039889263332,2019-03-29 20:45:00,2019-03-29 21:00:00
61,2,1,1,0.005321182235877596,2019-03-29 20:45:00,2019-03-29 21:00:00
62,1,0,1,0.0028761947005835242,2019-03-29 20:45:00,2019-03-29 21:00:00
64,3,2,1,0.0706202878000441,2019-03-29 20:45:00,2019-03-29 21:00:00
67,9,5,4,0.007440248892300303,2019-03-29 20:45:00,2019-03-29 21:00:00
68,2,0,2,0.0028761947005835242,2019-03-29 20:45:00,2019-03-29 21:00:00
69,4,1,3,0.00409868846823056,2019-03-29 20:45:00,2019-03-29 21:00:00
70,3,2,1,0.024361297588484338,2019-03-29 20:45:00,2019-03-29 21:00:00
80,3,1,2,0.005201700885764207,2019-03-29 20:45:00,2019-03-29 21:00:00
86,2,2,0,0.017061811561177705,2019-03-29 20:45:00,2019-03-29 21:00:00
87,1,1,0,0.00409868846823056,2019-03-29 20:45:00,2019-03-29 21:00:00
88,4,3,1,0.012338501242626032,2019-03-29 20:45:00,2019-03-29 21:00:00
89,3,1,2,0.013365539433613583,2019-03-29 20:45:00,2019-03-29 21:00:00
90,5,3,2,0.014682518227516048,2019-03-29 20:45:00,2019-03-29 21:00:00
104,2,0,2,0.0028761947005835242,2019-03-29 20:45:00,2019-03-29 21:00:00
109,3,1,2,0.005471039889263332,2019-03-29 20:45:00,2019-03-29 21:00:00
110,9,6,3,0.015147312796186516,2019-03-29 20:45:00,2019-03-29 21:00:00
111,3,2,1,0.008391030624738498,2019-03-29 20:45:00,2019-03-29 21:00:00
112,4,0,4,0.0028761947005835242,2019-03-29 20:45:00,2019-03-29 21:00:00
114,4,2,2,0.019142833587465016,2019-03-29 20:45:00,2019-03-29 21:00:00
116,4,3,1,0.03540947247434651,2019-03-29 20:45:00,2019-03-29 21:00:00
119,1,0,1,0.0028761947005835242,2019-03-29 20:45:00,2019-03-29 21:00:00
120,2,0,2,0.0028761947005835242,2019-03-29 20:45:00,2019-03-29 21:00:00
122,1,0,1,0.0028761947005835242,2019-03-29 20:45:00,2019-03-29 21:00:00
126,3,3,0,0.006873605230109922,2019-03-29 20:45:00,2019-03-29 21:00:00
127,4,0,4,0.0028761947005835242,2019-03-29 20:45:00,2019-03-29 21:00:00
129,2,2,0,0.011002494507265493,2019-03-29 20:45:00,2019-03-29 21:00:00
135,1,0,1,0.0028761947005835242,2019-03-29 20:45:00,2019-03-29 21:00:00
137,7,3,4,0.012209208689029739,2019-03-29 20:45:00,2019-03-29 21:00:00
138,9,7,2,0.034671173680612684,2019-03-29 20:45:00,2019-03-29 21:00:00
141,1,1,0,0.00409868846823056,2019-03-29 20:45:00,2019-03-29 21:00:00
151,2,1,1,0.019142833587465016,2019-03-29 20:45:00,2019-03-29 21:00:00
153,3,0,3,0.0028761947005835242,2019-03-29 20:45:00,2019-03-29 21:00:00
164,5,1,4,0.0036524061976996873,2019-03-29 20:45:00,2019-03-29 21:00:00
168,2,1,1,0.00409868846823056,2019-03-29 20:45:00,2019-03-29 21:00:00
172,3,2,1,0.004445100431981143,2019-03-29 20:45:00,2019-03-29 21:00:00
173,4,2,2,0.03063816392282508,2019-03-29 20:45:00,2019-03-29 21:00:00
190,1,1,0,0.003660647566282334,2019-03-29 20:45:00,2019-03-29 21:00:00
191,3,0,3,0.0028761947005835242,2019-03-29 20:45:00,2019-03-29 21:00:00
195,1,1,0,0.004457415349466545,2019-03-29 20:45:00,2019-03-29 21:00:00
197,3,3,0,0.008347176408750514,2019-03-29 20:45:00,2019-03-29 21:00:00
203,1,1,0,0.004457415349466545,2019-03-29 20:45:00,2019-03-29 21:00:00
1,2,0,2,0.0030071837980421732,2019-03-29 21:00:00,2019-03-29 21:15:00
2,3,1,2,0.00624084586541628,2019-03-29 21:00:00,2019-03-29 21:15:00
5,1,1,0,0.005371907746149556,2019-03-29 21:00:00,2019-03-29 21:15:00
10,4,2,2,0.019992960621231095,2019-03-29 21:00:00,2019-03-29 21:15:00
11,5,3,2,0.02848584903282556,2019-03-29 21:00:00,2019-03-29 21:15:00
16,4,3,1,0.014591607886638429,2019-03-29 21:00:00,2019-03-29 21:15:00
18,2,1,1,0.009595407330761332,2019-03-29 21:00:00,2019-03-29 21:15:00
19,4,1,3,0.0049171540091144834,2019-03-29 21:00:00,2019-03-29 21:15:00
20,2,1,1,0.019992960621231095,2019-03-29 21:00:00,2019-03-29 21:15:00
23,4,2,2,0.005563516392260425,2019-03-29 21:00:00,2019-03-29 21:15:00
26,2,2,0,0.007433933834407411,2019-03-29 21:00:00,2019-03-29 21:15:00
28,3,1,2,0.0044005306628454284,2019-03-29 21:00:00,2019-03-29 21:15:00
35,2,1,1,0.005371907746149556,2019-03-29 21:00:00,2019-03-29 21:15:00
41,6,3,3,0.0174314599713346,2019-03-29 21:00:00,2019-03-29 21:15:00
46,9,4,5,0.01123378326283206,2019-03-29 21:00:00,2019-03-29 21:15:00
57,1,0,1,0.0030071837980421732,2019-03-29 21:00:00,2019-03-29 21:15:00
58,3,2,1,0.005346280400957799,2019-03-29 21:00:00,2019-03-29 21:15:00
61,2,1,1,0.007573767548741992,2019-03-29 21:00:00,2019-03-29 21:15:00
62,1,0,1,0.0030071837980421732,2019-03-29 21:00:00,2019-03-29 21:15:00
64,5,3,2,0.03758536344728826,2019-03-29 21:00:00,2019-03-29 21:15:00
67,7,4,3,0.006841682689369551,2019-03-29 21:00:00,2019-03-29 21:15:00
69,3,0,3,0.0030071837980421732,2019-03-29 21:00:00,2019-03-29 21:15:00
70,4,2,2,0.007453395609612764,2019-03-29 21:00:00,2019-03-29 21:15:00
80,2,0,2,0.0030071837980421732,2019-03-29 21:00:00,2019-03-29 21:15:00
86,1,1,0,0.0052302897038274685,2019-03-29 21:00:00,2019-03-29 21:15:00
88,3,2,1,0.009885564054943617,2019-03-29 21:00:00,2019-03-29 21:15:00
89,4,1,3,0.011411156372438183,2019-03-29 21:00:00,2019-03-29 21:15:00
90,3,3,0,0.020555303443075025,2019-03-29 21:00:00,2019-03-29 21:15:00
104,1,0,1,0.0030071837980421732,2019-03-29 21:00:00,2019-03-29 21:15:00
106,2,1,1,0.019992960621231095,2019-03-29 21:00:00,2019-03-29 21:15:00
109,5,1,4,0.004409219044192558,2019-03-29 21:00:00,2019-03-29 21:15:00
110,4,3,1,0.007749922806080618,2019-03-29 21:00:00,2019-03-29 21:15:00
111,1,0,1,0.0030071837980421732,2019-03-29 21:00:00,2019-03-29 21:15:00
112,2,0,2,0.0030071837980421732,2019-03-29 21:00:00,2019-03-29 21:15:00
114,4,2,2,0.019992960621231095,2019-03-29 21:00:00,2019-03-29 21:15:00
116,7,5,2,0.022000624594721317,2019-03-29 21:00:00,2019-03-29 21:15:00
118,1,1,0,0.0049171540091144834,2019-03-29 21:00:00,2019-03-29 21:15:00
119,3,2,1,0.005563516392260425,2019-03-29 21:00:00,2019-03-29 21:15:00
120,1,1,0,0.007120168921179807,2019-03-29 21:00:00,2019-03-29 21:15:00
126,4,2,2,0.009676501515398058,2019-03-29 21:00:00,2019-03-29 21:15:00
127,1,0,1,0.0030071837980421732,2019-03-29 21:00:00,2019-03-29 21:15:00
129,3,2,1,0.010970293761631045,2019-03-29 21:00:00,2019-03-29 21:15:00
137,6,2,4,0.00659697518002667,2019-03-29 21:00:00,2019-03-29 21:15:00
138,8,3,5,0.020159053421891723,2019-03-29 21:00:00,2019-03-29 21:15:00
151,2,1,1,0.019992960621231095,2019-03-29 21:00:00,2019-03-29 21:15:00
153,2,1,1,0.0049171540091144834,2019-03-29 21:00:00,2019-03-29 21:15:00
159,1,1,0,0.006434671894232918,2019-03-29 21:00:00,2019-03-29 21:15:00
164,4,2,2,0.021451581816322722,2019-03-29 21:00:00,2019-03-29 21:15:00
168,1,1,0,0.005563516392260425,2019-03-29 21:00:00,2019-03-29 21:15:00
170,2,0,2,0.0030071837980421732,2019-03-29 21:00:00,2019-03-29 21:15:00
173,3,1,2,0.0052302897038274685,2019-03-29 21:00:00,2019-03-29 21:15:00
177,2,0,2,0.0030071837980421732,2019-03-29 21:00:00,2019-03-29 21:15:00
189,1,1,0,0.012125619452921076,2019-03-29 21:00:00,2019-03-29 21:15:00
190,2,2,0,0.013637120969842445,2019-03-29 21:00:00,2019-03-29 21:15:00
195,1,1,0,0.004945852313779847,2019-03-29 21:00:00,2019-03-29 21:15:00
196,2,1,1,0.005563516392260425,2019-03-29 21:00:00,2019-03-29 21:15:00
197,2,2,0,0.008465390689561064,2019-03-29 21:00:00,2019-03-29 21:15:00
201,2,2,0,0.004881306511572656,2019-03-29 21:00:00,2019-03-29 21:15:00
2,1,0,1,0.0036045470369294405,2019-03-29 21:15:00,2019-03-29 21:30:00
5,1,1,0,0.006439070309399066,2019-03-29 21:15:00,2019-03-29 21:30:00
10,4,2,2,0.023887846503972722,2019-03-29 21:15:00,2019-03-29 21:30:00
16,3,3,0,0.008093998300147839,2019-03-29 21:15:00,2019-03-29 21:30:00
18,2,2,0,0.010605984916413944,2019-03-29 21:15:00,2019-03-29 21:30:00
19,2,1,1,0.004370591505761709,2019-03-29 21:15:00,2019-03-29 21:30:00
20,2,0,2,0.0036045470369294405,2019-03-29 21:15:00,2019-03-29 21:30:00
23,4,2,2,0.006668724912258511,2019-03-29 21:15:00,2019-03-29 21:30:00
26,1,1,0,0.006439070309399066,2019-03-29 21:15:00,2019-03-29 21:30:00
28,3,3,0,0.012512028247777942,2019-03-29 21:15:00,2019-03-29 21:30:00
35,3,1,2,0.006439070309399066,2019-03-29 21:15:00,2019-03-29 21:30:00
41,6,2,4,0.006269329706019941,2019-03-29 21:15:00,2019-03-29 21:30:00
46,4,0,4,0.0036045470369294405,2019-03-29 21:15:00,2019-03-29 21:30:00
50,1,0,1,0.0036045470369294405,2019-03-29 21:15:00,2019-03-29 21:30:00
58,1,1,0,0.007242291836609408,2019-03-29 21:15:00,2019-03-29 21:30:00
61,1,1,0,0.006341468265409489,2019-03-29 21:15:00,2019-03-29 21:30:00
62,2,1,1,0.023887846503972722,2019-03-29 21:15:00,2019-03-29 21:30:00
64,3,1,2,0.006269329706019941,2019-03-29 21:15:00,2019-03-29 21:30:00
67,4,3,1,0.006668724912258511,2019-03-29 21:15:00,2019-03-29 21:30:00
69,3,0,3,0.0036045470369294405,2019-03-29 21:15:00,2019-03-29 21:30:00
86,1,1,0,0.006269329706019941,2019-03-29 21:15:00,2019-03-29 21:30:00
88,3,2,1,0.010605984916413942,2019-03-29 21:15:00,2019-03-29 21:30:00
89,3,1,2,0.01262074780694653,2019-03-29 21:15:00,2019-03-29 21:30:00
90,2,2,0,0.009735130719744292,2019-03-29 21:15:00,2019-03-29 21:30:00
106,2,1,1,0.023887846503972722,2019-03-29 21:15:00,2019-03-29 21:30:00
109,5,2,3,0.006668724912258511,2019-03-29 21:15:00,2019-03-29 21:30:00
110,2,1,1,0.006668724912258511,2019-03-29 21:15:00,2019-03-29 21:30:00
111,1,0,1,0.0036045470369294405,2019-03-29 21:15:00,2019-03-29 21:30:00
113,1,0,1,0.0036045470369294405,2019-03-29 21:15:00,2019-03-29 21:30:00
114,5,2,3,0.00831967282822396,2019-03-29 21:15:00,2019-03-29 21:30:00
116,3,1,2,0.006269329706019941,2019-03-29 21:15:00,2019-03-29 21:30:00
118,3,3,0,0.00782014942818642,2019-03-29 21:15:00,2019-03-29 21:30:00
119,3,2,1,0.005647332287148821,2019-03-29 21:15:00,2019-03-29 21:30:00
120,1,1,0,0.011199499837962373,2019-03-29 21:15:00,2019-03-29 21:30:00
126,5,4,1,0.008934112375110442,2019-03-29 21:15:00,2019-03-29 21:30:00
127,3,1,2,0.006668724912258511,2019-03-29 21:15:00,2019-03-29 21:30:00
129,3,2,1,0.013769843239314546,2019-03-29 21:15:00,2019-03-29 21:30:00
137,4,2,2,0.008558407093904928,2019-03-29 21:15:00,2019-03-29 21:30:00
138,8,2,6,0.005029820424818767,2019-03-29 21:15:00,2019-03-29 21:30:00
141,1,1,0,0.004625939662039131,2019-03-29 21:15:00,2019-03-29 21:30:00
153,2,2,0,0.0074347693810907795,2019-03-29 21:15:00,2019-03-29 21:30:00
159,1,1,0,0.004317183730874104,2019-03-29 21:15:00,2019-03-29 21:30:00
164,4,2,2,0.026630317181051574,2019-03-29 21:15:00,2019-03-29 21:30:00
170,3,0,3,0.0036045470369294405,2019-03-29 21:15:00,2019-03-29 21:30:00
173,3,1,2,0.006269329706019941,2019-03-29 21:15:00,2019-03-29 21:30:00
175,1,1,0,0.006269329706019941,2019-03-29 21:15:00,2019-03-29 21:30:00
177,2,0,2,0.0036045470369294405,2019-03-29 21:15:00,2019-03-29 21:30:00
189,1,1,0,0.014924373348131893,2019-03-29 21:15:00,2019-03-29 21:30:00
190,5,1,4,0.006269329706019941,2019-03-29 21:15:00,2019-03-29 21:30:00
196,1,0,1,0.0036045470369294405,2019-03-29 21:15:00,2019-03-29 21:30:00
200,1,1,0,0.007242291836609408,2019-03-29 21:15:00,2019-03-29 21:30:00
201,2,2,0,0.0073839114002222745,2019-03-29 21:15:00,2019-03-29 21:30:00
202,2,1,1,0.023887846503972722,2019-03-29 21:15:00,2019-03-29 21:30:00
2,2,1,1,0.008393555409438952,2019-03-29 21:30:00,2019-03-29 21:45:00
5,3,2,1,0.06907786220381733,2019-03-29 21:30:00,2019-03-29 21:45:00
10,4,2,2,0.021028590433563695,2019-03-29 21:30:00,2019-03-29 21:45:00
15,1,0,1,0.0031602357811311437,2019-03-29 21:30:00,2019-03-29 21:45:00
18,4,2,2,0.003974409457028363,2019-03-29 21:30:00,2019-03-29 21:45:00
19,1,0,1,0.0031602357811311437,2019-03-29 21:30:00,2019-03-29 21:45:00
20,2,0,2,0.0031602357811311437,2019-03-29 21:30:00,2019-03-29 21:45:00
21,2,2,0,0.003974409457028363,2019-03-29 21:30:00,2019-03-29 21:45:00
23,4,4,0,0.009225466917321094,2019-03-29 21:30:00,2019-03-29 21:45:00
26,3,2,1,0.029291134935372155,2019-03-29 21:30:00,2019-03-29 21:45:00
28,3,3,0,0.010914027217449341,2019-03-29 21:30:00,2019-03-29 21:45:00
35,2,0,2,0.0031602357811311437,2019-03-29 21:30:00,2019-03-29 21:45:00
41,11,6,5,0.029291134935372155,2019-03-29 21:30:00,2019-03-29 21:45:00
46,1,0,1,0.0031602357811311437,2019-03-29 21:30:00,2019-03-29 21:45:00
50,1,0,1,0.0031602357811311437,2019-03-29 21:30:00,2019-03-29 21:45:00
58,3,2,1,0.00814220593469329,2019-03-29 21:30:00,2019-03-29 21:45:00
61,1,1,0,0.004503501429946778,2019-03-29 21:30:00,2019-03-29 21:45:00
62,4,2,2,0.007833107384206773,2019-03-29 21:30:00,2019-03-29 21:45:00
67,14,4,10,0.004788583132925583,2019-03-29 21:30:00,2019-03-29 21:45:00
79,2,1,1,0.021028590433563695,2019-03-29 21:30:00,2019-03-29 21:45:00
85,3,3,0,0.007499131278064562,2019-03-29 21:30:00,2019-03-29 21:45:00
88,4,3,1,0.006872051017684054,2019-03-29 21:30:00,2019-03-29 21:45:00
89,3,1,2,0.009002527114076175,2019-03-29 21:30:00,2019-03-29 21:45:00
90,2,2,0,0.009673559684578318,2019-03-29 21:30:00,2019-03-29 21:45:00
104,1,0,1,0.0031602357811311437,2019-03-29 21:30:00,2019-03-29 21:45:00
106,3,2,1,0.03889694508599624,2019-03-29 21:30:00,2019-03-29 21:45:00
108,1,0,1,0.0031602357811311437,2019-03-29 21:30:00,2019-03-29 21:45:00
109,5,2,3,0.005846767078762412,2019-03-29 21:30:00,2019-03-29 21:45:00
111,2,0,2,0.0031602357811311437,2019-03-29 21:30:00,2019-03-29 21:45:00
113,1,1,0,0.005846767078762412,2019-03-29 21:30:00,2019-03-29 21:45:00
114,6,3,3,0.013496071259069126,2019-03-29 21:30:00,2019-03-29 21:45:00
116,2,1,1,0.021028590433563695,2019-03-29 21:30:00,2019-03-29 21:45:00
118,2,2,0,0.007177587315789516,2019-03-29 21:30:00,2019-03-29 21:45:00
119,1,0,1,0.0031602357811311437,2019-03-29 21:30:00,2019-03-29 21:45:00
120,3,2,1,0.006155865629248928,2019-03-29 21:30:00,2019-03-29 21:45:00
122,1,0,1,0.0031602357811311437,2019-03-29 21:30:00,2019-03-29 21:45:00
126,2,0,2,0.0031602357811311437,2019-03-29 21:30:00,2019-03-29 21:45:00
127,5,1,4,0.005846767078762412,2019-03-29 21:30:00,2019-03-29 21:45:00
129,2,2,0,0.009673559684578318,2019-03-29 21:30:00,2019-03-29 21:45:00
137,10,3,7,0.013605143933670273,2019-03-29 21:30:00,2019-03-29 21:45:00
138,7,3,4,0.012581601116487446,2019-03-29 21:30:00,2019-03-29 21:45:00
141,1,1,0,0.005846767078762412,2019-03-29 21:30:00,2019-03-29 21:45:00
147,1,1,0,0.0035673226190797535,2019-03-29 21:30:00,2019-03-29 21:45:00
153,1,1,0,0.004402843829664716,2019-03-29 21:30:00,2019-03-29 21:45:00
159,1,1,0,0.005834321666973882,2019-03-29 21:30:00,2019-03-29 21:45:00
170,1,0,1,0.0031602357811311437,2019-03-29 21:30:00,2019-03-29 21:45:00
171,1,1,0,0.005846767078762412,2019-03-29 21:30:00,2019-03-29 21:45:00
173,4,1,3,0.004409868777462541,2019-03-29 21:30:00,2019-03-29 21:45:00
177,2,0,2,0.0031602357811311437,2019-03-29 21:30:00,2019-03-29 21:45:00
197,3,2,1,0.00850840755281662,2019-03-29 21:30:00,2019-03-29 21:45:00
200,1,1,0,0.004812599980433294,2019-03-29 21:30:00,2019-03-29 21:45:00
201,2,2,0,0.006473857243887337,2019-03-29 21:30:00,2019-03-29 21:45:00
202,2,1,1,0.021028590433563695,2019-03-29 21:30:00,2019-03-29 21:45:00
2,2,1,1,0.026395522068993902,2019-03-29 21:45:00,2019-03-29 22:00:00
5,2,1,1,0.019835907034069233,2019-03-29 21:45:00,2019-03-29 22:00:00
10,5,3,2,0.0364599673990648,2019-03-29 21:45:00,2019-03-29 22:00:00
15,1,0,1,0.002980905838964258,2019-03-29 21:45:00,2019-03-29 22:00:00
16,1,1,0,0.003825586931995712,2019-03-29 21:45:00,2019-03-29 22:00:00
18,4,2,2,0.004856212809795427,2019-03-29 21:45:00,2019-03-29 22:00:00
19,2,1,1,0.019835907034069233,2019-03-29 21:45:00,2019-03-29 22:00:00
20,2,1,1,0.019835907034069233,2019-03-29 21:45:00,2019-03-29 22:00:00
21,2,2,0,0.004856212809795427,2019-03-29 21:45:00,2019-03-29 22:00:00
23,5,4,1,0.00964323908094976,2019-03-29 21:45:00,2019-03-29 22:00:00
35,2,0,2,0.002980905838964258,2019-03-29 21:45:00,2019-03-29 22:00:00
40,2,1,1,0.019835907034069233,2019-03-29 21:45:00,2019-03-29 22:00:00
41,6,3,3,0.008830180400775326,2019-03-29 21:45:00,2019-03-29 22:00:00
57,1,1,0,0.00551494911805862,2019-03-29 21:45:00,2019-03-29 22:00:00
58,4,3,1,0.01836872737187108,2019-03-29 21:45:00,2019-03-29 22:00:00
61,1,1,0,0.004247927478511439,2019-03-29 21:45:00,2019-03-29 22:00:00
62,2,1,1,0.012884447011293865,2019-03-29 21:45:00,2019-03-29 22:00:00
67,7,2,5,0.00551494911805862,2019-03-29 21:45:00,2019-03-29 22:00:00
69,2,0,2,0.002980905838964258,2019-03-29 21:45:00,2019-03-29 22:00:00
75,1,1,0,0.011246078847980701,2019-03-29 21:45:00,2019-03-29 22:00:00
79,2,1,1,0.019835907034069233,2019-03-29 21:45:00,2019-03-29 22:00:00
85,3,3,0,0.006742015121454346,2019-03-29 21:45:00,2019-03-29 22:00:00
88,1,0,1,0.002980905838964258,2019-03-29 21:45:00,2019-03-29 22:00:00
89,1,1,0,0.00551494911805862,2019-03-29 21:45:00,2019-03-29 22:00:00
106,3,2,1,0.0366909082291742,2019-03-29 21:45:00,2019-03-29 22:00:00
108,1,0,1,0.002980905838964258,2019-03-29 21:45:00,2019-03-29 22:00:00
109,6,3,3,0.008048992397152982,2019-03-29 21:45:00,2019-03-29 22:00:00
110,2,0,2,0.002980905838964258,2019-03-29 21:45:00,2019-03-29 22:00:00
111,5,1,4,0.003785394959187482,2019-03-29 21:45:00,2019-03-29 22:00:00
114,3,2,1,0.00840398369089212,2019-03-29 21:45:00,2019-03-29 22:00:00
116,4,1,3,0.004159599206067842,2019-03-29 21:45:00,2019-03-29 22:00:00
118,2,2,0,0.005185580963927024,2019-03-29 21:45:00,2019-03-29 22:00:00
119,1,0,1,0.002980905838964258,2019-03-29 21:45:00,2019-03-29 22:00:00
120,3,2,1,0.02756260215309033,2019-03-29 21:45:00,2019-03-29 22:00:00
122,1,0,1,0.002980905838964258,2019-03-29 21:45:00,2019-03-29 22:00:00
126,4,3,1,0.011648009557464756,2019-03-29 21:45:00,2019-03-29 22:00:00
127,3,0,3,0.002980905838964258,2019-03-29 21:45:00,2019-03-29 22:00:00
129,1,1,0,0.00551494911805862,2019-03-29 21:45:00,2019-03-29 22:00:00
137,5,1,4,0.010125672563787262,2019-03-29 21:45:00,2019-03-29 22:00:00
138,15,7,8,0.02718354664449263,2019-03-29 21:45:00,2019-03-29 22:00:00
153,1,1,0,0.003825586931995712,2019-03-29 21:45:00,2019-03-29 22:00:00
154,1,0,1,0.002980905838964258,2019-03-29 21:45:00,2019-03-29 22:00:00
159,1,1,0,0.005869940411797758,2019-03-29 21:45:00,2019-03-29 22:00:00
164,1,0,1,0.002980905838964258,2019-03-29 21:45:00,2019-03-29 22:00:00
168,4,2,2,0.01944392794596282,2019-03-29 21:45:00,2019-03-29 22:00:00
171,1,1,0,0.00551494911805862,2019-03-29 21:45:00,2019-03-29 22:00:00
173,6,3,3,0.019835907034069233,2019-03-29 21:45:00,2019-03-29 22:00:00
177,2,0,2,0.002980905838964258,2019-03-29 21:45:00,2019-03-29 22:00:00
191,2,0,2,0.002980905838964258,2019-03-29 21:45:00,2019-03-29 22:00:00
197,2,2,0,0.008758974984631258,2019-03-29 21:45:00,2019-03-29 22:00:00
200,1,1,0,0.005133036881007898,2019-03-29 21:45:00,2019-03-29 22:00:00
201,2,2,0,0.007542566889005247,2019-03-29 21:45:00,2019-03-29 22:00:00
202,2,1,1,0.019835907034069233,2019-03-29 21:45:00,2019-03-29 22:00:00
1,2,1,1,0.007291875743585486,2019-03-29 22:00:00,2019-03-29 22:15:00
2,1,0,1,0.0039413861460461715,2019-03-29 22:00:00,2019-03-29 22:15:00
5,2,1,1,0.02601256752494857,2019-03-29 22:00:00,2019-03-29 22:15:00
10,2,2,0,0.010642365341124801,2019-03-29 22:00:00,2019-03-29 22:15:00
16,1,1,0,0.007291875743585486,2019-03-29 22:00:00,2019-03-29 22:15:00
18,2,2,0,0.008861225559878585,2019-03-29 22:00:00,2019-03-29 22:15:00
21,3,0,3,0.0039413861460461715,2019-03-29 22:00:00,2019-03-29 22:15:00
23,2,0,2,0.0039413861460461715,2019-03-29 22:00:00,2019-03-29 22:15:00
27,1,0,1,0.0039413861460461715,2019-03-29 22:00:00,2019-03-29 22:15:00
35,1,0,1,0.0039413861460461715,2019-03-29 22:00:00,2019-03-29 22:15:00
41,1,0,1,0.0039413861460461715,2019-03-29 22:00:00,2019-03-29 22:15:00
50,1,0,1,0.0039413861460461715,2019-03-29 22:00:00,2019-03-29 22:15:00
58,2,2,0,0.009751242083727966,2019-03-29 22:00:00,2019-03-29 22:15:00
61,1,1,0,0.007291875743585486,2019-03-29 22:00:00,2019-03-29 22:15:00
67,15,8,7,0.0202557841935663,2019-03-29 22:00:00,2019-03-29 22:15:00
68,1,1,0,0.009383098539865523,2019-03-29 22:00:00,2019-03-29 22:15:00
69,3,0,3,0.0039413861460461715,2019-03-29 22:00:00,2019-03-29 22:15:00
70,1,0,1,0.0039413861460461715,2019-03-29 22:00:00,2019-03-29 22:15:00
75,1,1,0,0.005532921009519736,2019-03-29 22:00:00,2019-03-29 22:15:00
85,2,2,0,0.005616630944815829,2019-03-29 22:00:00,2019-03-29 22:15:00
86,1,1,0,0.005058216011892609,2019-03-29 22:00:00,2019-03-29 22:15:00
88,3,1,2,0.006855130423047959,2019-03-29 22:00:00,2019-03-29 22:15:00
89,1,1,0,0.006855130423047959,2019-03-29 22:00:00,2019-03-29 22:15:00
109,5,2,3,0.006175045877739048,2019-03-29 22:00:00,2019-03-29 22:15:00
110,2,0,2,0.0039413861460461715,2019-03-29 22:00:00,2019-03-29 22:15:00
111,4,0,4,0.0039413861460461715,2019-03-29 22:00:00,2019-03-29 22:15:00
113,1,0,1,0.0039413861460461715,2019-03-29 22:00:00,2019-03-29 22:15:00
114,2,1,1,0.007441979891387594,2019-03-29 22:00:00,2019-03-29 22:15:00
116,3,1,2,0.005616630944815829,2019-03-29 22:00:00,2019-03-29 22:15:00
118,2,1,1,0.006401305852962379,2019-03-29 22:00:00,2019-03-29 22:15:00
119,1,0,1,0.0039413861460461715,2019-03-29 22:00:00,2019-03-29 22:15:00
120,1,1,0,0.007291875743585486,2019-03-29 22:00:00,2019-03-29 22:15:00
126,3,3,0,0.014443167382070441,2019-03-29 22:00:00,2019-03-29 22:15:00
127,1,0,1,0.0039413861460461715,2019-03-29 22:00:00,2019-03-29 22:15:00
129,1,1,0,0.007291875743585486,2019-03-29 22:00:00,2019-03-29 22:15:00
137,5,2,3,0.01432787624235379,2019-03-29 22:00:00,2019-03-29 22:15:00
138,14,8,6,0.02470720383319612,2019-03-29 22:00:00,2019-03-29 22:15:00
151,1,1,0,0.005058216011892609,2019-03-29 22:00:00,2019-03-29 22:15:00
168,4,1,3,0.005616630944815829,2019-03-29 22:00:00,2019-03-29 22:15:00
171,1,1,0,0.006401305852962379,2019-03-29 22:00:00,2019-03-29 22:15:00
173,6,3,3,0.02601256752494857,2019-03-29 22:00:00,2019-03-29 22:15:00
177,1,0,1,0.0039413861460461715,2019-03-29 22:00:00,2019-03-29 22:15:00
191,3,1,2,0.010140105729348245,2019-03-29 22:00:00,2019-03-29 22:15:00
197,3,3,0,0.014293063234268332,2019-03-29 22:00:00,2019-03-29 22:15:00
200,1,1,0,0.008001472221045358,2019-03-29 22:00:00,2019-03-29 22:15:00
201,3,3,0,0.008278548270796214,2019-03-29 22:00:00,2019-03-29 22:15:00
1,3,1,2,0.0063886402532064585,2019-03-29 22:15:00,2019-03-29 22:30:00
2,2,0,2,0.0034531473830296346,2019-03-29 22:15:00,2019-03-29 22:30:00
5,2,1,1,0.022964013920999952,2019-03-29 22:15:00,2019-03-29 22:30:00
10,2,1,1,0.0063886402532064585,2019-03-29 22:15:00,2019-03-29 22:30:00
18,1,0,1,0.0034531473830296346,2019-03-29 22:15:00,2019-03-29 22:30:00
21,3,0,3,0.0034531473830296346,2019-03-29 22:15:00,2019-03-29 22:30:00
27,1,0,1,0.0034531473830296346,2019-03-29 22:15:00,2019-03-29 22:30:00
28,1,1,0,0.010314120115699975,2019-03-29 22:15:00,2019-03-29 22:30:00
35,1,0,1,0.0034531473830296346,2019-03-29 22:15:00,2019-03-29 22:30:00
41,4,3,1,0.07856112066473407,2019-03-29 22:15:00,2019-03-29 22:30:00
46,1,0,1,0.0034531473830296346,2019-03-29 22:15:00,2019-03-29 22:30:00
50,1,0,1,0.0034531473830296346,2019-03-29 22:15:00,2019-03-29 22:30:00
57,1,1,0,0.004818570958797017,2019-03-29 22:15:00,2019-03-29 22:30:00
58,1,1,0,0.005544768402612886,2019-03-29 22:15:00,2019-03-29 22:30:00
61,2,1,1,0.0063886402532064585,2019-03-29 22:15:00,2019-03-29 22:30:00
66,1,0,1,0.0034531473830296346,2019-03-29 22:15:00,2019-03-29 22:30:00
67,6,5,1,0.011488049397441443,2019-03-29 22:15:00,2019-03-29 22:30:00
68,1,1,0,0.0063886402532064585,2019-03-29 22:15:00,2019-03-29 22:30:00
69,3,1,2,0.007549418110331781,2019-03-29 22:15:00,2019-03-29 22:30:00
70,1,0,1,0.0034531473830296346,2019-03-29 22:15:00,2019-03-29 22:30:00
85,2,2,0,0.005410142629814183,2019-03-29 22:15:00,2019-03-29 22:30:00
88,3,1,2,0.006006047368666049,2019-03-29 22:15:00,2019-03-29 22:30:00
89,1,1,0,0.006006047368666049,2019-03-29 22:15:00,2019-03-29 22:30:00
90,1,1,0,0.0063886402532064585,2019-03-29 22:15:00,2019-03-29 22:30:00
104,2,1,1,0.004818570958797017,2019-03-29 22:15:00,2019-03-29 22:30:00
109,4,3,1,0.014054215863748925,2019-03-29 22:15:00,2019-03-29 22:30:00
110,4,1,3,0.005544768402612886,2019-03-29 22:15:00,2019-03-29 22:30:00
111,3,0,3,0.0034531473830296346,2019-03-29 22:15:00,2019-03-29 22:30:00
113,1,0,1,0.0034531473830296346,2019-03-29 22:15:00,2019-03-29 22:30:00
114,4,1,3,0.004818570958797017,2019-03-29 22:15:00,2019-03-29 22:30:00
118,1,0,1,0.0034531473830296346,2019-03-29 22:15:00,2019-03-29 22:30:00
119,2,1,1,0.006168642987107726,2019-03-29 22:15:00,2019-03-29 22:30:00
127,4,3,1,0.008070638799846324,2019-03-29 22:15:00,2019-03-29 22:30:00
129,1,1,0,0.008697147036214442,2019-03-29 22:15:00,2019-03-29 22:30:00
135,1,1,0,0.013219248498172617,2019-03-29 22:15:00,2019-03-29 22:30:00
137,3,1,2,0.004920893818118046,2019-03-29 22:15:00,2019-03-29 22:30:00
138,10,4,6,0.010863296928988846,2019-03-29 22:15:00,2019-03-29 22:30:00
151,1,1,0,0.0044316450064219096,2019-03-29 22:15:00,2019-03-29 22:30:00
153,1,0,1,0.0034531473830296346,2019-03-29 22:15:00,2019-03-29 22:30:00
158,1,1,0,0.0063886402532064585,2019-03-29 22:15:00,2019-03-29 22:30:00
162,1,1,0,0.0063886402532064585,2019-03-29 22:15:00,2019-03-29 22:30:00
168,2,0,2,0.0034531473830296346,2019-03-29 22:15:00,2019-03-29 22:30:00
170,1,1,0,0.015400900243373298,2019-03-29 22:15:00,2019-03-29 22:30:00
172,1,1,0,0.0044316450064219096,2019-03-29 22:15:00,2019-03-29 22:30:00
173,4,2,2,0.022964013920999952,2019-03-29 22:15:00,2019-03-29 22:30:00
177,1,0,1,0.0034531473830296346,2019-03-29 22:15:00,2019-03-29 22:30:00
191,1,1,0,0.006168642987107726,2019-03-29 22:15:00,2019-03-29 22:30:00
197,3,3,0,0.009466967864417584,2019-03-29 22:15:00,2019-03-29 22:30:00
199,3,2,1,0.05905025412676374,2019-03-29 22:15:00,2019-03-29 22:30:00
201,2,1,1,0.004920893818118046,2019-03-29 22:15:00,2019-03-29 22:30:00
202,1,1,0,0.005024354331754853,2019-03-29 22:15:00,2019-03-29 22:30:00
1,1,0,1,0.0037252063221300774,2019-03-29 22:30:00,2019-03-29 22:45:00
2,3,2,1,0.007631039357595319,2019-03-29 22:30:00,2019-03-29 22:45:00
5,2,1,1,0.024746365065378795,2019-03-29 22:30:00,2019-03-29 22:45:00
10,1,0,1,0.0037252063221300774,2019-03-29 22:30:00,2019-03-29 22:45:00
16,5,2,3,0.007407626046674503,2019-03-29 22:30:00,2019-03-29 22:45:00
18,4,1,3,0.005198174211947848,2019-03-29 22:30:00,2019-03-29 22:45:00
19,2,0,2,0.0037252063221300774,2019-03-29 22:30:00,2019-03-29 22:45:00
26,1,1,0,0.005909833880629338,2019-03-29 22:30:00,2019-03-29 22:45:00
28,3,2,1,0.008284010182409983,2019-03-29 22:30:00,2019-03-29 22:45:00
35,1,0,1,0.0037252063221300774,2019-03-29 22:30:00,2019-03-29 22:45:00
41,1,1,0,0.0068919319768584964,2019-03-29 22:30:00,2019-03-29 22:45:00
46,1,0,1,0.0037252063221300774,2019-03-29 22:30:00,2019-03-29 22:45:00
57,2,2,0,0.006781537039312058,2019-03-29 22:30:00,2019-03-29 22:45:00
58,1,1,0,0.012406695728344939,2019-03-29 22:30:00,2019-03-29 22:45:00
61,1,1,0,0.0068919319768584964,2019-03-29 22:30:00,2019-03-29 22:45:00
66,1,0,1,0.0037252063221300774,2019-03-29 22:30:00,2019-03-29 22:45:00
67,2,1,1,0.0068919319768584964,2019-03-29 22:30:00,2019-03-29 22:45:00
68,1,1,0,0.0068919319768584964,2019-03-29 22:30:00,2019-03-29 22:45:00
69,1,1,0,0.008237943926093219,2019-03-29 22:30:00,2019-03-29 22:45:00
74,1,0,1,0.0037252063221300774,2019-03-29 22:30:00,2019-03-29 22:45:00
88,1,0,1,0.0037252063221300774,2019-03-29 22:30:00,2019-03-29 22:45:00
89,2,1,1,0.0068919319768584964,2019-03-29 22:30:00,2019-03-29 22:45:00
90,3,3,0,0.00939628800630828,2019-03-29 22:30:00,2019-03-29 22:45:00
104,2,1,1,0.005308569149494287,2019-03-29 22:30:00,2019-03-29 22:45:00
109,5,3,2,0.005572462954054988,2019-03-29 22:30:00,2019-03-29 22:45:00
111,5,2,3,0.00583635675861569,2019-03-29 22:30:00,2019-03-29 22:45:00
112,1,1,0,0.010767363971497548,2019-03-29 22:30:00,2019-03-29 22:45:00
113,1,0,1,0.0037252063221300774,2019-03-29 22:30:00,2019-03-29 22:45:00
114,2,0,2,0.0037252063221300774,2019-03-29 22:30:00,2019-03-29 22:45:00
118,1,0,1,0.0037252063221300774,2019-03-29 22:30:00,2019-03-29 22:45:00
119,4,1,3,0.0068919319768584964,2019-03-29 22:30:00,2019-03-29 22:45:00
126,5,3,2,0.054694740352887655,2019-03-29 22:30:00,2019-03-29 22:45:00
127,6,3,3,0.004912728442653234,2019-03-29 22:30:00,2019-03-29 22:45:00
129,1,1,0,0.0056781228398626975,2019-03-29 22:30:00,2019-03-29 22:45:00
135,1,1,0,0.009583955875327939,2019-03-29 22:30:00,2019-03-29 22:45:00
137,2,1,1,0.010212304158130363,2019-03-29 22:30:00,2019-03-29 22:45:00
138,8,0,8,0.0037252063221300774,2019-03-29 22:30:00,2019-03-29 22:45:00
140,1,1,0,0.009583955875327939,2019-03-29 22:30:00,2019-03-29 22:45:00
153,2,1,1,0.005308569149494287,2019-03-29 22:30:00,2019-03-29 22:45:00
158,6,6,0,0.018439839050203223,2019-03-29 22:30:00,2019-03-29 22:45:00
159,6,3,3,0.024746365065378795,2019-03-29 22:30:00,2019-03-29 22:45:00
170,2,1,1,0.004121047028971129,2019-03-29 22:30:00,2019-03-29 22:45:00
172,1,1,0,0.005379009073366093,2019-03-29 22:30:00,2019-03-29 22:45:00
173,2,1,1,0.024746365065378795,2019-03-29 22:30:00,2019-03-29 22:45:00
191,2,2,0,0.00650936273323305,2019-03-29 22:30:00,2019-03-29 22:45:00
195,2,2,0,0.004516887735812182,2019-03-29 22:30:00,2019-03-29 22:45:00
197,1,1,0,0.0068919319768584964,2019-03-29 22:30:00,2019-03-29 22:45:00
199,7,3,4,0.01027908899762786,2019-03-29 22:30:00,2019-03-29 22:45:00
201,3,0,3,0.0037252063221300774,2019-03-29 22:30:00,2019-03-29 22:45:00
1,1,0,1,0.004131680965478722,2019-03-29 22:45:00,2019-03-29 23:00:00
2,3,3,0,0.00916619547790885,2019-03-29 22:45:00,2019-03-29 23:00:00
5,2,1,1,0.027265017632456146,2019-03-29 22:45:00,2019-03-29 23:00:00
16,3,1,2,0.0048341379537056054,2019-03-29 22:45:00,2019-03-29 23:00:00
18,3,1,2,0.004813692012546694,2019-03-29 22:45:00,2019-03-29 23:00:00
19,5,0,5,0.004131680965478722,2019-03-29 22:45:00,2019-03-29 23:00:00
26,1,1,0,0.009390695913100412,2019-03-29 22:45:00,2019-03-29 23:00:00
27,1,1,0,0.006297709727580344,2019-03-29 22:45:00,2019-03-29 23:00:00
28,2,1,1,0.00764396590661314,2019-03-29 22:45:00,2019-03-29 23:00:00
35,1,0,1,0.004131680965478722,2019-03-29 22:45:00,2019-03-29 23:00:00
41,1,1,0,0.009383309930433386,2019-03-29 22:45:00,2019-03-29 23:00:00
57,1,1,0,0.00953949651505677,2019-03-29 22:45:00,2019-03-29 23:00:00
58,6,4,2,0.012722780365635577,2019-03-29 22:45:00,2019-03-29 23:00:00
61,2,2,0,0.008814727553657947,2019-03-29 22:45:00,2019-03-29 23:00:00
66,2,1,1,0.006177714106682639,2019-03-29 22:45:00,2019-03-29 23:00:00
67,2,1,1,0.00764396590661314,2019-03-29 22:45:00,2019-03-29 23:00:00
68,1,1,0,0.00764396590661314,2019-03-29 22:45:00,2019-03-29 23:00:00
74,1,0,1,0.004131680965478722,2019-03-29 22:45:00,2019-03-29 23:00:00
88,3,2,1,0.006180513847807132,2019-03-29 22:45:00,2019-03-29 23:00:00
89,2,1,1,0.00938568335796257,2019-03-29 22:45:00,2019-03-29 23:00:00
90,2,2,0,0.00824112617564723,2019-03-29 22:45:00,2019-03-29 23:00:00
109,7,1,6,0.004813692012546694,2019-03-29 22:45:00,2019-03-29 23:00:00
111,2,2,0,0.00764396590661314,2019-03-29 22:45:00,2019-03-29 23:00:00
112,1,1,0,0.01062976725178359,2019-03-29 22:45:00,2019-03-29 23:00:00
113,1,0,1,0.004131680965478722,2019-03-29 22:45:00,2019-03-29 23:00:00
118,1,0,1,0.004131680965478722,2019-03-29 22:45:00,2019-03-29 23:00:00
119,4,1,3,0.00764396590661314,2019-03-29 22:45:00,2019-03-29 23:00:00
126,1,1,0,0.006186403570562976,2019-03-29 22:45:00,2019-03-29 23:00:00
137,3,0,3,0.004131680965478722,2019-03-29 22:45:00,2019-03-29 23:00:00
138,4,0,4,0.004131680965478722,2019-03-29 22:45:00,2019-03-29 23:00:00
140,1,1,0,0.012110438366212199,2019-03-29 22:45:00,2019-03-29 23:00:00
147,1,1,0,0.01062976725178359,2019-03-29 22:45:00,2019-03-29 23:00:00
153,3,1,2,0.0048341379537056054,2019-03-29 22:45:00,2019-03-29 23:00:00
158,3,2,1,0.005495703059614667,2019-03-29 22:45:00,2019-03-29 23:00:00
159,6,3,3,0.027265017632456146,2019-03-29 22:45:00,2019-03-29 23:00:00
162,1,1,0,0.0048341379537056054,2019-03-29 22:45:00,2019-03-29 23:00:00
164,1,1,0,0.00953949651505677,2019-03-29 22:45:00,2019-03-29 23:00:00
170,1,1,0,0.005009752200762326,2019-03-29 22:45:00,2019-03-29 23:00:00
177,2,2,0,0.005495703059614667,2019-03-29 22:45:00,2019-03-29 23:00:00
195,2,2,0,0.005887823436045931,2019-03-29 22:45:00,2019-03-29 23:00:00
199,2,1,1,0.006186403570562976,2019-03-29 22:45:00,2019-03-29 23:00:00
201,2,0,2,0.004131680965478722,2019-03-29 22:45:00,2019-03-29 23:00:00
2,1,1,0,0.005239075153013299,2019-03-29 23:00:00,2019-03-29 23:15:00
5,2,1,1,0.0270374431780463,2019-03-29 23:00:00,2019-03-29 23:15:00
16,3,1,2,0.007552613221117213,2019-03-29 23:00:00,2019-03-29 23:15:00
18,1,0,1,0.004082306118961343,2019-03-29 23:00:00,2019-03-29 23:15:00
19,3,0,3,0.004082306118961343,2019-03-29 23:00:00,2019-03-29 23:15:00
20,1,0,1,0.004082306118961343,2019-03-29 23:00:00,2019-03-29 23:15:00
27,1,1,0,0.007100274066453849,2019-03-29 23:00:00,2019-03-29 23:15:00
28,1,1,0,0.007552613221117213,2019-03-29 23:00:00,2019-03-29 23:15:00
35,1,0,1,0.004082306118961343,2019-03-29 23:00:00,2019-03-29 23:15:00
41,4,4,0,0.007552613221117213,2019-03-29 23:00:00,2019-03-29 23:15:00
57,1,1,0,0.00852172941289359,2019-03-29 23:00:00,2019-03-29 23:15:00
58,5,3,2,0.010444535806247103,2019-03-29 23:00:00,2019-03-29 23:15:00
61,3,2,1,0.009287766772195147,2019-03-29 23:00:00,2019-03-29 23:15:00
66,1,1,0,0.007552613221117213,2019-03-29 23:00:00,2019-03-29 23:15:00
67,3,0,3,0.004082306118961343,2019-03-29 23:00:00,2019-03-29 23:15:00
68,1,1,0,0.007552613221117213,2019-03-29 23:00:00,2019-03-29 23:15:00
70,2,2,0,0.006395844187065256,2019-03-29 23:00:00,2019-03-29 23:15:00
74,1,0,1,0.004082306118961343,2019-03-29 23:00:00,2019-03-29 23:15:00
79,2,1,1,0.0270374431780463,2019-03-29 23:00:00,2019-03-29 23:15:00
86,2,0,2,0.004082306118961343,2019-03-29 23:00:00,2019-03-29 23:15:00
88,1,0,1,0.004082306118961343,2019-03-29 23:00:00,2019-03-29 23:15:00
89,1,1,0,0.007552613221117213,2019-03-29 23:00:00,2019-03-29 23:15:00
90,2,2,0,0.01050272566786737,2019-03-29 23:00:00,2019-03-29 23:15:00
109,3,0,3,0.004082306118961343,2019-03-29 23:00:00,2019-03-29 23:15:00
110,2,2,0,0.007552613221117213,2019-03-29 23:00:00,2019-03-29 23:15:00
111,2,2,0,0.008709382255169169,2019-03-29 23:00:00,2019-03-29 23:15:00
114,1,1,0,0.007100274066453849,2019-03-29 23:00:00,2019-03-29 23:15:00
118,1,0,1,0.004082306118961343,2019-03-29 23:00:00,2019-03-29 23:15:00
119,3,1,2,0.007100274066453849,2019-03-29 23:00:00,2019-03-29 23:15:00
120,1,1,0,0.007552613221117213,2019-03-29 23:00:00,2019-03-29 23:15:00
127,1,1,0,0.01197778189124245,2019-03-29 23:00:00,2019-03-29 23:15:00
129,1,0,1,0.004082306118961343,2019-03-29 23:00:00,2019-03-29 23:15:00
137,2,0,2,0.004082306118961343,2019-03-29 23:00:00,2019-03-29 23:15:00
138,3,1,2,0.007100274066453849,2019-03-29 23:00:00,2019-03-29 23:15:00
141,1,0,1,0.004082306118961343,2019-03-29 23:00:00,2019-03-29 23:15:00
147,1,1,0,0.005239075153013299,2019-03-29 23:00:00,2019-03-29 23:15:00
151,1,1,0,0.007552613221117213,2019-03-29 23:00:00,2019-03-29 23:15:00
153,1,0,1,0.004082306118961343,2019-03-29 23:00:00,2019-03-29 23:15:00
158,1,0,1,0.004082306118961343,2019-03-29 23:00:00,2019-03-29 23:15:00
159,6,3,3,0.0270374431780463,2019-03-29 23:00:00,2019-03-29 23:15:00
162,1,1,0,0.005239075153013299,2019-03-29 23:00:00,2019-03-29 23:15:00
164,1,1,0,0.00852172941289359,2019-03-29 23:00:00,2019-03-29 23:15:00
173,1,0,1,0.004082306118961343,2019-03-29 23:00:00,2019-03-29 23:15:00
177,2,2,0,0.006395844187065256,2019-03-29 23:00:00,2019-03-29 23:15:00
191,4,0,4,0.004082306118961343,2019-03-29 23:00:00,2019-03-29 23:15:00
199,1,1,0,0.007552613221117213,2019-03-29 23:00:00,2019-03-29 23:15:00
1,3,1,2,0.0069744401061191804,2019-03-29 23:15:00,2019-03-29 23:30:00
2,1,1,0,0.0069744401061191804,2019-03-29 23:15:00,2019-03-29 23:30:00
5,2,1,1,0.025019628863901223,2019-03-29 23:15:00,2019-03-29 23:30:00
15,6,3,3,0.025019628863901223,2019-03-29 23:15:00,2019-03-29 23:30:00
16,6,1,5,0.0069744401061191804,2019-03-29 23:15:00,2019-03-29 23:30:00
18,2,0,2,0.003769782273655078,2019-03-29 23:15:00,2019-03-29 23:30:00
19,1,0,1,0.003769782273655078,2019-03-29 23:15:00,2019-03-29 23:30:00
20,1,0,1,0.003769782273655078,2019-03-29 23:15:00,2019-03-29 23:30:00
27,1,1,0,0.005972105539307137,2019-03-29 23:15:00,2019-03-29 23:30:00
30,2,2,0,0.009698749144382048,2019-03-29 23:15:00,2019-03-29 23:30:00
35,1,0,1,0.003769782273655078,2019-03-29 23:15:00,2019-03-29 23:30:00
58,1,1,0,0.006268482447331779,2019-03-29 23:15:00,2019-03-29 23:30:00
61,2,2,0,0.009473140279795882,2019-03-29 23:15:00,2019-03-29 23:30:00
66,2,1,1,0.005372111189887129,2019-03-29 23:15:00,2019-03-29 23:30:00
67,1,0,1,0.003769782273655078,2019-03-29 23:15:00,2019-03-29 23:30:00
68,3,1,2,0.015187153894350148,2019-03-29 23:15:00,2019-03-29 23:30:00
69,1,1,0,0.0069744401061191804,2019-03-29 23:15:00,2019-03-29 23:30:00
74,1,0,1,0.003769782273655078,2019-03-29 23:15:00,2019-03-29 23:30:00
79,2,1,1,0.025019628863901223,2019-03-29 23:15:00,2019-03-29 23:30:00
86,2,0,2,0.003769782273655078,2019-03-29 23:15:00,2019-03-29 23:30:00
87,1,1,0,0.010225417425982122,2019-03-29 23:15:00,2019-03-29 23:30:00
88,3,2,1,0.009522387999396009,2019-03-29 23:15:00,2019-03-29 23:30:00
89,1,1,0,0.011864824748519277,2019-03-29 23:15:00,2019-03-29 23:30:00
90,2,2,0,0.006141369021945866,2019-03-29 23:15:00,2019-03-29 23:30:00
104,2,1,1,0.025019628863901223,2019-03-29 23:15:00,2019-03-29 23:30:00
109,2,0,2,0.003769782273655078,2019-03-29 23:15:00,2019-03-29 23:30:00
110,2,2,0,0.0069744401061191804,2019-03-29 23:15:00,2019-03-29 23:30:00
111,3,3,0,0.0113790866374233,2019-03-29 23:15:00,2019-03-29 23:30:00
113,1,0,1,0.003769782273655078,2019-03-29 23:15:00,2019-03-29 23:30:00
118,3,2,1,0.013430075258446224,2019-03-29 23:15:00,2019-03-29 23:30:00
119,7,3,4,0.010362556745916636,2019-03-29 23:15:00,2019-03-29 23:30:00
120,1,1,0,0.0069744401061191804,2019-03-29 23:15:00,2019-03-29 23:30:00
122,1,1,0,0.006268482447331779,2019-03-29 23:15:00,2019-03-29 23:30:00
129,1,0,1,0.003769782273655078,2019-03-29 23:15:00,2019-03-29 23:30:00
137,9,4,5,0.01469614949173545,2019-03-29 23:15:00,2019-03-29 23:30:00
138,1,0,1,0.003769782273655078,2019-03-29 23:15:00,2019-03-29 23:30:00
141,1,0,1,0.003769782273655078,2019-03-29 23:15:00,2019-03-29 23:30:00
151,1,1,0,0.0069744401061191804,2019-03-29 23:15:00,2019-03-29 23:30:00
153,1,0,1,0.003769782273655078,2019-03-29 23:15:00,2019-03-29 23:30:00
158,1,0,1,0.003769782273655078,2019-03-29 23:15:00,2019-03-29 23:30:00
159,6,3,3,0.025019628863901223,2019-03-29 23:15:00,2019-03-29 23:30:00
164,3,1,2,0.0069744401061191804,2019-03-29 23:15:00,2019-03-29 23:30:00
168,1,1,0,0.004955575647800472,2019-03-29 23:15:00,2019-03-29 23:30:00
170,1,1,0,0.005372111189887129,2019-03-29 23:15:00,2019-03-29 23:30:00
177,2,2,0,0.0069744401061191804,2019-03-29 23:15:00,2019-03-29 23:30:00
1,4,1,3,0.00758076211840621,2019-03-29 23:30:00,2019-03-29 23:45:00
2,1,1,0,0.00758076211840621,2019-03-29 23:30:00,2019-03-29 23:45:00
5,2,1,1,0.027138268448926445,2019-03-29 23:30:00,2019-03-29 23:45:00
15,6,3,3,0.027138268448926445,2019-03-29 23:30:00,2019-03-29 23:45:00
16,2,0,2,0.004097520125651419,2019-03-29 23:30:00,2019-03-29 23:45:00
18,3,0,3,0.004097520125651419,2019-03-29 23:30:00,2019-03-29 23:45:00
26,1,1,0,0.006245637506951484,2019-03-29 23:30:00,2019-03-29 23:45:00
27,1,1,0,0.01202242734512432,2019-03-29 23:30:00,2019-03-29 23:45:00
28,1,1,0,0.008567798835454679,2019-03-29 23:30:00,2019-03-29 23:45:00
30,2,2,0,0.00839375488825155,2019-03-29 23:30:00,2019-03-29 23:45:00
50,1,1,0,0.010541872269551616,2019-03-29 23:30:00,2019-03-29 23:45:00
57,4,2,2,0.008741842782657806,2019-03-29 23:30:00,2019-03-29 23:45:00
58,1,1,0,0.005839141122028815,2019-03-29 23:30:00,2019-03-29 23:45:00
66,1,0,1,0.004097520125651419,2019-03-29 23:30:00,2019-03-29 23:45:00
68,1,0,1,0.004097520125651419,2019-03-29 23:30:00,2019-03-29 23:45:00
86,2,0,2,0.004097520125651419,2019-03-29 23:30:00,2019-03-29 23:45:00
87,1,1,0,0.00758076211840621,2019-03-29 23:30:00,2019-03-29 23:45:00
88,2,1,1,0.00758076211840621,2019-03-29 23:30:00,2019-03-29 23:45:00
89,1,1,0,0.010541872269551616,2019-03-29 23:30:00,2019-03-29 23:45:00
90,1,1,0,0.00758076211840621,2019-03-29 23:30:00,2019-03-29 23:45:00
104,6,3,3,0.027138268448926445,2019-03-29 23:30:00,2019-03-29 23:45:00
109,2,0,2,0.004097520125651419,2019-03-29 23:30:00,2019-03-29 23:45:00
110,2,2,0,0.00758076211840621,2019-03-29 23:30:00,2019-03-29 23:45:00
111,2,0,2,0.004097520125651419,2019-03-29 23:30:00,2019-03-29 23:45:00
112,1,0,1,0.004097520125651419,2019-03-29 23:30:00,2019-03-29 23:45:00
114,2,1,1,0.005258600789903016,2019-03-29 23:30:00,2019-03-29 23:45:00
119,3,2,1,0.009322383114783606,2019-03-29 23:30:00,2019-03-29 23:45:00
122,1,1,0,0.005839141122028815,2019-03-29 23:30:00,2019-03-29 23:45:00
137,2,0,2,0.004097520125651419,2019-03-29 23:30:00,2019-03-29 23:45:00
138,1,0,1,0.004097520125651419,2019-03-29 23:30:00,2019-03-29 23:45:00
140,1,0,1,0.004097520125651419,2019-03-29 23:30:00,2019-03-29 23:45:00
153,1,0,1,0.004097520125651419,2019-03-29 23:30:00,2019-03-29 23:45:00
154,3,2,1,0.00758076211840621,2019-03-29 23:30:00,2019-03-29 23:45:00
162,1,1,0,0.010541872269551616,2019-03-29 23:30:00,2019-03-29 23:45:00
168,1,1,0,0.005839141122028815,2019-03-29 23:30:00,2019-03-29 23:45:00
170,1,1,0,0.005258600789903016,2019-03-29 23:30:00,2019-03-29 23:45:00
177,3,2,1,0.00758076211840621,2019-03-29 23:30:00,2019-03-29 23:45:00
189,1,0,1,0.004097520125651419,2019-03-29 23:30:00,2019-03-29 23:45:00
197,2,2,0,0.011528908986600084,2019-03-29 23:30:00,2019-03-29 23:45:00
1,2,1,1,0.007592233599332119,2019-03-29 23:45:00,2019-03-30 00:00:00
2,1,1,0,0.007592233599332119,2019-03-29 23:45:00,2019-03-30 00:00:00
5,2,1,1,0.027179880004984273,2019-03-29 23:45:00,2019-03-30 00:00:00
15,1,1,0,0.005160918410092686,2019-03-29 23:45:00,2019-03-30 00:00:00
18,2,0,2,0.004103721553289299,2019-03-29 23:45:00,2019-03-30 00:00:00
26,2,1,1,0.010557822112146686,2019-03-29 23:45:00,2019-03-30 00:00:00
27,1,1,0,0.007592233599332119,2019-03-29 23:45:00,2019-03-30 00:00:00
35,1,0,1,0.004103721553289299,2019-03-29 23:45:00,2019-03-30 00:00:00
50,1,1,0,0.005266558901970239,2019-03-29 23:45:00,2019-03-30 00:00:00
57,4,2,2,0.006905174433114096,2019-03-29 23:45:00,2019-03-30 00:00:00
58,1,1,0,0.010557822112146686,2019-03-29 23:45:00,2019-03-30 00:00:00
62,1,1,0,0.015222234676503228,2019-03-29 23:45:00,2019-03-30 00:00:00
74,2,2,0,0.007592233599332119,2019-03-29 23:45:00,2019-03-30 00:00:00
88,1,0,1,0.004103721553289299,2019-03-29 23:45:00,2019-03-30 00:00:00
89,1,1,0,0.007592233599332119,2019-03-29 23:45:00,2019-03-30 00:00:00
104,4,2,2,0.027179880004984273,2019-03-29 23:45:00,2019-03-30 00:00:00
109,2,2,0,0.007592233599332119,2019-03-29 23:45:00,2019-03-30 00:00:00
110,2,0,2,0.004103721553289299,2019-03-29 23:45:00,2019-03-30 00:00:00
111,1,0,1,0.004103721553289299,2019-03-29 23:45:00,2019-03-30 00:00:00
114,1,1,0,0.005847977576310709,2019-03-29 23:45:00,2019-03-30 00:00:00
118,2,0,2,0.004103721553289299,2019-03-29 23:45:00,2019-03-30 00:00:00
119,1,0,1,0.004103721553289299,2019-03-29 23:45:00,2019-03-30 00:00:00
126,2,1,1,0.01307893022896065,2019-03-29 23:45:00,2019-03-30 00:00:00
137,2,1,1,0.007592233599332119,2019-03-29 23:45:00,2019-03-30 00:00:00
138,7,2,5,0.006218115266896073,2019-03-29 23:45:00,2019-03-30 00:00:00
141,1,1,0,0.007592233599332119,2019-03-29 23:45:00,2019-03-30 00:00:00
154,3,0,3,0.004103721553289299,2019-03-29 23:45:00,2019-03-30 00:00:00
162,1,1,0,0.007592233599332119,2019-03-29 23:45:00,2019-03-30 00:00:00
164,1,0,1,0.004103721553289299,2019-03-29 23:45:00,2019-03-30 00:00:00
168,2,2,0,0.006429396250651179,2019-03-29 23:45:00,2019-03-30 00:00:00
170,1,1,0,0.005160918410092686,2019-03-29 23:45:00,2019-03-30 00:00:00
173,1,0,1,0.004103721553289299,2019-03-29 23:45:00,2019-03-30 00:00:00
177,1,0,1,0.004103721553289299,2019-03-29 23:45:00,2019-03-30 00:00:00
189,1,0,1,0.004103721553289299,2019-03-29 23:45:00,2019-03-30 00:00:00
190,1,1,0,0.007592233599332119,2019-03-29 23:45:00,2019-03-30 00:00:00
191,1,0,1,0.004103721553289299,2019-03-29 23:45:00,2019-03-30 00:00:00
197,2,2,0,0.00997376397472646,2019-03-29 23:45:00,2019-03-30 00:00:00
199,1,1,0,0.007592233599332119,2019-03-29 23:45:00,2019-03-30 00:00:00
202,2,1,1,0.027179880004984273,2019-03-29 23:45:00,2019-03-30 00:00:00
1,1,1,0,0.007310456812273391,2019-03-30 00:00:00,2019-03-30 00:15:00
2,5,3,2,0.04854819422960686,2019-03-30 00:00:00,2019-03-30 00:15:00
15,1,1,0,0.004376650268507328,2019-03-30 00:00:00,2019-03-30 00:15:00
16,3,0,3,0.0039514174737585485,2019-03-30 00:00:00,2019-03-30 00:15:00
18,1,0,1,0.0039514174737585485,2019-03-30 00:00:00,2019-03-30 00:15:00
23,1,1,0,0.005513841971903834,2019-03-30 00:00:00,2019-03-30 00:15:00
26,1,0,1,0.0039514174737585485,2019-03-30 00:00:00,2019-03-30 00:15:00
35,1,0,1,0.0039514174737585485,2019-03-30 00:00:00,2019-03-30 00:15:00
41,1,1,0,0.005071097253263495,2019-03-30 00:00:00,2019-03-30 00:15:00
46,1,0,1,0.0039514174737585485,2019-03-30 00:00:00,2019-03-30 00:15:00
50,1,0,1,0.0039514174737585485,2019-03-30 00:00:00,2019-03-30 00:15:00
57,1,1,0,0.005071097253263495,2019-03-30 00:00:00,2019-03-30 00:15:00
58,1,1,0,0.007310456812273391,2019-03-30 00:00:00,2019-03-30 00:15:00
69,2,2,0,0.00773568960702217,2019-03-30 00:00:00,2019-03-30 00:15:00
74,2,2,0,0.006190777032768443,2019-03-30 00:00:00,2019-03-30 00:15:00
88,2,1,1,0.007310456812273391,2019-03-30 00:00:00,2019-03-30 00:15:00
89,1,1,0,0.010165982757915162,2019-03-30 00:00:00,2019-03-30 00:15:00
104,7,5,2,0.07492033939499088,2019-03-30 00:00:00,2019-03-30 00:15:00
109,5,2,3,0.007310456812273391,2019-03-30 00:00:00,2019-03-30 00:15:00
110,2,0,2,0.0039514174737585485,2019-03-30 00:00:00,2019-03-30 00:15:00
111,2,0,2,0.0039514174737585485,2019-03-30 00:00:00,2019-03-30 00:15:00
112,2,2,0,0.006872626397873701,2019-03-30 00:00:00,2019-03-30 00:15:00
114,3,1,2,0.007310456812273391,2019-03-30 00:00:00,2019-03-30 00:15:00
118,3,0,3,0.0039514174737585485,2019-03-30 00:00:00,2019-03-30 00:15:00
119,1,0,1,0.0039514174737585485,2019-03-30 00:00:00,2019-03-30 00:15:00
120,1,1,0,0.004376650268507328,2019-03-30 00:00:00,2019-03-30 00:15:00
126,3,3,0,0.009549816371283285,2019-03-30 00:00:00,2019-03-30 00:15:00
137,1,0,1,0.0039514174737585485,2019-03-30 00:00:00,2019-03-30 00:15:00
138,19,6,13,0.006502814242251222,2019-03-30 00:00:00,2019-03-30 00:15:00
141,5,5,0,0.012908855709798127,2019-03-30 00:00:00,2019-03-30 00:15:00
154,3,0,3,0.0039514174737585485,2019-03-30 00:00:00,2019-03-30 00:15:00
158,2,2,0,0.008094460996529624,2019-03-30 00:00:00,2019-03-30 00:15:00
162,1,1,0,0.006022939235144086,2019-03-30 00:00:00,2019-03-30 00:15:00
164,1,0,1,0.0039514174737585485,2019-03-30 00:00:00,2019-03-30 00:15:00
168,3,3,0,0.007753201530913727,2019-03-30 00:00:00,2019-03-30 00:15:00
170,1,1,0,0.004376650268507328,2019-03-30 00:00:00,2019-03-30 00:15:00
171,2,2,0,0.004801883063256106,2019-03-30 00:00:00,2019-03-30 00:15:00
189,1,0,1,0.0039514174737585485,2019-03-30 00:00:00,2019-03-30 00:15:00
190,1,1,0,0.005071097253263495,2019-03-30 00:00:00,2019-03-30 00:15:00
191,3,0,3,0.0039514174737585485,2019-03-30 00:00:00,2019-03-30 00:15:00
195,6,2,4,0.006872626397873701,2019-03-30 00:00:00,2019-03-30 00:15:00
197,1,1,0,0.007310456812273391,2019-03-30 00:00:00,2019-03-30 00:15:00
199,1,1,0,0.004376650268507328,2019-03-30 00:00:00,2019-03-30 00:15:00
202,4,1,3,0.005513841971903834,2019-03-30 00:00:00,2019-03-30 00:15:00
2,5,2,3,0.008998620682081244,2019-03-30 00:15:00,2019-03-30 00:30:00
5,2,1,1,0.010969622454038833,2019-03-30 00:15:00,2019-03-30 00:30:00
16,1,0,1,0.003898777180773475,2019-03-30 00:15:00,2019-03-30 00:30:00
19,3,0,3,0.003898777180773475,2019-03-30 00:15:00,2019-03-30 00:30:00
23,1,0,1,0.003898777180773475,2019-03-30 00:15:00,2019-03-30 00:30:00
41,3,2,1,0.008317798147121542,2019-03-30 00:15:00,2019-03-30 00:30:00
46,1,0,1,0.003898777180773475,2019-03-30 00:15:00,2019-03-30 00:30:00
50,2,1,1,0.02582285487785446,2019-03-30 00:15:00,2019-03-30 00:30:00
57,2,2,0,0.014328742110860503,2019-03-30 00:15:00,2019-03-30 00:30:00
58,3,3,0,0.011522864460388568,2019-03-30 00:15:00,2019-03-30 00:30:00
66,1,1,0,0.007213042905534526,2019-03-30 00:15:00,2019-03-30 00:30:00
69,2,2,0,0.007765420526328034,2019-03-30 00:15:00,2019-03-30 00:30:00
70,1,0,1,0.003898777180773475,2019-03-30 00:15:00,2019-03-30 00:30:00
74,2,1,1,0.02582285487785446,2019-03-30 00:15:00,2019-03-30 00:30:00
88,1,0,1,0.003898777180773475,2019-03-30 00:15:00,2019-03-30 00:30:00
89,1,1,0,0.007213042905534526,2019-03-30 00:15:00,2019-03-30 00:30:00
90,5,3,2,0.008870175767915052,2019-03-30 00:15:00,2019-03-30 00:30:00
104,1,1,0,0.007213042905534526,2019-03-30 00:15:00,2019-03-30 00:30:00
109,6,3,3,0.019434758877139045,2019-03-30 00:15:00,2019-03-30 00:30:00
110,5,3,2,0.014376748300144552,2019-03-30 00:15:00,2019-03-30 00:30:00
111,2,0,2,0.003898777180773475,2019-03-30 00:15:00,2019-03-30 00:30:00
112,2,2,0,0.006781019169629795,2019-03-30 00:15:00,2019-03-30 00:30:00
114,2,0,2,0.003898777180773475,2019-03-30 00:15:00,2019-03-30 00:30:00
118,1,0,1,0.003898777180773475,2019-03-30 00:15:00,2019-03-30 00:30:00
119,1,1,0,0.0069646273738431155,2019-03-30 00:15:00,2019-03-30 00:30:00
120,1,1,0,0.0044511548015669835,2019-03-30 00:15:00,2019-03-30 00:30:00
122,1,1,0,0.007213042905534526,2019-03-30 00:15:00,2019-03-30 00:30:00
126,4,4,0,0.010527308630295577,2019-03-30 00:15:00,2019-03-30 00:30:00
127,1,1,0,0.0044511548015669835,2019-03-30 00:15:00,2019-03-30 00:30:00
137,4,2,2,0.011439194897601871,2019-03-30 00:15:00,2019-03-30 00:30:00
138,6,0,6,0.003898777180773475,2019-03-30 00:15:00,2019-03-30 00:30:00
141,4,2,2,0.007213042905534526,2019-03-30 00:15:00,2019-03-30 00:30:00
154,3,0,3,0.003898777180773475,2019-03-30 00:15:00,2019-03-30 00:30:00
158,2,2,0,0.0149132149385811,2019-03-30 00:15:00,2019-03-30 00:30:00
162,1,1,0,0.009405996059677287,2019-03-30 00:15:00,2019-03-30 00:30:00
164,1,0,1,0.003898777180773475,2019-03-30 00:15:00,2019-03-30 00:30:00
168,3,3,0,0.009422553388708559,2019-03-30 00:15:00,2019-03-30 00:30:00
170,2,0,2,0.003898777180773475,2019-03-30 00:15:00,2019-03-30 00:30:00
171,2,2,0,0.005003532422360492,2019-03-30 00:15:00,2019-03-30 00:30:00
189,1,1,0,0.005003532422360492,2019-03-30 00:15:00,2019-03-30 00:30:00
191,2,0,2,0.003898777180773475,2019-03-30 00:15:00,2019-03-30 00:30:00
195,6,2,4,0.006781019169629795,2019-03-30 00:15:00,2019-03-30 00:30:00
197,2,1,1,0.02582285487785446,2019-03-30 00:15:00,2019-03-30 00:30:00
199,1,1,0,0.0044511548015669835,2019-03-30 00:15:00,2019-03-30 00:30:00
202,1,0,1,0.003898777180773475,2019-03-30 00:15:00,2019-03-30 00:30:00
203,2,0,2,0.003898777180773475,2019-03-30 00:15:00,2019-03-30 00:30:00
2,1,0,1,0.0040861845476835735,2019-03-30 00:30:00,2019-03-30 00:45:00
5,4,2,2,0.013986305086435225,2019-03-30 00:30:00,2019-03-30 00:45:00
10,5,5,0,0.009296590197359842,2019-03-30 00:30:00,2019-03-30 00:45:00
15,1,0,1,0.0040861845476835735,2019-03-30 00:30:00,2019-03-30 00:45:00
18,1,0,1,0.0040861845476835735,2019-03-30 00:30:00,2019-03-30 00:45:00
19,1,0,1,0.0040861845476835735,2019-03-30 00:30:00,2019-03-30 00:45:00
23,4,0,4,0.0040861845476835735,2019-03-30 00:30:00,2019-03-30 00:45:00
28,2,2,0,0.0075597883141344194,2019-03-30 00:30:00,2019-03-30 00:45:00
41,2,1,1,0.0075597883141344194,2019-03-30 00:30:00,2019-03-30 00:45:00
50,1,1,0,0.0075597883141344194,2019-03-30 00:30:00,2019-03-30 00:45:00
57,2,2,0,0.013504667596753337,2019-03-30 00:30:00,2019-03-30 00:45:00
58,6,6,0,0.015678833510594535,2019-03-30 00:30:00,2019-03-30 00:45:00
66,1,1,0,0.0075597883141344194,2019-03-30 00:30:00,2019-03-30 00:45:00
68,3,1,2,0.0057018958982171,2019-03-30 00:30:00,2019-03-30 00:45:00
70,1,0,1,0.0040861845476835735,2019-03-30 00:30:00,2019-03-30 00:45:00
74,2,1,1,0.02696491449880984,2019-03-30 00:30:00,2019-03-30 00:45:00
86,2,2,0,0.00812546292401739,2019-03-30 00:30:00,2019-03-30 00:45:00
88,1,0,1,0.0040861845476835735,2019-03-30 00:30:00,2019-03-30 00:45:00
89,1,1,0,0.0075597883141344194,2019-03-30 00:30:00,2019-03-30 00:45:00
90,3,3,0,0.013482042122454558,2019-03-30 00:30:00,2019-03-30 00:45:00
109,5,2,3,0.006913679411117245,2019-03-30 00:30:00,2019-03-30 00:45:00
110,3,3,0,0.010468427860918268,2019-03-30 00:30:00,2019-03-30 00:45:00
111,1,0,1,0.0040861845476835735,2019-03-30 00:30:00,2019-03-30 00:45:00
112,4,1,3,0.0057018958982171,2019-03-30 00:30:00,2019-03-30 00:45:00
113,2,0,2,0.0040861845476835735,2019-03-30 00:30:00,2019-03-30 00:45:00
114,2,0,2,0.0040861845476835735,2019-03-30 00:30:00,2019-03-30 00:45:00
116,2,0,2,0.0040861845476835735,2019-03-30 00:30:00,2019-03-30 00:45:00
118,1,0,1,0.0040861845476835735,2019-03-30 00:30:00,2019-03-30 00:45:00
119,1,1,0,0.004954585489296285,2019-03-30 00:30:00,2019-03-30 00:45:00
120,1,1,0,0.00612642315285471,2019-03-30 00:30:00,2019-03-30 00:45:00
126,6,6,0,0.0136385949054234,2019-03-30 00:30:00,2019-03-30 00:45:00
135,2,1,1,0.02696491449880984,2019-03-30 00:30:00,2019-03-30 00:45:00
137,6,2,4,0.009600026919305556,2019-03-30 00:30:00,2019-03-30 00:45:00
138,2,0,2,0.0040861845476835735,2019-03-30 00:30:00,2019-03-30 00:45:00
141,4,0,4,0.0040861845476835735,2019-03-30 00:30:00,2019-03-30 00:45:00
157,1,1,0,0.006045278469504534,2019-03-30 00:30:00,2019-03-30 00:45:00
158,1,0,1,0.0040861845476835735,2019-03-30 00:30:00,2019-03-30 00:45:00
162,1,1,0,0.006045278469504534,2019-03-30 00:30:00,2019-03-30 00:45:00
170,1,0,1,0.0040861845476835735,2019-03-30 00:30:00,2019-03-30 00:45:00
171,1,1,0,0.006509751573483864,2019-03-30 00:30:00,2019-03-30 00:45:00
189,1,1,0,0.0075597883141344194,2019-03-30 00:30:00,2019-03-30 00:45:00
190,2,2,0,0.0075597883141344194,2019-03-30 00:30:00,2019-03-30 00:45:00
191,2,0,2,0.0040861845476835735,2019-03-30 00:30:00,2019-03-30 00:45:00
197,1,0,1,0.0040861845476835735,2019-03-30 00:30:00,2019-03-30 00:45:00
201,4,0,4,0.0040861845476835735,2019-03-30 00:30:00,2019-03-30 00:45:00
203,3,1,2,0.010031063830302491,2019-03-30 00:30:00,2019-03-30 00:45:00
2,1,0,1,0.0039558217261453,2019-03-30 00:45:00,2019-03-30 01:00:00
5,3,2,1,0.010681354257899433,2019-03-30 00:45:00,2019-03-30 01:00:00
10,5,5,0,0.009560432169273745,2019-03-30 00:45:00,2019-03-30 01:00:00
15,1,0,1,0.0039558217261453,2019-03-30 00:45:00,2019-03-30 01:00:00
18,1,0,1,0.0039558217261453,2019-03-30 00:45:00,2019-03-30 01:00:00
19,1,0,1,0.0039558217261453,2019-03-30 00:45:00,2019-03-30 01:00:00
23,3,0,3,0.0039558217261453,2019-03-30 00:45:00,2019-03-30 01:00:00
28,2,2,0,0.005261775292963948,2019-03-30 00:45:00,2019-03-30 01:00:00
35,2,2,0,0.009932787934791206,2019-03-30 00:45:00,2019-03-30 01:00:00
41,2,2,0,0.00868868318313664,2019-03-30 00:45:00,2019-03-30 01:00:00
57,1,1,0,0.005637204859083833,2019-03-30 00:45:00,2019-03-30 01:00:00
58,6,5,1,0.016454755283747263,2019-03-30 00:45:00,2019-03-30 01:00:00
62,1,0,1,0.0039558217261453,2019-03-30 00:45:00,2019-03-30 01:00:00
67,3,0,3,0.0039558217261453,2019-03-30 00:45:00,2019-03-30 01:00:00
68,2,0,2,0.0039558217261453,2019-03-30 00:45:00,2019-03-30 01:00:00
74,2,1,1,0.02610635694019657,2019-03-30 00:45:00,2019-03-30 01:00:00
86,3,3,0,0.010120893213586588,2019-03-30 00:45:00,2019-03-30 01:00:00
88,8,1,7,0.007318587992022367,2019-03-30 00:45:00,2019-03-30 01:00:00
89,1,1,0,0.0048445985723986895,2019-03-30 00:45:00,2019-03-30 01:00:00
90,2,1,1,0.005226467887746238,2019-03-30 00:45:00,2019-03-30 01:00:00
109,6,2,4,0.006446839005885262,2019-03-30 00:45:00,2019-03-30 01:00:00
110,6,3,3,0.01255865842385806,2019-03-30 00:45:00,2019-03-30 01:00:00
111,2,0,2,0.0039558217261453,2019-03-30 00:45:00,2019-03-30 01:00:00
112,1,0,1,0.0039558217261453,2019-03-30 00:45:00,2019-03-30 01:00:00
113,2,0,2,0.0039558217261453,2019-03-30 00:45:00,2019-03-30 01:00:00
114,2,0,2,0.0039558217261453,2019-03-30 00:45:00,2019-03-30 01:00:00
116,4,2,2,0.005261775292963948,2019-03-30 00:45:00,2019-03-30 01:00:00
118,2,2,0,0.0061976659033966775,2019-03-30 00:45:00,2019-03-30 01:00:00
120,1,1,0,0.008199868999271595,2019-03-30 00:45:00,2019-03-30 01:00:00
126,7,5,2,0.012362737390837967,2019-03-30 00:45:00,2019-03-30 01:00:00
127,1,0,1,0.0039558217261453,2019-03-30 00:45:00,2019-03-30 01:00:00
135,2,1,1,0.02610635694019657,2019-03-30 00:45:00,2019-03-30 01:00:00
137,6,4,2,0.009984918530782535,2019-03-30 00:45:00,2019-03-30 01:00:00
138,7,1,6,0.004608798509554624,2019-03-30 00:45:00,2019-03-30 01:00:00
140,2,2,0,0.005637204859083833,2019-03-30 00:45:00,2019-03-30 01:00:00
141,4,0,4,0.0039558217261453,2019-03-30 00:45:00,2019-03-30 01:00:00
147,1,1,0,0.006944304830468253,2019-03-30 00:45:00,2019-03-30 01:00:00
162,3,3,0,0.015835362327878286,2019-03-30 00:45:00,2019-03-30 01:00:00
164,7,3,4,0.014061679428262575,2019-03-30 00:45:00,2019-03-30 01:00:00
169,3,3,0,0.006622152264905468,2019-03-30 00:45:00,2019-03-30 01:00:00
171,1,1,0,0.005637204859083833,2019-03-30 00:45:00,2019-03-30 01:00:00
190,2,2,0,0.00842877686118012,2019-03-30 00:45:00,2019-03-30 01:00:00
191,2,0,2,0.0039558217261453,2019-03-30 00:45:00,2019-03-30 01:00:00
196,1,1,0,0.017943992627772257,2019-03-30 00:45:00,2019-03-30 01:00:00
201,6,2,4,0.005978893700668897,2019-03-30 00:45:00,2019-03-30 01:00:00
203,1,1,0,0.013035931307815685,2019-03-30 00:45:00,2019-03-30 01:00:00
2,1,0,1,0.0038067394478053743,2019-03-30 01:00:00,2019-03-30 01:15:00
5,2,1,1,0.007042796188556324,2019-03-30 01:00:00,2019-03-30 01:15:00
10,2,2,0,0.007042796188556324,2019-03-30 01:00:00,2019-03-30 01:15:00
15,1,0,1,0.0038067394478053743,2019-03-30 01:00:00,2019-03-30 01:15:00
23,1,0,1,0.0038067394478053743,2019-03-30 01:00:00,2019-03-30 01:15:00
28,1,1,0,0.007042796188556324,2019-03-30 01:00:00,2019-03-30 01:15:00
41,1,1,0,0.006719413681274371,2019-03-30 01:00:00,2019-03-30 01:15:00
57,1,1,0,0.005424767818180849,2019-03-30 01:00:00,2019-03-30 01:15:00
58,12,7,5,0.040617516163747334,2019-03-30 01:00:00,2019-03-30 01:15:00
62,1,0,1,0.0038067394478053743,2019-03-30 01:00:00,2019-03-30 01:15:00
67,3,0,3,0.0038067394478053743,2019-03-30 01:00:00,2019-03-30 01:15:00
74,2,1,1,0.025235573750912448,2019-03-30 01:00:00,2019-03-30 01:15:00
75,4,2,2,0.025235573750912448,2019-03-30 01:00:00,2019-03-30 01:15:00
86,1,1,0,0.00488542502805569,2019-03-30 01:00:00,2019-03-30 01:15:00
88,4,1,3,0.007042796188556324,2019-03-30 01:00:00,2019-03-30 01:15:00
89,1,1,0,0.0058024193546650305,2019-03-30 01:00:00,2019-03-30 01:15:00
90,1,0,1,0.0038067394478053743,2019-03-30 01:00:00,2019-03-30 01:15:00
109,5,2,3,0.010278852929307273,2019-03-30 01:00:00,2019-03-30 01:15:00
110,3,1,2,0.007042796188556324,2019-03-30 01:00:00,2019-03-30 01:15:00
113,1,0,1,0.0038067394478053743,2019-03-30 01:00:00,2019-03-30 01:15:00
115,1,0,1,0.0038067394478053743,2019-03-30 01:00:00,2019-03-30 01:15:00
116,3,3,0,0.006233782003368586,2019-03-30 01:00:00,2019-03-30 01:15:00
118,2,2,0,0.005964110608306007,2019-03-30 01:00:00,2019-03-30 01:15:00
119,1,0,1,0.0038067394478053743,2019-03-30 01:00:00,2019-03-30 01:15:00
126,4,2,2,0.007042796188556324,2019-03-30 01:00:00,2019-03-30 01:15:00
127,1,0,1,0.0038067394478053743,2019-03-30 01:00:00,2019-03-30 01:15:00
129,1,1,0,0.007042796188556324,2019-03-30 01:00:00,2019-03-30 01:15:00
135,2,1,1,0.025235573750912448,2019-03-30 01:00:00,2019-03-30 01:15:00
137,2,0,2,0.0038067394478053743,2019-03-30 01:00:00,2019-03-30 01:15:00
138,4,0,4,0.0038067394478053743,2019-03-30 01:00:00,2019-03-30 01:15:00
140,1,1,0,0.007042796188556324,2019-03-30 01:00:00,2019-03-30 01:15:00
141,2,0,2,0.0038067394478053743,2019-03-30 01:00:00,2019-03-30 01:15:00
154,1,0,1,0.0038067394478053743,2019-03-30 01:00:00,2019-03-30 01:15:00
162,3,3,0,0.01270645340185334,2019-03-30 01:00:00,2019-03-30 01:15:00
164,2,2,0,0.009793779168384344,2019-03-30 01:00:00,2019-03-30 01:15:00
169,2,2,0,0.007798099261524687,2019-03-30 01:00:00,2019-03-30 01:15:00
170,1,1,0,0.007042796188556324,2019-03-30 01:00:00,2019-03-30 01:15:00
173,2,1,1,0.025235573750912448,2019-03-30 01:00:00,2019-03-30 01:15:00
191,2,0,2,0.0038067394478053743,2019-03-30 01:00:00,2019-03-30 01:15:00
196,1,1,0,0.010713190010694464,2019-03-30 01:00:00,2019-03-30 01:15:00
201,7,4,3,0.021341328992240283,2019-03-30 01:00:00,2019-03-30 01:15:00
203,1,1,0,0.009793779168384344,2019-03-30 01:00:00,2019-03-30 01:15:00
15,1,0,1,0.004146752078407651,2019-03-30 01:15:00,2019-03-30 01:30:00
16,1,0,1,0.004146752078407651,2019-03-30 01:15:00,2019-03-30 01:30:00
18,1,1,0,0.008670750911399471,2019-03-30 01:15:00,2019-03-30 01:30:00
23,1,0,1,0.004146752078407651,2019-03-30 01:15:00,2019-03-30 01:30:00
28,3,3,0,0.008846884307084649,2019-03-30 01:15:00,2019-03-30 01:30:00
50,2,0,2,0.004146752078407651,2019-03-30 01:15:00,2019-03-30 01:30:00
57,1,1,0,0.007319584458545044,2019-03-30 01:15:00,2019-03-30 01:30:00
58,3,1,2,0.0076718512499153995,2019-03-30 01:15:00,2019-03-30 01:30:00
61,2,2,0,0.0076718512499153995,2019-03-30 01:15:00,2019-03-30 01:30:00
67,2,0,2,0.004146752078407651,2019-03-30 01:15:00,2019-03-30 01:30:00
74,2,1,1,0.0274645001012381,2019-03-30 01:15:00,2019-03-30 01:30:00
75,4,2,2,0.0274645001012381,2019-03-30 01:15:00,2019-03-30 01:30:00
88,1,0,1,0.004146752078407651,2019-03-30 01:15:00,2019-03-30 01:30:00
89,2,2,0,0.011196950421423147,2019-03-30 01:15:00,2019-03-30 01:30:00
106,1,1,0,0.0076718512499153995,2019-03-30 01:15:00,2019-03-30 01:30:00
108,1,0,1,0.004146752078407651,2019-03-30 01:15:00,2019-03-30 01:30:00
109,5,2,3,0.011196950421423147,2019-03-30 01:15:00,2019-03-30 01:30:00
110,2,0,2,0.004146752078407651,2019-03-30 01:15:00,2019-03-30 01:30:00
113,2,0,2,0.004146752078407651,2019-03-30 01:15:00,2019-03-30 01:30:00
114,3,3,0,0.014193649405875362,2019-03-30 01:15:00,2019-03-30 01:30:00
115,1,0,1,0.004146752078407651,2019-03-30 01:15:00,2019-03-30 01:30:00
116,2,1,1,0.0053217851355769,2019-03-30 01:15:00,2019-03-30 01:30:00
118,4,2,2,0.0076718512499153995,2019-03-30 01:15:00,2019-03-30 01:30:00
119,1,0,1,0.004146752078407651,2019-03-30 01:15:00,2019-03-30 01:30:00
126,2,2,0,0.0076718512499153995,2019-03-30 01:15:00,2019-03-30 01:30:00
129,1,1,0,0.0076718512499153995,2019-03-30 01:15:00,2019-03-30 01:30:00
135,2,1,1,0.0274645001012381,2019-03-30 01:15:00,2019-03-30 01:30:00
137,1,0,1,0.004146752078407651,2019-03-30 01:15:00,2019-03-30 01:30:00
138,3,0,3,0.004146752078407651,2019-03-30 01:15:00,2019-03-30 01:30:00
140,1,1,0,0.0076718512499153995,2019-03-30 01:15:00,2019-03-30 01:30:00
154,1,0,1,0.004146752078407651,2019-03-30 01:15:00,2019-03-30 01:30:00
162,1,1,0,0.007319584458545044,2019-03-30 01:15:00,2019-03-30 01:30:00
164,2,2,0,0.0076718512499153995,2019-03-30 01:15:00,2019-03-30 01:30:00
191,2,0,2,0.004146752078407651,2019-03-30 01:15:00,2019-03-30 01:30:00
201,4,4,0,0.015016415671674256,2019-03-30 01:15:00,2019-03-30 01:30:00
15,1,0,1,0.004340629059112831,2019-03-30 01:30:00,2019-03-30 01:45:00
23,1,0,1,0.004340629059112831,2019-03-30 01:30:00,2019-03-30 01:45:00
28,1,1,0,0.006185568802785625,2019-03-30 01:30:00,2019-03-30 01:45:00
50,2,0,2,0.004340629059112831,2019-03-30 01:30:00,2019-03-30 01:45:00
58,3,3,0,0.020660455804850632,2019-03-30 01:30:00,2019-03-30 01:45:00
61,2,2,0,0.008030508546458419,2019-03-30 01:30:00,2019-03-30 01:45:00
67,1,0,1,0.004340629059112831,2019-03-30 01:30:00,2019-03-30 01:45:00
88,4,3,1,0.011239401836582546,2019-03-30 01:30:00,2019-03-30 01:45:00
89,1,1,0,0.013895159490894144,2019-03-30 01:30:00,2019-03-30 01:45:00
109,4,2,2,0.013967308929485216,2019-03-30 01:30:00,2019-03-30 01:45:00
111,3,0,3,0.004340629059112831,2019-03-30 01:30:00,2019-03-30 01:45:00
114,5,3,2,0.014857131885337063,2019-03-30 01:30:00,2019-03-30 01:45:00
118,3,1,2,0.008030508546458419,2019-03-30 01:30:00,2019-03-30 01:45:00
126,2,2,0,0.006577059978833575,2019-03-30 01:30:00,2019-03-30 01:45:00
135,2,1,1,0.028409190880208584,2019-03-30 01:30:00,2019-03-30 01:45:00
137,1,0,1,0.004340629059112831,2019-03-30 01:30:00,2019-03-30 01:45:00
138,2,0,2,0.004340629059112831,2019-03-30 01:30:00,2019-03-30 01:45:00
141,2,0,2,0.004340629059112831,2019-03-30 01:30:00,2019-03-30 01:45:00
158,3,3,0,0.008030508546458419,2019-03-30 01:30:00,2019-03-30 01:45:00
162,1,1,0,0.010277429442139628,2019-03-30 01:30:00,2019-03-30 01:45:00
164,3,1,2,0.007549522349236959,2019-03-30 01:30:00,2019-03-30 01:45:00
172,1,1,0,0.005458844518973203,2019-03-30 01:30:00,2019-03-30 01:45:00
173,1,0,1,0.004340629059112831,2019-03-30 01:30:00,2019-03-30 01:45:00
191,7,2,5,0.006577059978833575,2019-03-30 01:30:00,2019-03-30 01:45:00
199,1,1,0,0.008030508546458419,2019-03-30 01:30:00,2019-03-30 01:45:00
201,1,1,0,0.006185568802785625,2019-03-30 01:30:00,2019-03-30 01:45:00
18,1,0,1,0.0044674416784946805,2019-03-30 01:45:00,2019-03-30 02:00:00
23,1,0,1,0.0044674416784946805,2019-03-30 01:45:00,2019-03-30 02:00:00
58,4,4,0,0.015860536365063155,2019-03-30 01:45:00,2019-03-30 02:00:00
67,1,0,1,0.0044674416784946805,2019-03-30 01:45:00,2019-03-30 02:00:00
88,6,1,5,0.00636629079292276,2019-03-30 01:45:00,2019-03-30 02:00:00
89,1,1,0,0.00554982312293985,2019-03-30 01:45:00,2019-03-30 02:00:00
109,4,2,2,0.014375461904996951,2019-03-30 01:45:00,2019-03-30 02:00:00
110,1,1,0,0.008265139907350838,2019-03-30 01:45:00,2019-03-30 02:00:00
111,3,0,3,0.0044674416784946805,2019-03-30 01:45:00,2019-03-30 02:00:00
114,2,0,2,0.0044674416784946805,2019-03-30 01:45:00,2019-03-30 02:00:00
115,4,4,0,0.00879696745627536,2019-03-30 01:45:00,2019-03-30 02:00:00
118,1,1,0,0.008265139907350838,2019-03-30 01:45:00,2019-03-30 02:00:00
119,1,0,1,0.0044674416784946805,2019-03-30 01:45:00,2019-03-30 02:00:00
122,1,1,0,0.00636629079292276,2019-03-30 01:45:00,2019-03-30 02:00:00
126,2,2,0,0.00699924049773212,2019-03-30 01:45:00,2019-03-30 02:00:00
135,2,1,1,0.029234665852148307,2019-03-30 01:45:00,2019-03-30 02:00:00
137,1,0,1,0.0044674416784946805,2019-03-30 01:45:00,2019-03-30 02:00:00
138,1,0,1,0.0044674416784946805,2019-03-30 01:45:00,2019-03-30 02:00:00
141,1,0,1,0.0044674416784946805,2019-03-30 01:45:00,2019-03-30 02:00:00
158,3,3,0,0.008265139907350838,2019-03-30 01:45:00,2019-03-30 02:00:00
162,1,1,0,0.010577763676140793,2019-03-30 01:45:00,2019-03-30 02:00:00
164,2,0,2,0.0044674416784946805,2019-03-30 01:45:00,2019-03-30 02:00:00
172,2,2,0,0.009531039316969558,2019-03-30 01:45:00,2019-03-30 02:00:00
191,3,0,3,0.0044674416784946805,2019-03-30 01:45:00,2019-03-30 02:00:00
201,1,1,0,0.008265139907350838,2019-03-30 01:45:00,2019-03-30 02:00:00
16,1,0,1,0.004239770716725461,2019-03-30 02:00:00,2019-03-30 02:15:00
18,1,0,1,0.004239770716725461,2019-03-30 02:00:00,2019-03-30 02:15:00
23,1,0,1,0.004239770716725461,2019-03-30 02:00:00,2019-03-30 02:15:00
26,1,1,0,0.007374138885825637,2019-03-30 02:00:00,2019-03-30 02:15:00
58,2,2,0,0.01144809015170068,2019-03-30 02:00:00,2019-03-30 02:15:00
68,1,1,0,0.008110161405599187,2019-03-30 02:00:00,2019-03-30 02:15:00
88,5,0,5,0.004239770716725461,2019-03-30 02:00:00,2019-03-30 02:15:00
89,1,1,0,0.004960602660222983,2019-03-30 02:00:00,2019-03-30 02:15:00
109,3,2,1,0.012709905138249983,2019-03-30 02:00:00,2019-03-30 02:15:00
110,1,1,0,0.00784393043421307,2019-03-30 02:00:00,2019-03-30 02:15:00
115,8,6,2,0.047148395742964984,2019-03-30 02:00:00,2019-03-30 02:15:00
119,1,0,1,0.004239770716725461,2019-03-30 02:00:00,2019-03-30 02:15:00
126,2,2,0,0.00784393043421307,2019-03-30 02:00:00,2019-03-30 02:15:00
135,2,1,1,0.028077895731302975,2019-03-30 02:00:00,2019-03-30 02:15:00
137,1,0,1,0.004239770716725461,2019-03-30 02:00:00,2019-03-30 02:15:00
138,5,3,2,0.01144809015170068,2019-03-30 02:00:00,2019-03-30 02:15:00
141,1,0,1,0.004239770716725461,2019-03-30 02:00:00,2019-03-30 02:15:00
162,1,1,0,0.015044446939766023,2019-03-30 02:00:00,2019-03-30 02:15:00
170,2,0,2,0.004239770716725461,2019-03-30 02:00:00,2019-03-30 02:15:00
172,1,1,0,0.00784393043421307,2019-03-30 02:00:00,2019-03-30 02:15:00
191,2,0,2,0.004239770716725461,2019-03-30 02:00:00,2019-03-30 02:15:00
196,3,1,2,0.007374138885825637,2019-03-30 02:00:00,2019-03-30 02:15:00
199,1,1,0,0.008110161405599187,2019-03-30 02:00:00,2019-03-30 02:15:00
201,3,1,2,0.009105745420762373,2019-03-30 02:00:00,2019-03-30 02:15:00
16,1,0,1,0.003940074259553308,2019-03-30 02:15:00,2019-03-30 02:30:00
23,1,0,1,0.003940074259553308,2019-03-30 02:15:00,2019-03-30 02:30:00
26,1,1,0,0.007289487044471385,2019-03-30 02:15:00,2019-03-30 02:30:00
46,2,0,2,0.003940074259553308,2019-03-30 02:15:00,2019-03-30 02:30:00
58,1,1,0,0.005056545187859333,2019-03-30 02:15:00,2019-03-30 02:30:00
68,1,1,0,0.01239170295244446,2019-03-30 02:15:00,2019-03-30 02:30:00
88,6,2,4,0.007289487044471385,2019-03-30 02:15:00,2019-03-30 02:30:00
89,2,1,1,0.00548926748351951,2019-03-30 02:15:00,2019-03-30 02:30:00
109,5,1,4,0.007289487044471385,2019-03-30 02:15:00,2019-03-30 02:30:00
110,1,1,0,0.007289487044471385,2019-03-30 02:15:00,2019-03-30 02:30:00
111,9,6,3,0.05703301256941118,2019-03-30 02:15:00,2019-03-30 02:30:00
112,1,0,1,0.003940074259553308,2019-03-30 02:15:00,2019-03-30 02:30:00
115,5,4,1,0.05703301256941118,2019-03-30 02:15:00,2019-03-30 02:30:00
119,1,0,1,0.003940074259553308,2019-03-30 02:15:00,2019-03-30 02:30:00
126,3,3,0,0.010638899829389462,2019-03-30 02:15:00,2019-03-30 02:30:00
135,2,1,1,0.026182073418971885,2019-03-30 02:15:00,2019-03-30 02:30:00
137,3,0,3,0.003940074259553308,2019-03-30 02:15:00,2019-03-30 02:30:00
138,4,3,1,0.010638899829389462,2019-03-30 02:15:00,2019-03-30 02:30:00
162,1,1,0,0.00548926748351951,2019-03-30 02:15:00,2019-03-30 02:30:00
170,2,0,2,0.003940074259553308,2019-03-30 02:15:00,2019-03-30 02:30:00
191,2,0,2,0.003940074259553308,2019-03-30 02:15:00,2019-03-30 02:30:00
196,1,0,1,0.003940074259553308,2019-03-30 02:15:00,2019-03-30 02:30:00
199,1,1,0,0.01239170295244446,2019-03-30 02:15:00,2019-03-30 02:30:00
201,6,4,2,0.01988355823062681,2019-03-30 02:15:00,2019-03-30 02:30:00
10,3,1,2,0.007331223780888041,2019-03-30 02:30:00,2019-03-30 02:45:00
23,1,0,1,0.004215080814689904,2019-03-30 02:30:00,2019-03-30 02:45:00
26,1,1,0,0.0077982691322091725,2019-03-30 02:30:00,2019-03-30 02:45:00
46,3,0,3,0.004215080814689904,2019-03-30 02:30:00,2019-03-30 02:45:00
58,1,1,0,0.006006674973449538,2019-03-30 02:30:00,2019-03-30 02:45:00
61,2,0,2,0.004215080814689904,2019-03-30 02:30:00,2019-03-30 02:45:00
69,1,0,1,0.004215080814689904,2019-03-30 02:30:00,2019-03-30 02:45:00
88,6,2,4,0.006603873026369416,2019-03-30 02:30:00,2019-03-30 02:45:00
89,1,1,0,0.005618558377617997,2019-03-30 02:30:00,2019-03-30 02:45:00
109,2,1,1,0.0077982691322091725,2019-03-30 02:30:00,2019-03-30 02:45:00
110,3,1,2,0.0077982691322091725,2019-03-30 02:30:00,2019-03-30 02:45:00
111,6,3,3,0.027816472292391196,2019-03-30 02:30:00,2019-03-30 02:45:00
112,1,0,1,0.004215080814689904,2019-03-30 02:30:00,2019-03-30 02:45:00
115,6,4,2,0.014654535845062254,2019-03-30 02:30:00,2019-03-30 02:45:00
119,2,1,1,0.006006674973449538,2019-03-30 02:30:00,2019-03-30 02:45:00
126,3,3,0,0.01290449890037327,2019-03-30 02:30:00,2019-03-30 02:45:00
135,2,1,1,0.027816472292391196,2019-03-30 02:30:00,2019-03-30 02:45:00
137,2,0,2,0.004215080814689904,2019-03-30 02:30:00,2019-03-30 02:45:00
138,1,0,1,0.004215080814689904,2019-03-30 02:30:00,2019-03-30 02:45:00
157,1,1,0,0.010444103156277975,2019-03-30 02:30:00,2019-03-30 02:45:00
160,1,1,0,0.0077982691322091725,2019-03-30 02:30:00,2019-03-30 02:45:00
162,1,1,0,0.01084435203349883,2019-03-30 02:30:00,2019-03-30 02:45:00
164,1,1,0,0.006006674973449538,2019-03-30 02:30:00,2019-03-30 02:45:00
170,1,1,0,0.007331223780888041,2019-03-30 02:30:00,2019-03-30 02:45:00
172,1,1,0,0.005409476920529659,2019-03-30 02:30:00,2019-03-30 02:45:00
191,2,0,2,0.004215080814689904,2019-03-30 02:30:00,2019-03-30 02:45:00
196,1,0,1,0.004215080814689904,2019-03-30 02:30:00,2019-03-30 02:45:00
199,1,1,0,0.01800302291711937,2019-03-30 02:30:00,2019-03-30 02:45:00
201,5,4,1,0.016219134509777737,2019-03-30 02:30:00,2019-03-30 02:45:00
10,2,0,2,0.004441948954469415,2019-03-30 02:45:00,2019-03-30 03:00:00
23,1,0,1,0.004441948954469415,2019-03-30 02:45:00,2019-03-30 03:00:00
46,2,0,2,0.004441948954469415,2019-03-30 02:45:00,2019-03-30 03:00:00
57,1,1,0,0.005154434034515257,2019-03-30 02:45:00,2019-03-30 03:00:00
58,1,1,0,0.006198324726174517,2019-03-30 02:45:00,2019-03-30 03:00:00
61,2,0,2,0.004441948954469415,2019-03-30 02:45:00,2019-03-30 03:00:00
67,1,1,0,0.005154434034515257,2019-03-30 02:45:00,2019-03-30 03:00:00
69,1,0,1,0.004441948954469415,2019-03-30 02:45:00,2019-03-30 03:00:00
88,4,0,4,0.004441948954469415,2019-03-30 02:45:00,2019-03-30 03:00:00
89,1,1,0,0.005385954783772502,2019-03-30 02:45:00,2019-03-30 03:00:00
109,2,1,1,0.008217972271681761,2019-03-30 02:45:00,2019-03-30 03:00:00
110,1,1,0,0.005154434034515257,2019-03-30 02:45:00,2019-03-30 03:00:00
112,9,2,7,0.005866919114561099,2019-03-30 02:45:00,2019-03-30 03:00:00
115,6,4,2,0.012651499668533968,2019-03-30 02:45:00,2019-03-30 03:00:00
119,1,1,0,0.0063299606130755885,2019-03-30 02:45:00,2019-03-30 03:00:00
126,3,3,0,0.011993995588894107,2019-03-30 02:45:00,2019-03-30 03:00:00
127,1,0,1,0.004441948954469415,2019-03-30 02:45:00,2019-03-30 03:00:00
135,2,1,1,0.029068985360681712,2019-03-30 02:45:00,2019-03-30 03:00:00
137,4,1,3,0.006198324726174517,2019-03-30 02:45:00,2019-03-30 03:00:00
138,3,1,2,0.0077257692400952375,2019-03-30 02:45:00,2019-03-30 03:00:00
157,1,1,0,0.00981948218062471,2019-03-30 02:45:00,2019-03-30 03:00:00
160,1,1,0,0.008217972271681761,2019-03-30 02:45:00,2019-03-30 03:00:00
162,1,1,0,0.011427960445323359,2019-03-30 02:45:00,2019-03-30 03:00:00
164,1,1,0,0.0063299606130755885,2019-03-30 02:45:00,2019-03-30 03:00:00
168,1,1,0,0.006198324726174517,2019-03-30 02:45:00,2019-03-30 03:00:00
170,3,3,0,0.010105983930287934,2019-03-30 02:45:00,2019-03-30 03:00:00
171,1,1,0,0.005154434034515257,2019-03-30 02:45:00,2019-03-30 03:00:00
172,2,2,0,0.0070424456931214305,2019-03-30 02:45:00,2019-03-30 03:00:00
191,2,0,2,0.004441948954469415,2019-03-30 02:45:00,2019-03-30 03:00:00
201,1,1,0,0.0077257692400952375,2019-03-30 02:45:00,2019-03-30 03:00:00
10,2,0,2,0.0043247167678731315,2019-03-30 03:00:00,2019-03-30 03:15:00
23,1,0,1,0.0043247167678731315,2019-03-30 03:00:00,2019-03-30 03:15:00
40,1,1,0,0.008001094142740485,2019-03-30 03:00:00,2019-03-30 03:15:00
46,1,0,1,0.0043247167678731315,2019-03-30 03:00:00,2019-03-30 03:15:00
57,1,1,0,0.005550175892828916,2019-03-30 03:00:00,2019-03-30 03:15:00
58,1,1,0,0.006162905455306808,2019-03-30 03:00:00,2019-03-30 03:15:00
61,1,0,1,0.0043247167678731315,2019-03-30 03:00:00,2019-03-30 03:15:00
67,4,2,2,0.006775635017784699,2019-03-30 03:00:00,2019-03-30 03:15:00
71,1,1,0,0.007204669985850214,2019-03-30 03:00:00,2019-03-30 03:15:00
74,1,1,0,0.007204669985850214,2019-03-30 03:00:00,2019-03-30 03:15:00
88,4,0,4,0.0043247167678731315,2019-03-30 03:00:00,2019-03-30 03:15:00
89,1,1,0,0.00524381111158997,2019-03-30 03:00:00,2019-03-30 03:15:00
109,2,1,1,0.008001094142740485,2019-03-30 03:00:00,2019-03-30 03:15:00
112,3,0,3,0.0043247167678731315,2019-03-30 03:00:00,2019-03-30 03:15:00
115,5,4,1,0.046875167791707285,2019-03-30 03:00:00,2019-03-30 03:15:00
119,1,1,0,0.008001094142740485,2019-03-30 03:00:00,2019-03-30 03:15:00
126,3,3,0,0.011677471517607837,2019-03-30 03:00:00,2019-03-30 03:15:00
127,1,0,1,0.0043247167678731315,2019-03-30 03:00:00,2019-03-30 03:15:00
135,2,1,1,0.02863926021006408,2019-03-30 03:00:00,2019-03-30 03:15:00
137,2,0,2,0.0043247167678731315,2019-03-30 03:00:00,2019-03-30 03:15:00
138,2,0,2,0.0043247167678731315,2019-03-30 03:00:00,2019-03-30 03:15:00
141,1,1,0,0.006162905455306808,2019-03-30 03:00:00,2019-03-30 03:15:00
162,1,1,0,0.011126387734370706,2019-03-30 03:00:00,2019-03-30 03:15:00
168,1,1,0,0.006162905455306808,2019-03-30 03:00:00,2019-03-30 03:15:00
170,2,2,0,0.008001094142740485,2019-03-30 03:00:00,2019-03-30 03:15:00
191,2,0,2,0.0043247167678731315,2019-03-30 03:00:00,2019-03-30 03:15:00
201,1,1,0,0.006162905455306808,2019-03-30 03:00:00,2019-03-30 03:15:00
10,2,0,2,0.004301804140588662,2019-03-30 03:15:00,2019-03-30 03:30:00
40,2,1,1,0.006130251498586807,2019-03-30 03:15:00,2019-03-30 03:30:00
46,2,0,2,0.004301804140588662,2019-03-30 03:15:00,2019-03-30 03:30:00
58,1,1,0,0.007958698856584952,2019-03-30 03:15:00,2019-03-30 03:30:00
61,1,0,1,0.004301804140588662,2019-03-30 03:15:00,2019-03-30 03:30:00
67,2,0,2,0.004301804140588662,2019-03-30 03:15:00,2019-03-30 03:30:00
71,1,1,0,0.006130251498586807,2019-03-30 03:15:00,2019-03-30 03:30:00
74,1,1,0,0.006130251498586807,2019-03-30 03:15:00,2019-03-30 03:30:00
88,4,0,4,0.004301804140588662,2019-03-30 03:15:00,2019-03-30 03:30:00
89,1,1,0,0.005216027819587734,2019-03-30 03:15:00,2019-03-30 03:30:00
109,1,0,1,0.004301804140588662,2019-03-30 03:15:00,2019-03-30 03:30:00
115,5,4,1,0.04662761810479518,2019-03-30 03:15:00,2019-03-30 03:30:00
119,5,1,4,0.007958698856584952,2019-03-30 03:15:00,2019-03-30 03:30:00
126,2,2,0,0.007958698856584952,2019-03-30 03:15:00,2019-03-30 03:30:00
135,2,1,1,0.028487983548706672,2019-03-30 03:15:00,2019-03-30 03:30:00
137,1,0,1,0.004301804140588662,2019-03-30 03:15:00,2019-03-30 03:30:00
138,8,5,3,0.015443689217434938,2019-03-30 03:15:00,2019-03-30 03:30:00
141,1,1,0,0.008678068235759482,2019-03-30 03:15:00,2019-03-30 03:30:00
162,1,1,0,0.007958698856584952,2019-03-30 03:15:00,2019-03-30 03:30:00
168,1,1,0,0.009513061989424535,2019-03-30 03:15:00,2019-03-30 03:30:00
170,2,2,0,0.007958698856584952,2019-03-30 03:15:00,2019-03-30 03:30:00
173,1,1,0,0.006130251498586807,2019-03-30 03:15:00,2019-03-30 03:30:00
191,2,0,2,0.004301804140588662,2019-03-30 03:15:00,2019-03-30 03:30:00
201,1,1,0,0.008678068235759482,2019-03-30 03:15:00,2019-03-30 03:30:00
40,1,0,1,0.004277173160282725,2019-03-30 03:30:00,2019-03-30 03:45:00
46,1,0,1,0.004277173160282725,2019-03-30 03:30:00,2019-03-30 03:45:00
58,1,1,0,0.007913127459985295,2019-03-30 03:30:00,2019-03-30 03:45:00
61,1,0,1,0.004277173160282725,2019-03-30 03:30:00,2019-03-30 03:45:00
67,1,0,1,0.004277173160282725,2019-03-30 03:30:00,2019-03-30 03:45:00
71,1,1,0,0.007913127459985295,2019-03-30 03:30:00,2019-03-30 03:45:00
88,4,0,4,0.004277173160282725,2019-03-30 03:30:00,2019-03-30 03:45:00
89,1,1,0,0.005186161735208368,2019-03-30 03:30:00,2019-03-30 03:45:00
90,1,1,0,0.007913127459985295,2019-03-30 03:30:00,2019-03-30 03:45:00
109,1,0,1,0.004277173160282725,2019-03-30 03:30:00,2019-03-30 03:45:00
115,5,4,1,0.04636021432724267,2019-03-30 03:30:00,2019-03-30 03:45:00
119,5,1,4,0.007913127459985295,2019-03-30 03:30:00,2019-03-30 03:45:00
120,1,1,0,0.007913127459985295,2019-03-30 03:30:00,2019-03-30 03:45:00
126,3,3,0,0.011549081759687867,2019-03-30 03:30:00,2019-03-30 03:45:00
129,1,0,1,0.004277173160282725,2019-03-30 03:30:00,2019-03-30 03:45:00
135,2,1,1,0.028324625255688407,2019-03-30 03:30:00,2019-03-30 03:45:00
137,1,0,1,0.004277173160282725,2019-03-30 03:30:00,2019-03-30 03:45:00
138,8,5,3,0.01535525029345189,2019-03-30 03:30:00,2019-03-30 03:45:00
141,1,1,0,0.007913127459985295,2019-03-30 03:30:00,2019-03-30 03:45:00
153,1,0,1,0.004277173160282725,2019-03-30 03:30:00,2019-03-30 03:45:00
162,1,1,0,0.007913127459985295,2019-03-30 03:30:00,2019-03-30 03:45:00
164,1,0,1,0.004277173160282725,2019-03-30 03:30:00,2019-03-30 03:45:00
168,1,1,0,0.007913127459985295,2019-03-30 03:30:00,2019-03-30 03:45:00
170,1,1,0,0.008628373247561027,2019-03-30 03:30:00,2019-03-30 03:45:00
191,2,0,2,0.004277173160282725,2019-03-30 03:30:00,2019-03-30 03:45:00
201,1,1,0,0.008628373247561027,2019-03-30 03:30:00,2019-03-30 03:45:00
19,1,0,1,0.004182877277031295,2019-03-30 03:45:00,2019-03-30 04:00:00
46,1,0,1,0.004182877277031295,2019-03-30 03:45:00,2019-03-30 04:00:00
58,1,1,0,0.006635942497492499,2019-03-30 03:45:00,2019-03-30 04:00:00
61,1,0,1,0.004182877277031295,2019-03-30 03:45:00,2019-03-30 04:00:00
67,1,0,1,0.004182877277031295,2019-03-30 03:45:00,2019-03-30 04:00:00
68,1,0,1,0.004182877277031295,2019-03-30 03:45:00,2019-03-30 04:00:00
71,1,1,0,0.007738680176549847,2019-03-30 03:45:00,2019-03-30 04:00:00
88,4,0,4,0.004182877277031295,2019-03-30 03:45:00,2019-03-30 04:00:00
89,1,1,0,0.005071828001910934,2019-03-30 03:45:00,2019-03-30 04:00:00
90,1,1,0,0.007738680176549847,2019-03-30 03:45:00,2019-03-30 04:00:00
106,1,1,0,0.007738680176549847,2019-03-30 03:45:00,2019-03-30 04:00:00
109,1,0,1,0.004182877277031295,2019-03-30 03:45:00,2019-03-30 04:00:00
111,1,1,0,0.007738680176549847,2019-03-30 03:45:00,2019-03-30 04:00:00
115,5,4,1,0.045419589024085855,2019-03-30 03:45:00,2019-03-30 04:00:00
119,1,1,0,0.007738680176549847,2019-03-30 03:45:00,2019-03-30 04:00:00
126,2,2,0,0.007738680176549847,2019-03-30 03:45:00,2019-03-30 04:00:00
135,3,2,1,0.05131054784509366,2019-03-30 03:45:00,2019-03-30 04:00:00
137,7,3,4,0.011542072938414909,2019-03-30 03:45:00,2019-03-30 04:00:00
138,4,2,2,0.01345984927208847,2019-03-30 03:45:00,2019-03-30 04:00:00
141,1,1,0,0.007738680176549847,2019-03-30 03:45:00,2019-03-30 04:00:00
158,1,0,1,0.004182877277031295,2019-03-30 03:45:00,2019-03-30 04:00:00
162,1,1,0,0.007738680176549847,2019-03-30 03:45:00,2019-03-30 04:00:00
164,1,0,1,0.004182877277031295,2019-03-30 03:45:00,2019-03-30 04:00:00
191,2,0,2,0.004182877277031295,2019-03-30 03:45:00,2019-03-30 04:00:00
196,1,0,1,0.004182877277031295,2019-03-30 03:45:00,2019-03-30 04:00:00
201,1,1,0,0.009904046372569917,2019-03-30 03:45:00,2019-03-30 04:00:00
18,1,0,1,0.004285226817579271,2019-03-30 04:00:00,2019-03-30 04:15:00
19,1,0,1,0.004285226817579271,2019-03-30 04:00:00,2019-03-30 04:15:00
46,2,0,2,0.004285226817579271,2019-03-30 04:00:00,2019-03-30 04:15:00
58,1,1,0,0.011024776707470173,2019-03-30 04:00:00,2019-03-30 04:15:00
61,1,0,1,0.004285226817579271,2019-03-30 04:00:00,2019-03-30 04:15:00
68,1,0,1,0.004285226817579271,2019-03-30 04:00:00,2019-03-30 04:15:00
75,1,1,0,0.007928029676496348,2019-03-30 04:00:00,2019-03-30 04:15:00
88,4,0,4,0.004285226817579271,2019-03-30 04:00:00,2019-03-30 04:15:00
89,1,1,0,0.0051959275323085405,2019-03-30 04:00:00,2019-03-30 04:15:00
106,1,1,0,0.007928029676496348,2019-03-30 04:00:00,2019-03-30 04:15:00
109,1,0,1,0.004285226817579271,2019-03-30 04:00:00,2019-03-30 04:15:00
111,1,0,1,0.004285226817579271,2019-03-30 04:00:00,2019-03-30 04:15:00
115,5,4,1,0.046447008532703934,2019-03-30 04:00:00,2019-03-30 04:15:00
119,5,5,0,0.014325740986768129,2019-03-30 04:00:00,2019-03-30 04:15:00
120,1,0,1,0.004285226817579271,2019-03-30 04:00:00,2019-03-30 04:15:00
126,4,4,0,0.011570832535413425,2019-03-30 04:00:00,2019-03-30 04:15:00
135,2,1,1,0.02837767351193622,2019-03-30 04:00:00,2019-03-30 04:15:00
137,2,1,1,0.007928029676496348,2019-03-30 04:00:00,2019-03-30 04:15:00
138,10,3,7,0.01317026036298137,2019-03-30 04:00:00,2019-03-30 04:15:00
141,1,1,0,0.007928029676496348,2019-03-30 04:00:00,2019-03-30 04:15:00
158,1,1,0,0.0058846546451472165,2019-03-30 04:00:00,2019-03-30 04:15:00
162,1,1,0,0.007928029676496348,2019-03-30 04:00:00,2019-03-30 04:15:00
164,1,0,1,0.004285226817579271,2019-03-30 04:00:00,2019-03-30 04:15:00
191,2,0,2,0.004285226817579271,2019-03-30 04:00:00,2019-03-30 04:15:00
201,1,1,0,0.0058846546451472165,2019-03-30 04:00:00,2019-03-30 04:15:00
1,1,1,0,0.012861891855975568,2019-03-30 04:15:00,2019-03-30 04:30:00
18,1,0,1,0.0039029747379516794,2019-03-30 04:15:00,2019-03-30 04:30:00
19,1,0,1,0.0039029747379516794,2019-03-30 04:15:00,2019-03-30 04:30:00
46,2,0,2,0.0039029747379516794,2019-03-30 04:15:00,2019-03-30 04:30:00
57,1,1,0,0.011028901326714328,2019-03-30 04:15:00,2019-03-30 04:30:00
58,1,1,0,0.008625940254725671,2019-03-30 04:15:00,2019-03-30 04:30:00
61,1,0,1,0.0039029747379516794,2019-03-30 04:15:00,2019-03-30 04:30:00
68,1,0,1,0.0039029747379516794,2019-03-30 04:15:00,2019-03-30 04:30:00
75,1,1,0,0.0072208379467747115,2019-03-30 04:15:00,2019-03-30 04:30:00
88,4,0,4,0.0039029747379516794,2019-03-30 04:15:00,2019-03-30 04:30:00
89,1,1,0,0.004732440540157437,2019-03-30 04:15:00,2019-03-30 04:30:00
104,1,0,1,0.0039029747379516794,2019-03-30 04:15:00,2019-03-30 04:30:00
106,3,2,1,0.047961904635113406,2019-03-30 04:15:00,2019-03-30 04:30:00
109,1,0,1,0.0039029747379516794,2019-03-30 04:15:00,2019-03-30 04:30:00
111,1,0,1,0.0039029747379516794,2019-03-30 04:15:00,2019-03-30 04:30:00
115,5,4,1,0.04245453839796821,2019-03-30 04:15:00,2019-03-30 04:30:00
119,1,1,0,0.0072208379467747115,2019-03-30 04:15:00,2019-03-30 04:30:00
120,1,0,1,0.0039029747379516794,2019-03-30 04:15:00,2019-03-30 04:30:00
126,5,4,1,0.010538701155597744,2019-03-30 04:15:00,2019-03-30 04:30:00
127,2,1,1,0.02593243968653254,2019-03-30 04:15:00,2019-03-30 04:30:00
135,2,1,1,0.02593243968653254,2019-03-30 04:15:00,2019-03-30 04:30:00
137,6,3,3,0.016666768980322696,2019-03-30 04:15:00,2019-03-30 04:30:00
138,4,2,2,0.010538701155597744,2019-03-30 04:15:00,2019-03-30 04:30:00
141,1,1,0,0.0072208379467747115,2019-03-30 04:15:00,2019-03-30 04:30:00
158,2,1,1,0.008382433296963624,2019-03-30 04:15:00,2019-03-30 04:30:00
162,1,1,0,0.0072208379467747115,2019-03-30 04:15:00,2019-03-30 04:30:00
164,1,0,1,0.0039029747379516794,2019-03-30 04:15:00,2019-03-30 04:30:00
173,1,1,0,0.0072208379467747115,2019-03-30 04:15:00,2019-03-30 04:30:00
191,2,0,2,0.0039029747379516794,2019-03-30 04:15:00,2019-03-30 04:30:00
201,1,1,0,0.008382433296963624,2019-03-30 04:15:00,2019-03-30 04:30:00
1,1,1,0,0.013957977820007674,2019-03-30 04:30:00,2019-03-30 04:45:00
18,1,0,1,0.004235605987628493,2019-03-30 04:30:00,2019-03-30 04:45:00
19,1,0,1,0.004235605987628493,2019-03-30 04:30:00,2019-03-30 04:45:00
46,2,0,2,0.004235605987628493,2019-03-30 04:30:00,2019-03-30 04:45:00
57,1,1,0,0.007836221587682667,2019-03-30 04:30:00,2019-03-30 04:45:00
58,1,1,0,0.00736688851867808,2019-03-30 04:30:00,2019-03-30 04:45:00
61,1,0,1,0.004235605987628493,2019-03-30 04:30:00,2019-03-30 04:45:00
64,1,1,0,0.007836221587682667,2019-03-30 04:30:00,2019-03-30 04:45:00
67,1,0,1,0.004235605987628493,2019-03-30 04:30:00,2019-03-30 04:45:00
70,1,1,0,0.007836221587682667,2019-03-30 04:30:00,2019-03-30 04:45:00
75,1,1,0,0.007836221587682667,2019-03-30 04:30:00,2019-03-30 04:45:00
88,4,0,4,0.004235605987628493,2019-03-30 04:30:00,2019-03-30 04:45:00
89,1,1,0,0.005135759887642036,2019-03-30 04:30:00,2019-03-30 04:45:00
109,2,0,2,0.004235605987628493,2019-03-30 04:30:00,2019-03-30 04:45:00
115,5,4,1,0.04590885763861591,2019-03-30 04:30:00,2019-03-30 04:45:00
119,1,1,0,0.007836221587682667,2019-03-30 04:30:00,2019-03-30 04:45:00
120,1,0,1,0.004235605987628493,2019-03-30 04:30:00,2019-03-30 04:45:00
126,5,4,1,0.011436837187736842,2019-03-30 04:30:00,2019-03-30 04:45:00
135,2,1,1,0.02804889264533559,2019-03-30 04:30:00,2019-03-30 04:45:00
137,3,1,2,0.00736688851867808,2019-03-30 04:30:00,2019-03-30 04:45:00
138,3,2,1,0.011436837187736842,2019-03-30 04:30:00,2019-03-30 04:45:00
141,1,1,0,0.007836221587682667,2019-03-30 04:30:00,2019-03-30 04:45:00
158,1,0,1,0.004235605987628493,2019-03-30 04:30:00,2019-03-30 04:45:00
162,1,1,0,0.00603591378765558,2019-03-30 04:30:00,2019-03-30 04:45:00
164,1,0,1,0.004235605987628493,2019-03-30 04:30:00,2019-03-30 04:45:00
175,1,0,1,0.004235605987628493,2019-03-30 04:30:00,2019-03-30 04:45:00
191,2,0,2,0.004235605987628493,2019-03-30 04:30:00,2019-03-30 04:45:00
201,2,2,0,0.015758285620034763,2019-03-30 04:30:00,2019-03-30 04:45:00
18,4,2,2,0.014442937053036876,2019-03-30 04:45:00,2019-03-30 05:00:00
19,1,0,1,0.0041677808800274,2019-03-30 04:45:00,2019-03-30 05:00:00
22,1,1,0,0.007710714838621071,2019-03-30 04:45:00,2019-03-30 05:00:00
46,1,0,1,0.0041677808800274,2019-03-30 04:45:00,2019-03-30 05:00:00
58,2,1,1,0.007710714838621071,2019-03-30 04:45:00,2019-03-30 05:00:00
61,1,0,1,0.0041677808800274,2019-03-30 04:45:00,2019-03-30 05:00:00
64,1,1,0,0.007710714838621071,2019-03-30 04:45:00,2019-03-30 05:00:00
67,1,0,1,0.0041677808800274,2019-03-30 04:45:00,2019-03-30 05:00:00
70,1,1,0,0.007710714838621071,2019-03-30 04:45:00,2019-03-30 05:00:00
88,5,0,5,0.0041677808800274,2019-03-30 04:45:00,2019-03-30 05:00:00
89,2,1,1,0.004876367671746134,2019-03-30 04:45:00,2019-03-30 05:00:00
109,1,0,1,0.0041677808800274,2019-03-30 04:45:00,2019-03-30 05:00:00
115,5,4,1,0.041654859815150914,2019-03-30 04:45:00,2019-03-30 05:00:00
119,1,1,0,0.007710714838621071,2019-03-30 04:45:00,2019-03-30 05:00:00
126,4,3,1,0.01125364879721474,2019-03-30 04:45:00,2019-03-30 05:00:00
135,2,1,1,0.027597205214479597,2019-03-30 04:45:00,2019-03-30 05:00:00
137,1,0,1,0.0041677808800274,2019-03-30 04:45:00,2019-03-30 05:00:00
138,4,3,1,0.017994942524040394,2019-03-30 04:45:00,2019-03-30 05:00:00
141,1,1,0,0.007710714838621071,2019-03-30 04:45:00,2019-03-30 05:00:00
157,1,1,0,0.010722532549969608,2019-03-30 04:45:00,2019-03-30 05:00:00
159,1,0,1,0.0041677808800274,2019-03-30 04:45:00,2019-03-30 05:00:00
162,1,1,0,0.007710714838621071,2019-03-30 04:45:00,2019-03-30 05:00:00
164,1,0,1,0.0041677808800274,2019-03-30 04:45:00,2019-03-30 05:00:00
175,1,0,1,0.0041677808800274,2019-03-30 04:45:00,2019-03-30 05:00:00
191,2,0,2,0.0041677808800274,2019-03-30 04:45:00,2019-03-30 05:00:00
201,1,1,0,0.01946520511425352,2019-03-30 04:45:00,2019-03-30 05:00:00
203,1,1,0,0.010306711064583349,2019-03-30 04:45:00,2019-03-30 05:00:00
18,5,3,2,0.01642348202821687,2019-03-30 05:00:00,2019-03-30 05:15:00
19,1,0,1,0.0041883802876147794,2019-03-30 05:00:00,2019-03-30 05:15:00
50,1,1,0,0.007748841948526397,2019-03-30 05:00:00,2019-03-30 05:15:00
58,1,1,0,0.007748841948526397,2019-03-30 05:00:00,2019-03-30 05:15:00
61,1,0,1,0.0041883802876147794,2019-03-30 05:00:00,2019-03-30 05:15:00
88,4,0,4,0.0041883802876147794,2019-03-30 05:00:00,2019-03-30 05:15:00
89,2,1,1,0.005078495702842684,2019-03-30 05:00:00,2019-03-30 05:15:00
109,2,1,1,0.005375200841251985,2019-03-30 05:00:00,2019-03-30 05:15:00
111,1,0,1,0.0041883802876147794,2019-03-30 05:00:00,2019-03-30 05:15:00
113,1,0,1,0.0041883802876147794,2019-03-30 05:00:00,2019-03-30 05:15:00
115,5,4,1,0.04539798217777681,2019-03-30 05:00:00,2019-03-30 05:15:00
119,1,1,0,0.007748841948526397,2019-03-30 05:00:00,2019-03-30 05:15:00
126,3,2,1,0.006562021394889191,2019-03-30 05:00:00,2019-03-30 05:15:00
135,2,1,1,0.027736724224850226,2019-03-30 05:00:00,2019-03-30 05:15:00
137,1,0,1,0.0041883802876147794,2019-03-30 05:00:00,2019-03-30 05:15:00
138,4,3,1,0.019046767868640492,2019-03-30 05:00:00,2019-03-30 05:15:00
141,1,1,0,0.007748841948526397,2019-03-30 05:00:00,2019-03-30 05:15:00
162,1,1,0,0.008757753594277573,2019-03-30 05:00:00,2019-03-30 05:15:00
164,1,0,1,0.0041883802876147794,2019-03-30 05:00:00,2019-03-30 05:15:00
191,3,0,3,0.0041883802876147794,2019-03-30 05:00:00,2019-03-30 05:15:00
196,3,1,2,0.007284735414891283,2019-03-30 05:00:00,2019-03-30 05:15:00
201,1,1,0,0.020380053498941765,2019-03-30 05:00:00,2019-03-30 05:15:00
203,1,1,0,0.011169160812503874,2019-03-30 05:00:00,2019-03-30 05:15:00
1,1,1,0,0.007417090744096211,2019-03-30 05:15:00,2019-03-30 05:30:00
10,1,1,0,0.008388348176392203,2019-03-30 05:15:00,2019-03-30 05:30:00
18,2,0,2,0.0042644667715957315,2019-03-30 05:15:00,2019-03-30 05:30:00
19,1,0,1,0.0042644667715957315,2019-03-30 05:15:00,2019-03-30 05:30:00
26,1,1,0,0.005950668614335061,2019-03-30 05:15:00,2019-03-30 05:30:00
30,3,1,2,0.007417090744096211,2019-03-30 05:15:00,2019-03-30 05:30:00
41,1,1,0,0.007889619424235375,2019-03-30 05:15:00,2019-03-30 05:30:00
58,1,1,0,0.007889619424235375,2019-03-30 05:15:00,2019-03-30 05:30:00
61,1,0,1,0.0042644667715957315,2019-03-30 05:15:00,2019-03-30 05:30:00
88,4,0,4,0.0042644667715957315,2019-03-30 05:15:00,2019-03-30 05:30:00
89,1,1,0,0.005170754934755642,2019-03-30 05:15:00,2019-03-30 05:30:00
90,1,1,0,0.010971359528870909,2019-03-30 05:15:00,2019-03-30 05:30:00
104,1,0,1,0.0042644667715957315,2019-03-30 05:15:00,2019-03-30 05:30:00
109,1,0,1,0.0042644667715957315,2019-03-30 05:15:00,2019-03-30 05:30:00
115,5,4,1,0.046221919973515824,2019-03-30 05:15:00,2019-03-30 05:30:00
119,1,1,0,0.007889619424235375,2019-03-30 05:15:00,2019-03-30 05:30:00
126,2,2,0,0.007889619424235375,2019-03-30 05:15:00,2019-03-30 05:30:00
135,2,1,1,0.02824015431555007,2019-03-30 05:15:00,2019-03-30 05:30:00
137,1,0,1,0.0042644667715957315,2019-03-30 05:15:00,2019-03-30 05:30:00
138,4,2,2,0.009702195750555198,2019-03-30 05:15:00,2019-03-30 05:30:00
141,2,1,1,0.007889619424235375,2019-03-30 05:15:00,2019-03-30 05:30:00
153,2,2,0,0.009575821266974704,2019-03-30 05:15:00,2019-03-30 05:30:00
162,1,1,0,0.007889619424235375,2019-03-30 05:15:00,2019-03-30 05:30:00
164,1,0,1,0.0042644667715957315,2019-03-30 05:15:00,2019-03-30 05:30:00
172,1,0,1,0.0042644667715957315,2019-03-30 05:15:00,2019-03-30 05:30:00
191,2,0,2,0.0042644667715957315,2019-03-30 05:15:00,2019-03-30 05:30:00
196,4,1,3,0.005950668614335061,2019-03-30 05:15:00,2019-03-30 05:30:00
201,1,1,0,0.008388348176392203,2019-03-30 05:15:00,2019-03-30 05:30:00
203,1,1,0,0.006077043097915553,2019-03-30 05:15:00,2019-03-30 05:30:00
1,1,1,0,0.007623232131968215,2019-03-30 05:30:00,2019-03-30 05:45:00
10,1,1,0,0.00884961586581119,2019-03-30 05:30:00,2019-03-30 05:45:00
18,1,0,1,0.004120449190366245,2019-03-30 05:30:00,2019-03-30 05:45:00
19,1,0,1,0.004120449190366245,2019-03-30 05:30:00,2019-03-30 05:45:00
26,1,1,0,0.007623232131968215,2019-03-30 05:30:00,2019-03-30 05:45:00
30,1,0,1,0.004120449190366245,2019-03-30 05:30:00,2019-03-30 05:45:00
41,1,1,0,0.007623232131968215,2019-03-30 05:30:00,2019-03-30 05:45:00
58,1,1,0,0.007623232131968215,2019-03-30 05:30:00,2019-03-30 05:45:00
61,1,0,1,0.004120449190366245,2019-03-30 05:30:00,2019-03-30 05:45:00
88,5,0,5,0.004120449190366245,2019-03-30 05:30:00,2019-03-30 05:45:00
89,1,1,0,0.004821005778686639,2019-03-30 05:30:00,2019-03-30 05:45:00
90,1,1,0,0.004821005778686639,2019-03-30 05:30:00,2019-03-30 05:45:00
104,3,1,2,0.00716671144680672,2019-03-30 05:30:00,2019-03-30 05:45:00
109,1,0,1,0.004120449190366245,2019-03-30 05:30:00,2019-03-30 05:45:00
115,5,4,1,0.0412790225677894,2019-03-30 05:30:00,2019-03-30 05:45:00
119,1,1,0,0.007623232131968215,2019-03-30 05:30:00,2019-03-30 05:45:00
126,4,3,1,0.0505686659121452,2019-03-30 05:30:00,2019-03-30 05:45:00
135,2,1,1,0.027344557551255717,2019-03-30 05:30:00,2019-03-30 05:45:00
137,1,0,1,0.004120449190366245,2019-03-30 05:30:00,2019-03-30 05:45:00
138,4,2,2,0.011126015073570184,2019-03-30 05:30:00,2019-03-30 05:45:00
141,1,1,0,0.007623232131968215,2019-03-30 05:30:00,2019-03-30 05:45:00
153,1,1,0,0.00716671144680672,2019-03-30 05:30:00,2019-03-30 05:45:00
162,1,1,0,0.007623232131968215,2019-03-30 05:30:00,2019-03-30 05:45:00
164,1,0,1,0.004120449190366245,2019-03-30 05:30:00,2019-03-30 05:45:00
172,1,0,1,0.004120449190366245,2019-03-30 05:30:00,2019-03-30 05:45:00
191,2,0,2,0.004120449190366245,2019-03-30 05:30:00,2019-03-30 05:45:00
196,1,0,1,0.004120449190366245,2019-03-30 05:30:00,2019-03-30 05:45:00
201,1,1,0,0.00884961586581119,2019-03-30 05:30:00,2019-03-30 05:45:00
1,2,2,0,0.011159660236446715,2019-03-30 05:45:00,2019-03-30 06:00:00
10,1,1,0,0.008876330885456515,2019-03-30 05:45:00,2019-03-30 06:00:00
18,1,0,1,0.004132953697179196,2019-03-30 05:45:00,2019-03-30 06:00:00
19,1,0,1,0.004132953697179196,2019-03-30 05:45:00,2019-03-30 06:00:00
26,1,1,0,0.0076463069668129555,2019-03-30 05:45:00,2019-03-30 06:00:00
30,1,0,1,0.004132953697179196,2019-03-30 05:45:00,2019-03-30 06:00:00
58,1,1,0,0.0076463069668129555,2019-03-30 05:45:00,2019-03-30 06:00:00
61,1,0,1,0.004132953697179196,2019-03-30 05:45:00,2019-03-30 06:00:00
88,4,0,4,0.004132953697179196,2019-03-30 05:45:00,2019-03-30 06:00:00
89,1,1,0,0.005011292014587636,2019-03-30 05:45:00,2019-03-30 06:00:00
104,1,0,1,0.004132953697179196,2019-03-30 05:45:00,2019-03-30 06:00:00
109,1,0,1,0.004132953697179196,2019-03-30 05:45:00,2019-03-30 06:00:00
115,5,4,1,0.0449389821026111,2019-03-30 05:45:00,2019-03-30 06:00:00
119,1,1,0,0.0076463069668129555,2019-03-30 05:45:00,2019-03-30 06:00:00
126,4,3,1,0.05076841473195852,2019-03-30 05:45:00,2019-03-30 06:00:00
135,2,1,1,0.027450684214568852,2019-03-30 05:45:00,2019-03-30 06:00:00
137,1,0,1,0.004132953697179196,2019-03-30 05:45:00,2019-03-30 06:00:00
138,4,2,2,0.011159660236446715,2019-03-30 05:45:00,2019-03-30 06:00:00
141,1,1,0,0.0076463069668129555,2019-03-30 05:45:00,2019-03-30 06:00:00
162,1,1,0,0.0076463069668129555,2019-03-30 05:45:00,2019-03-30 06:00:00
164,1,0,1,0.004132953697179196,2019-03-30 05:45:00,2019-03-30 06:00:00
191,2,0,2,0.004132953697179196,2019-03-30 05:45:00,2019-03-30 06:00:00
196,1,0,1,0.004132953697179196,2019-03-30 05:45:00,2019-03-30 06:00:00
201,1,1,0,0.008876330885456515,2019-03-30 05:45:00,2019-03-30 06:00:00
1,1,1,0,0.007673259733148355,2019-03-30 06:00:00,2019-03-30 06:15:00
18,1,0,1,0.00414752156235771,2019-03-30 06:00:00,2019-03-30 06:15:00
19,1,0,1,0.00414752156235771,2019-03-30 06:00:00,2019-03-30 06:15:00
30,1,0,1,0.00414752156235771,2019-03-30 06:00:00,2019-03-30 06:15:00
58,1,1,0,0.007673259733148355,2019-03-30 06:00:00,2019-03-30 06:15:00
61,1,0,1,0.00414752156235771,2019-03-30 06:00:00,2019-03-30 06:15:00
68,1,1,0,0.007673259733148355,2019-03-30 06:00:00,2019-03-30 06:15:00
88,4,0,4,0.00414752156235771,2019-03-30 06:00:00,2019-03-30 06:15:00
89,1,1,0,0.005028956105055372,2019-03-30 06:00:00,2019-03-30 06:15:00
109,1,0,1,0.00414752156235771,2019-03-30 06:00:00,2019-03-30 06:15:00
115,5,4,1,0.045097721096749345,2019-03-30 06:00:00,2019-03-30 06:15:00
119,1,1,0,0.007673259733148355,2019-03-30 06:00:00,2019-03-30 06:15:00
126,4,3,1,0.050947749601662436,2019-03-30 06:00:00,2019-03-30 06:15:00
135,2,1,1,0.027547635582010076,2019-03-30 06:00:00,2019-03-30 06:15:00
137,1,0,1,0.00414752156235771,2019-03-30 06:00:00,2019-03-30 06:15:00
138,3,2,1,0.011198997903939,2019-03-30 06:00:00,2019-03-30 06:15:00
141,1,1,0,0.007673259733148355,2019-03-30 06:00:00,2019-03-30 06:15:00
156,1,0,1,0.00414752156235771,2019-03-30 06:00:00,2019-03-30 06:15:00
162,1,1,0,0.007673259733148355,2019-03-30 06:00:00,2019-03-30 06:15:00
164,1,0,1,0.00414752156235771,2019-03-30 06:00:00,2019-03-30 06:15:00
191,2,0,2,0.00414752156235771,2019-03-30 06:00:00,2019-03-30 06:15:00
201,1,1,0,0.013667719776652381,2019-03-30 06:00:00,2019-03-30 06:15:00
1,1,1,0,0.007995831810682797,2019-03-30 06:15:00,2019-03-30 06:30:00
18,1,0,1,0.004321881792083732,2019-03-30 06:15:00,2019-03-30 06:30:00
19,1,0,1,0.004321881792083732,2019-03-30 06:15:00,2019-03-30 06:30:00
30,1,0,1,0.004321881792083732,2019-03-30 06:15:00,2019-03-30 06:30:00
58,1,1,0,0.007995831810682797,2019-03-30 06:15:00,2019-03-30 06:30:00
61,1,0,1,0.004321881792083732,2019-03-30 06:15:00,2019-03-30 06:30:00
68,1,1,0,0.007995831810682797,2019-03-30 06:15:00,2019-03-30 06:30:00
88,5,0,5,0.004321881792083732,2019-03-30 06:15:00,2019-03-30 06:30:00
89,1,1,0,0.005056671795803545,2019-03-30 06:15:00,2019-03-30 06:30:00
109,3,1,2,0.007516933108419081,2019-03-30 06:15:00,2019-03-30 06:30:00
115,5,4,1,0.04319488202366346,2019-03-30 06:15:00,2019-03-30 06:30:00
119,1,1,0,0.007995831810682797,2019-03-30 06:15:00,2019-03-30 06:30:00
126,2,2,0,0.007995831810682797,2019-03-30 06:15:00,2019-03-30 06:30:00
135,2,1,1,0.028617506936821063,2019-03-30 06:15:00,2019-03-30 06:30:00
137,1,0,1,0.004321881792083732,2019-03-30 06:15:00,2019-03-30 06:30:00
138,3,2,1,0.01166978182928186,2019-03-30 06:15:00,2019-03-30 06:30:00
141,1,1,0,0.007995831810682797,2019-03-30 06:15:00,2019-03-30 06:30:00
151,1,0,1,0.004321881792083732,2019-03-30 06:15:00,2019-03-30 06:30:00
156,1,0,1,0.004321881792083732,2019-03-30 06:15:00,2019-03-30 06:30:00
159,1,1,0,0.007995831810682797,2019-03-30 06:15:00,2019-03-30 06:30:00
162,1,1,0,0.007516933108419081,2019-03-30 06:15:00,2019-03-30 06:30:00
164,1,0,1,0.004321881792083732,2019-03-30 06:15:00,2019-03-30 06:30:00
169,1,1,0,0.005056671795803545,2019-03-30 06:15:00,2019-03-30 06:30:00
191,2,0,2,0.004321881792083732,2019-03-30 06:15:00,2019-03-30 06:30:00
201,1,1,0,0.01424225623110078,2019-03-30 06:15:00,2019-03-30 06:30:00
1,1,1,0,0.008011527460487056,2019-03-30 06:30:00,2019-03-30 06:45:00
5,2,0,2,0.004330355743344154,2019-03-30 06:30:00,2019-03-30 06:45:00
18,1,1,0,0.006170941601915604,2019-03-30 06:30:00,2019-03-30 06:45:00
20,2,0,2,0.004330355743344154,2019-03-30 06:30:00,2019-03-30 06:45:00
30,1,0,1,0.004330355743344154,2019-03-30 06:30:00,2019-03-30 06:45:00
35,1,1,0,0.008793869965624928,2019-03-30 06:30:00,2019-03-30 06:45:00
41,1,1,0,0.006170941601915604,2019-03-30 06:30:00,2019-03-30 06:45:00
61,1,0,1,0.004330355743344154,2019-03-30 06:30:00,2019-03-30 06:45:00
87,1,1,0,0.008011527460487056,2019-03-30 06:30:00,2019-03-30 06:45:00
88,4,0,4,0.004330355743344154,2019-03-30 06:30:00,2019-03-30 06:45:00
89,2,1,1,0.005250648672629879,2019-03-30 06:30:00,2019-03-30 06:45:00
90,1,1,0,0.006170941601915604,2019-03-30 06:30:00,2019-03-30 06:45:00
109,1,0,1,0.004330355743344154,2019-03-30 06:30:00,2019-03-30 06:45:00
115,5,4,1,0.04693628737028033,2019-03-30 06:30:00,2019-03-30 06:45:00
119,1,1,0,0.008011527460487056,2019-03-30 06:30:00,2019-03-30 06:45:00
126,2,2,0,0.008011527460487056,2019-03-30 06:30:00,2019-03-30 06:45:00
127,1,1,0,0.006170941601915604,2019-03-30 06:30:00,2019-03-30 06:45:00
135,2,1,1,0.028676602387307678,2019-03-30 06:30:00,2019-03-30 06:45:00
138,1,0,1,0.004330355743344154,2019-03-30 06:30:00,2019-03-30 06:45:00
141,1,1,0,0.008011527460487056,2019-03-30 06:30:00,2019-03-30 06:45:00
160,1,0,1,0.004330355743344154,2019-03-30 06:30:00,2019-03-30 06:45:00
162,2,1,1,0.008011527460487056,2019-03-30 06:30:00,2019-03-30 06:45:00
164,1,0,1,0.004330355743344154,2019-03-30 06:30:00,2019-03-30 06:45:00
177,1,1,0,0.01114089748103855,2019-03-30 06:30:00,2019-03-30 06:45:00
191,2,0,2,0.004330355743344154,2019-03-30 06:30:00,2019-03-30 06:45:00
201,1,1,0,0.008011527460487056,2019-03-30 06:30:00,2019-03-30 06:45:00
1,1,1,0,0.007728806380540305,2019-03-30 06:45:00,2019-03-30 07:00:00
5,3,1,2,0.007728806380540305,2019-03-30 06:45:00,2019-03-30 07:00:00
18,1,1,0,0.005953172080610365,2019-03-30 06:45:00,2019-03-30 07:00:00
20,2,0,2,0.004177537780680424,2019-03-30 06:45:00,2019-03-30 07:00:00
30,1,0,1,0.004177537780680424,2019-03-30 06:45:00,2019-03-30 07:00:00
35,3,3,0,0.00848354288718162,2019-03-30 06:45:00,2019-03-30 07:00:00
41,1,1,0,0.007462645093892993,2019-03-30 06:45:00,2019-03-30 07:00:00
58,1,0,1,0.004177537780680424,2019-03-30 06:45:00,2019-03-30 07:00:00
61,1,0,1,0.004177537780680424,2019-03-30 06:45:00,2019-03-30 07:00:00
87,1,1,0,0.007728806380540305,2019-03-30 06:45:00,2019-03-30 07:00:00
88,4,0,4,0.004177537780680424,2019-03-30 06:45:00,2019-03-30 07:00:00
89,4,1,3,0.005065354930645394,2019-03-30 06:45:00,2019-03-30 07:00:00
90,3,1,2,0.005953172080610365,2019-03-30 06:45:00,2019-03-30 07:00:00
109,1,0,1,0.004177537780680424,2019-03-30 06:45:00,2019-03-30 07:00:00
115,5,4,1,0.04536009851902641,2019-03-30 06:45:00,2019-03-30 07:00:00
119,1,1,0,0.007728806380540305,2019-03-30 06:45:00,2019-03-30 07:00:00
126,2,2,0,0.007728806380540305,2019-03-30 06:45:00,2019-03-30 07:00:00
127,1,1,0,0.007462645093892993,2019-03-30 06:45:00,2019-03-30 07:00:00
135,2,1,1,0.027710429631163845,2019-03-30 06:45:00,2019-03-30 07:00:00
138,1,0,1,0.004177537780680424,2019-03-30 06:45:00,2019-03-30 07:00:00
141,1,1,0,0.007728806380540305,2019-03-30 06:45:00,2019-03-30 07:00:00
158,2,1,1,0.027710429631163845,2019-03-30 06:45:00,2019-03-30 07:00:00
160,1,0,1,0.004177537780680424,2019-03-30 06:45:00,2019-03-30 07:00:00
162,2,1,1,0.007728806380540305,2019-03-30 06:45:00,2019-03-30 07:00:00
164,1,0,1,0.004177537780680424,2019-03-30 06:45:00,2019-03-30 07:00:00
170,2,2,0,0.009238279393822933,2019-03-30 06:45:00,2019-03-30 07:00:00
177,1,1,0,0.01074775240710556,2019-03-30 06:45:00,2019-03-30 07:00:00
191,2,0,2,0.004177537780680424,2019-03-30 06:45:00,2019-03-30 07:00:00
201,1,1,0,0.007728806380540305,2019-03-30 06:45:00,2019-03-30 07:00:00
1,1,1,0,0.007453338150536254,2019-03-30 07:00:00,2019-03-30 07:15:00
2,1,0,1,0.004028632881323458,2019-03-30 07:00:00,2019-03-30 07:15:00
5,1,1,0,0.007453338150536254,2019-03-30 07:00:00,2019-03-30 07:15:00
30,1,0,1,0.004028632881323458,2019-03-30 07:00:00,2019-03-30 07:15:00
35,5,4,1,0.07366277286878804,2019-03-30 07:00:00,2019-03-30 07:15:00
58,1,0,1,0.004028632881323458,2019-03-30 07:00:00,2019-03-30 07:15:00
61,1,0,1,0.004028632881323458,2019-03-30 07:00:00,2019-03-30 07:15:00
67,1,1,0,0.007453338150536254,2019-03-30 07:00:00,2019-03-30 07:15:00
70,1,1,0,0.007453338150536254,2019-03-30 07:00:00,2019-03-30 07:15:00
74,1,0,1,0.004028632881323458,2019-03-30 07:00:00,2019-03-30 07:15:00
87,1,1,0,0.007453338150536254,2019-03-30 07:00:00,2019-03-30 07:15:00
88,4,0,4,0.004028632881323458,2019-03-30 07:00:00,2019-03-30 07:15:00
89,5,2,3,0.008309514467839452,2019-03-30 07:00:00,2019-03-30 07:15:00
109,1,0,1,0.004028632881323458,2019-03-30 07:00:00,2019-03-30 07:15:00
112,1,1,0,0.007453338150536254,2019-03-30 07:00:00,2019-03-30 07:15:00
115,5,4,1,0.04382902911346683,2019-03-30 07:00:00,2019-03-30 07:15:00
119,1,1,0,0.007453338150536254,2019-03-30 07:00:00,2019-03-30 07:15:00
126,2,2,0,0.007453338150536254,2019-03-30 07:00:00,2019-03-30 07:15:00
135,2,1,1,0.02677171644254825,2019-03-30 07:00:00,2019-03-30 07:15:00
138,1,0,1,0.004028632881323458,2019-03-30 07:00:00,2019-03-30 07:15:00
141,1,1,0,0.007453338150536254,2019-03-30 07:00:00,2019-03-30 07:15:00
158,1,0,1,0.004028632881323458,2019-03-30 07:00:00,2019-03-30 07:15:00
160,1,0,1,0.004028632881323458,2019-03-30 07:00:00,2019-03-30 07:15:00
162,1,1,0,0.007453338150536254,2019-03-30 07:00:00,2019-03-30 07:15:00
164,1,0,1,0.004028632881323458,2019-03-30 07:00:00,2019-03-30 07:15:00
170,1,0,1,0.004028632881323458,2019-03-30 07:00:00,2019-03-30 07:15:00
191,2,0,2,0.004028632881323458,2019-03-30 07:00:00,2019-03-30 07:15:00
201,1,1,0,0.007453338150536254,2019-03-30 07:00:00,2019-03-30 07:15:00
1,1,1,0,0.00758410641924454,2019-03-30 07:15:00,2019-03-30 07:30:00
18,2,2,0,0.015251307324608023,2019-03-30 07:15:00,2019-03-30 07:30:00
20,1,0,1,0.0040993317743156414,2019-03-30 07:15:00,2019-03-30 07:30:00
30,1,0,1,0.0040993317743156414,2019-03-30 07:15:00,2019-03-30 07:30:00
41,1,0,1,0.0040993317743156414,2019-03-30 07:15:00,2019-03-30 07:30:00
46,1,1,0,0.007129878636121445,2019-03-30 07:15:00,2019-03-30 07:30:00
61,1,0,1,0.0040993317743156414,2019-03-30 07:15:00,2019-03-30 07:30:00
67,1,1,0,0.00758410641924454,2019-03-30 07:15:00,2019-03-30 07:30:00
70,3,2,1,0.011068881064173438,2019-03-30 07:15:00,2019-03-30 07:30:00
74,1,0,1,0.0040993317743156414,2019-03-30 07:15:00,2019-03-30 07:30:00
88,4,0,4,0.0040993317743156414,2019-03-30 07:15:00,2019-03-30 07:30:00
89,1,1,0,0.004970525435547866,2019-03-30 07:15:00,2019-03-30 07:30:00
109,1,0,1,0.0040993317743156414,2019-03-30 07:15:00,2019-03-30 07:30:00
111,1,1,0,0.00758410641924454,2019-03-30 07:15:00,2019-03-30 07:30:00
112,1,1,0,0.0058417190967800904,2019-03-30 07:15:00,2019-03-30 07:30:00
115,5,4,1,0.044510962229930166,2019-03-30 07:15:00,2019-03-30 07:30:00
116,6,3,3,0.017505082377347516,2019-03-30 07:15:00,2019-03-30 07:30:00
119,3,2,1,0.05028405229501794,2019-03-30 07:15:00,2019-03-30 07:30:00
126,2,2,0,0.00758410641924454,2019-03-30 07:15:00,2019-03-30 07:30:00
135,3,1,2,0.007129878636121445,2019-03-30 07:15:00,2019-03-30 07:30:00
137,1,0,1,0.0040993317743156414,2019-03-30 07:15:00,2019-03-30 07:30:00
138,1,0,1,0.0040993317743156414,2019-03-30 07:15:00,2019-03-30 07:30:00
141,1,1,0,0.00758410641924454,2019-03-30 07:15:00,2019-03-30 07:30:00
153,1,1,0,0.00758410641924454,2019-03-30 07:15:00,2019-03-30 07:30:00
158,1,0,1,0.0040993317743156414,2019-03-30 07:15:00,2019-03-30 07:30:00
162,1,1,0,0.00758410641924454,2019-03-30 07:15:00,2019-03-30 07:30:00
164,1,0,1,0.0040993317743156414,2019-03-30 07:15:00,2019-03-30 07:30:00
170,2,0,2,0.0040993317743156414,2019-03-30 07:15:00,2019-03-30 07:30:00
171,1,0,1,0.0040993317743156414,2019-03-30 07:15:00,2019-03-30 07:30:00
172,1,1,0,0.00905981975336713,2019-03-30 07:15:00,2019-03-30 07:30:00
191,2,0,2,0.0040993317743156414,2019-03-30 07:15:00,2019-03-30 07:30:00
201,1,1,0,0.00758410641924454,2019-03-30 07:15:00,2019-03-30 07:30:00
1,1,1,0,0.006844317934384061,2019-03-30 07:30:00,2019-03-30 07:45:00
18,5,3,2,0.02585274826313439,2019-03-30 07:30:00,2019-03-30 07:45:00
20,1,0,1,0.003699479064776631,2019-03-30 07:30:00,2019-03-30 07:45:00
30,1,0,1,0.003699479064776631,2019-03-30 07:30:00,2019-03-30 07:45:00
41,1,0,1,0.003699479064776631,2019-03-30 07:30:00,2019-03-30 07:45:00
46,1,1,0,0.0064343758612703745,2019-03-30 07:30:00,2019-03-30 07:45:00
50,1,1,0,0.006844317934384061,2019-03-30 07:30:00,2019-03-30 07:45:00
57,1,1,0,0.006844317934384061,2019-03-30 07:30:00,2019-03-30 07:45:00
61,1,0,1,0.003699479064776631,2019-03-30 07:30:00,2019-03-30 07:45:00
62,2,2,0,0.007393722211469703,2019-03-30 07:30:00,2019-03-30 07:45:00
67,2,2,0,0.009989156803991492,2019-03-30 07:30:00,2019-03-30 07:45:00
68,1,0,1,0.003699479064776631,2019-03-30 07:30:00,2019-03-30 07:45:00
70,2,1,1,0.0162763366297159,2019-03-30 07:30:00,2019-03-30 07:45:00
88,6,1,5,0.014688864893811894,2019-03-30 07:30:00,2019-03-30 07:45:00
89,1,1,0,0.006197041018979039,2019-03-30 07:30:00,2019-03-30 07:45:00
109,1,0,1,0.003699479064776631,2019-03-30 07:30:00,2019-03-30 07:45:00
110,1,0,1,0.003699479064776631,2019-03-30 07:30:00,2019-03-30 07:45:00
111,2,1,1,0.006844317934384061,2019-03-30 07:30:00,2019-03-30 07:45:00
115,7,5,2,0.029587261221307178,2019-03-30 07:30:00,2019-03-30 07:45:00
116,6,2,4,0.008691439507730598,2019-03-30 07:30:00,2019-03-30 07:45:00
119,4,3,1,0.07665360943792698,2019-03-30 07:30:00,2019-03-30 07:45:00
126,2,2,0,0.006844317934384061,2019-03-30 07:30:00,2019-03-30 07:45:00
127,1,0,1,0.003699479064776631,2019-03-30 07:30:00,2019-03-30 07:45:00
135,3,1,2,0.0064343758612703745,2019-03-30 07:30:00,2019-03-30 07:45:00
137,1,0,1,0.003699479064776631,2019-03-30 07:30:00,2019-03-30 07:45:00
138,2,1,1,0.006844317934384061,2019-03-30 07:30:00,2019-03-30 07:45:00
140,2,1,1,0.024553635090453413,2019-03-30 07:30:00,2019-03-30 07:45:00
141,2,2,0,0.017833703763419324,2019-03-30 07:30:00,2019-03-30 07:45:00
151,2,2,0,0.006844317934384061,2019-03-30 07:30:00,2019-03-30 07:45:00
153,1,1,0,0.006844317934384061,2019-03-30 07:30:00,2019-03-30 07:45:00
158,1,0,1,0.003699479064776631,2019-03-30 07:30:00,2019-03-30 07:45:00
160,2,0,2,0.003699479064776631,2019-03-30 07:30:00,2019-03-30 07:45:00
162,1,1,0,0.006844317934384061,2019-03-30 07:30:00,2019-03-30 07:45:00
164,1,0,1,0.003699479064776631,2019-03-30 07:30:00,2019-03-30 07:45:00
170,2,1,1,0.006844317934384061,2019-03-30 07:30:00,2019-03-30 07:45:00
171,1,0,1,0.003699479064776631,2019-03-30 07:30:00,2019-03-30 07:45:00
172,2,1,1,0.005546600638123167,2019-03-30 07:30:00,2019-03-30 07:45:00
190,1,0,1,0.003699479064776631,2019-03-30 07:30:00,2019-03-30 07:45:00
191,2,0,2,0.003699479064776631,2019-03-30 07:30:00,2019-03-30 07:45:00
201,1,1,0,0.009517717793760686,2019-03-30 07:30:00,2019-03-30 07:45:00
1,1,1,0,0.007174066045614739,2019-03-30 07:45:00,2019-03-30 08:00:00
18,9,6,3,0.017790763604635104,2019-03-30 07:45:00,2019-03-30 08:00:00
21,1,1,0,0.007174066045614739,2019-03-30 07:45:00,2019-03-30 08:00:00
23,2,2,0,0.018036951081735017,2019-03-30 07:45:00,2019-03-30 08:00:00
30,1,0,1,0.003877713120414758,2019-03-30 07:45:00,2019-03-30 08:00:00
50,1,1,0,0.007174066045614739,2019-03-30 07:45:00,2019-03-30 08:00:00
61,2,0,2,0.003877713120414758,2019-03-30 07:45:00,2019-03-30 08:00:00
62,2,2,0,0.009771629777571596,2019-03-30 07:45:00,2019-03-30 08:00:00
67,1,1,0,0.007174066045614739,2019-03-30 07:45:00,2019-03-30 08:00:00
68,1,0,1,0.003877713120414758,2019-03-30 07:45:00,2019-03-30 08:00:00
70,1,1,0,0.015713325036007364,2019-03-30 07:45:00,2019-03-30 08:00:00
85,2,0,2,0.003877713120414758,2019-03-30 07:45:00,2019-03-30 08:00:00
88,6,1,5,0.00891899172332314,2019-03-30 07:45:00,2019-03-30 08:00:00
89,2,1,1,0.005394113931687396,2019-03-30 07:45:00,2019-03-30 08:00:00
90,1,0,1,0.003877713120414758,2019-03-30 07:45:00,2019-03-30 08:00:00
104,2,0,2,0.003877713120414758,2019-03-30 07:45:00,2019-03-30 08:00:00
109,2,1,1,0.009976263896478337,2019-03-30 07:45:00,2019-03-30 08:00:00
110,1,0,1,0.003877713120414758,2019-03-30 07:45:00,2019-03-30 08:00:00
111,2,1,1,0.00891899172332314,2019-03-30 07:45:00,2019-03-30 08:00:00
115,7,5,2,0.02784453152618847,2019-03-30 07:45:00,2019-03-30 08:00:00
116,4,1,3,0.010399799001430085,2019-03-30 07:45:00,2019-03-30 08:00:00
118,1,0,1,0.003877713120414758,2019-03-30 07:45:00,2019-03-30 08:00:00
119,5,3,2,0.015344328389230057,2019-03-30 07:45:00,2019-03-30 08:00:00
120,1,0,1,0.003877713120414758,2019-03-30 07:45:00,2019-03-30 08:00:00
126,3,2,1,0.012778461747341935,2019-03-30 07:45:00,2019-03-30 08:00:00
127,1,1,0,0.006824671448993177,2019-03-30 07:45:00,2019-03-30 08:00:00
135,2,1,1,0.0253148837770031,2019-03-30 07:45:00,2019-03-30 08:00:00
137,2,2,0,0.01755826795284153,2019-03-30 07:45:00,2019-03-30 08:00:00
138,1,0,1,0.003877713120414758,2019-03-30 07:45:00,2019-03-30 08:00:00
140,3,1,2,0.006744366937618583,2019-03-30 07:45:00,2019-03-30 08:00:00
141,3,2,1,0.012215344648523122,2019-03-30 07:45:00,2019-03-30 08:00:00
151,2,2,0,0.007174066045614739,2019-03-30 07:45:00,2019-03-30 08:00:00
153,1,0,1,0.003877713120414758,2019-03-30 07:45:00,2019-03-30 08:00:00
160,2,0,2,0.003877713120414758,2019-03-30 07:45:00,2019-03-30 08:00:00
162,1,1,0,0.012358431026506687,2019-03-30 07:45:00,2019-03-30 08:00:00
164,1,0,1,0.003877713120414758,2019-03-30 07:45:00,2019-03-30 08:00:00
169,2,2,0,0.007174066045614739,2019-03-30 07:45:00,2019-03-30 08:00:00
170,2,1,1,0.007174066045614739,2019-03-30 07:45:00,2019-03-30 08:00:00
172,1,0,1,0.003877713120414758,2019-03-30 07:45:00,2019-03-30 08:00:00
190,1,0,1,0.003877713120414758,2019-03-30 07:45:00,2019-03-30 08:00:00
191,4,2,2,0.01047041897081472,2019-03-30 07:45:00,2019-03-30 08:00:00
197,1,0,1,0.003877713120414758,2019-03-30 07:45:00,2019-03-30 08:00:00
201,1,1,0,0.007174066045614739,2019-03-30 07:45:00,2019-03-30 08:00:00
1,1,1,0,0.006768109600105869,2019-03-30 08:00:00,2019-03-30 08:15:00
5,1,0,1,0.003658277983967289,2019-03-30 08:00:00,2019-03-30 08:15:00
16,1,1,0,0.006768109600105869,2019-03-30 08:00:00,2019-03-30 08:15:00
18,6,5,1,0.013648687593807187,2019-03-30 08:00:00,2019-03-30 08:15:00
19,2,2,0,0.009567159502616478,2019-03-30 08:00:00,2019-03-30 08:15:00
23,1,1,0,0.010501566901829044,2019-03-30 08:00:00,2019-03-30 08:15:00
30,1,0,1,0.003658277983967289,2019-03-30 08:00:00,2019-03-30 08:15:00
40,1,1,0,0.005213193792036579,2019-03-30 08:00:00,2019-03-30 08:15:00
57,2,1,1,0.015260941577584314,2019-03-30 08:00:00,2019-03-30 08:15:00
58,1,0,1,0.003658277983967289,2019-03-30 08:00:00,2019-03-30 08:15:00
61,2,0,2,0.003658277983967289,2019-03-30 08:00:00,2019-03-30 08:15:00
62,3,1,2,0.006362748379521966,2019-03-30 08:00:00,2019-03-30 08:15:00
66,1,0,1,0.003658277983967289,2019-03-30 08:00:00,2019-03-30 08:15:00
75,2,1,1,0.024303537953113043,2019-03-30 08:00:00,2019-03-30 08:15:00
85,2,0,2,0.003658277983967289,2019-03-30 08:00:00,2019-03-30 08:15:00
87,1,1,0,0.006768109600105869,2019-03-30 08:00:00,2019-03-30 08:15:00
88,4,0,4,0.003658277983967289,2019-03-30 08:00:00,2019-03-30 08:15:00
89,2,1,1,0.004435735888001934,2019-03-30 08:00:00,2019-03-30 08:15:00
90,1,0,1,0.003658277983967289,2019-03-30 08:00:00,2019-03-30 08:15:00
104,2,0,2,0.003658277983967289,2019-03-30 08:00:00,2019-03-30 08:15:00
109,2,1,1,0.005213193792036579,2019-03-30 08:00:00,2019-03-30 08:15:00
110,2,1,1,0.005213193792036579,2019-03-30 08:00:00,2019-03-30 08:15:00
111,1,1,0,0.00808993912295418,2019-03-30 08:00:00,2019-03-30 08:15:00
114,1,1,0,0.006362748379521966,2019-03-30 08:00:00,2019-03-30 08:15:00
115,5,4,1,0.03978748292997238,2019-03-30 08:00:00,2019-03-30 08:15:00
116,2,2,0,0.010622134583145933,2019-03-30 08:00:00,2019-03-30 08:15:00
119,4,2,2,0.009067218775076642,2019-03-30 08:00:00,2019-03-30 08:15:00
126,5,3,2,0.016099666706850264,2019-03-30 08:00:00,2019-03-30 08:15:00
135,2,1,1,0.024303537953113043,2019-03-30 08:00:00,2019-03-30 08:15:00
137,1,1,0,0.006768109600105869,2019-03-30 08:00:00,2019-03-30 08:15:00
138,1,0,1,0.003658277983967289,2019-03-30 08:00:00,2019-03-30 08:15:00
140,2,0,2,0.003658277983967289,2019-03-30 08:00:00,2019-03-30 08:15:00
141,1,1,0,0.012055427691499119,2019-03-30 08:00:00,2019-03-30 08:15:00
153,1,0,1,0.003658277983967289,2019-03-30 08:00:00,2019-03-30 08:15:00
157,1,0,1,0.003658277983967289,2019-03-30 08:00:00,2019-03-30 08:15:00
162,1,1,0,0.00808993912295418,2019-03-30 08:00:00,2019-03-30 08:15:00
164,3,2,1,0.009877941216244449,2019-03-30 08:00:00,2019-03-30 08:15:00
169,2,2,0,0.006768109600105869,2019-03-30 08:00:00,2019-03-30 08:15:00
170,2,0,2,0.003658277983967289,2019-03-30 08:00:00,2019-03-30 08:15:00
172,1,0,1,0.003658277983967289,2019-03-30 08:00:00,2019-03-30 08:15:00
177,2,1,1,0.024303537953113043,2019-03-30 08:00:00,2019-03-30 08:15:00
190,2,1,1,0.024303537953113043,2019-03-30 08:00:00,2019-03-30 08:15:00
191,5,2,3,0.009877941216244449,2019-03-30 08:00:00,2019-03-30 08:15:00
195,1,1,0,0.01663168242870542,2019-03-30 08:00:00,2019-03-30 08:15:00
197,1,0,1,0.003658277983967289,2019-03-30 08:00:00,2019-03-30 08:15:00
199,1,0,1,0.003658277983967289,2019-03-30 08:00:00,2019-03-30 08:15:00
201,1,1,0,0.006768109600105869,2019-03-30 08:00:00,2019-03-30 08:15:00
1,2,2,0,0.008200800247810263,2019-03-30 08:15:00,2019-03-30 08:30:00
5,1,0,1,0.0036045343122452665,2019-03-30 08:15:00,2019-03-30 08:30:00
16,2,1,1,0.02395993018437499,2019-03-30 08:15:00,2019-03-30 08:30:00
18,4,2,2,0.010384109823834031,2019-03-30 08:15:00,2019-03-30 08:30:00
19,2,1,1,0.0066687116026219306,2019-03-30 08:15:00,2019-03-30 08:30:00
21,1,1,0,0.008018318480316616,2019-03-30 08:15:00,2019-03-30 08:30:00
26,3,2,1,0.005550114912120832,2019-03-30 08:15:00,2019-03-30 08:30:00
28,5,1,4,0.00457732461218305,2019-03-30 08:15:00,2019-03-30 08:30:00
30,2,0,2,0.0036045343122452665,2019-03-30 08:15:00,2019-03-30 08:30:00
40,1,1,0,0.009273595325963682,2019-03-30 08:15:00,2019-03-30 08:30:00
46,3,2,1,0.030420798708438973,2019-03-30 08:15:00,2019-03-30 08:30:00
57,2,1,1,0.008018318480316616,2019-03-30 08:15:00,2019-03-30 08:30:00
58,3,0,3,0.0036045343122452665,2019-03-30 08:15:00,2019-03-30 08:30:00
61,1,0,1,0.0036045343122452665,2019-03-30 08:15:00,2019-03-30 08:30:00
62,3,1,2,0.006269335046555944,2019-03-30 08:15:00,2019-03-30 08:30:00
66,2,1,1,0.02395993018437499,2019-03-30 08:15:00,2019-03-30 08:30:00
67,1,1,0,0.005136622957433598,2019-03-30 08:15:00,2019-03-30 08:30:00
75,2,1,1,0.02395993018437499,2019-03-30 08:15:00,2019-03-30 08:30:00
87,1,1,0,0.0066687116026219306,2019-03-30 08:15:00,2019-03-30 08:30:00
88,4,0,4,0.0036045343122452665,2019-03-30 08:15:00,2019-03-30 08:30:00
89,2,1,1,0.004370578634839433,2019-03-30 08:15:00,2019-03-30 08:30:00
90,1,0,1,0.0036045343122452665,2019-03-30 08:15:00,2019-03-30 08:30:00
104,1,0,1,0.0036045343122452665,2019-03-30 08:15:00,2019-03-30 08:30:00
109,1,0,1,0.0036045343122452665,2019-03-30 08:15:00,2019-03-30 08:30:00
114,1,1,0,0.006269335046555944,2019-03-30 08:15:00,2019-03-30 08:30:00
115,6,4,2,0.010266536148021962,2019-03-30 08:15:00,2019-03-30 08:30:00
116,2,2,0,0.0115989365151773,2019-03-30 08:15:00,2019-03-30 08:30:00
119,4,2,2,0.0115989365151773,2019-03-30 08:15:00,2019-03-30 08:30:00
126,2,2,0,0.009273595325963682,2019-03-30 08:15:00,2019-03-30 08:30:00
135,2,1,1,0.02395993018437499,2019-03-30 08:15:00,2019-03-30 08:30:00
137,1,1,0,0.004625926742370821,2019-03-30 08:15:00,2019-03-30 08:30:00
138,1,0,1,0.0036045343122452665,2019-03-30 08:15:00,2019-03-30 08:30:00
141,1,1,0,0.010576037187634557,2019-03-30 08:15:00,2019-03-30 08:30:00
153,1,1,0,0.005136622957433598,2019-03-30 08:15:00,2019-03-30 08:30:00
154,2,1,1,0.02395993018437499,2019-03-30 08:15:00,2019-03-30 08:30:00
157,1,0,1,0.0036045343122452665,2019-03-30 08:15:00,2019-03-30 08:30:00
160,1,0,1,0.0036045343122452665,2019-03-30 08:15:00,2019-03-30 08:30:00
162,2,2,0,0.01138685671174753,2019-03-30 08:15:00,2019-03-30 08:30:00
164,3,2,1,0.008200800247810263,2019-03-30 08:15:00,2019-03-30 08:30:00
168,2,2,0,0.005647319172496376,2019-03-30 08:15:00,2019-03-30 08:30:00
169,1,1,0,0.007968403180239465,2019-03-30 08:15:00,2019-03-30 08:30:00
172,1,0,1,0.0036045343122452665,2019-03-30 08:15:00,2019-03-30 08:30:00
177,1,0,1,0.0036045343122452665,2019-03-30 08:15:00,2019-03-30 08:30:00
190,2,1,1,0.02395993018437499,2019-03-30 08:15:00,2019-03-30 08:30:00
191,3,1,2,0.0066687116026219306,2019-03-30 08:15:00,2019-03-30 08:30:00
195,1,1,0,0.01042098210887931,2019-03-30 08:15:00,2019-03-30 08:30:00
199,2,0,2,0.0036045343122452665,2019-03-30 08:15:00,2019-03-30 08:30:00
201,1,1,0,0.0066687116026219306,2019-03-30 08:15:00,2019-03-30 08:30:00
1,3,2,1,0.007689104177899879,2019-03-30 08:30:00,2019-03-30 08:45:00
5,1,1,0,0.006896855995557061,2019-03-30 08:30:00,2019-03-30 08:45:00
18,1,0,1,0.003727863266185784,2019-03-30 08:30:00,2019-03-30 08:45:00
19,1,0,1,0.003727863266185784,2019-03-30 08:30:00,2019-03-30 08:45:00
20,2,1,1,0.024564378358868582,2019-03-30 08:30:00,2019-03-30 08:45:00
21,1,1,0,0.006896855995557061,2019-03-30 08:30:00,2019-03-30 08:45:00
26,4,3,1,0.01103765978910508,2019-03-30 08:30:00,2019-03-30 08:45:00
27,1,0,1,0.003727863266185784,2019-03-30 08:30:00,2019-03-30 08:45:00
28,5,1,4,0.00520188599616427,2019-03-30 08:30:00,2019-03-30 08:45:00
30,4,0,4,0.003727863266185784,2019-03-30 08:30:00,2019-03-30 08:45:00
40,1,1,0,0.006896855995557061,2019-03-30 08:30:00,2019-03-30 08:45:00
41,1,0,1,0.003727863266185784,2019-03-30 08:30:00,2019-03-30 08:45:00
46,4,4,0,0.016460050238874622,2019-03-30 08:30:00,2019-03-30 08:45:00
57,1,0,1,0.003727863266185784,2019-03-30 08:30:00,2019-03-30 08:45:00
58,3,1,2,0.004520111448528603,2019-03-30 08:30:00,2019-03-30 08:45:00
61,4,1,3,0.00520188599616427,2019-03-30 08:30:00,2019-03-30 08:45:00
62,3,1,2,0.006483781651960065,2019-03-30 08:30:00,2019-03-30 08:45:00
67,2,1,1,0.004520111448528603,2019-03-30 08:30:00,2019-03-30 08:45:00
85,1,0,1,0.003727863266185784,2019-03-30 08:30:00,2019-03-30 08:45:00
88,4,0,4,0.003727863266185784,2019-03-30 08:30:00,2019-03-30 08:45:00
89,3,1,2,0.004520111448528603,2019-03-30 08:30:00,2019-03-30 08:45:00
90,2,0,2,0.003727863266185784,2019-03-30 08:30:00,2019-03-30 08:45:00
109,2,1,1,0.009115346194339471,2019-03-30 08:30:00,2019-03-30 08:45:00
110,3,2,1,0.006896855995557061,2019-03-30 08:30:00,2019-03-30 08:45:00
112,1,0,1,0.003727863266185784,2019-03-30 08:30:00,2019-03-30 08:45:00
114,2,1,1,0.006483781651960065,2019-03-30 08:30:00,2019-03-30 08:45:00
115,6,4,2,0.010617659230621487,2019-03-30 08:30:00,2019-03-30 08:45:00
116,3,2,1,0.014109986691832433,2019-03-30 08:30:00,2019-03-30 08:45:00
118,1,1,0,0.009239700037734347,2019-03-30 08:30:00,2019-03-30 08:45:00
119,4,2,2,0.009047572963551655,2019-03-30 08:30:00,2019-03-30 08:45:00
120,1,0,1,0.003727863266185784,2019-03-30 08:30:00,2019-03-30 08:45:00
126,5,4,1,0.018777338899348302,2019-03-30 08:30:00,2019-03-30 08:45:00
135,4,2,2,0.011995618423508627,2019-03-30 08:30:00,2019-03-30 08:45:00
137,1,1,0,0.006896855995557061,2019-03-30 08:30:00,2019-03-30 08:45:00
138,2,1,1,0.004520111448528603,2019-03-30 08:30:00,2019-03-30 08:45:00
141,2,2,0,0.010065848724928337,2019-03-30 08:30:00,2019-03-30 08:45:00
153,2,2,0,0.01450282912249316,2019-03-30 08:30:00,2019-03-30 08:45:00
154,2,1,1,0.024564378358868582,2019-03-30 08:30:00,2019-03-30 08:45:00
160,1,0,1,0.003727863266185784,2019-03-30 08:30:00,2019-03-30 08:45:00
162,2,2,0,0.020860262586926817,2019-03-30 08:30:00,2019-03-30 08:45:00
164,1,0,1,0.003727863266185784,2019-03-30 08:30:00,2019-03-30 08:45:00
168,2,2,0,0.007570344741334657,2019-03-30 08:30:00,2019-03-30 08:45:00
169,1,1,0,0.00824091468359303,2019-03-30 08:30:00,2019-03-30 08:45:00
172,1,0,1,0.003727863266185784,2019-03-30 08:30:00,2019-03-30 08:45:00
189,2,2,0,0.008818096733131497,2019-03-30 08:30:00,2019-03-30 08:45:00
191,7,2,5,0.03168603699085896,2019-03-30 08:30:00,2019-03-30 08:45:00
195,1,1,0,0.006896855995557061,2019-03-30 08:30:00,2019-03-30 08:45:00
201,2,2,0,0.010739337470705934,2019-03-30 08:30:00,2019-03-30 08:45:00
202,1,0,1,0.003727863266185784,2019-03-30 08:30:00,2019-03-30 08:45:00
1,3,2,1,0.006945029411275382,2019-03-30 08:45:00,2019-03-30 09:00:00
2,1,1,0,0.006229445699290747,2019-03-30 08:45:00,2019-03-30 09:00:00
10,1,0,1,0.0033671108513522053,2019-03-30 08:45:00,2019-03-30 09:00:00
15,1,0,1,0.0033671108513522053,2019-03-30 08:45:00,2019-03-30 09:00:00
16,1,0,1,0.0033671108513522053,2019-03-30 08:45:00,2019-03-30 09:00:00
18,5,1,4,0.004275820606228051,2019-03-30 08:45:00,2019-03-30 09:00:00
20,3,1,2,0.005856366397054634,2019-03-30 08:45:00,2019-03-30 09:00:00
26,5,3,2,0.05295081926331112,2019-03-30 08:45:00,2019-03-30 09:00:00
27,1,0,1,0.0033671108513522053,2019-03-30 08:45:00,2019-03-30 09:00:00
28,1,0,1,0.0033671108513522053,2019-03-30 08:45:00,2019-03-30 09:00:00
30,4,0,4,0.0033671108513522053,2019-03-30 08:45:00,2019-03-30 09:00:00
37,1,1,0,0.004321222467331719,2019-03-30 08:45:00,2019-03-30 09:00:00
46,3,3,0,0.010754524726153007,2019-03-30 08:45:00,2019-03-30 09:00:00
57,1,0,1,0.0033671108513522053,2019-03-30 08:45:00,2019-03-30 09:00:00
58,1,1,0,0.00408269456333684,2019-03-30 08:45:00,2019-03-30 09:00:00
61,2,0,2,0.0033671108513522053,2019-03-30 08:45:00,2019-03-30 09:00:00
62,3,2,1,0.041401427550729675,2019-03-30 08:45:00,2019-03-30 09:00:00
67,2,1,1,0.00408269456333684,2019-03-30 08:45:00,2019-03-30 09:00:00
85,1,0,1,0.0033671108513522053,2019-03-30 08:45:00,2019-03-30 09:00:00
87,5,5,0,0.022324085817809522,2019-03-30 08:45:00,2019-03-30 09:00:00
88,5,0,5,0.0033671108513522053,2019-03-30 08:45:00,2019-03-30 09:00:00
89,3,1,2,0.003939577820939914,2019-03-30 08:45:00,2019-03-30 09:00:00
90,3,0,3,0.0033671108513522053,2019-03-30 08:45:00,2019-03-30 09:00:00
99,1,1,0,0.006229445699290747,2019-03-30 08:45:00,2019-03-30 09:00:00
109,4,3,1,0.012623949102453836,2019-03-30 08:45:00,2019-03-30 09:00:00
110,4,2,2,0.0052753340833112325,2019-03-30 08:45:00,2019-03-30 09:00:00
112,2,1,1,0.006229445699290747,2019-03-30 08:45:00,2019-03-30 09:00:00
113,1,1,0,0.007307795530309668,2019-03-30 08:45:00,2019-03-30 09:00:00
114,2,1,1,0.004798278275321476,2019-03-30 08:45:00,2019-03-30 09:00:00
115,5,4,1,0.033794564210854174,2019-03-30 08:45:00,2019-03-30 09:00:00
116,3,1,2,0.009271050904639012,2019-03-30 08:45:00,2019-03-30 09:00:00
118,1,1,0,0.007446087781430053,2019-03-30 08:45:00,2019-03-30 09:00:00
119,3,2,1,0.0318928483758853,2019-03-30 08:45:00,2019-03-30 09:00:00
120,2,1,1,0.007446087781430053,2019-03-30 08:45:00,2019-03-30 09:00:00
122,2,1,1,0.004275820606228051,2019-03-30 08:45:00,2019-03-30 09:00:00
126,5,4,1,0.013926100495051663,2019-03-30 08:45:00,2019-03-30 09:00:00
135,4,2,2,0.01083487748845949,2019-03-30 08:45:00,2019-03-30 09:00:00
137,1,1,0,0.009697030001848468,2019-03-30 08:45:00,2019-03-30 09:00:00
138,1,1,0,0.00408269456333684,2019-03-30 08:45:00,2019-03-30 09:00:00
140,1,0,1,0.0033671108513522053,2019-03-30 08:45:00,2019-03-30 09:00:00
141,3,2,1,0.011525064711507901,2019-03-30 08:45:00,2019-03-30 09:00:00
147,2,1,1,0.004798278275321476,2019-03-30 08:45:00,2019-03-30 09:00:00
153,3,3,0,0.013573282902101313,2019-03-30 08:45:00,2019-03-30 09:00:00
160,1,0,1,0.0033671108513522053,2019-03-30 08:45:00,2019-03-30 09:00:00
162,1,1,0,0.014098997423986922,2019-03-30 08:45:00,2019-03-30 09:00:00
164,1,0,1,0.0033671108513522053,2019-03-30 08:45:00,2019-03-30 09:00:00
168,3,1,2,0.0056093729967476805,2019-03-30 08:45:00,2019-03-30 09:00:00
169,2,2,0,0.008135621206949458,2019-03-30 08:45:00,2019-03-30 09:00:00
170,1,0,1,0.0033671108513522053,2019-03-30 08:45:00,2019-03-30 09:00:00
172,2,0,2,0.0033671108513522053,2019-03-30 08:45:00,2019-03-30 09:00:00
173,1,0,1,0.0033671108513522053,2019-03-30 08:45:00,2019-03-30 09:00:00
189,3,3,0,0.008812651294563724,2019-03-30 08:45:00,2019-03-30 09:00:00
191,10,4,6,0.02210987782435988,2019-03-30 08:45:00,2019-03-30 09:00:00
197,1,0,1,0.0033671108513522053,2019-03-30 08:45:00,2019-03-30 09:00:00
1,2,2,0,0.007307878347924466,2019-03-30 09:00:00,2019-03-30 09:15:00
2,2,2,0,0.015511371937846505,2019-03-30 09:00:00,2019-03-30 09:15:00
10,3,1,2,0.0062203197948256655,2019-03-30 09:00:00,2019-03-30 09:15:00
13,1,1,0,0.006616555548709313,2019-03-30 09:00:00,2019-03-30 09:15:00
15,1,0,1,0.003576335524557871,2019-03-30 09:00:00,2019-03-30 09:15:00
16,2,1,1,0.006616555548709313,2019-03-30 09:00:00,2019-03-30 09:15:00
18,5,1,4,0.005742579249773229,2019-03-30 09:00:00,2019-03-30 09:15:00
19,1,0,1,0.003576335524557871,2019-03-30 09:00:00,2019-03-30 09:15:00
20,4,2,2,0.007422799092062348,2019-03-30 09:00:00,2019-03-30 09:15:00
23,4,1,3,0.006616555548709313,2019-03-30 09:00:00,2019-03-30 09:15:00
26,4,2,2,0.023784761123110003,2019-03-30 09:00:00,2019-03-30 09:15:00
28,2,0,2,0.003576335524557871,2019-03-30 09:00:00,2019-03-30 09:15:00
30,1,0,1,0.003576335524557871,2019-03-30 09:00:00,2019-03-30 09:15:00
41,4,4,0,0.0122413104254193,2019-03-30 09:00:00,2019-03-30 09:15:00
61,3,1,2,0.0050964455366335915,2019-03-30 09:00:00,2019-03-30 09:15:00
62,5,4,1,0.07034510863238645,2019-03-30 09:00:00,2019-03-30 09:15:00
66,1,0,1,0.003576335524557871,2019-03-30 09:00:00,2019-03-30 09:15:00
87,3,3,0,0.010264819577691042,2019-03-30 09:00:00,2019-03-30 09:15:00
88,5,0,5,0.003576335524557871,2019-03-30 09:00:00,2019-03-30 09:15:00
89,1,1,0,0.004184379529388159,2019-03-30 09:00:00,2019-03-30 09:15:00
99,1,1,0,0.005742579249773229,2019-03-30 09:00:00,2019-03-30 09:15:00
109,3,2,1,0.007422799092062348,2019-03-30 09:00:00,2019-03-30 09:15:00
110,2,0,2,0.003576335524557871,2019-03-30 09:00:00,2019-03-30 09:15:00
112,1,1,0,0.007654091816590825,2019-03-30 09:00:00,2019-03-30 09:15:00
114,1,1,0,0.0050964455366335915,2019-03-30 09:00:00,2019-03-30 09:15:00
115,5,4,1,0.03590981648224127,2019-03-30 09:00:00,2019-03-30 09:15:00
119,3,2,1,0.03818102531598624,2019-03-30 09:00:00,2019-03-30 09:15:00
120,2,2,0,0.009978236978435749,2019-03-30 09:00:00,2019-03-30 09:15:00
122,1,1,0,0.00479678338500841,2019-03-30 09:00:00,2019-03-30 09:15:00
126,2,2,0,0.004958981122988177,2019-03-30 09:00:00,2019-03-30 09:15:00
127,1,1,0,0.0050964455366335915,2019-03-30 09:00:00,2019-03-30 09:15:00
129,1,1,0,0.0050964455366335915,2019-03-30 09:00:00,2019-03-30 09:15:00
135,2,1,1,0.023784761123110003,2019-03-30 09:00:00,2019-03-30 09:15:00
137,2,0,2,0.003576335524557871,2019-03-30 09:00:00,2019-03-30 09:15:00
147,2,1,1,0.005742579249773229,2019-03-30 09:00:00,2019-03-30 09:15:00
153,2,2,0,0.004958981122988177,2019-03-30 09:00:00,2019-03-30 09:15:00
154,1,0,1,0.003576335524557871,2019-03-30 09:00:00,2019-03-30 09:15:00
162,1,0,1,0.003576335524557871,2019-03-30 09:00:00,2019-03-30 09:15:00
168,1,0,1,0.003576335524557871,2019-03-30 09:00:00,2019-03-30 09:15:00
169,2,2,0,0.006616555548709313,2019-03-30 09:00:00,2019-03-30 09:15:00
170,2,1,1,0.00479678338500841,2019-03-30 09:00:00,2019-03-30 09:15:00
172,2,0,2,0.003576335524557871,2019-03-30 09:00:00,2019-03-30 09:15:00
173,3,1,2,0.0050964455366335915,2019-03-30 09:00:00,2019-03-30 09:15:00
189,1,1,0,0.00479678338500841,2019-03-30 09:00:00,2019-03-30 09:15:00
191,13,3,10,0.008132090454491358,2019-03-30 09:00:00,2019-03-30 09:15:00
197,2,1,1,0.006616555548709313,2019-03-30 09:00:00,2019-03-30 09:15:00
203,1,0,1,0.003576335524557871,2019-03-30 09:00:00,2019-03-30 09:15:00
1,3,3,0,0.009826737833386388,2019-03-30 09:15:00,2019-03-30 09:30:00
2,2,1,1,0.006794379967594918,2019-03-30 09:15:00,2019-03-30 09:30:00
13,1,1,0,0.0064780744061661115,2019-03-30 09:15:00,2019-03-30 09:30:00
16,1,1,0,0.004245632121352595,2019-03-30 09:15:00,2019-03-30 09:30:00
18,7,5,2,0.011538391330179571,2019-03-30 09:15:00,2019-03-30 09:30:00
19,1,0,1,0.0035014846930814226,2019-03-30 09:15:00,2019-03-30 09:30:00
20,2,1,1,0.023297070230464585,2019-03-30 09:15:00,2019-03-30 09:30:00
23,4,1,3,0.0064780744061661115,2019-03-30 09:15:00,2019-03-30 09:30:00
26,4,2,2,0.023297070230464585,2019-03-30 09:15:00,2019-03-30 09:30:00
28,2,0,2,0.0035014846930814226,2019-03-30 09:15:00,2019-03-30 09:30:00
30,1,0,1,0.0035014846930814226,2019-03-30 09:15:00,2019-03-30 09:30:00
41,5,5,0,0.016889563444123238,2019-03-30 09:15:00,2019-03-30 09:30:00
46,1,1,0,0.0064780744061661115,2019-03-30 09:15:00,2019-03-30 09:30:00
50,1,0,1,0.0035014846930814226,2019-03-30 09:15:00,2019-03-30 09:30:00
57,1,1,0,0.004989779549623767,2019-03-30 09:15:00,2019-03-30 09:30:00
58,2,1,1,0.004493681264109652,2019-03-30 09:15:00,2019-03-30 09:30:00
61,1,0,1,0.0035014846930814226,2019-03-30 09:15:00,2019-03-30 09:30:00
62,4,3,1,0.028245966614810374,2019-03-30 09:15:00,2019-03-30 09:30:00
66,4,0,4,0.0035014846930814226,2019-03-30 09:15:00,2019-03-30 09:30:00
71,2,1,1,0.023297070230464585,2019-03-30 09:15:00,2019-03-30 09:30:00
87,2,2,0,0.0064780744061661115,2019-03-30 09:15:00,2019-03-30 09:30:00
88,4,0,4,0.0035014846930814226,2019-03-30 09:15:00,2019-03-30 09:30:00
89,1,1,0,0.004245632121352595,2019-03-30 09:15:00,2019-03-30 09:30:00
109,2,1,1,0.003873558407217009,2019-03-30 09:15:00,2019-03-30 09:30:00
110,2,0,2,0.0035014846930814226,2019-03-30 09:15:00,2019-03-30 09:30:00
113,1,0,1,0.0035014846930814226,2019-03-30 09:15:00,2019-03-30 09:30:00
115,7,6,1,0.04804155215219353,2019-03-30 09:15:00,2019-03-30 09:30:00
116,1,0,1,0.0035014846930814226,2019-03-30 09:15:00,2019-03-30 09:30:00
119,3,2,1,0.043092655767847744,2019-03-30 09:15:00,2019-03-30 09:30:00
120,2,2,0,0.010765718416454795,2019-03-30 09:15:00,2019-03-30 09:30:00
126,2,2,0,0.004245632121352595,2019-03-30 09:15:00,2019-03-30 09:30:00
127,1,1,0,0.004989779549623767,2019-03-30 09:15:00,2019-03-30 09:30:00
129,1,1,0,0.0064780744061661115,2019-03-30 09:15:00,2019-03-30 09:30:00
135,2,1,1,0.023297070230464585,2019-03-30 09:15:00,2019-03-30 09:30:00
137,1,0,1,0.0035014846930814226,2019-03-30 09:15:00,2019-03-30 09:30:00
138,1,0,1,0.0035014846930814226,2019-03-30 09:15:00,2019-03-30 09:30:00
153,3,3,0,0.007222221834437284,2019-03-30 09:15:00,2019-03-30 09:30:00
158,3,0,3,0.0035014846930814226,2019-03-30 09:15:00,2019-03-30 09:30:00
162,1,0,1,0.0035014846930814226,2019-03-30 09:15:00,2019-03-30 09:30:00
164,4,2,2,0.023297070230464585,2019-03-30 09:15:00,2019-03-30 09:30:00
168,2,0,2,0.0035014846930814226,2019-03-30 09:15:00,2019-03-30 09:30:00
169,2,2,0,0.0064780744061661115,2019-03-30 09:15:00,2019-03-30 09:30:00
170,1,1,0,0.008405939526523411,2019-03-30 09:15:00,2019-03-30 09:30:00
173,2,0,2,0.0035014846930814226,2019-03-30 09:15:00,2019-03-30 09:30:00
191,8,0,8,0.0035014846930814226,2019-03-30 09:15:00,2019-03-30 09:30:00
196,1,1,0,0.004989779549623767,2019-03-30 09:15:00,2019-03-30 09:30:00
197,1,1,0,0.004989779549623767,2019-03-30 09:15:00,2019-03-30 09:30:00
203,2,0,2,0.0035014846930814226,2019-03-30 09:15:00,2019-03-30 09:30:00
1,4,3,1,0.011286505993633556,2019-03-30 09:30:00,2019-03-30 09:45:00
2,2,1,1,0.004673902257973296,2019-03-30 09:30:00,2019-03-30 09:45:00
16,2,1,1,0.005881553951042375,2019-03-30 09:30:00,2019-03-30 09:45:00
18,6,3,3,0.009464238019193797,2019-03-30 09:30:00,2019-03-30 09:45:00
19,1,1,0,0.005881553951042375,2019-03-30 09:30:00,2019-03-30 09:45:00
20,3,2,1,0.04679735370845857,2019-03-30 09:30:00,2019-03-30 09:45:00
23,1,1,0,0.00453031594039458,2019-03-30 09:30:00,2019-03-30 09:45:00
26,5,3,2,0.08501067744457919,2019-03-30 09:30:00,2019-03-30 09:45:00
27,1,1,0,0.008178935032301823,2019-03-30 09:30:00,2019-03-30 09:45:00
28,1,0,1,0.003179077929746785,2019-03-30 09:30:00,2019-03-30 09:45:00
30,1,0,1,0.003179077929746785,2019-03-30 09:30:00,2019-03-30 09:45:00
35,1,0,1,0.003179077929746785,2019-03-30 09:30:00,2019-03-30 09:45:00
41,1,1,0,0.005860936657466344,2019-03-30 09:30:00,2019-03-30 09:45:00
50,1,0,1,0.003179077929746785,2019-03-30 09:30:00,2019-03-30 09:45:00
58,4,1,3,0.004436109947636187,2019-03-30 09:30:00,2019-03-30 09:45:00
61,1,0,1,0.003179077929746785,2019-03-30 09:30:00,2019-03-30 09:45:00
62,5,3,2,0.006704432002982748,2019-03-30 09:30:00,2019-03-30 09:45:00
66,3,0,3,0.003179077929746785,2019-03-30 09:30:00,2019-03-30 09:45:00
67,1,1,0,0.005881553951042375,2019-03-30 09:30:00,2019-03-30 09:45:00
69,1,0,1,0.003179077929746785,2019-03-30 09:30:00,2019-03-30 09:45:00
71,2,1,1,0.02116688344549062,2019-03-30 09:30:00,2019-03-30 09:45:00
87,1,1,0,0.00453031594039458,2019-03-30 09:30:00,2019-03-30 09:45:00
88,5,0,5,0.003179077929746785,2019-03-30 09:30:00,2019-03-30 09:45:00
89,1,1,0,0.003719573134005903,2019-03-30 09:30:00,2019-03-30 09:45:00
108,3,1,2,0.00552931397857076,2019-03-30 09:30:00,2019-03-30 09:45:00
109,3,1,2,0.0035168874324087336,2019-03-30 09:30:00,2019-03-30 09:45:00
112,1,1,0,0.010407935954834994,2019-03-30 09:30:00,2019-03-30 09:45:00
113,2,1,1,0.03755592939645208,2019-03-30 09:30:00,2019-03-30 09:45:00
114,1,1,0,0.004436109947636187,2019-03-30 09:30:00,2019-03-30 09:45:00
115,11,8,3,0.011721151936106775,2019-03-30 09:30:00,2019-03-30 09:45:00
118,1,1,0,0.00552931397857076,2019-03-30 09:30:00,2019-03-30 09:45:00
119,4,2,2,0.010229786076218713,2019-03-30 09:30:00,2019-03-30 09:45:00
120,3,2,1,0.008503549260797412,2019-03-30 09:30:00,2019-03-30 09:45:00
122,1,1,0,0.007527310054923122,2019-03-30 09:30:00,2019-03-30 09:45:00
126,2,2,0,0.0038546969350706827,2019-03-30 09:30:00,2019-03-30 09:45:00
135,2,1,1,0.02116688344549062,2019-03-30 09:30:00,2019-03-30 09:45:00
137,1,0,1,0.003179077929746785,2019-03-30 09:30:00,2019-03-30 09:45:00
153,7,6,1,0.04043190323565186,2019-03-30 09:30:00,2019-03-30 09:45:00
159,1,1,0,0.005860936657466344,2019-03-30 09:30:00,2019-03-30 09:45:00
164,4,2,2,0.02116688344549062,2019-03-30 09:30:00,2019-03-30 09:45:00
168,3,3,0,0.012172134959711537,2019-03-30 09:30:00,2019-03-30 09:45:00
169,1,1,0,0.005881553951042375,2019-03-30 09:30:00,2019-03-30 09:45:00
170,3,1,2,0.00552931397857076,2019-03-30 09:30:00,2019-03-30 09:45:00
173,2,0,2,0.003179077929746785,2019-03-30 09:30:00,2019-03-30 09:45:00
190,1,0,1,0.003179077929746785,2019-03-30 09:30:00,2019-03-30 09:45:00
191,8,0,8,0.003179077929746785,2019-03-30 09:30:00,2019-03-30 09:45:00
196,1,0,1,0.003179077929746785,2019-03-30 09:30:00,2019-03-30 09:45:00
197,2,1,1,0.00453031594039458,2019-03-30 09:30:00,2019-03-30 09:45:00
203,2,0,2,0.003179077929746785,2019-03-30 09:30:00,2019-03-30 09:45:00
1,2,2,0,0.008862047216436169,2019-03-30 09:45:00,2019-03-30 10:00:00
5,1,0,1,0.003422483066889434,2019-03-30 09:45:00,2019-03-30 10:00:00
10,3,1,2,0.005952652274448425,2019-03-30 09:45:00,2019-03-30 10:00:00
16,5,3,2,0.011062198034328912,2019-03-30 09:45:00,2019-03-30 10:00:00
18,5,2,3,0.004368643648070979,2019-03-30 09:45:00,2019-03-30 10:00:00
19,1,1,0,0.006331878008877179,2019-03-30 09:45:00,2019-03-30 10:00:00
20,5,3,2,0.01413373247669256,2019-03-30 09:45:00,2019-03-30 10:00:00
23,2,2,0,0.007569787717638202,2019-03-30 09:45:00,2019-03-30 10:00:00
26,4,2,2,0.022744257027539135,2019-03-30 09:45:00,2019-03-30 10:00:00
27,1,1,0,0.008124475649325011,2019-03-30 09:45:00,2019-03-30 10:00:00
28,3,1,2,0.005952652274448425,2019-03-30 09:45:00,2019-03-30 10:00:00
30,1,0,1,0.003422483066889434,2019-03-30 09:45:00,2019-03-30 10:00:00
35,1,0,1,0.003422483066889434,2019-03-30 09:45:00,2019-03-30 10:00:00
41,4,3,1,0.050285534744684744,2019-03-30 09:45:00,2019-03-30 10:00:00
46,2,2,0,0.011633834061287148,2019-03-30 09:45:00,2019-03-30 10:00:00
58,6,3,3,0.005784410835248678,2019-03-30 09:45:00,2019-03-30 10:00:00
61,3,1,2,0.0048771805378833065,2019-03-30 09:45:00,2019-03-30 10:00:00
62,3,2,1,0.0056327634136029495,2019-03-30 09:45:00,2019-03-30 10:00:00
67,5,1,4,0.0043461316582980615,2019-03-30 09:45:00,2019-03-30 10:00:00
70,1,0,1,0.003422483066889434,2019-03-30 09:45:00,2019-03-30 10:00:00
71,3,1,2,0.005952652274448425,2019-03-30 09:45:00,2019-03-30 10:00:00
74,2,2,0,0.006913756997274728,2019-03-30 09:45:00,2019-03-30 10:00:00
79,1,0,1,0.003422483066889434,2019-03-30 09:45:00,2019-03-30 10:00:00
85,1,0,1,0.003422483066889434,2019-03-30 09:45:00,2019-03-30 10:00:00
87,1,1,0,0.005061585429229003,2019-03-30 09:45:00,2019-03-30 10:00:00
88,5,0,5,0.003422483066889434,2019-03-30 09:45:00,2019-03-30 10:00:00
89,2,2,0,0.004477442345877756,2019-03-30 09:45:00,2019-03-30 10:00:00
90,8,1,7,0.0038955633574802064,2019-03-30 09:45:00,2019-03-30 10:00:00
106,1,1,0,0.005952652274448425,2019-03-30 09:45:00,2019-03-30 10:00:00
108,1,0,1,0.003422483066889434,2019-03-30 09:45:00,2019-03-30 10:00:00
109,3,0,3,0.003422483066889434,2019-03-30 09:45:00,2019-03-30 10:00:00
111,1,1,0,0.0048771805378833065,2019-03-30 09:45:00,2019-03-30 10:00:00
112,6,6,0,0.015348270747828505,2019-03-30 09:45:00,2019-03-30 10:00:00
114,3,1,2,0.005061585429229003,2019-03-30 09:45:00,2019-03-30 10:00:00
115,14,8,6,0.012851876633211164,2019-03-30 09:45:00,2019-03-30 10:00:00
116,1,0,1,0.003422483066889434,2019-03-30 09:45:00,2019-03-30 10:00:00
118,5,4,1,0.009102823783103061,2019-03-30 09:45:00,2019-03-30 10:00:00
119,8,3,5,0.008327034284958429,2019-03-30 09:45:00,2019-03-30 10:00:00
120,5,0,5,0.003422483066889434,2019-03-30 09:45:00,2019-03-30 10:00:00
126,3,3,0,0.010421203602254523,2019-03-30 09:45:00,2019-03-30 10:00:00
133,1,1,0,0.006331878008877179,2019-03-30 09:45:00,2019-03-30 10:00:00
135,2,1,1,0.022744257027539135,2019-03-30 09:45:00,2019-03-30 10:00:00
137,3,2,1,0.006913756997274728,2019-03-30 09:45:00,2019-03-30 10:00:00
138,2,2,0,0.008025669118162023,2019-03-30 09:45:00,2019-03-30 10:00:00
141,1,1,0,0.008124475649325011,2019-03-30 09:45:00,2019-03-30 10:00:00
153,5,5,0,0.00881284207431238,2019-03-30 09:45:00,2019-03-30 10:00:00
157,1,0,1,0.003422483066889434,2019-03-30 09:45:00,2019-03-30 10:00:00
158,2,0,2,0.003422483066889434,2019-03-30 09:45:00,2019-03-30 10:00:00
159,1,1,0,0.004660392775650457,2019-03-30 09:45:00,2019-03-30 10:00:00
164,5,3,2,0.03240514400786398,2019-03-30 09:45:00,2019-03-30 10:00:00
168,3,3,0,0.010311483599086482,2019-03-30 09:45:00,2019-03-30 10:00:00
169,5,5,0,0.011297163200816468,2019-03-30 09:45:00,2019-03-30 10:00:00
170,4,2,2,0.00763943174615442,2019-03-30 09:45:00,2019-03-30 10:00:00
172,1,0,1,0.003422483066889434,2019-03-30 09:45:00,2019-03-30 10:00:00
173,1,0,1,0.003422483066889434,2019-03-30 09:45:00,2019-03-30 10:00:00
190,1,0,1,0.003422483066889434,2019-03-30 09:45:00,2019-03-30 10:00:00
191,10,2,8,0.010399911704411846,2019-03-30 09:45:00,2019-03-30 10:00:00
195,2,0,2,0.003422483066889434,2019-03-30 09:45:00,2019-03-30 10:00:00
196,1,1,0,0.006331878008877179,2019-03-30 09:45:00,2019-03-30 10:00:00
197,4,1,3,0.006331878008877179,2019-03-30 09:45:00,2019-03-30 10:00:00
199,4,2,2,0.022744257027539135,2019-03-30 09:45:00,2019-03-30 10:00:00
203,1,0,1,0.003422483066889434,2019-03-30 09:45:00,2019-03-30 10:00:00
1,3,2,1,0.007727413308993606,2019-03-30 10:00:00,2019-03-30 10:15:00
2,9,2,7,0.003576661712812899,2019-03-30 10:00:00,2019-03-30 10:15:00
5,3,2,1,0.02289185287822805,2019-03-30 10:00:00,2019-03-30 10:15:00
10,3,1,2,0.004709962286085225,2019-03-30 10:00:00,2019-03-30 10:15:00
16,3,1,2,0.005009946439125533,2019-03-30 10:00:00,2019-03-30 10:15:00
18,4,2,2,0.003628736699307562,2019-03-30 10:00:00,2019-03-30 10:15:00
20,4,2,2,0.008714026446064513,2019-03-30 10:00:00,2019-03-30 10:15:00
23,1,1,0,0.0042503403624212475,2019-03-30 10:00:00,2019-03-30 10:15:00
26,4,2,2,0.018028579955358403,2019-03-30 10:00:00,2019-03-30 10:15:00
27,5,1,4,0.004837443422137284,2019-03-30 10:00:00,2019-03-30 10:15:00
28,7,3,4,0.012785398244569713,2019-03-30 10:00:00,2019-03-30 10:15:00
30,1,0,1,0.002707930206095581,2019-03-30 10:00:00,2019-03-30 10:15:00
35,1,0,1,0.002707930206095581,2019-03-30 10:00:00,2019-03-30 10:15:00
41,2,1,1,0.018028579955358403,2019-03-30 10:00:00,2019-03-30 10:15:00
46,1,1,0,0.0031683334527015713,2019-03-30 10:00:00,2019-03-30 10:15:00
58,5,3,2,0.00457293170211936,2019-03-30 10:00:00,2019-03-30 10:15:00
61,7,2,5,0.004649453378536265,2019-03-30 10:00:00,2019-03-30 10:15:00
62,3,2,1,0.006310919423583054,2019-03-30 10:00:00,2019-03-30 10:15:00
67,5,2,3,0.008917856655683915,2019-03-30 10:00:00,2019-03-30 10:15:00
70,3,1,2,0.004709962286085225,2019-03-30 10:00:00,2019-03-30 10:15:00
71,6,4,2,0.021978146686451202,2019-03-30 10:00:00,2019-03-30 10:15:00
74,5,3,2,0.009193376560901096,2019-03-30 10:00:00,2019-03-30 10:15:00
79,1,0,1,0.002707930206095581,2019-03-30 10:00:00,2019-03-30 10:15:00
87,1,1,0,0.004651695277993935,2019-03-30 10:00:00,2019-03-30 10:15:00
88,5,0,5,0.002707930206095581,2019-03-30 10:00:00,2019-03-30 10:15:00
89,2,2,0,0.0036026992060602305,2019-03-30 10:00:00,2019-03-30 10:15:00
90,5,0,5,0.002707930206095581,2019-03-30 10:00:00,2019-03-30 10:15:00
104,1,1,0,0.005425397075963654,2019-03-30 10:00:00,2019-03-30 10:15:00
106,1,1,0,0.012051330743353102,2019-03-30 10:00:00,2019-03-30 10:15:00
108,1,0,1,0.002707930206095581,2019-03-30 10:00:00,2019-03-30 10:15:00
109,3,1,2,0.0048557417235282644,2019-03-30 10:00:00,2019-03-30 10:15:00
110,1,1,0,0.0045950069026401376,2019-03-30 10:00:00,2019-03-30 10:15:00
111,2,2,0,0.0055472811608178515,2019-03-30 10:00:00,2019-03-30 10:15:00
112,2,2,0,0.0038589383226105573,2019-03-30 10:00:00,2019-03-30 10:15:00
115,5,4,1,0.02722096980491609,2019-03-30 10:00:00,2019-03-30 10:15:00
116,1,0,1,0.002707930206095581,2019-03-30 10:00:00,2019-03-30 10:15:00
118,6,5,1,0.08376458625460471,2019-03-30 10:00:00,2019-03-30 10:15:00
119,6,2,4,0.004442640264833087,2019-03-30 10:00:00,2019-03-30 10:15:00
120,4,0,4,0.002707930206095581,2019-03-30 10:00:00,2019-03-30 10:15:00
122,1,1,0,0.0031683334527015713,2019-03-30 10:00:00,2019-03-30 10:15:00
126,6,3,3,0.011676190513337877,2019-03-30 10:00:00,2019-03-30 10:15:00
127,1,1,0,0.005009946439125533,2019-03-30 10:00:00,2019-03-30 10:15:00
133,1,1,0,0.004709962286085225,2019-03-30 10:00:00,2019-03-30 10:15:00
135,2,1,1,0.018028579955358403,2019-03-30 10:00:00,2019-03-30 10:15:00
137,6,3,3,0.007579057299218437,2019-03-30 10:00:00,2019-03-30 10:15:00
138,5,5,0,0.009500447452896424,2019-03-30 10:00:00,2019-03-30 10:15:00
140,1,1,0,0.0034984452620212894,2019-03-30 10:00:00,2019-03-30 10:15:00
141,1,1,0,0.004837443422137284,2019-03-30 10:00:00,2019-03-30 10:15:00
153,1,1,0,0.004479249149049347,2019-03-30 10:00:00,2019-03-30 10:15:00
157,3,1,2,0.004709962286085225,2019-03-30 10:00:00,2019-03-30 10:15:00
158,4,1,3,0.005009946439125533,2019-03-30 10:00:00,2019-03-30 10:15:00
159,1,1,0,0.0042503403624212475,2019-03-30 10:00:00,2019-03-30 10:15:00
164,7,4,3,0.02568890482998981,2019-03-30 10:00:00,2019-03-30 10:15:00
168,7,6,1,0.09636869747198033,2019-03-30 10:00:00,2019-03-30 10:15:00
169,11,9,2,0.009215120663822678,2019-03-30 10:00:00,2019-03-30 10:15:00
170,5,2,3,0.0066590564615312976,2019-03-30 10:00:00,2019-03-30 10:15:00
172,1,0,1,0.002707930206095581,2019-03-30 10:00:00,2019-03-30 10:15:00
173,1,0,1,0.002707930206095581,2019-03-30 10:00:00,2019-03-30 10:15:00
191,6,2,4,0.00847605977192572,2019-03-30 10:00:00,2019-03-30 10:15:00
195,2,0,2,0.002707930206095581,2019-03-30 10:00:00,2019-03-30 10:15:00
196,1,1,0,0.005425397075963654,2019-03-30 10:00:00,2019-03-30 10:15:00
197,5,1,4,0.003438761186749446,2019-03-30 10:00:00,2019-03-30 10:15:00
199,5,2,3,0.0062505680920031115,2019-03-30 10:00:00,2019-03-30 10:15:00
1,4,1,3,0.004618332839310015,2019-03-30 10:15:00,2019-03-30 10:30:00
2,9,2,7,0.0033103412107474512,2019-03-30 10:15:00,2019-03-30 10:30:00
5,3,2,1,0.019372316294154278,2019-03-30 10:15:00,2019-03-30 10:30:00
10,1,0,1,0.0024962405208237078,2019-03-30 10:15:00,2019-03-30 10:30:00
15,2,1,1,0.005219702147191637,2019-03-30 10:15:00,2019-03-30 10:30:00
16,5,2,3,0.0064446495745106025,2019-03-30 10:15:00,2019-03-30 10:30:00
18,8,4,4,0.0068027163737843935,2019-03-30 10:15:00,2019-03-30 10:30:00
20,3,1,2,0.0043418730292354305,2019-03-30 10:15:00,2019-03-30 10:30:00
21,2,2,0,0.004618332839310015,2019-03-30 10:15:00,2019-03-30 10:30:00
22,2,0,2,0.0024962405208237078,2019-03-30 10:15:00,2019-03-30 10:30:00
23,1,1,0,0.004618332839310015,2019-03-30 10:15:00,2019-03-30 10:30:00
26,4,2,2,0.016628315321219486,2019-03-30 10:15:00,2019-03-30 10:30:00
27,6,1,5,0.0043418730292354305,2019-03-30 10:15:00,2019-03-30 10:30:00
28,4,2,2,0.005927066253353739,2019-03-30 10:15:00,2019-03-30 10:30:00
30,1,0,1,0.0024962405208237078,2019-03-30 10:15:00,2019-03-30 10:30:00
35,1,0,1,0.0024962405208237078,2019-03-30 10:15:00,2019-03-30 10:30:00
37,1,0,1,0.0024962405208237078,2019-03-30 10:15:00,2019-03-30 10:30:00
41,2,1,1,0.016628315321219486,2019-03-30 10:15:00,2019-03-30 10:30:00
57,2,2,0,0.005387988161460189,2019-03-30 10:15:00,2019-03-30 10:30:00
58,1,1,0,0.004029119132925385,2019-03-30 10:15:00,2019-03-30 10:30:00
61,2,0,2,0.0024962405208237078,2019-03-30 10:15:00,2019-03-30 10:30:00
62,1,1,0,0.004618332839310015,2019-03-30 10:15:00,2019-03-30 10:30:00
67,2,2,0,0.006581432960375602,2019-03-30 10:15:00,2019-03-30 10:30:00
68,1,0,1,0.0024962405208237078,2019-03-30 10:15:00,2019-03-30 10:30:00
69,1,1,0,0.004322557256024295,2019-03-30 10:15:00,2019-03-30 10:30:00
70,3,2,1,0.02969934396237211,2019-03-30 10:15:00,2019-03-30 10:30:00
71,7,5,2,0.03976787698304736,2019-03-30 10:15:00,2019-03-30 10:30:00
74,3,1,2,0.004618332839310015,2019-03-30 10:15:00,2019-03-30 10:30:00
79,1,0,1,0.0024962405208237078,2019-03-30 10:15:00,2019-03-30 10:30:00
87,1,0,1,0.0024962405208237078,2019-03-30 10:15:00,2019-03-30 10:30:00
88,6,1,5,0.005619182816143072,2019-03-30 10:15:00,2019-03-30 10:30:00
89,2,2,0,0.0038537257249530114,2019-03-30 10:15:00,2019-03-30 10:30:00
104,1,0,1,0.0024962405208237078,2019-03-30 10:15:00,2019-03-30 10:30:00
109,1,1,0,0.005619182816143072,2019-03-30 10:15:00,2019-03-30 10:30:00
111,1,0,1,0.0024962405208237078,2019-03-30 10:15:00,2019-03-30 10:30:00
112,3,1,2,0.0043418730292354305,2019-03-30 10:15:00,2019-03-30 10:30:00
114,3,2,1,0.005753923094207117,2019-03-30 10:15:00,2019-03-30 10:30:00
115,5,4,1,0.03570675925420212,2019-03-30 10:15:00,2019-03-30 10:30:00
116,1,0,1,0.0024962405208237078,2019-03-30 10:15:00,2019-03-30 10:30:00
119,7,3,4,0.007212257610654846,2019-03-30 10:15:00,2019-03-30 10:30:00
120,1,0,1,0.0024962405208237078,2019-03-30 10:15:00,2019-03-30 10:30:00
122,2,2,0,0.0078891848029069,2019-03-30 10:15:00,2019-03-30 10:30:00
126,6,3,3,0.004087809759688438,2019-03-30 10:15:00,2019-03-30 10:30:00
137,4,2,2,0.007346703536333035,2019-03-30 10:15:00,2019-03-30 10:30:00
138,5,4,1,0.010986603376362064,2019-03-30 10:15:00,2019-03-30 10:30:00
140,2,1,1,0.0035572866800668615,2019-03-30 10:15:00,2019-03-30 10:30:00
141,2,1,1,0.00320360462698581,2019-03-30 10:15:00,2019-03-30 10:30:00
153,4,0,4,0.0024962405208237078,2019-03-30 10:15:00,2019-03-30 10:30:00
157,4,3,1,0.022049312141388746,2019-03-30 10:15:00,2019-03-30 10:30:00
158,1,1,0,0.004618332839310015,2019-03-30 10:15:00,2019-03-30 10:30:00
164,6,3,3,0.016628315321219486,2019-03-30 10:15:00,2019-03-30 10:30:00
168,9,8,1,0.126103162668091,2019-03-30 10:15:00,2019-03-30 10:30:00
169,16,14,2,0.010116352951764714,2019-03-30 10:15:00,2019-03-30 10:30:00
170,1,0,1,0.0024962405208237078,2019-03-30 10:15:00,2019-03-30 10:30:00
173,1,0,1,0.0024962405208237078,2019-03-30 10:15:00,2019-03-30 10:30:00
177,5,4,1,0.09622193471325109,2019-03-30 10:15:00,2019-03-30 10:30:00
191,1,1,0,0.0043418730292354305,2019-03-30 10:15:00,2019-03-30 10:30:00
196,1,1,0,0.005015670090842427,2019-03-30 10:15:00,2019-03-30 10:30:00
197,7,1,6,0.002908310456545522,2019-03-30 10:15:00,2019-03-30 10:30:00
199,1,1,0,0.0030267636004452847,2019-03-30 10:15:00,2019-03-30 10:30:00
201,6,0,6,0.0024962405208237078,2019-03-30 10:15:00,2019-03-30 10:30:00
203,3,0,3,0.0024962405208237078,2019-03-30 10:15:00,2019-03-30 10:30:00
1,9,5,4,0.0134070198955215,2019-03-30 10:30:00,2019-03-30 10:45:00
2,7,1,6,0.003209630134426161,2019-03-30 10:30:00,2019-03-30 10:45:00
5,2,1,1,0.017632025240977206,2019-03-30 10:30:00,2019-03-30 10:45:00
16,2,0,2,0.002647065286768491,2019-03-30 10:30:00,2019-03-30 10:45:00
18,11,5,6,0.0072134544451851875,2019-03-30 10:30:00,2019-03-30 10:45:00
19,4,4,0,0.011117037356483547,2019-03-30 10:30:00,2019-03-30 10:45:00
20,2,1,1,0.017632025240977206,2019-03-30 10:30:00,2019-03-30 10:45:00
23,5,1,4,0.0033614643931057834,2019-03-30 10:30:00,2019-03-30 10:45:00
26,4,2,2,0.017632025240977206,2019-03-30 10:30:00,2019-03-30 10:45:00
27,6,1,5,0.0048973246773991695,2019-03-30 10:30:00,2019-03-30 10:45:00
28,2,2,0,0.007746872748424618,2019-03-30 10:30:00,2019-03-30 10:45:00
30,3,1,2,0.0054966133577939395,2019-03-30 10:30:00,2019-03-30 10:45:00
37,1,0,1,0.002647065286768491,2019-03-30 10:30:00,2019-03-30 10:45:00
40,2,1,1,0.017632025240977206,2019-03-30 10:30:00,2019-03-30 10:45:00
46,1,1,0,0.0048973246773991695,2019-03-30 10:30:00,2019-03-30 10:45:00
57,1,1,0,0.0038070809399411727,2019-03-30 10:30:00,2019-03-30 10:45:00
61,2,0,2,0.002647065286768491,2019-03-30 10:30:00,2019-03-30 10:45:00
62,8,4,4,0.00814042672386722,2019-03-30 10:30:00,2019-03-30 10:45:00
66,1,0,1,0.002647065286768491,2019-03-30 10:30:00,2019-03-30 10:45:00
67,2,1,1,0.0037721949820838305,2019-03-30 10:30:00,2019-03-30 10:45:00
68,1,0,1,0.002647065286768491,2019-03-30 10:30:00,2019-03-30 10:45:00
69,1,1,0,0.0037721949820838305,2019-03-30 10:30:00,2019-03-30 10:45:00
70,5,2,3,0.005263819926881743,2019-03-30 10:30:00,2019-03-30 10:45:00
71,7,5,2,0.039801430382776476,2019-03-30 10:30:00,2019-03-30 10:45:00
74,2,0,2,0.002647065286768491,2019-03-30 10:30:00,2019-03-30 10:45:00
75,2,2,0,0.0046912094409882095,2019-03-30 10:30:00,2019-03-30 10:45:00
87,1,0,1,0.002647065286768491,2019-03-30 10:30:00,2019-03-30 10:45:00
88,9,3,6,0.005312512970112449,2019-03-30 10:30:00,2019-03-30 10:45:00
89,1,1,0,0.0033997813018541295,2019-03-30 10:30:00,2019-03-30 10:45:00
90,5,3,2,0.022627011892380106,2019-03-30 10:30:00,2019-03-30 10:45:00
104,1,0,1,0.002647065286768491,2019-03-30 10:30:00,2019-03-30 10:45:00
106,1,0,1,0.002647065286768491,2019-03-30 10:30:00,2019-03-30 10:45:00
109,3,2,1,0.004261832625251948,2019-03-30 10:30:00,2019-03-30 10:45:00
110,1,0,1,0.002647065286768491,2019-03-30 10:30:00,2019-03-30 10:45:00
111,3,0,3,0.002647065286768491,2019-03-30 10:30:00,2019-03-30 10:45:00
112,1,0,1,0.002647065286768491,2019-03-30 10:30:00,2019-03-30 10:45:00
114,4,3,1,0.005729977132512486,2019-03-30 10:30:00,2019-03-30 10:45:00
115,7,6,1,0.061781683911734664,2019-03-30 10:30:00,2019-03-30 10:45:00
116,1,0,1,0.002647065286768491,2019-03-30 10:30:00,2019-03-30 10:45:00
119,4,3,1,0.030119491869484472,2019-03-30 10:30:00,2019-03-30 10:45:00
126,9,3,6,0.007837472406416772,2019-03-30 10:30:00,2019-03-30 10:45:00
127,1,0,1,0.002647065286768491,2019-03-30 10:30:00,2019-03-30 10:45:00
137,5,2,3,0.004093660609316784,2019-03-30 10:30:00,2019-03-30 10:45:00
138,6,4,2,0.015973708885692994,2019-03-30 10:30:00,2019-03-30 10:45:00
140,1,1,0,0.0037721949820838305,2019-03-30 10:30:00,2019-03-30 10:45:00
141,1,1,0,0.0033971517503120505,2019-03-30 10:30:00,2019-03-30 10:45:00
147,2,0,2,0.002647065286768491,2019-03-30 10:30:00,2019-03-30 10:45:00
153,4,2,2,0.007613663782806472,2019-03-30 10:30:00,2019-03-30 10:45:00
154,1,1,0,0.0048973246773991695,2019-03-30 10:30:00,2019-03-30 10:45:00
157,4,3,1,0.024406371078713258,2019-03-30 10:30:00,2019-03-30 10:45:00
164,4,2,2,0.017632025240977206,2019-03-30 10:30:00,2019-03-30 10:45:00
168,5,5,0,0.011063148368887162,2019-03-30 10:30:00,2019-03-30 10:45:00
169,16,16,0,0.011913452196367214,2019-03-30 10:30:00,2019-03-30 10:45:00
170,1,0,1,0.002647065286768491,2019-03-30 10:30:00,2019-03-30 10:45:00
171,1,0,1,0.002647065286768491,2019-03-30 10:30:00,2019-03-30 10:45:00
177,5,4,1,0.10072963150272683,2019-03-30 10:30:00,2019-03-30 10:45:00
189,2,2,0,0.007147584068029849,2019-03-30 10:30:00,2019-03-30 10:45:00
191,3,1,2,0.005853826119867121,2019-03-30 10:30:00,2019-03-30 10:45:00
196,1,1,0,0.004378593809691354,2019-03-30 10:30:00,2019-03-30 10:45:00
197,4,0,4,0.002647065286768491,2019-03-30 10:30:00,2019-03-30 10:45:00
199,5,2,3,0.0061101223326142165,2019-03-30 10:30:00,2019-03-30 10:45:00
201,7,0,7,0.002647065286768491,2019-03-30 10:30:00,2019-03-30 10:45:00
203,3,0,3,0.002647065286768491,2019-03-30 10:30:00,2019-03-30 10:45:00
1,5,4,1,0.041761841925127614,2019-03-30 10:45:00,2019-03-30 11:00:00
2,6,1,5,0.003400100701337688,2019-03-30 10:45:00,2019-03-30 11:00:00
5,3,1,2,0.004608047977922649,2019-03-30 10:45:00,2019-03-30 11:00:00
16,1,0,1,0.0026493647644230183,2019-03-30 10:45:00,2019-03-30 11:00:00
18,12,6,6,0.022868436263400516,2019-03-30 10:45:00,2019-03-30 11:00:00
19,5,5,0,0.008086590885578069,2019-03-30 10:45:00,2019-03-30 11:00:00
20,5,4,1,0.03424209636382389,2019-03-30 10:45:00,2019-03-30 11:00:00
22,1,0,1,0.0026493647644230183,2019-03-30 10:45:00,2019-03-30 11:00:00
23,7,2,5,0.007169701612500163,2019-03-30 10:45:00,2019-03-30 11:00:00
26,3,1,2,0.004608047977922649,2019-03-30 10:45:00,2019-03-30 11:00:00
27,2,0,2,0.0026493647644230183,2019-03-30 10:45:00,2019-03-30 11:00:00
28,4,2,2,0.008014966234350933,2019-03-30 10:45:00,2019-03-30 11:00:00
30,2,1,1,0.03812720423862004,2019-03-30 10:45:00,2019-03-30 11:00:00
35,2,1,1,0.017633600279149526,2019-03-30 10:45:00,2019-03-30 11:00:00
37,2,1,1,0.0060562830208513024,2019-03-30 10:45:00,2019-03-30 11:00:00
40,1,0,1,0.0026493647644230183,2019-03-30 10:45:00,2019-03-30 11:00:00
41,3,1,2,0.004608047977922649,2019-03-30 10:45:00,2019-03-30 11:00:00
46,2,2,0,0.006027676480539032,2019-03-30 10:45:00,2019-03-30 11:00:00
50,1,0,1,0.0026493647644230183,2019-03-30 10:45:00,2019-03-30 11:00:00
57,1,1,0,0.003881837480744772,2019-03-30 10:45:00,2019-03-30 11:00:00
58,2,0,2,0.0026493647644230183,2019-03-30 10:45:00,2019-03-30 11:00:00
61,2,0,2,0.0026493647644230183,2019-03-30 10:45:00,2019-03-30 11:00:00
62,6,2,4,0.008141942654334013,2019-03-30 10:45:00,2019-03-30 11:00:00
64,2,1,1,0.0028996100767279083,2019-03-30 10:45:00,2019-03-30 11:00:00
66,1,0,1,0.0026493647644230183,2019-03-30 10:45:00,2019-03-30 11:00:00
67,4,1,3,0.004901572575167028,2019-03-30 10:45:00,2019-03-30 11:00:00
68,2,0,2,0.0026493647644230183,2019-03-30 10:45:00,2019-03-30 11:00:00
69,3,3,0,0.009112463599410668,2019-03-30 10:45:00,2019-03-30 11:00:00
70,4,1,3,0.0036969659986418116,2019-03-30 10:45:00,2019-03-30 11:00:00
71,5,4,1,0.03424209636382389,2019-03-30 10:45:00,2019-03-30 11:00:00
74,1,0,1,0.0026493647644230183,2019-03-30 10:45:00,2019-03-30 11:00:00
75,2,2,0,0.009130104922756989,2019-03-30 10:45:00,2019-03-30 11:00:00
87,2,1,1,0.004471528722984693,2019-03-30 10:45:00,2019-03-30 11:00:00
88,11,4,7,0.010160054838848891,2019-03-30 10:45:00,2019-03-30 11:00:00
89,2,1,1,0.003883308304637228,2019-03-30 10:45:00,2019-03-30 11:00:00
90,5,3,2,0.008960677341255162,2019-03-30 10:45:00,2019-03-30 11:00:00
99,1,0,1,0.0026493647644230183,2019-03-30 10:45:00,2019-03-30 11:00:00
106,1,0,1,0.0026493647644230183,2019-03-30 10:45:00,2019-03-30 11:00:00
108,2,1,1,0.017633600279149526,2019-03-30 10:45:00,2019-03-30 11:00:00
109,4,3,1,0.006924867048676779,2019-03-30 10:45:00,2019-03-30 11:00:00
110,1,0,1,0.0026493647644230183,2019-03-30 10:45:00,2019-03-30 11:00:00
111,1,0,1,0.0026493647644230183,2019-03-30 10:45:00,2019-03-30 11:00:00
112,1,1,0,0.004038313567036181,2019-03-30 10:45:00,2019-03-30 11:00:00
113,1,0,1,0.0026493647644230183,2019-03-30 10:45:00,2019-03-30 11:00:00
114,2,2,0,0.004901572575167028,2019-03-30 10:45:00,2019-03-30 11:00:00
115,8,5,3,0.01707766530059775,2019-03-30 10:45:00,2019-03-30 11:00:00
116,1,0,1,0.0026493647644230183,2019-03-30 10:45:00,2019-03-30 11:00:00
118,3,1,2,0.004608047977922649,2019-03-30 10:45:00,2019-03-30 11:00:00
119,5,4,1,0.05509418906596579,2019-03-30 10:45:00,2019-03-30 11:00:00
126,11,3,8,0.007840770718822151,2019-03-30 10:45:00,2019-03-30 11:00:00
127,2,1,1,0.003775468669795023,2019-03-30 10:45:00,2019-03-30 11:00:00
129,3,1,2,0.004608047977922649,2019-03-30 10:45:00,2019-03-30 11:00:00
135,1,1,0,0.004901572575167028,2019-03-30 10:45:00,2019-03-30 11:00:00
137,3,1,2,0.0028996100767279083,2019-03-30 10:45:00,2019-03-30 11:00:00
138,5,2,3,0.006430211936484323,2019-03-30 10:45:00,2019-03-30 11:00:00
140,1,1,0,0.003775468669795023,2019-03-30 10:45:00,2019-03-30 11:00:00
147,2,0,2,0.0026493647644230183,2019-03-30 10:45:00,2019-03-30 11:00:00
153,6,2,4,0.005213067537726901,2019-03-30 10:45:00,2019-03-30 11:00:00
154,1,1,0,0.004203263364564141,2019-03-30 10:45:00,2019-03-30 11:00:00
157,2,1,1,0.017633600279149526,2019-03-30 10:45:00,2019-03-30 11:00:00
158,1,1,0,0.006450698023852791,2019-03-30 10:45:00,2019-03-30 11:00:00
161,1,1,0,0.004038313567036181,2019-03-30 10:45:00,2019-03-30 11:00:00
162,5,2,3,0.00611521017687494,2019-03-30 10:45:00,2019-03-30 11:00:00
164,1,1,0,0.003775468669795023,2019-03-30 10:45:00,2019-03-30 11:00:00
168,7,6,1,0.012868606552510242,2019-03-30 10:45:00,2019-03-30 11:00:00
169,21,21,0,0.03125291013124052,2019-03-30 10:45:00,2019-03-30 11:00:00
170,6,1,5,0.003192081451680986,2019-03-30 10:45:00,2019-03-30 11:00:00
171,7,3,4,0.007311060564846384,2019-03-30 10:45:00,2019-03-30 11:00:00
177,1,1,0,0.004471528722984693,2019-03-30 10:45:00,2019-03-30 11:00:00
189,2,2,0,0.007153780385911037,2019-03-30 10:45:00,2019-03-30 11:00:00
190,2,2,0,0.0037347981389389533,2019-03-30 10:45:00,2019-03-30 11:00:00
191,9,5,4,0.013837779043949141,2019-03-30 10:45:00,2019-03-30 11:00:00
196,1,1,0,0.004382287470648979,2019-03-30 10:45:00,2019-03-30 11:00:00
197,3,0,3,0.0026493647644230183,2019-03-30 10:45:00,2019-03-30 11:00:00
199,5,2,3,0.00611521017687494,2019-03-30 10:45:00,2019-03-30 11:00:00
201,9,0,9,0.0026493647644230183,2019-03-30 10:45:00,2019-03-30 11:00:00
203,3,1,2,0.013589504113620688,2019-03-30 10:45:00,2019-03-30 11:00:00
1,3,2,1,0.005285191020539209,2019-03-30 11:00:00,2019-03-30 11:15:00
2,7,1,6,0.005487949823044364,2019-03-30 11:00:00,2019-03-30 11:15:00
5,8,2,6,0.004061652287766257,2019-03-30 11:00:00,2019-03-30 11:15:00
15,1,1,0,0.0048848423146052086,2019-03-30 11:00:00,2019-03-30 11:15:00
16,2,0,2,0.0029107504448930626,2019-03-30 11:00:00,2019-03-30 11:15:00
18,8,4,4,0.012217967579221509,2019-03-30 11:00:00,2019-03-30 11:15:00
19,2,2,0,0.005385087493722737,2019-03-30 11:00:00,2019-03-30 11:15:00
20,11,8,3,0.011648736763252406,2019-03-30 11:00:00,2019-03-30 11:15:00
23,14,7,7,0.01595752244629424,2019-03-30 11:00:00,2019-03-30 11:15:00
26,3,0,3,0.0029107504448930626,2019-03-30 11:00:00,2019-03-30 11:15:00
28,4,2,2,0.006497043896943973,2019-03-30 11:00:00,2019-03-30 11:15:00
30,3,1,2,0.0037355294611696207,2019-03-30 11:00:00,2019-03-30 11:15:00
35,3,1,2,0.0050625265161236095,2019-03-30 11:00:00,2019-03-30 11:15:00
37,2,1,1,0.0056722648806674155,2019-03-30 11:00:00,2019-03-30 11:15:00
41,11,2,9,0.003588666908151918,2019-03-30 11:00:00,2019-03-30 11:15:00
46,6,2,4,0.006838377134983311,2019-03-30 11:00:00,2019-03-30 11:15:00
50,1,0,1,0.0029107504448930626,2019-03-30 11:00:00,2019-03-30 11:15:00
57,1,1,0,0.0037355294611696207,2019-03-30 11:00:00,2019-03-30 11:15:00
58,1,0,1,0.0029107504448930626,2019-03-30 11:00:00,2019-03-30 11:15:00
61,3,0,3,0.0029107504448930626,2019-03-30 11:00:00,2019-03-30 11:15:00
62,9,5,4,0.014858886413142635,2019-03-30 11:00:00,2019-03-30 11:15:00
64,2,1,1,0.003185676783651915,2019-03-30 11:00:00,2019-03-30 11:15:00
67,10,5,5,0.014744185011531078,2019-03-30 11:00:00,2019-03-30 11:15:00
69,6,3,3,0.010800596039405065,2019-03-30 11:00:00,2019-03-30 11:15:00
70,2,0,2,0.0029107504448930626,2019-03-30 11:00:00,2019-03-30 11:15:00
71,5,4,1,0.034951188472082034,2019-03-30 11:00:00,2019-03-30 11:15:00
74,1,0,1,0.0029107504448930626,2019-03-30 11:00:00,2019-03-30 11:15:00
75,3,2,1,0.008103973398913772,2019-03-30 11:00:00,2019-03-30 11:15:00
85,3,3,0,0.023199000280115598,2019-03-30 11:00:00,2019-03-30 11:15:00
87,6,2,4,0.009288685031924857,2019-03-30 11:00:00,2019-03-30 11:15:00
88,8,2,6,0.004061652287766257,2019-03-30 11:00:00,2019-03-30 11:15:00
89,2,1,1,0.0034862013663296597,2019-03-30 11:00:00,2019-03-30 11:15:00
90,2,1,1,0.003185676783651915,2019-03-30 11:00:00,2019-03-30 11:15:00
99,1,0,1,0.0029107504448930626,2019-03-30 11:00:00,2019-03-30 11:15:00
101,1,1,0,0.007314593162212711,2019-03-30 11:00:00,2019-03-30 11:15:00
104,1,0,1,0.0029107504448930626,2019-03-30 11:00:00,2019-03-30 11:15:00
106,1,0,1,0.0029107504448930626,2019-03-30 11:00:00,2019-03-30 11:15:00
108,5,2,3,0.006718065084114952,2019-03-30 11:00:00,2019-03-30 11:15:00
109,6,6,0,0.022503722388606418,2019-03-30 11:00:00,2019-03-30 11:15:00
110,1,1,0,0.003427093837369677,2019-03-30 11:00:00,2019-03-30 11:15:00
111,4,3,1,0.014976632160858715,2019-03-30 11:00:00,2019-03-30 11:15:00
112,4,3,1,0.009587753137220942,2019-03-30 11:00:00,2019-03-30 11:15:00
114,1,1,0,0.0041479189693079,2019-03-30 11:00:00,2019-03-30 11:15:00
115,8,5,3,0.007555612109457923,2019-03-30 11:00:00,2019-03-30 11:15:00
116,1,1,0,0.005971236797830243,2019-03-30 11:00:00,2019-03-30 11:15:00
118,7,2,5,0.006527266784283763,2019-03-30 11:00:00,2019-03-30 11:15:00
119,9,2,7,0.004251872853646236,2019-03-30 11:00:00,2019-03-30 11:15:00
120,1,1,0,0.004848656455283972,2019-03-30 11:00:00,2019-03-30 11:15:00
122,1,0,1,0.0029107504448930626,2019-03-30 11:00:00,2019-03-30 11:15:00
126,9,1,8,0.007403575860002136,2019-03-30 11:00:00,2019-03-30 11:15:00
127,2,1,1,0.005385087493722737,2019-03-30 11:00:00,2019-03-30 11:15:00
129,4,2,2,0.005540698976397064,2019-03-30 11:00:00,2019-03-30 11:15:00
137,6,4,2,0.024202962508865958,2019-03-30 11:00:00,2019-03-30 11:15:00
138,11,8,3,0.015541111765219266,2019-03-30 11:00:00,2019-03-30 11:15:00
141,2,1,1,0.003427093837369677,2019-03-30 11:00:00,2019-03-30 11:15:00
151,1,1,0,0.0037355294611696207,2019-03-30 11:00:00,2019-03-30 11:15:00
153,5,1,4,0.0036974577060363487,2019-03-30 11:00:00,2019-03-30 11:15:00
154,1,1,0,0.004350138096820301,2019-03-30 11:00:00,2019-03-30 11:15:00
157,4,3,1,0.026947502792156807,2019-03-30 11:00:00,2019-03-30 11:15:00
160,4,2,2,0.01931888595735996,2019-03-30 11:00:00,2019-03-30 11:15:00
161,1,1,0,0.005417516545431109,2019-03-30 11:00:00,2019-03-30 11:15:00
162,3,1,2,0.0050625265161236095,2019-03-30 11:00:00,2019-03-30 11:15:00
164,1,0,1,0.0029107504448930626,2019-03-30 11:00:00,2019-03-30 11:15:00
168,11,7,4,0.017777824980223754,2019-03-30 11:00:00,2019-03-30 11:15:00
169,23,23,0,0.029436955397746017,2019-03-30 11:00:00,2019-03-30 11:15:00
170,4,0,4,0.0029107504448930626,2019-03-30 11:00:00,2019-03-30 11:15:00
171,9,4,5,0.008466081925089613,2019-03-30 11:00:00,2019-03-30 11:15:00
172,1,1,0,0.0036965296308083956,2019-03-30 11:00:00,2019-03-30 11:15:00
173,2,0,2,0.0029107504448930626,2019-03-30 11:00:00,2019-03-30 11:15:00
177,2,0,2,0.0029107504448930626,2019-03-30 11:00:00,2019-03-30 11:15:00
190,13,7,6,0.014540166767505393,2019-03-30 11:00:00,2019-03-30 11:15:00
191,7,7,0,0.01416725258736801,2019-03-30 11:00:00,2019-03-30 11:15:00
195,1,0,1,0.0029107504448930626,2019-03-30 11:00:00,2019-03-30 11:15:00
197,4,2,2,0.006063400744480961,2019-03-30 11:00:00,2019-03-30 11:15:00
199,4,2,2,0.01931888595735996,2019-03-30 11:00:00,2019-03-30 11:15:00
201,9,0,9,0.0029107504448930626,2019-03-30 11:00:00,2019-03-30 11:15:00
203,1,1,0,0.006688966386886013,2019-03-30 11:00:00,2019-03-30 11:15:00
1,3,2,1,0.004320348643259224,2019-03-30 11:15:00,2019-03-30 11:30:00
2,2,1,1,0.0032168255163444993,2019-03-30 11:15:00,2019-03-30 11:30:00
5,12,6,6,0.010015231861356456,2019-03-30 11:15:00,2019-03-30 11:30:00
15,1,1,0,0.004700461533835072,2019-03-30 11:15:00,2019-03-30 11:30:00
16,2,0,2,0.0026530184899842733,2019-03-30 11:15:00,2019-03-30 11:30:00
18,7,3,4,0.009308322811421273,2019-03-30 11:15:00,2019-03-30 11:30:00
19,4,2,2,0.007956657486503775,2019-03-30 11:15:00,2019-03-30 11:30:00
20,8,5,3,0.008808319936406454,2019-03-30 11:15:00,2019-03-30 11:30:00
23,10,5,5,0.012232166907954596,2019-03-30 11:15:00,2019-03-30 11:30:00
26,2,0,2,0.0026530184899842733,2019-03-30 11:15:00,2019-03-30 11:30:00
30,2,0,2,0.0026530184899842733,2019-03-30 11:15:00,2019-03-30 11:30:00
35,8,4,4,0.0088757810483596,2019-03-30 11:15:00,2019-03-30 11:30:00
37,1,0,1,0.0026530184899842733,2019-03-30 11:15:00,2019-03-30 11:30:00
40,1,1,0,0.00770147003029017,2019-03-30 11:15:00,2019-03-30 11:30:00
41,9,1,8,0.004908246595425177,2019-03-30 11:15:00,2019-03-30 11:30:00
46,5,1,4,0.0033689814781302074,2019-03-30 11:15:00,2019-03-30 11:30:00
50,1,0,1,0.0026530184899842733,2019-03-30 11:15:00,2019-03-30 11:30:00
57,1,1,0,0.003780632542704725,2019-03-30 11:15:00,2019-03-30 11:30:00
58,4,0,4,0.0026530184899842733,2019-03-30 11:15:00,2019-03-30 11:30:00
61,3,1,2,0.004908246595425177,2019-03-30 11:15:00,2019-03-30 11:30:00
62,13,8,5,0.0246113583784417,2019-03-30 11:15:00,2019-03-30 11:30:00
64,2,1,1,0.0034047611917979075,2019-03-30 11:15:00,2019-03-30 11:30:00
66,1,0,1,0.0026530184899842733,2019-03-30 11:15:00,2019-03-30 11:30:00
67,6,3,3,0.007101028973949533,2019-03-30 11:15:00,2019-03-30 11:30:00
69,4,2,2,0.006299025597850623,2019-03-30 11:15:00,2019-03-30 11:30:00
70,5,2,3,0.009358049307892503,2019-03-30 11:15:00,2019-03-30 11:30:00
71,5,4,1,0.02835721093015327,2019-03-30 11:15:00,2019-03-30 11:30:00
74,5,2,3,0.006123126365138662,2019-03-30 11:15:00,2019-03-30 11:30:00
75,3,2,1,0.0066095793109428695,2019-03-30 11:15:00,2019-03-30 11:30:00
80,2,1,1,0.01761659553205444,2019-03-30 11:15:00,2019-03-30 11:30:00
85,3,3,0,0.010557639038223113,2019-03-30 11:15:00,2019-03-30 11:30:00
87,3,1,2,0.004817079069167214,2019-03-30 11:15:00,2019-03-30 11:30:00
88,5,0,5,0.0026530184899842733,2019-03-30 11:15:00,2019-03-30 11:30:00
89,1,1,0,0.003104064111072454,2019-03-30 11:15:00,2019-03-30 11:30:00
90,2,1,1,0.0034047611917979075,2019-03-30 11:15:00,2019-03-30 11:30:00
99,3,0,3,0.0026530184899842733,2019-03-30 11:15:00,2019-03-30 11:30:00
101,1,1,0,0.004817079069167214,2019-03-30 11:15:00,2019-03-30 11:30:00
104,3,0,3,0.0026530184899842733,2019-03-30 11:15:00,2019-03-30 11:30:00
106,1,0,1,0.0026530184899842733,2019-03-30 11:15:00,2019-03-30 11:30:00
108,3,1,2,0.004614232334558705,2019-03-30 11:15:00,2019-03-30 11:30:00
109,9,5,4,0.02375437882313,2019-03-30 11:15:00,2019-03-30 11:30:00
110,4,4,0,0.011340663783421263,2019-03-30 11:15:00,2019-03-30 11:30:00
111,9,4,5,0.008399047626099282,2019-03-30 11:15:00,2019-03-30 11:30:00
112,6,3,3,0.009476822451842722,2019-03-30 11:15:00,2019-03-30 11:30:00
115,17,11,6,0.033120899982342945,2019-03-30 11:15:00,2019-03-30 11:30:00
116,1,1,0,0.005330323523397901,2019-03-30 11:15:00,2019-03-30 11:30:00
118,3,1,2,0.005021517460309841,2019-03-30 11:15:00,2019-03-30 11:30:00
119,9,2,7,0.005394259113147285,2019-03-30 11:15:00,2019-03-30 11:30:00
120,1,1,0,0.004732700222642636,2019-03-30 11:15:00,2019-03-30 11:30:00
122,1,0,1,0.0026530184899842733,2019-03-30 11:15:00,2019-03-30 11:30:00
126,6,1,5,0.003174560615893816,2019-03-30 11:15:00,2019-03-30 11:30:00
127,2,2,0,0.006889408215723605,2019-03-30 11:15:00,2019-03-30 11:30:00
129,2,1,1,0.0034047611917979075,2019-03-30 11:15:00,2019-03-30 11:30:00
137,6,4,2,0.01645075844597867,2019-03-30 11:15:00,2019-03-30 11:30:00
138,8,5,3,0.007637144058095022,2019-03-30 11:15:00,2019-03-30 11:30:00
140,2,1,1,0.00964541542106447,2019-03-30 11:15:00,2019-03-30 11:30:00
141,3,2,1,0.011507693485218002,2019-03-30 11:15:00,2019-03-30 11:30:00
151,2,1,1,0.003780632542704725,2019-03-30 11:15:00,2019-03-30 11:30:00
153,5,2,3,0.006123126365138662,2019-03-30 11:15:00,2019-03-30 11:30:00
157,5,2,3,0.00549099419328882,2019-03-30 11:15:00,2019-03-30 11:30:00
158,1,1,0,0.006035054847006184,2019-03-30 11:15:00,2019-03-30 11:30:00
159,7,3,4,0.008088532833632665,2019-03-30 11:15:00,2019-03-30 11:30:00
160,3,1,2,0.004371999757446612,2019-03-30 11:15:00,2019-03-30 11:30:00
161,1,1,0,0.004665162104452945,2019-03-30 11:15:00,2019-03-30 11:30:00
162,2,1,1,0.005866801046342895,2019-03-30 11:15:00,2019-03-30 11:30:00
164,1,1,0,0.0053048379882440246,2019-03-30 11:15:00,2019-03-30 11:30:00
168,19,12,7,0.026665618958755844,2019-03-30 11:15:00,2019-03-30 11:30:00
169,15,15,0,0.0330126191969549,2019-03-30 11:15:00,2019-03-30 11:30:00
170,4,0,4,0.0026530184899842733,2019-03-30 11:15:00,2019-03-30 11:30:00
171,9,4,5,0.013930852408237316,2019-03-30 11:15:00,2019-03-30 11:30:00
172,1,0,1,0.0026530184899842733,2019-03-30 11:15:00,2019-03-30 11:30:00
173,2,1,1,0.004908246595425177,2019-03-30 11:15:00,2019-03-30 11:30:00
177,3,1,2,0.004371999757446612,2019-03-30 11:15:00,2019-03-30 11:30:00
189,3,1,2,0.004614232334558705,2019-03-30 11:15:00,2019-03-30 11:30:00
190,9,5,4,0.009856387970646816,2019-03-30 11:15:00,2019-03-30 11:30:00
191,8,8,0,0.017051710208346664,2019-03-30 11:15:00,2019-03-30 11:30:00
196,1,1,0,0.005338380717575503,2019-03-30 11:15:00,2019-03-30 11:30:00
197,7,2,5,0.004906131155730416,2019-03-30 11:15:00,2019-03-30 11:30:00
199,4,2,2,0.01761659553205444,2019-03-30 11:15:00,2019-03-30 11:30:00
201,3,0,3,0.0026530184899842733,2019-03-30 11:15:00,2019-03-30 11:30:00
203,5,3,2,0.039052875568467475,2019-03-30 11:15:00,2019-03-30 11:30:00
1,4,2,2,0.004352204706632167,2019-03-30 11:30:00,2019-03-30 11:45:00
2,4,2,2,0.004766681609075307,2019-03-30 11:30:00,2019-03-30 11:45:00
5,13,7,6,0.008650912919252624,2019-03-30 11:30:00,2019-03-30 11:45:00
10,2,1,1,0.0025158167244181046,2019-03-30 11:30:00,2019-03-30 11:45:00
11,3,1,2,0.0037045512059775245,2019-03-30 11:30:00,2019-03-30 11:45:00
15,3,0,3,0.0021299327444730598,2019-03-30 11:30:00,2019-03-30 11:45:00
16,7,5,2,0.009347379621656684,2019-03-30 11:30:00,2019-03-30 11:45:00
18,7,3,4,0.004220878279055431,2019-03-30 11:30:00,2019-03-30 11:45:00
19,5,2,3,0.003924010131651675,2019-03-30 11:30:00,2019-03-30 11:45:00
20,6,3,3,0.004049080459410449,2019-03-30 11:30:00,2019-03-30 11:45:00
23,10,3,7,0.010872084362960475,2019-03-30 11:30:00,2019-03-30 11:45:00
26,1,0,1,0.0021299327444730598,2019-03-30 11:30:00,2019-03-30 11:45:00
28,2,0,2,0.0021299327444730598,2019-03-30 11:30:00,2019-03-30 11:45:00
30,1,0,1,0.0021299327444730598,2019-03-30 11:30:00,2019-03-30 11:45:00
35,8,4,4,0.006710323090613835,2019-03-30 11:30:00,2019-03-30 11:45:00
37,1,0,1,0.0021299327444730598,2019-03-30 11:30:00,2019-03-30 11:45:00
41,16,3,13,0.005901047556444881,2019-03-30 11:30:00,2019-03-30 11:45:00
46,5,1,4,0.002704750213218744,2019-03-30 11:30:00,2019-03-30 11:45:00
50,1,0,1,0.0021299327444730598,2019-03-30 11:30:00,2019-03-30 11:45:00
57,4,1,3,0.003940545114995372,2019-03-30 11:30:00,2019-03-30 11:45:00
58,6,0,6,0.0021299327444730598,2019-03-30 11:30:00,2019-03-30 11:45:00
61,2,1,1,0.003940545114995372,2019-03-30 11:30:00,2019-03-30 11:45:00
62,11,9,2,0.05923340110024904,2019-03-30 11:30:00,2019-03-30 11:45:00
64,1,0,1,0.0021299327444730598,2019-03-30 11:30:00,2019-03-30 11:45:00
66,1,0,1,0.0021299327444730598,2019-03-30 11:30:00,2019-03-30 11:45:00
67,5,2,3,0.005859194123335335,2019-03-30 11:30:00,2019-03-30 11:45:00
69,3,2,1,0.0061160230614705135,2019-03-30 11:30:00,2019-03-30 11:45:00
70,3,1,2,0.004464912880654922,2019-03-30 11:30:00,2019-03-30 11:45:00
71,5,4,1,0.022402029602620457,2019-03-30 11:30:00,2019-03-30 11:45:00
74,7,4,3,0.011561149846890603,2019-03-30 11:30:00,2019-03-30 11:45:00
75,3,2,1,0.003924010131651675,2019-03-30 11:30:00,2019-03-30 11:45:00
80,2,1,1,0.014185185579606057,2019-03-30 11:30:00,2019-03-30 11:45:00
85,5,5,0,0.012091152748321572,2019-03-30 11:30:00,2019-03-30 11:45:00
87,3,2,1,0.0071192292637883925,2019-03-30 11:30:00,2019-03-30 11:45:00
88,12,2,10,0.007875065127541311,2019-03-30 11:30:00,2019-03-30 11:45:00
89,1,1,0,0.002799416782064473,2019-03-30 11:30:00,2019-03-30 11:45:00
90,2,1,1,0.003940545114995372,2019-03-30 11:30:00,2019-03-30 11:45:00
99,4,0,4,0.0021299327444730598,2019-03-30 11:30:00,2019-03-30 11:45:00
104,4,0,4,0.0021299327444730598,2019-03-30 11:30:00,2019-03-30 11:45:00
106,3,2,1,0.0032795676819644282,2019-03-30 11:30:00,2019-03-30 11:45:00
108,5,1,4,0.002704750213218744,2019-03-30 11:30:00,2019-03-30 11:45:00
109,4,2,2,0.007875065127541311,2019-03-30 11:30:00,2019-03-30 11:45:00
110,8,7,1,0.00753011113563281,2019-03-30 11:30:00,2019-03-30 11:45:00
111,7,3,4,0.005304878525087139,2019-03-30 11:30:00,2019-03-30 11:45:00
112,8,5,3,0.014367388637762976,2019-03-30 11:30:00,2019-03-30 11:45:00
114,1,0,1,0.0021299327444730598,2019-03-30 11:30:00,2019-03-30 11:45:00
115,21,13,8,0.021970212727734948,2019-03-30 11:30:00,2019-03-30 11:45:00
116,3,3,0,0.009591023377323525,2019-03-30 11:30:00,2019-03-30 11:45:00
118,4,2,2,0.00522945014540278,2019-03-30 11:30:00,2019-03-30 11:45:00
119,10,4,6,0.0077906331331929375,2019-03-30 11:30:00,2019-03-30 11:45:00
120,1,1,0,0.003450555978292959,2019-03-30 11:30:00,2019-03-30 11:45:00
126,20,7,13,0.006295056768945393,2019-03-30 11:30:00,2019-03-30 11:45:00
127,4,2,2,0.0042815969830787,2019-03-30 11:30:00,2019-03-30 11:45:00
129,2,1,1,0.0041562194585608985,2019-03-30 11:30:00,2019-03-30 11:45:00
133,1,1,0,0.008531431159863104,2019-03-30 11:30:00,2019-03-30 11:45:00
135,2,1,1,0.014185185579606057,2019-03-30 11:30:00,2019-03-30 11:45:00
137,7,5,2,0.009256207497460691,2019-03-30 11:30:00,2019-03-30 11:45:00
138,8,6,2,0.008334141217596482,2019-03-30 11:30:00,2019-03-30 11:45:00
141,1,1,0,0.008182216169814824,2019-03-30 11:30:00,2019-03-30 11:45:00
151,1,0,1,0.0021299327444730598,2019-03-30 11:30:00,2019-03-30 11:45:00
153,9,4,5,0.006704583278203909,2019-03-30 11:30:00,2019-03-30 11:45:00
154,1,0,1,0.0021299327444730598,2019-03-30 11:30:00,2019-03-30 11:45:00
157,3,0,3,0.0021299327444730598,2019-03-30 11:30:00,2019-03-30 11:45:00
158,2,1,1,0.0032418655757430457,2019-03-30 11:30:00,2019-03-30 11:45:00
159,6,2,4,0.0038543851507101125,2019-03-30 11:30:00,2019-03-30 11:45:00
160,2,0,2,0.0021299327444730598,2019-03-30 11:30:00,2019-03-30 11:45:00
161,1,1,0,0.0037904498804257063,2019-03-30 11:30:00,2019-03-30 11:45:00
162,6,3,3,0.006073146792975479,2019-03-30 11:30:00,2019-03-30 11:45:00
164,4,4,0,0.006760496616724656,2019-03-30 11:30:00,2019-03-30 11:45:00
168,23,16,7,0.020541229637491498,2019-03-30 11:30:00,2019-03-30 11:45:00
169,17,15,2,0.1497561045439914,2019-03-30 11:30:00,2019-03-30 11:45:00
170,3,0,3,0.0021299327444730598,2019-03-30 11:30:00,2019-03-30 11:45:00
171,11,5,6,0.010155565665911363,2019-03-30 11:30:00,2019-03-30 11:45:00
172,1,0,1,0.0021299327444730598,2019-03-30 11:30:00,2019-03-30 11:45:00
173,2,2,0,0.00439319820762595,2019-03-30 11:30:00,2019-03-30 11:45:00
175,4,1,3,0.002972122351605838,2019-03-30 11:30:00,2019-03-30 11:45:00
177,3,3,0,0.005993048840272237,2019-03-30 11:30:00,2019-03-30 11:45:00
189,9,3,6,0.0037045512059775245,2019-03-30 11:30:00,2019-03-30 11:45:00
190,13,10,3,0.015237896337306666,2019-03-30 11:30:00,2019-03-30 11:45:00
191,5,5,0,0.01600626510117697,2019-03-30 11:30:00,2019-03-30 11:45:00
196,3,2,1,0.0038734157131319552,2019-03-30 11:30:00,2019-03-30 11:45:00
197,8,1,7,0.0024243462854844277,2019-03-30 11:30:00,2019-03-30 11:45:00
199,4,2,2,0.014185185579606057,2019-03-30 11:30:00,2019-03-30 11:45:00
201,1,0,1,0.0021299327444730598,2019-03-30 11:30:00,2019-03-30 11:45:00
203,5,3,2,0.03078367376225011,2019-03-30 11:30:00,2019-03-30 11:45:00
1,3,3,0,0.004065732043396783,2019-03-30 11:45:00,2019-03-30 12:00:00
2,6,2,4,0.0029892199179127254,2019-03-30 11:45:00,2019-03-30 12:00:00
5,11,6,5,0.010149489781636602,2019-03-30 11:45:00,2019-03-30 12:00:00
10,2,1,1,0.0026333242169281346,2019-03-30 11:45:00,2019-03-30 12:00:00
11,1,0,1,0.0017455499029341427,2019-03-30 11:45:00,2019-03-30 12:00:00
13,5,2,3,0.004028468688511389,2019-03-30 11:45:00,2019-03-30 12:00:00
15,7,4,3,0.0052617283840569445,2019-03-30 11:45:00,2019-03-30 12:00:00
16,8,6,2,0.014442759799518668,2019-03-30 11:45:00,2019-03-30 12:00:00
18,10,8,2,0.01209265734215448,2019-03-30 11:45:00,2019-03-30 12:00:00
19,5,1,4,0.018583720636635104,2019-03-30 11:45:00,2019-03-30 12:00:00
20,7,3,4,0.0038379383620450198,2019-03-30 11:45:00,2019-03-30 12:00:00
23,16,7,9,0.010215450503199365,2019-03-30 11:45:00,2019-03-30 12:00:00
26,2,2,0,0.0024356898267931483,2019-03-30 11:45:00,2019-03-30 12:00:00
27,1,0,1,0.0017455499029341427,2019-03-30 11:45:00,2019-03-30 12:00:00
28,4,0,4,0.0017455499029341427,2019-03-30 11:45:00,2019-03-30 12:00:00
30,2,0,2,0.0017455499029341427,2019-03-30 11:45:00,2019-03-30 12:00:00
35,7,4,3,0.013991718571776742,2019-03-30 11:45:00,2019-03-30 12:00:00
37,1,0,1,0.0017455499029341427,2019-03-30 11:45:00,2019-03-30 12:00:00
40,1,0,1,0.0017455499029341427,2019-03-30 11:45:00,2019-03-30 12:00:00
41,9,3,6,0.004506109598370167,2019-03-30 11:45:00,2019-03-30 12:00:00
46,6,2,4,0.0031586841644025455,2019-03-30 11:45:00,2019-03-30 12:00:00
50,2,0,2,0.0017455499029341427,2019-03-30 11:45:00,2019-03-30 12:00:00
57,4,1,3,0.002195189556475119,2019-03-30 11:45:00,2019-03-30 12:00:00
58,14,3,11,0.004604871277916514,2019-03-30 11:45:00,2019-03-30 12:00:00
61,1,0,1,0.0017455499029341427,2019-03-30 11:45:00,2019-03-30 12:00:00
62,20,12,8,0.00967647805017116,2019-03-30 11:45:00,2019-03-30 12:00:00
64,2,1,1,0.006986594666756949,2019-03-30 11:45:00,2019-03-30 12:00:00
66,1,0,1,0.0017455499029341427,2019-03-30 11:45:00,2019-03-30 12:00:00
67,5,1,4,0.008346738298373785,2019-03-30 11:45:00,2019-03-30 12:00:00
68,3,3,0,0.0054037539014761245,2019-03-30 11:45:00,2019-03-30 12:00:00
69,5,2,3,0.003345011431919915,2019-03-30 11:45:00,2019-03-30 12:00:00
70,2,0,2,0.0017455499029341427,2019-03-30 11:45:00,2019-03-30 12:00:00
71,2,1,1,0.01162913795231345,2019-03-30 11:45:00,2019-03-30 12:00:00
74,9,6,3,0.023294328100331656,2019-03-30 11:45:00,2019-03-30 12:00:00
75,7,3,4,0.015272152290331669,2019-03-30 11:45:00,2019-03-30 12:00:00
80,7,2,5,0.0026448292100160957,2019-03-30 11:45:00,2019-03-30 12:00:00
85,6,6,0,0.015132547440018039,2019-03-30 11:45:00,2019-03-30 12:00:00
87,4,2,2,0.009393798392910506,2019-03-30 11:45:00,2019-03-30 12:00:00
88,10,1,9,0.0024356898267931483,2019-03-30 11:45:00,2019-03-30 12:00:00
89,1,1,0,0.001975596544220478,2019-03-30 11:45:00,2019-03-30 12:00:00
90,4,3,1,0.0074619501880740565,2019-03-30 11:45:00,2019-03-30 12:00:00
99,5,2,3,0.0024874357611405734,2019-03-30 11:45:00,2019-03-30 12:00:00
104,3,1,2,0.003035838059622328,2019-03-30 11:45:00,2019-03-30 12:00:00
106,2,2,0,0.0030488644554803237,2019-03-30 11:45:00,2019-03-30 12:00:00
108,16,7,9,0.00689944478972496,2019-03-30 11:45:00,2019-03-30 12:00:00
109,9,6,3,0.022046422393854227,2019-03-30 11:45:00,2019-03-30 12:00:00
110,7,6,1,0.006677581582414353,2019-03-30 11:45:00,2019-03-30 12:00:00
111,8,4,4,0.010103650267737156,2019-03-30 11:45:00,2019-03-30 12:00:00
112,7,4,3,0.01176987628267118,2019-03-30 11:45:00,2019-03-30 12:00:00
113,1,1,0,0.0021684305283663726,2019-03-30 11:45:00,2019-03-30 12:00:00
114,4,1,3,0.0024356898267931483,2019-03-30 11:45:00,2019-03-30 12:00:00
115,14,8,6,0.006266153939607937,2019-03-30 11:45:00,2019-03-30 12:00:00
118,3,1,2,0.003519541757263575,2019-03-30 11:45:00,2019-03-30 12:00:00
119,11,9,2,0.017146571596474685,2019-03-30 11:45:00,2019-03-30 12:00:00
120,7,3,4,0.004714261343639393,2019-03-30 11:45:00,2019-03-30 12:00:00
122,2,1,1,0.01162913795231345,2019-03-30 11:45:00,2019-03-30 12:00:00
126,24,11,13,0.012068318962378947,2019-03-30 11:45:00,2019-03-30 12:00:00
127,5,1,4,0.002101445603918733,2019-03-30 11:45:00,2019-03-30 12:00:00
129,1,1,0,0.002380807613756707,2019-03-30 11:45:00,2019-03-30 12:00:00
133,3,2,1,0.0493453722596492,2019-03-30 11:45:00,2019-03-30 12:00:00
135,3,2,1,0.016570931977003104,2019-03-30 11:45:00,2019-03-30 12:00:00
137,11,5,6,0.014935186931241583,2019-03-30 11:45:00,2019-03-30 12:00:00
138,24,14,10,0.01902969798667558,2019-03-30 11:45:00,2019-03-30 12:00:00
140,1,1,0,0.001975596544220478,2019-03-30 11:45:00,2019-03-30 12:00:00
141,5,2,3,0.004028468688511389,2019-03-30 11:45:00,2019-03-30 12:00:00
151,2,0,2,0.0017455499029341427,2019-03-30 11:45:00,2019-03-30 12:00:00
153,8,5,3,0.011658656974297524,2019-03-30 11:45:00,2019-03-30 12:00:00
154,2,1,1,0.009033453382771717,2019-03-30 11:45:00,2019-03-30 12:00:00
157,5,2,3,0.00973216425524881,2019-03-30 11:45:00,2019-03-30 12:00:00
158,2,0,2,0.0017455499029341427,2019-03-30 11:45:00,2019-03-30 12:00:00
159,6,1,5,0.0024874357611405734,2019-03-30 11:45:00,2019-03-30 12:00:00
160,2,0,2,0.0017455499029341427,2019-03-30 11:45:00,2019-03-30 12:00:00
161,1,1,0,0.003519541757263575,2019-03-30 11:45:00,2019-03-30 12:00:00
162,8,4,4,0.005698683241667293,2019-03-30 11:45:00,2019-03-30 12:00:00
164,5,4,1,0.06410606980538629,2019-03-30 11:45:00,2019-03-30 12:00:00
168,26,19,7,0.03148556179599949,2019-03-30 11:45:00,2019-03-30 12:00:00
169,9,7,2,0.012330107509066959,2019-03-30 11:45:00,2019-03-30 12:00:00
170,3,0,3,0.0017455499029341427,2019-03-30 11:45:00,2019-03-30 12:00:00
171,10,5,5,0.02075073402889694,2019-03-30 11:45:00,2019-03-30 12:00:00
172,4,0,4,0.0017455499029341427,2019-03-30 11:45:00,2019-03-30 12:00:00
173,4,3,1,0.005417894378146915,2019-03-30 11:45:00,2019-03-30 12:00:00
175,2,0,2,0.0017455499029341427,2019-03-30 11:45:00,2019-03-30 12:00:00
177,3,3,0,0.0051487687760605645,2019-03-30 11:45:00,2019-03-30 12:00:00
189,11,5,6,0.020775147421051347,2019-03-30 11:45:00,2019-03-30 12:00:00
190,8,5,3,0.0070068996722682355,2019-03-30 11:45:00,2019-03-30 12:00:00
191,8,7,1,0.01980589959875175,2019-03-30 11:45:00,2019-03-30 12:00:00
196,3,2,1,0.009484316818125092,2019-03-30 11:45:00,2019-03-30 12:00:00
197,10,2,8,0.0028360455951500253,2019-03-30 11:45:00,2019-03-30 12:00:00
199,8,2,6,0.0024356898267931483,2019-03-30 11:45:00,2019-03-30 12:00:00
200,6,2,4,0.003035838059622328,2019-03-30 11:45:00,2019-03-30 12:00:00
201,1,0,1,0.0017455499029341427,2019-03-30 11:45:00,2019-03-30 12:00:00
203,6,4,2,0.047753517890956505,2019-03-30 11:45:00,2019-03-30 12:00:00
1,4,1,3,0.003253738081894519,2019-03-30 12:00:00,2019-03-30 12:15:00
2,4,1,3,0.0024541051151593316,2019-03-30 12:00:00,2019-03-30 12:15:00
5,9,3,6,0.0033063519579778185,2019-03-30 12:00:00,2019-03-30 12:15:00
10,1,1,0,0.0022720985693402687,2019-03-30 12:00:00,2019-03-30 12:15:00
11,1,0,1,0.001758742461242396,2019-03-30 12:00:00,2019-03-30 12:15:00
13,3,1,2,0.003058799080401283,2019-03-30 12:00:00,2019-03-30 12:15:00
15,7,7,0,0.011777248959473104,2019-03-30 12:00:00,2019-03-30 12:15:00
16,6,3,3,0.003890643063259602,2019-03-30 12:00:00,2019-03-30 12:15:00
18,13,10,3,0.01092519768711415,2019-03-30 12:00:00,2019-03-30 12:15:00
19,12,5,7,0.012303983491484233,2019-03-30 12:00:00,2019-03-30 12:15:00
20,6,4,2,0.01662558938556744,2019-03-30 12:00:00,2019-03-30 12:15:00
22,3,0,3,0.001758742461242396,2019-03-30 12:00:00,2019-03-30 12:15:00
23,19,9,10,0.02169947976325973,2019-03-30 12:00:00,2019-03-30 12:15:00
26,8,6,2,0.024335567840448383,2019-03-30 12:00:00,2019-03-30 12:15:00
27,1,0,1,0.001758742461242396,2019-03-30 12:00:00,2019-03-30 12:15:00
28,6,2,4,0.003241866963394958,2019-03-30 12:00:00,2019-03-30 12:15:00
30,1,0,1,0.001758742461242396,2019-03-30 12:00:00,2019-03-30 12:15:00
35,8,4,4,0.006537927575333882,2019-03-30 12:00:00,2019-03-30 12:15:00
37,2,0,2,0.001758742461242396,2019-03-30 12:00:00,2019-03-30 12:15:00
40,1,0,1,0.001758742461242396,2019-03-30 12:00:00,2019-03-30 12:15:00
41,10,3,7,0.004297460399366403,2019-03-30 12:00:00,2019-03-30 12:15:00
46,10,8,2,0.011284662951523826,2019-03-30 12:00:00,2019-03-30 12:15:00
50,3,1,2,0.002500304712318677,2019-03-30 12:00:00,2019-03-30 12:15:00
57,5,1,4,0.0022333514140710463,2019-03-30 12:00:00,2019-03-30 12:15:00
58,11,3,8,0.00574722106703033,2019-03-30 12:00:00,2019-03-30 12:15:00
61,1,0,1,0.001758742461242396,2019-03-30 12:00:00,2019-03-30 12:15:00
62,20,9,11,0.00959563567208593,2019-03-30 12:00:00,2019-03-30 12:15:00
64,1,1,0,0.01734640131044924,2019-03-30 12:00:00,2019-03-30 12:15:00
66,1,1,0,0.002645993321356938,2019-03-30 12:00:00,2019-03-30 12:15:00
67,2,1,1,0.0027003546399837954,2019-03-30 12:00:00,2019-03-30 12:15:00
68,3,3,0,0.003867790806208118,2019-03-30 12:00:00,2019-03-30 12:15:00
69,13,4,9,0.0028266358798985057,2019-03-30 12:00:00,2019-03-30 12:15:00
70,9,1,8,0.001967834101702795,2019-03-30 12:00:00,2019-03-30 12:15:00
71,2,1,1,0.011713045408955293,2019-03-30 12:00:00,2019-03-30 12:15:00
74,15,8,7,0.007753900597377989,2019-03-30 12:00:00,2019-03-30 12:15:00
75,14,9,5,0.01690235837334168,2019-03-30 12:00:00,2019-03-30 12:15:00
80,5,1,4,0.0022333514140710463,2019-03-30 12:00:00,2019-03-30 12:15:00
85,13,9,4,0.018849203785990205,2019-03-30 12:00:00,2019-03-30 12:15:00
86,7,5,2,0.031230725771147605,2019-03-30 12:00:00,2019-03-30 12:15:00
87,4,2,2,0.0067271766861877295,2019-03-30 12:00:00,2019-03-30 12:15:00
88,6,0,6,0.001758742461242396,2019-03-30 12:00:00,2019-03-30 12:15:00
89,3,2,1,0.003605862290706901,2019-03-30 12:00:00,2019-03-30 12:15:00
90,5,3,2,0.00644964586727282,2019-03-30 12:00:00,2019-03-30 12:15:00
99,2,2,0,0.003136652410755221,2019-03-30 12:00:00,2019-03-30 12:15:00
104,3,1,2,0.003058799080401283,2019-03-30 12:00:00,2019-03-30 12:15:00
106,4,3,1,0.015267609220578007,2019-03-30 12:00:00,2019-03-30 12:15:00
108,13,4,9,0.0028266358798985057,2019-03-30 12:00:00,2019-03-30 12:15:00
109,13,7,6,0.014230885556936851,2019-03-30 12:00:00,2019-03-30 12:15:00
110,6,3,3,0.005295726103383099,2019-03-30 12:00:00,2019-03-30 12:15:00
111,12,7,5,0.01334015341616941,2019-03-30 12:00:00,2019-03-30 12:15:00
112,10,5,5,0.005738233822124402,2019-03-30 12:00:00,2019-03-30 12:15:00
113,3,3,0,0.003588284706631157,2019-03-30 12:00:00,2019-03-30 12:15:00
114,4,3,1,0.010877051169322043,2019-03-30 12:00:00,2019-03-30 12:15:00
115,9,4,5,0.00301959637966633,2019-03-30 12:00:00,2019-03-30 12:15:00
116,2,0,2,0.001758742461242396,2019-03-30 12:00:00,2019-03-30 12:15:00
118,4,1,3,0.0024541051151593316,2019-03-30 12:00:00,2019-03-30 12:15:00
119,18,12,6,0.02561626524981568,2019-03-30 12:00:00,2019-03-30 12:15:00
120,7,3,4,0.0062678588087811005,2019-03-30 12:00:00,2019-03-30 12:15:00
126,26,12,14,0.015117291669108841,2019-03-30 12:00:00,2019-03-30 12:15:00
127,5,1,4,0.0023694728708137346,2019-03-30 12:00:00,2019-03-30 12:15:00
129,3,1,2,0.0024541051151593316,2019-03-30 12:00:00,2019-03-30 12:15:00
133,2,1,1,0.011713045408955293,2019-03-30 12:00:00,2019-03-30 12:15:00
135,4,3,1,0.022019582779474817,2019-03-30 12:00:00,2019-03-30 12:15:00
137,19,12,7,0.013157695320136612,2019-03-30 12:00:00,2019-03-30 12:15:00
138,32,15,17,0.017743623099042163,2019-03-30 12:00:00,2019-03-30 12:15:00
140,7,1,6,0.00200790839801775,2019-03-30 12:00:00,2019-03-30 12:15:00
141,4,1,3,0.0024541051151593316,2019-03-30 12:00:00,2019-03-30 12:15:00
151,5,2,3,0.0037099817525318903,2019-03-30 12:00:00,2019-03-30 12:15:00
153,12,8,4,0.01563849891103918,2019-03-30 12:00:00,2019-03-30 12:15:00
154,8,5,3,0.01915632469126696,2019-03-30 12:00:00,2019-03-30 12:15:00
157,8,4,4,0.010098538454263825,2019-03-30 12:00:00,2019-03-30 12:15:00
158,4,2,2,0.0045225482906978,2019-03-30 12:00:00,2019-03-30 12:15:00
159,6,1,5,0.001967834101702795,2019-03-30 12:00:00,2019-03-30 12:15:00
160,1,0,1,0.001758742461242396,2019-03-30 12:00:00,2019-03-30 12:15:00
162,10,4,6,0.004655545613563971,2019-03-30 12:00:00,2019-03-30 12:15:00
164,6,4,2,0.01741464054430649,2019-03-30 12:00:00,2019-03-30 12:15:00
168,36,26,10,0.029221744791496883,2019-03-30 12:00:00,2019-03-30 12:15:00
169,9,8,1,0.018335004335054767,2019-03-30 12:00:00,2019-03-30 12:15:00
170,3,0,3,0.001758742461242396,2019-03-30 12:00:00,2019-03-30 12:15:00
171,8,5,3,0.04909585461225157,2019-03-30 12:00:00,2019-03-30 12:15:00
172,4,0,4,0.001758742461242396,2019-03-30 12:00:00,2019-03-30 12:15:00
173,4,2,2,0.005658912318719057,2019-03-30 12:00:00,2019-03-30 12:15:00
175,4,1,3,0.0024541051151593316,2019-03-30 12:00:00,2019-03-30 12:15:00
177,4,4,0,0.005071409208783718,2019-03-30 12:00:00,2019-03-30 12:15:00
189,12,6,6,0.013486243933396161,2019-03-30 12:00:00,2019-03-30 12:15:00
190,9,5,4,0.006388954439109152,2019-03-30 12:00:00,2019-03-30 12:15:00
191,8,6,2,0.0158929854521809,2019-03-30 12:00:00,2019-03-30 12:15:00
195,2,2,0,0.002755406208343811,2019-03-30 12:00:00,2019-03-30 12:15:00
196,5,1,4,0.0037750504803717388,2019-03-30 12:00:00,2019-03-30 12:15:00
197,11,2,9,0.0029559160928004347,2019-03-30 12:00:00,2019-03-30 12:15:00
199,9,2,7,0.002322902003047731,2019-03-30 12:00:00,2019-03-30 12:15:00
200,8,4,4,0.003987451882412391,2019-03-30 12:00:00,2019-03-30 12:15:00
201,1,0,1,0.001758742461242396,2019-03-30 12:00:00,2019-03-30 12:15:00
203,7,5,2,0.04143388087279623,2019-03-30 12:00:00,2019-03-30 12:15:00
1,13,5,8,0.006224047264981362,2019-03-30 12:15:00,2019-03-30 12:30:00
2,6,2,4,0.008219451486282019,2019-03-30 12:15:00,2019-03-30 12:30:00
5,8,2,6,0.002488316658122315,2019-03-30 12:15:00,2019-03-30 12:30:00
10,1,1,0,0.003561574508821369,2019-03-30 12:15:00,2019-03-30 12:30:00
15,4,2,2,0.005407470780212516,2019-03-30 12:15:00,2019-03-30 12:30:00
16,10,4,6,0.006281816792390978,2019-03-30 12:15:00,2019-03-30 12:30:00
18,17,10,7,0.009419540629175728,2019-03-30 12:15:00,2019-03-30 12:30:00
19,5,2,3,0.002371937233335979,2019-03-30 12:15:00,2019-03-30 12:30:00
20,8,6,2,0.03216873594192238,2019-03-30 12:15:00,2019-03-30 12:30:00
22,2,0,2,0.0017832536368864275,2019-03-30 12:15:00,2019-03-30 12:30:00
23,16,10,6,0.02200406849076527,2019-03-30 12:15:00,2019-03-30 12:30:00
26,9,6,3,0.02377255513802319,2019-03-30 12:15:00,2019-03-30 12:30:00
27,1,1,0,0.00270636716617092,2019-03-30 12:15:00,2019-03-30 12:30:00
28,4,2,2,0.003647630309985884,2019-03-30 12:15:00,2019-03-30 12:30:00
30,1,0,1,0.0017832536368864275,2019-03-30 12:15:00,2019-03-30 12:30:00
35,6,3,3,0.011876287715361854,2019-03-30 12:15:00,2019-03-30 12:30:00
37,3,0,3,0.0017832536368864275,2019-03-30 12:15:00,2019-03-30 12:30:00
41,9,2,7,0.0023552826972571515,2019-03-30 12:15:00,2019-03-30 12:30:00
46,16,12,4,0.0222099770977216,2019-03-30 12:15:00,2019-03-30 12:30:00
50,4,2,2,0.0031920451307768717,2019-03-30 12:15:00,2019-03-30 12:30:00
57,7,1,6,0.0020775954351112034,2019-03-30 12:15:00,2019-03-30 12:30:00
58,12,6,6,0.005338864902921131,2019-03-30 12:15:00,2019-03-30 12:30:00
61,4,1,3,0.002488316658122315,2019-03-30 12:15:00,2019-03-30 12:30:00
62,18,8,10,0.010965119727996268,2019-03-30 12:15:00,2019-03-30 12:30:00
64,1,1,0,0.0071246230345244806,2019-03-30 12:15:00,2019-03-30 12:30:00
67,2,1,1,0.003498193343105879,2019-03-30 12:15:00,2019-03-30 12:30:00
68,4,4,0,0.004022667772937349,2019-03-30 12:15:00,2019-03-30 12:30:00
69,6,0,6,0.0017832536368864275,2019-03-30 12:15:00,2019-03-30 12:30:00
70,8,1,7,0.002029734530821315,2019-03-30 12:15:00,2019-03-30 12:30:00
71,6,3,3,0.011876287715361854,2019-03-30 12:15:00,2019-03-30 12:30:00
74,14,8,6,0.009092446168924307,2019-03-30 12:15:00,2019-03-30 12:30:00
75,12,8,4,0.010032659169008655,2019-03-30 12:15:00,2019-03-30 12:30:00
79,2,0,2,0.0017832536368864275,2019-03-30 12:15:00,2019-03-30 12:30:00
80,4,1,3,0.002488316658122315,2019-03-30 12:15:00,2019-03-30 12:30:00
85,9,6,3,0.008364080382702267,2019-03-30 12:15:00,2019-03-30 12:30:00
86,6,4,2,0.029013555725499275,2019-03-30 12:15:00,2019-03-30 12:30:00
87,2,0,2,0.0017832536368864275,2019-03-30 12:15:00,2019-03-30 12:30:00
88,7,2,5,0.012465992432162534,2019-03-30 12:15:00,2019-03-30 12:30:00
89,3,2,1,0.006049950450747732,2019-03-30 12:15:00,2019-03-30 12:30:00
90,1,1,0,0.0032990974381690245,2019-03-30 12:15:00,2019-03-30 12:30:00
99,2,2,0,0.004884137179483417,2019-03-30 12:15:00,2019-03-30 12:30:00
106,8,5,3,0.014969334076765053,2019-03-30 12:15:00,2019-03-30 12:30:00
108,14,4,10,0.002732797796863228,2019-03-30 12:15:00,2019-03-30 12:30:00
109,11,8,3,0.01588005006131893,2019-03-30 12:15:00,2019-03-30 12:30:00
110,6,3,3,0.003444379190326344,2019-03-30 12:15:00,2019-03-30 12:30:00
111,13,7,6,0.015560116277336916,2019-03-30 12:15:00,2019-03-30 12:30:00
112,9,5,4,0.004364826536668769,2019-03-30 12:15:00,2019-03-30 12:30:00
113,4,3,1,0.003806249104179777,2019-03-30 12:15:00,2019-03-30 12:30:00
114,3,3,0,0.008942347447791339,2019-03-30 12:15:00,2019-03-30 12:30:00
115,12,5,7,0.014641322661857817,2019-03-30 12:15:00,2019-03-30 12:30:00
116,2,0,2,0.0017832536368864275,2019-03-30 12:15:00,2019-03-30 12:30:00
118,3,1,2,0.0037512136855146036,2019-03-30 12:15:00,2019-03-30 12:30:00
119,12,7,5,0.012531698888040593,2019-03-30 12:15:00,2019-03-30 12:30:00
120,7,3,4,0.008525460921022725,2019-03-30 12:15:00,2019-03-30 12:30:00
122,4,0,4,0.0017832536368864275,2019-03-30 12:15:00,2019-03-30 12:30:00
126,24,9,15,0.008409234112480306,2019-03-30 12:15:00,2019-03-30 12:30:00
127,2,0,2,0.0017832536368864275,2019-03-30 12:15:00,2019-03-30 12:30:00
129,6,3,3,0.007575933270574146,2019-03-30 12:15:00,2019-03-30 12:30:00
133,2,1,1,0.011876287715361854,2019-03-30 12:15:00,2019-03-30 12:30:00
135,2,1,1,0.011876287715361854,2019-03-30 12:15:00,2019-03-30 12:30:00
137,18,11,7,0.016203683171446482,2019-03-30 12:15:00,2019-03-30 12:30:00
138,32,12,20,0.011460385414468149,2019-03-30 12:15:00,2019-03-30 12:30:00
140,1,0,1,0.0017832536368864275,2019-03-30 12:15:00,2019-03-30 12:30:00
141,2,1,1,0.0071246230345244806,2019-03-30 12:15:00,2019-03-30 12:30:00
151,6,4,2,0.018035894194810286,2019-03-30 12:15:00,2019-03-30 12:30:00
153,10,4,6,0.007943487469734075,2019-03-30 12:15:00,2019-03-30 12:30:00
154,8,4,4,0.004343618523956535,2019-03-30 12:15:00,2019-03-30 12:30:00
157,8,2,6,0.002420521787148781,2019-03-30 12:15:00,2019-03-30 12:30:00
158,2,2,0,0.006788696084028448,2019-03-30 12:15:00,2019-03-30 12:30:00
159,8,3,5,0.0029829408455027467,2019-03-30 12:15:00,2019-03-30 12:30:00
160,1,0,1,0.0017832536368864275,2019-03-30 12:15:00,2019-03-30 12:30:00
162,16,6,10,0.0036395492664184313,2019-03-30 12:15:00,2019-03-30 12:30:00
164,7,6,1,0.07015251235544072,2019-03-30 12:15:00,2019-03-30 12:30:00
168,53,38,15,0.030258678625451552,2019-03-30 12:15:00,2019-03-30 12:30:00
169,20,14,6,0.03769546643470417,2019-03-30 12:15:00,2019-03-30 12:30:00
170,5,2,3,0.002541175537527726,2019-03-30 12:15:00,2019-03-30 12:30:00
171,8,5,3,0.019656243046695,2019-03-30 12:15:00,2019-03-30 12:30:00
172,1,0,1,0.0017832536368864275,2019-03-30 12:15:00,2019-03-30 12:30:00
173,2,1,1,0.011876287715361854,2019-03-30 12:15:00,2019-03-30 12:30:00
175,6,2,4,0.0031014528382887667,2019-03-30 12:15:00,2019-03-30 12:30:00
177,4,4,0,0.0056706257772792335,2019-03-30 12:15:00,2019-03-30 12:30:00
189,12,5,7,0.00820124501762235,2019-03-30 12:15:00,2019-03-30 12:30:00
190,17,10,7,0.014945479091697772,2019-03-30 12:15:00,2019-03-30 12:30:00
191,9,6,3,0.007748197401806195,2019-03-30 12:15:00,2019-03-30 12:30:00
195,2,2,0,0.0032990974381690245,2019-03-30 12:15:00,2019-03-30 12:30:00
196,3,0,3,0.0017832536368864275,2019-03-30 12:15:00,2019-03-30 12:30:00
197,11,2,9,0.0021985597747319788,2019-03-30 12:15:00,2019-03-30 12:30:00
199,9,2,7,0.0023552826972571515,2019-03-30 12:15:00,2019-03-30 12:30:00
200,8,4,4,0.003980252305890325,2019-03-30 12:15:00,2019-03-30 12:30:00
201,1,0,1,0.0017832536368864275,2019-03-30 12:15:00,2019-03-30 12:30:00
203,9,6,3,0.015213295400082195,2019-03-30 12:15:00,2019-03-30 12:30:00
1,7,3,4,0.007045053354359919,2019-03-30 12:30:00,2019-03-30 12:45:00
2,4,1,3,0.0023506910800123225,2019-03-30 12:30:00,2019-03-30 12:45:00
5,11,3,8,0.0029617971551948183,2019-03-30 12:30:00,2019-03-30 12:45:00
10,1,1,0,0.0063242112733396996,2019-03-30 12:30:00,2019-03-30 12:45:00
11,1,1,0,0.0022444527811689573,2019-03-30 12:30:00,2019-03-30 12:45:00
15,7,3,4,0.003781418673748179,2019-03-30 12:30:00,2019-03-30 12:45:00
16,9,4,5,0.006755423088057206,2019-03-30 12:30:00,2019-03-30 12:45:00
18,20,13,7,0.017901331453141742,2019-03-30 12:30:00,2019-03-30 12:45:00
19,5,1,4,0.0023323677040554443,2019-03-30 12:30:00,2019-03-30 12:45:00
20,14,8,6,0.010447091709872276,2019-03-30 12:30:00,2019-03-30 12:45:00
22,2,2,0,0.0037327750665380266,2019-03-30 12:30:00,2019-03-30 12:45:00
23,19,7,12,0.015297559791794021,2019-03-30 12:30:00,2019-03-30 12:45:00
26,15,9,6,0.014630330522302702,2019-03-30 12:30:00,2019-03-30 12:45:00
27,2,1,1,0.0027933756846357308,2019-03-30 12:30:00,2019-03-30 12:45:00
28,7,5,2,0.00799949547164021,2019-03-30 12:30:00,2019-03-30 12:45:00
30,1,0,1,0.0020176529784857573,2019-03-30 12:30:00,2019-03-30 12:45:00
35,6,3,3,0.01341906058699227,2019-03-30 12:30:00,2019-03-30 12:45:00
37,4,2,2,0.0028857882858221054,2019-03-30 12:30:00,2019-03-30 12:45:00
40,1,1,0,0.003244204333627986,2019-03-30 12:30:00,2019-03-30 12:45:00
41,13,4,9,0.006137497886817566,2019-03-30 12:30:00,2019-03-30 12:45:00
46,17,14,3,0.010302491158221171,2019-03-30 12:30:00,2019-03-30 12:45:00
50,4,2,2,0.003476708171225901,2019-03-30 12:30:00,2019-03-30 12:45:00
57,4,0,4,0.0020176529784857573,2019-03-30 12:30:00,2019-03-30 12:45:00
58,10,5,5,0.006658444456457739,2019-03-30 12:30:00,2019-03-30 12:45:00
61,2,0,2,0.0020176529784857573,2019-03-30 12:30:00,2019-03-30 12:45:00
62,14,6,8,0.007927143683822448,2019-03-30 12:30:00,2019-03-30 12:45:00
67,1,1,0,0.004945859077746317,2019-03-30 12:30:00,2019-03-30 12:45:00
68,10,5,5,0.006312093275768819,2019-03-30 12:30:00,2019-03-30 12:45:00
69,4,2,2,0.0037327750665380266,2019-03-30 12:30:00,2019-03-30 12:45:00
70,9,2,7,0.002664887170881516,2019-03-30 12:30:00,2019-03-30 12:45:00
71,6,3,3,0.01341906058699227,2019-03-30 12:30:00,2019-03-30 12:45:00
74,12,6,6,0.0057194373768025795,2019-03-30 12:30:00,2019-03-30 12:45:00
75,8,4,4,0.00330903302528928,2019-03-30 12:30:00,2019-03-30 12:45:00
79,6,0,6,0.0020176529784857573,2019-03-30 12:30:00,2019-03-30 12:45:00
80,6,2,4,0.0035091706654128696,2019-03-30 12:30:00,2019-03-30 12:45:00
85,7,5,2,0.007038178293763485,2019-03-30 12:30:00,2019-03-30 12:45:00
86,6,4,2,0.024178893359582176,2019-03-30 12:30:00,2019-03-30 12:45:00
87,6,2,4,0.0036248861600704212,2019-03-30 12:30:00,2019-03-30 12:45:00
88,6,2,4,0.01337191103506069,2019-03-30 12:30:00,2019-03-30 12:45:00
89,3,3,0,0.006512267770730095,2019-03-30 12:30:00,2019-03-30 12:45:00
90,1,0,1,0.0020176529784857573,2019-03-30 12:30:00,2019-03-30 12:45:00
99,3,3,0,0.010891030909084306,2019-03-30 12:30:00,2019-03-30 12:45:00
104,2,2,0,0.012883510614982469,2019-03-30 12:30:00,2019-03-30 12:45:00
106,6,4,2,0.016479270149392485,2019-03-30 12:30:00,2019-03-30 12:45:00
108,13,3,10,0.0027083271185915064,2019-03-30 12:30:00,2019-03-30 12:45:00
109,4,4,0,0.008018306615224699,2019-03-30 12:30:00,2019-03-30 12:45:00
110,6,1,5,0.002553150995403688,2019-03-30 12:30:00,2019-03-30 12:45:00
111,7,4,3,0.0074429000274044595,2019-03-30 12:30:00,2019-03-30 12:45:00
112,6,3,3,0.004367623339507904,2019-03-30 12:30:00,2019-03-30 12:45:00
113,1,0,1,0.0020176529784857573,2019-03-30 12:30:00,2019-03-30 12:45:00
114,3,3,0,0.004960908549882723,2019-03-30 12:30:00,2019-03-30 12:45:00
115,14,9,5,0.025327535891956212,2019-03-30 12:30:00,2019-03-30 12:45:00
116,2,2,0,0.005400352256834941,2019-03-30 12:30:00,2019-03-30 12:45:00
118,5,1,4,0.0032414489123280465,2019-03-30 12:30:00,2019-03-30 12:45:00
119,8,6,2,0.010173119846977796,2019-03-30 12:30:00,2019-03-30 12:45:00
120,6,2,4,0.0035091706654128696,2019-03-30 12:30:00,2019-03-30 12:45:00
122,7,1,6,0.0023506910800123225,2019-03-30 12:30:00,2019-03-30 12:45:00
126,15,4,11,0.007979485031341937,2019-03-30 12:30:00,2019-03-30 12:45:00
127,1,0,1,0.0020176529784857573,2019-03-30 12:30:00,2019-03-30 12:45:00
129,4,0,4,0.0020176529784857573,2019-03-30 12:30:00,2019-03-30 12:45:00
133,4,1,3,0.0028154124666534726,2019-03-30 12:30:00,2019-03-30 12:45:00
135,2,1,1,0.01341906058699227,2019-03-30 12:30:00,2019-03-30 12:45:00
137,28,15,13,0.018714429369296768,2019-03-30 12:30:00,2019-03-30 12:45:00
138,28,11,17,0.008376829688752965,2019-03-30 12:30:00,2019-03-30 12:45:00
140,4,3,1,0.005689040780012625,2019-03-30 12:30:00,2019-03-30 12:45:00
141,1,1,0,0.007694782006773223,2019-03-30 12:30:00,2019-03-30 12:45:00
147,2,0,2,0.0020176529784857573,2019-03-30 12:30:00,2019-03-30 12:45:00
151,6,4,2,0.011838841211962324,2019-03-30 12:30:00,2019-03-30 12:45:00
153,12,5,7,0.014944434272076005,2019-03-30 12:30:00,2019-03-30 12:45:00
154,9,4,5,0.0045626157947961255,2019-03-30 12:30:00,2019-03-30 12:45:00
157,9,3,6,0.0037796910055844703,2019-03-30 12:30:00,2019-03-30 12:45:00
158,2,0,2,0.0020176529784857573,2019-03-30 12:30:00,2019-03-30 12:45:00
159,10,4,6,0.004536535970029237,2019-03-30 12:30:00,2019-03-30 12:45:00
162,18,7,11,0.004395355249931394,2019-03-30 12:30:00,2019-03-30 12:45:00
164,10,8,2,0.023544583083671453,2019-03-30 12:30:00,2019-03-30 12:45:00
168,49,38,11,0.037888779492506616,2019-03-30 12:30:00,2019-03-30 12:45:00
169,16,13,3,0.020033640382886506,2019-03-30 12:30:00,2019-03-30 12:45:00
170,2,0,2,0.0020176529784857573,2019-03-30 12:30:00,2019-03-30 12:45:00
171,8,5,3,0.020719680399034716,2019-03-30 12:30:00,2019-03-30 12:45:00
172,4,1,3,0.0023506910800123225,2019-03-30 12:30:00,2019-03-30 12:45:00
173,3,2,1,0.0291945306181691,2019-03-30 12:30:00,2019-03-30 12:45:00
175,5,3,2,0.018568845715812562,2019-03-30 12:30:00,2019-03-30 12:45:00
177,2,1,1,0.01341906058699227,2019-03-30 12:30:00,2019-03-30 12:45:00
189,8,4,4,0.004667650250813416,2019-03-30 12:30:00,2019-03-30 12:45:00
190,12,6,6,0.009592214481168839,2019-03-30 12:30:00,2019-03-30 12:45:00
191,12,8,4,0.010816977495194797,2019-03-30 12:30:00,2019-03-30 12:45:00
195,2,0,2,0.0020176529784857573,2019-03-30 12:30:00,2019-03-30 12:45:00
196,1,1,0,0.00419169156892755,2019-03-30 12:30:00,2019-03-30 12:45:00
197,20,6,14,0.003735230413176747,2019-03-30 12:30:00,2019-03-30 12:45:00
199,10,2,8,0.0025621489951563763,2019-03-30 12:30:00,2019-03-30 12:45:00
200,6,4,2,0.03450675371595303,2019-03-30 12:30:00,2019-03-30 12:45:00
201,1,1,0,0.003090819372799155,2019-03-30 12:30:00,2019-03-30 12:45:00
203,10,6,4,0.02288670637080261,2019-03-30 12:30:00,2019-03-30 12:45:00
1,6,3,3,0.005081150257234383,2019-03-30 12:45:00,2019-03-30 13:00:00
2,9,4,5,0.00750782761712342,2019-03-30 12:45:00,2019-03-30 13:00:00
5,21,7,14,0.0030310990711967713,2019-03-30 12:45:00,2019-03-30 13:00:00
11,1,1,0,0.0020087849074409076,2019-03-30 12:45:00,2019-03-30 13:00:00
15,10,6,4,0.00735954673680569,2019-03-30 12:45:00,2019-03-30 13:00:00
16,10,4,6,0.005059379599946912,2019-03-30 12:45:00,2019-03-30 13:00:00
18,18,11,7,0.024707322291640344,2019-03-30 12:45:00,2019-03-30 13:00:00
19,4,2,2,0.002643664457924644,2019-03-30 12:45:00,2019-03-30 13:00:00
20,18,9,9,0.010110965304940437,2019-03-30 12:45:00,2019-03-30 13:00:00
22,2,2,0,0.002335407769297269,2019-03-30 12:45:00,2019-03-30 13:00:00
23,17,5,12,0.011404341559361727,2019-03-30 12:45:00,2019-03-30 13:00:00
26,16,8,8,0.012474151601557768,2019-03-30 12:45:00,2019-03-30 13:00:00
27,1,0,1,0.0017428251810738989,2019-03-30 12:45:00,2019-03-30 13:00:00
28,12,8,4,0.01337139579800425,2019-03-30 12:45:00,2019-03-30 13:00:00
30,1,0,1,0.0017428251810738989,2019-03-30 12:45:00,2019-03-30 13:00:00
35,8,4,4,0.006951333406112576,2019-03-30 12:45:00,2019-03-30 13:00:00
37,2,2,0,0.0033758771873059513,2019-03-30 12:45:00,2019-03-30 13:00:00
40,1,1,0,0.007899772724958724,2019-03-30 12:45:00,2019-03-30 13:00:00
41,12,4,8,0.004638539929630885,2019-03-30 12:45:00,2019-03-30 13:00:00
46,23,17,6,0.016807798387626242,2019-03-30 12:45:00,2019-03-30 13:00:00
50,3,1,2,0.0030310990711967713,2019-03-30 12:45:00,2019-03-30 13:00:00
57,13,6,7,0.004859613760138821,2019-03-30 12:45:00,2019-03-30 13:00:00
58,5,0,5,0.0017428251810738989,2019-03-30 12:45:00,2019-03-30 13:00:00
61,1,0,1,0.0017428251810738989,2019-03-30 12:45:00,2019-03-30 13:00:00
62,14,10,4,0.01792088569899845,2019-03-30 12:45:00,2019-03-30 13:00:00
64,1,0,1,0.0017428251810738989,2019-03-30 12:45:00,2019-03-30 13:00:00
66,1,0,1,0.0017428251810738989,2019-03-30 12:45:00,2019-03-30 13:00:00
67,4,2,2,0.009363492026925224,2019-03-30 12:45:00,2019-03-30 13:00:00
68,5,2,3,0.0024835534163531116,2019-03-30 12:45:00,2019-03-30 13:00:00
69,8,6,2,0.009952716014986974,2019-03-30 12:45:00,2019-03-30 13:00:00
70,11,4,7,0.0030845424195288743,2019-03-30 12:45:00,2019-03-30 13:00:00
71,6,3,3,0.011606759354540816,2019-03-30 12:45:00,2019-03-30 13:00:00
74,13,6,7,0.005090730190825011,2019-03-30 12:45:00,2019-03-30 13:00:00
75,12,6,6,0.005762998396815709,2019-03-30 12:45:00,2019-03-30 13:00:00
79,8,2,6,0.0025795840092435315,2019-03-30 12:45:00,2019-03-30 13:00:00
80,6,2,4,0.0030310990711967713,2019-03-30 12:45:00,2019-03-30 13:00:00
85,4,4,0,0.004623220057139324,2019-03-30 12:45:00,2019-03-30 13:00:00
86,8,6,2,0.037420057886231775,2019-03-30 12:45:00,2019-03-30 13:00:00
87,9,6,3,0.01260731320500668,2019-03-30 12:45:00,2019-03-30 13:00:00
88,7,2,5,0.005049861707797304,2019-03-30 12:45:00,2019-03-30 13:00:00
89,2,2,0,0.0029718050552819666,2019-03-30 12:45:00,2019-03-30 13:00:00
90,5,4,1,0.00968601001868507,2019-03-30 12:45:00,2019-03-30 13:00:00
99,4,3,1,0.008752065271970071,2019-03-30 12:45:00,2019-03-30 13:00:00
101,1,1,0,0.0032200958958734987,2019-03-30 12:45:00,2019-03-30 13:00:00
104,1,1,0,0.004883711748337072,2019-03-30 12:45:00,2019-03-30 13:00:00
106,5,2,3,0.004022174552567194,2019-03-30 12:45:00,2019-03-30 13:00:00
108,14,5,9,0.004632741026302683,2019-03-30 12:45:00,2019-03-30 13:00:00
109,11,3,8,0.00438899488102686,2019-03-30 12:45:00,2019-03-30 13:00:00
110,6,6,0,0.006632361337263397,2019-03-30 12:45:00,2019-03-30 13:00:00
111,11,5,6,0.012950550624951635,2019-03-30 12:45:00,2019-03-30 13:00:00
112,8,5,3,0.006746265003050554,2019-03-30 12:45:00,2019-03-30 13:00:00
113,6,3,3,0.002741123211483874,2019-03-30 12:45:00,2019-03-30 13:00:00
114,3,3,0,0.003956868722022133,2019-03-30 12:45:00,2019-03-30 13:00:00
115,11,9,2,0.014484145928947534,2019-03-30 12:45:00,2019-03-30 13:00:00
116,2,2,0,0.0053255972851053174,2019-03-30 12:45:00,2019-03-30 13:00:00
118,4,0,4,0.0017428251810738989,2019-03-30 12:45:00,2019-03-30 13:00:00
119,10,7,3,0.016501793428642407,2019-03-30 12:45:00,2019-03-30 13:00:00
120,4,1,3,0.002431888103761581,2019-03-30 12:45:00,2019-03-30 13:00:00
122,9,1,8,0.0019500230291099564,2019-03-30 12:45:00,2019-03-30 13:00:00
126,22,9,13,0.006378868325191747,2019-03-30 12:45:00,2019-03-30 13:00:00
127,3,0,3,0.0017428251810738989,2019-03-30 12:45:00,2019-03-30 13:00:00
129,4,0,4,0.0017428251810738989,2019-03-30 12:45:00,2019-03-30 13:00:00
133,8,1,7,0.001983713957907997,2019-03-30 12:45:00,2019-03-30 13:00:00
135,4,1,3,0.002431888103761581,2019-03-30 12:45:00,2019-03-30 13:00:00
137,24,11,13,0.025390707423819693,2019-03-30 12:45:00,2019-03-30 13:00:00
138,30,12,18,0.008858751319069845,2019-03-30 12:45:00,2019-03-30 13:00:00
140,4,3,1,0.006724087880758257,2019-03-30 12:45:00,2019-03-30 13:00:00
141,1,0,1,0.0017428251810738989,2019-03-30 12:45:00,2019-03-30 13:00:00
147,5,0,5,0.0017428251810738989,2019-03-30 12:45:00,2019-03-30 13:00:00
151,6,3,3,0.005397234368600118,2019-03-30 12:45:00,2019-03-30 13:00:00
153,10,2,8,0.007182252748676543,2019-03-30 12:45:00,2019-03-30 13:00:00
154,7,3,4,0.0028146047175733762,2019-03-30 12:45:00,2019-03-30 13:00:00
157,6,3,3,0.0035915067109317926,2019-03-30 12:45:00,2019-03-30 13:00:00
158,2,0,2,0.0017428251810738989,2019-03-30 12:45:00,2019-03-30 13:00:00
159,9,4,5,0.004702097631677554,2019-03-30 12:45:00,2019-03-30 13:00:00
161,2,1,1,0.011606759354540816,2019-03-30 12:45:00,2019-03-30 13:00:00
162,12,4,8,0.0030310990711967713,2019-03-30 12:45:00,2019-03-30 13:00:00
164,16,10,6,0.02216759752073652,2019-03-30 12:45:00,2019-03-30 13:00:00
168,46,39,7,0.057657503986253085,2019-03-30 12:45:00,2019-03-30 13:00:00
169,32,20,12,0.02333939387548234,2019-03-30 12:45:00,2019-03-30 13:00:00
170,4,0,4,0.0017428251810738989,2019-03-30 12:45:00,2019-03-30 13:00:00
171,3,3,0,0.004196977590874587,2019-03-30 12:45:00,2019-03-30 13:00:00
172,3,1,2,0.0019500230291099564,2019-03-30 12:45:00,2019-03-30 13:00:00
173,7,4,3,0.021470693528007734,2019-03-30 12:45:00,2019-03-30 13:00:00
175,5,3,2,0.015588609595622109,2019-03-30 12:45:00,2019-03-30 13:00:00
177,3,1,2,0.0030310990711967713,2019-03-30 12:45:00,2019-03-30 13:00:00
189,11,7,4,0.01840945493237842,2019-03-30 12:45:00,2019-03-30 13:00:00
190,14,7,7,0.009105062873387264,2019-03-30 12:45:00,2019-03-30 13:00:00
191,12,7,5,0.016319942420419332,2019-03-30 12:45:00,2019-03-30 13:00:00
195,5,0,5,0.0017428251810738989,2019-03-30 12:45:00,2019-03-30 13:00:00
196,4,3,1,0.008238037323461303,2019-03-30 12:45:00,2019-03-30 13:00:00
197,21,7,14,0.004380280228333665,2019-03-30 12:45:00,2019-03-30 13:00:00
199,6,1,5,0.0020998060888879405,2019-03-30 12:45:00,2019-03-30 13:00:00
200,6,4,2,0.06768458446094726,2019-03-30 12:45:00,2019-03-30 13:00:00
201,1,1,0,0.0024465264632525553,2019-03-30 12:45:00,2019-03-30 13:00:00
203,14,6,8,0.01593923810643633,2019-03-30 12:45:00,2019-03-30 13:00:00
1,13,6,7,0.006840229534354186,2019-03-30 13:00:00,2019-03-30 13:15:00
2,11,5,6,0.003976685459365491,2019-03-30 13:00:00,2019-03-30 13:15:00
5,19,6,13,0.002828231365909425,2019-03-30 13:00:00,2019-03-30 13:15:00
10,2,0,2,0.0017186526409776522,2019-03-30 13:00:00,2019-03-30 13:15:00
15,9,5,4,0.0036442296922875104,2019-03-30 13:00:00,2019-03-30 13:15:00
16,11,5,6,0.003606233860987678,2019-03-30 13:00:00,2019-03-30 13:15:00
18,13,9,4,0.02363789359349292,2019-03-30 13:00:00,2019-03-30 13:15:00
19,11,5,6,0.015055667773518425,2019-03-30 13:00:00,2019-03-30 13:15:00
20,18,10,8,0.01212004466786658,2019-03-30 13:00:00,2019-03-30 13:15:00
23,13,4,9,0.019753905724745738,2019-03-30 13:00:00,2019-03-30 13:15:00
26,11,3,8,0.002629460601164715,2019-03-30 13:00:00,2019-03-30 13:15:00
27,6,2,4,0.005553419403718989,2019-03-30 13:00:00,2019-03-30 13:15:00
28,7,7,0,0.012160041709088756,2019-03-30 13:00:00,2019-03-30 13:15:00
30,1,0,1,0.0017186526409776522,2019-03-30 13:00:00,2019-03-30 13:15:00
35,9,5,4,0.012550524796085906,2019-03-30 13:00:00,2019-03-30 13:15:00
37,2,2,0,0.0021201489913239857,2019-03-30 13:00:00,2019-03-30 13:15:00
40,3,3,0,0.01166856214308536,2019-03-30 13:00:00,2019-03-30 13:15:00
41,12,5,7,0.005900512257784683,2019-03-30 13:00:00,2019-03-30 13:15:00
46,22,16,6,0.017452025668243352,2019-03-30 13:00:00,2019-03-30 13:15:00
50,3,1,2,0.004415203103419213,2019-03-30 13:00:00,2019-03-30 13:15:00
57,20,7,13,0.006346294495867954,2019-03-30 13:00:00,2019-03-30 13:15:00
58,5,1,4,0.0021336371881838794,2019-03-30 13:00:00,2019-03-30 13:15:00
61,1,0,1,0.0017186526409776522,2019-03-30 13:00:00,2019-03-30 13:15:00
62,25,11,14,0.011968579394707466,2019-03-30 13:00:00,2019-03-30 13:15:00
64,1,0,1,0.0017186526409776522,2019-03-30 13:00:00,2019-03-30 13:15:00
66,5,4,1,0.0031567342788174934,2019-03-30 13:00:00,2019-03-30 13:15:00
67,10,7,3,0.029255299448099528,2019-03-30 13:00:00,2019-03-30 13:15:00
68,5,1,4,0.0021824362491269715,2019-03-30 13:00:00,2019-03-30 13:15:00
69,9,7,2,0.01749747526276085,2019-03-30 13:00:00,2019-03-30 13:15:00
70,11,5,6,0.004032237727972034,2019-03-30 13:00:00,2019-03-30 13:15:00
71,6,3,3,0.011423595345928586,2019-03-30 13:00:00,2019-03-30 13:15:00
74,15,6,9,0.004450710704977594,2019-03-30 13:00:00,2019-03-30 13:15:00
75,19,5,14,0.0033061814342634434,2019-03-30 13:00:00,2019-03-30 13:15:00
79,6,2,4,0.005390339888634647,2019-03-30 13:00:00,2019-03-30 13:15:00
80,2,1,1,0.011423595345928586,2019-03-30 13:00:00,2019-03-30 13:15:00
85,4,4,0,0.003832875681932409,2019-03-30 13:00:00,2019-03-30 13:15:00
86,9,5,4,0.004691996515582067,2019-03-30 13:00:00,2019-03-30 13:15:00
87,5,4,1,0.04122496472867253,2019-03-30 13:00:00,2019-03-30 13:15:00
88,6,0,6,0.0017186526409776522,2019-03-30 13:00:00,2019-03-30 13:15:00
89,4,3,1,0.0064312716822531235,2019-03-30 13:00:00,2019-03-30 13:15:00
90,3,3,0,0.004171225562794518,2019-03-30 13:00:00,2019-03-30 13:15:00
99,7,4,3,0.00481626873816295,2019-03-30 13:00:00,2019-03-30 13:15:00
101,1,1,0,0.004385936884943095,2019-03-30 13:00:00,2019-03-30 13:15:00
104,6,4,2,0.00665157163834007,2019-03-30 13:00:00,2019-03-30 13:15:00
106,5,2,3,0.003966367033103135,2019-03-30 13:00:00,2019-03-30 13:15:00
108,13,5,8,0.004943687532675302,2019-03-30 13:00:00,2019-03-30 13:15:00
109,16,8,8,0.007723523394945771,2019-03-30 13:00:00,2019-03-30 13:15:00
110,8,7,1,0.014028391442845511,2019-03-30 13:00:00,2019-03-30 13:15:00
111,11,3,8,0.004877519081719656,2019-03-30 13:00:00,2019-03-30 13:15:00
112,13,6,7,0.007185545500883372,2019-03-30 13:00:00,2019-03-30 13:15:00
113,5,4,1,0.00402777821381498,2019-03-30 13:00:00,2019-03-30 13:15:00
114,7,5,2,0.012519860285434763,2019-03-30 13:00:00,2019-03-30 13:15:00
115,13,10,3,0.028741402538732003,2019-03-30 13:00:00,2019-03-30 13:15:00
116,1,1,0,0.0034627146951419713,2019-03-30 13:00:00,2019-03-30 13:15:00
118,4,2,2,0.006027179833822161,2019-03-30 13:00:00,2019-03-30 13:15:00
119,9,5,4,0.006369268991324925,2019-03-30 13:00:00,2019-03-30 13:15:00
120,8,2,6,0.0023981534680721397,2019-03-30 13:00:00,2019-03-30 13:15:00
122,9,0,9,0.0017186526409776522,2019-03-30 13:00:00,2019-03-30 13:15:00
126,20,8,12,0.007666361656143714,2019-03-30 13:00:00,2019-03-30 13:15:00
127,3,2,1,0.004079011269851763,2019-03-30 13:00:00,2019-03-30 13:15:00
129,7,2,5,0.0026294606011647154,2019-03-30 13:00:00,2019-03-30 13:15:00
133,3,0,3,0.0017186526409776522,2019-03-30 13:00:00,2019-03-30 13:15:00
135,4,1,3,0.0020706801611175356,2019-03-30 13:00:00,2019-03-30 13:15:00
137,18,7,11,0.0064161096410281565,2019-03-30 13:00:00,2019-03-30 13:15:00
138,35,19,16,0.034551723156725375,2019-03-30 13:00:00,2019-03-30 13:15:00
140,3,3,0,0.0032061591551415967,2019-03-30 13:00:00,2019-03-30 13:15:00
141,1,0,1,0.0017186526409776522,2019-03-30 13:00:00,2019-03-30 13:15:00
147,5,0,5,0.0017186526409776522,2019-03-30 13:00:00,2019-03-30 13:15:00
151,6,2,4,0.0029890465335309676,2019-03-30 13:00:00,2019-03-30 13:15:00
153,8,4,4,0.005747162771789012,2019-03-30 13:00:00,2019-03-30 13:15:00
154,5,2,3,0.00208851221595491,2019-03-30 13:00:00,2019-03-30 13:15:00
157,4,2,2,0.0037108235125898692,2019-03-30 13:00:00,2019-03-30 13:15:00
159,13,8,5,0.006584191106524195,2019-03-30 13:00:00,2019-03-30 13:15:00
160,2,2,0,0.003957470788297408,2019-03-30 13:00:00,2019-03-30 13:15:00
161,2,1,1,0.011423595345928586,2019-03-30 13:00:00,2019-03-30 13:15:00
162,13,5,8,0.004433775492231329,2019-03-30 13:00:00,2019-03-30 13:15:00
164,13,10,3,0.014194677732260068,2019-03-30 13:00:00,2019-03-30 13:15:00
168,49,40,9,0.04830706045179404,2019-03-30 13:00:00,2019-03-30 13:15:00
169,38,19,19,0.020173542468513852,2019-03-30 13:00:00,2019-03-30 13:15:00
170,2,0,2,0.0017186526409776522,2019-03-30 13:00:00,2019-03-30 13:15:00
171,5,2,3,0.004993836705991704,2019-03-30 13:00:00,2019-03-30 13:15:00
172,3,1,2,0.0018809750756859007,2019-03-30 13:00:00,2019-03-30 13:15:00
173,7,3,4,0.004741636218128619,2019-03-30 13:00:00,2019-03-30 13:15:00
175,10,7,3,0.02562299112153313,2019-03-30 13:00:00,2019-03-30 13:15:00
177,3,2,1,0.0031721521461691975,2019-03-30 13:00:00,2019-03-30 13:15:00
189,13,8,5,0.029833844032278956,2019-03-30 13:00:00,2019-03-30 13:15:00
190,13,6,7,0.00515136501631437,2019-03-30 13:00:00,2019-03-30 13:15:00
191,17,10,7,0.014361003746615603,2019-03-30 13:00:00,2019-03-30 13:15:00
195,4,1,3,0.004545758211335333,2019-03-30 13:00:00,2019-03-30 13:15:00
196,5,2,3,0.004079011269851763,2019-03-30 13:00:00,2019-03-30 13:15:00
197,23,8,15,0.005891093860776352,2019-03-30 13:00:00,2019-03-30 13:15:00
199,6,1,5,0.0020706801611175356,2019-03-30 13:00:00,2019-03-30 13:15:00
200,8,4,4,0.028862414821405488,2019-03-30 13:00:00,2019-03-30 13:15:00
201,2,1,1,0.007185600482105696,2019-03-30 13:00:00,2019-03-30 13:15:00
203,16,6,10,0.006182315595877435,2019-03-30 13:00:00,2019-03-30 13:15:00
1,14,5,9,0.0067104531200720945,2019-03-30 13:15:00,2019-03-30 13:30:00
2,9,3,6,0.004291677462493585,2019-03-30 13:15:00,2019-03-30 13:30:00
5,16,6,10,0.0034290507820714917,2019-03-30 13:15:00,2019-03-30 13:30:00
10,2,0,2,0.0016907875092197315,2019-03-30 13:15:00,2019-03-30 13:30:00
11,4,2,2,0.01125237068905545,2019-03-30 13:15:00,2019-03-30 13:30:00
15,9,4,5,0.00788279452466381,2019-03-30 13:15:00,2019-03-30 13:30:00
16,12,8,4,0.0063182307834240906,2019-03-30 13:15:00,2019-03-30 13:30:00
18,15,8,7,0.01991645217327888,2019-03-30 13:15:00,2019-03-30 13:30:00
19,10,4,6,0.009872475910745011,2019-03-30 13:15:00,2019-03-30 13:30:00
20,33,12,21,0.006938038685314884,2019-03-30 13:15:00,2019-03-30 13:30:00
21,1,0,1,0.0016907875092197315,2019-03-30 13:15:00,2019-03-30 13:30:00
23,14,4,10,0.021277294325113032,2019-03-30 13:15:00,2019-03-30 13:30:00
26,19,8,11,0.005622221356888176,2019-03-30 13:15:00,2019-03-30 13:30:00
27,7,3,4,0.0038639016922567184,2019-03-30 13:15:00,2019-03-30 13:30:00
28,7,1,6,0.001969859573290033,2019-03-30 13:15:00,2019-03-30 13:30:00
30,1,0,1,0.0016907875092197315,2019-03-30 13:15:00,2019-03-30 13:30:00
35,9,3,6,0.0029405760131417163,2019-03-30 13:15:00,2019-03-30 13:30:00
37,2,2,0,0.002010429630780267,2019-03-30 13:15:00,2019-03-30 13:30:00
40,5,2,3,0.003294136404361379,2019-03-30 13:15:00,2019-03-30 13:30:00
41,13,8,5,0.012667956120376613,2019-03-30 13:15:00,2019-03-30 13:30:00
46,23,16,7,0.031065456395602067,2019-03-30 13:15:00,2019-03-30 13:30:00
50,2,0,2,0.0016907875092197315,2019-03-30 13:15:00,2019-03-30 13:30:00
57,13,5,8,0.007355460898205175,2019-03-30 13:15:00,2019-03-30 13:30:00
58,8,2,6,0.002880514730555695,2019-03-30 13:15:00,2019-03-30 13:30:00
61,1,0,1,0.0016907875092197315,2019-03-30 13:15:00,2019-03-30 13:30:00
62,19,7,12,0.013536909298705522,2019-03-30 13:15:00,2019-03-30 13:30:00
64,5,1,4,0.0021470500491703663,2019-03-30 13:15:00,2019-03-30 13:30:00
66,4,4,0,0.002540672391589941,2019-03-30 13:15:00,2019-03-30 13:30:00
67,12,8,4,0.011106184754792187,2019-03-30 13:15:00,2019-03-30 13:30:00
68,5,2,3,0.005102429020439133,2019-03-30 13:15:00,2019-03-30 13:30:00
69,11,6,5,0.012141629868673686,2019-03-30 13:15:00,2019-03-30 13:30:00
70,12,6,6,0.011262366228234944,2019-03-30 13:15:00,2019-03-30 13:30:00
74,12,4,8,0.0055125248783593536,2019-03-30 13:15:00,2019-03-30 13:30:00
75,17,4,13,0.0024442419359617168,2019-03-30 13:15:00,2019-03-30 13:30:00
79,8,4,4,0.012069430939195146,2019-03-30 13:15:00,2019-03-30 13:30:00
80,2,1,1,0.01125237068905545,2019-03-30 13:15:00,2019-03-30 13:30:00
85,6,4,2,0.005869593925835035,2019-03-30 13:15:00,2019-03-30 13:30:00
86,8,4,4,0.0047151148165962215,2019-03-30 13:15:00,2019-03-30 13:30:00
87,6,5,1,0.032153377454505826,2019-03-30 13:15:00,2019-03-30 13:30:00
88,5,0,5,0.0016907875092197315,2019-03-30 13:15:00,2019-03-30 13:30:00
89,3,2,1,0.004810484265231892,2019-03-30 13:15:00,2019-03-30 13:30:00
90,6,2,4,0.002726437278647188,2019-03-30 13:15:00,2019-03-30 13:30:00
99,4,2,2,0.0036087881439873077,2019-03-30 13:15:00,2019-03-30 13:30:00
101,1,1,0,0.0021073836771937264,2019-03-30 13:15:00,2019-03-30 13:30:00
104,4,3,1,0.003250499946991786,2019-03-30 13:15:00,2019-03-30 13:30:00
106,9,4,5,0.005284425089382025,2019-03-30 13:15:00,2019-03-30 13:30:00
108,13,5,8,0.004503142063968589,2019-03-30 13:15:00,2019-03-30 13:30:00
109,12,7,5,0.010861084280701894,2019-03-30 13:15:00,2019-03-30 13:30:00
110,12,11,1,0.015967831342867767,2019-03-30 13:15:00,2019-03-30 13:30:00
111,13,4,9,0.002807075765500938,2019-03-30 13:15:00,2019-03-30 13:30:00
112,8,2,6,0.003599592952313441,2019-03-30 13:15:00,2019-03-30 13:30:00
113,2,2,0,0.002019299494776612,2019-03-30 13:15:00,2019-03-30 13:30:00
114,6,3,3,0.007407605706351357,2019-03-30 13:15:00,2019-03-30 13:30:00
115,17,14,3,0.01934451701274435,2019-03-30 13:15:00,2019-03-30 13:30:00
116,5,4,1,0.010291993878842269,2019-03-30 13:15:00,2019-03-30 13:30:00
118,2,2,0,0.008058364113554156,2019-03-30 13:15:00,2019-03-30 13:30:00
119,12,4,8,0.004211991537972492,2019-03-30 13:15:00,2019-03-30 13:30:00
120,5,2,3,0.009236619002900872,2019-03-30 13:15:00,2019-03-30 13:30:00
122,8,0,8,0.0016907875092197315,2019-03-30 13:15:00,2019-03-30 13:30:00
126,17,9,8,0.01089154545501949,2019-03-30 13:15:00,2019-03-30 13:30:00
127,5,3,2,0.003966833425917019,2019-03-30 13:15:00,2019-03-30 13:30:00
129,13,8,5,0.01665737239262604,2019-03-30 13:15:00,2019-03-30 13:30:00
133,2,0,2,0.0016907875092197315,2019-03-30 13:15:00,2019-03-30 13:30:00
135,2,1,1,0.002381553079865206,2019-03-30 13:15:00,2019-03-30 13:30:00
137,18,11,7,0.020227645165069467,2019-03-30 13:15:00,2019-03-30 13:30:00
138,46,28,18,0.0549358807209361,2019-03-30 13:15:00,2019-03-30 13:30:00
140,3,3,0,0.00906043052246705,2019-03-30 13:15:00,2019-03-30 13:30:00
141,1,0,1,0.0016907875092197315,2019-03-30 13:15:00,2019-03-30 13:30:00
147,6,2,4,0.004694847511882376,2019-03-30 13:15:00,2019-03-30 13:30:00
151,7,3,4,0.003959455805688104,2019-03-30 13:15:00,2019-03-30 13:30:00
153,12,7,5,0.008690294589773035,2019-03-30 13:15:00,2019-03-30 13:30:00
154,5,2,3,0.0022737532831772923,2019-03-30 13:15:00,2019-03-30 13:30:00
157,6,2,4,0.003139634380370462,2019-03-30 13:15:00,2019-03-30 13:30:00
159,8,4,4,0.004378688246421137,2019-03-30 13:15:00,2019-03-30 13:30:00
160,2,2,0,0.0035519096007572016,2019-03-30 13:15:00,2019-03-30 13:30:00
161,2,1,1,0.01125237068905545,2019-03-30 13:15:00,2019-03-30 13:30:00
162,12,5,7,0.00895041002904592,2019-03-30 13:15:00,2019-03-30 13:30:00
164,15,8,7,0.012087450882048517,2019-03-30 13:15:00,2019-03-30 13:30:00
168,46,33,13,0.03780730278699675,2019-03-30 13:15:00,2019-03-30 13:30:00
169,22,9,13,0.012258768451986788,2019-03-30 13:15:00,2019-03-30 13:30:00
170,1,1,0,0.002298848335748984,2019-03-30 13:15:00,2019-03-30 13:30:00
171,3,3,0,0.0031682334602124215,2019-03-30 13:15:00,2019-03-30 13:30:00
172,4,2,2,0.0035564270920963414,2019-03-30 13:15:00,2019-03-30 13:30:00
173,3,1,2,0.0029405760131417163,2019-03-30 13:15:00,2019-03-30 13:30:00
175,10,7,3,0.05200242484311356,2019-03-30 13:15:00,2019-03-30 13:30:00
177,3,3,0,0.005417634330067303,2019-03-30 13:15:00,2019-03-30 13:30:00
189,13,7,6,0.011776088511077516,2019-03-30 13:15:00,2019-03-30 13:30:00
190,9,5,4,0.00828989399508296,2019-03-30 13:15:00,2019-03-30 13:30:00
191,15,11,4,0.01583265473621085,2019-03-30 13:15:00,2019-03-30 13:30:00
195,1,1,0,0.004453849791801629,2019-03-30 13:15:00,2019-03-30 13:30:00
196,4,3,1,0.012082528456350085,2019-03-30 13:15:00,2019-03-30 13:30:00
197,18,5,13,0.0025120674731119326,2019-03-30 13:15:00,2019-03-30 13:30:00
199,7,3,4,0.003250499946991786,2019-03-30 13:15:00,2019-03-30 13:30:00
200,2,0,2,0.0016907875092197315,2019-03-30 13:15:00,2019-03-30 13:30:00
201,2,1,1,0.005780257090513827,2019-03-30 13:15:00,2019-03-30 13:30:00
202,3,3,0,0.004005256587225184,2019-03-30 13:15:00,2019-03-30 13:30:00
203,19,8,11,0.008443303153489323,2019-03-30 13:15:00,2019-03-30 13:30:00
1,9,3,6,0.0037034400046456464,2019-03-30 13:30:00,2019-03-30 13:45:00
2,6,3,3,0.008562608239769646,2019-03-30 13:30:00,2019-03-30 13:45:00
5,30,11,19,0.0044358157184441836,2019-03-30 13:30:00,2019-03-30 13:45:00
11,6,2,4,0.002615148604694989,2019-03-30 13:30:00,2019-03-30 13:45:00
13,1,1,0,0.0031515430924705344,2019-03-30 13:30:00,2019-03-30 13:45:00
15,10,8,2,0.014122039009208925,2019-03-30 13:30:00,2019-03-30 13:45:00
16,13,9,4,0.009873241910874376,2019-03-30 13:30:00,2019-03-30 13:45:00
18,17,6,11,0.009869687859618805,2019-03-30 13:30:00,2019-03-30 13:45:00
19,11,2,9,0.005168512943709084,2019-03-30 13:30:00,2019-03-30 13:45:00
20,23,9,14,0.015601598573457734,2019-03-30 13:30:00,2019-03-30 13:45:00
21,1,0,1,0.001503687227278895,2019-03-30 13:30:00,2019-03-30 13:45:00
23,10,1,9,0.00401130822427609,2019-03-30 13:30:00,2019-03-30 13:45:00
26,15,9,6,0.013777350935954738,2019-03-30 13:30:00,2019-03-30 13:45:00
27,9,4,5,0.004844617110044973,2019-03-30 13:30:00,2019-03-30 13:45:00
28,7,1,6,0.0029188442330128636,2019-03-30 13:30:00,2019-03-30 13:45:00
30,1,0,1,0.001503687227278895,2019-03-30 13:30:00,2019-03-30 13:45:00
35,14,7,7,0.010682664372162807,2019-03-30 13:30:00,2019-03-30 13:45:00
37,2,2,0,0.0018692435211931974,2019-03-30 13:30:00,2019-03-30 13:45:00
40,9,1,8,0.0016824508294074703,2019-03-30 13:30:00,2019-03-30 13:45:00
41,9,4,5,0.0037577680807120736,2019-03-30 13:30:00,2019-03-30 13:45:00
46,21,13,8,0.011972736845252158,2019-03-30 13:30:00,2019-03-30 13:45:00
50,3,1,2,0.002266404166111417,2019-03-30 13:30:00,2019-03-30 13:45:00
57,5,0,5,0.001503687227278895,2019-03-30 13:30:00,2019-03-30 13:45:00
58,5,0,5,0.001503687227278895,2019-03-30 13:30:00,2019-03-30 13:45:00
61,1,0,1,0.001503687227278895,2019-03-30 13:30:00,2019-03-30 13:45:00
62,18,11,7,0.013568051040526191,2019-03-30 13:30:00,2019-03-30 13:45:00
64,3,0,3,0.001503687227278895,2019-03-30 13:30:00,2019-03-30 13:45:00
66,4,2,2,0.0018692435211931974,2019-03-30 13:30:00,2019-03-30 13:45:00
67,14,11,3,0.009264872193050389,2019-03-30 13:30:00,2019-03-30 13:45:00
68,3,2,1,0.004895803826441516,2019-03-30 13:30:00,2019-03-30 13:45:00
69,11,4,7,0.004664467154105463,2019-03-30 13:30:00,2019-03-30 13:45:00
70,13,7,6,0.013161968433218043,2019-03-30 13:30:00,2019-03-30 13:45:00
74,12,4,8,0.002923904492259938,2019-03-30 13:30:00,2019-03-30 13:45:00
75,15,3,12,0.002580274169705672,2019-03-30 13:30:00,2019-03-30 13:45:00
79,8,6,2,0.048651358647671346,2019-03-30 13:30:00,2019-03-30 13:45:00
80,2,1,1,0.010020873306503116,2019-03-30 13:30:00,2019-03-30 13:45:00
85,6,3,3,0.0049558889969883975,2019-03-30 13:30:00,2019-03-30 13:45:00
86,11,6,5,0.007139592563136362,2019-03-30 13:30:00,2019-03-30 13:45:00
87,6,5,1,0.0747339771882949,2019-03-30 13:30:00,2019-03-30 13:45:00
88,5,0,5,0.001503687227278895,2019-03-30 13:30:00,2019-03-30 13:45:00
89,3,2,1,0.003359133422669733,2019-03-30 13:30:00,2019-03-30 13:45:00
90,5,3,2,0.0042167967359712805,2019-03-30 13:30:00,2019-03-30 13:45:00
101,2,1,1,0.010020873306503116,2019-03-30 13:30:00,2019-03-30 13:45:00
104,2,0,2,0.001503687227278895,2019-03-30 13:30:00,2019-03-30 13:45:00
106,16,7,9,0.009529618325464282,2019-03-30 13:30:00,2019-03-30 13:45:00
108,16,8,8,0.008124721896136642,2019-03-30 13:30:00,2019-03-30 13:45:00
109,17,10,7,0.016027970660558805,2019-03-30 13:30:00,2019-03-30 13:45:00
110,16,12,4,0.021721824273666916,2019-03-30 13:30:00,2019-03-30 13:45:00
111,10,5,5,0.004613881605989058,2019-03-30 13:30:00,2019-03-30 13:45:00
112,6,2,4,0.0025293855400297044,2019-03-30 13:30:00,2019-03-30 13:45:00
113,5,3,2,0.003254775888737923,2019-03-30 13:30:00,2019-03-30 13:45:00
114,3,2,1,0.0022614814478354923,2019-03-30 13:30:00,2019-03-30 13:45:00
115,17,13,4,0.011798578635753629,2019-03-30 13:30:00,2019-03-30 13:45:00
116,7,5,2,0.01136997833798671,2019-03-30 13:30:00,2019-03-30 13:45:00
118,4,2,2,0.004232082887297155,2019-03-30 13:30:00,2019-03-30 13:45:00
119,12,4,8,0.007412791987211839,2019-03-30 13:30:00,2019-03-30 13:45:00
120,6,4,2,0.006814957000394688,2019-03-30 13:30:00,2019-03-30 13:45:00
122,7,0,7,0.001503687227278895,2019-03-30 13:30:00,2019-03-30 13:45:00
126,21,10,11,0.005136343326864521,2019-03-30 13:30:00,2019-03-30 13:45:00
127,6,3,3,0.004306794874267315,2019-03-30 13:30:00,2019-03-30 13:45:00
129,15,8,7,0.013173303310266055,2019-03-30 13:30:00,2019-03-30 13:45:00
133,2,0,2,0.001503687227278895,2019-03-30 13:30:00,2019-03-30 13:45:00
135,3,1,2,0.0018910121679346023,2019-03-30 13:30:00,2019-03-30 13:45:00
137,23,15,8,0.02618334655484596,2019-03-30 13:30:00,2019-03-30 13:45:00
138,42,23,19,0.03254252372481683,2019-03-30 13:30:00,2019-03-30 13:45:00
140,3,3,0,0.009850899679099861,2019-03-30 13:30:00,2019-03-30 13:45:00
141,1,0,1,0.001503687227278895,2019-03-30 13:30:00,2019-03-30 13:45:00
147,6,2,4,0.003847293182639111,2019-03-30 13:30:00,2019-03-30 13:45:00
151,8,3,5,0.002749077620546577,2019-03-30 13:30:00,2019-03-30 13:45:00
153,19,13,6,0.020212579813210906,2019-03-30 13:30:00,2019-03-30 13:45:00
154,6,4,2,0.003012088364603256,2019-03-30 13:30:00,2019-03-30 13:45:00
157,12,5,7,0.0026675208423232897,2019-03-30 13:30:00,2019-03-30 13:45:00
158,4,2,2,0.010020873306503116,2019-03-30 13:30:00,2019-03-30 13:45:00
159,9,5,4,0.004113582696292171,2019-03-30 13:30:00,2019-03-30 13:45:00
160,2,2,0,0.003252015007146337,2019-03-30 13:30:00,2019-03-30 13:45:00
162,18,9,9,0.008564707114037324,2019-03-30 13:30:00,2019-03-30 13:45:00
164,13,7,6,0.008453225234508196,2019-03-30 13:30:00,2019-03-30 13:45:00
168,64,49,15,0.06981006690949182,2019-03-30 13:30:00,2019-03-30 13:45:00
169,38,17,21,0.038061307779647904,2019-03-30 13:30:00,2019-03-30 13:45:00
170,2,1,1,0.003930067094061389,2019-03-30 13:30:00,2019-03-30 13:45:00
171,6,4,2,0.007177386277673106,2019-03-30 13:30:00,2019-03-30 13:45:00
172,7,3,4,0.004127047474189415,2019-03-30 13:30:00,2019-03-30 13:45:00
173,2,1,1,0.010020873306503116,2019-03-30 13:30:00,2019-03-30 13:45:00
175,8,4,4,0.012294671688301692,2019-03-30 13:30:00,2019-03-30 13:45:00
177,11,5,6,0.004954366894270177,2019-03-30 13:30:00,2019-03-30 13:45:00
189,14,8,6,0.00441574947907356,2019-03-30 13:30:00,2019-03-30 13:45:00
190,12,5,7,0.005962703778134555,2019-03-30 13:30:00,2019-03-30 13:45:00
191,25,12,13,0.014770785265240267,2019-03-30 13:30:00,2019-03-30 13:45:00
196,5,3,2,0.003329679296792519,2019-03-30 13:30:00,2019-03-30 13:45:00
197,18,5,13,0.002234070819161843,2019-03-30 13:30:00,2019-03-30 13:45:00
199,7,2,5,0.0022783371085903096,2019-03-30 13:30:00,2019-03-30 13:45:00
200,2,0,2,0.001503687227278895,2019-03-30 13:30:00,2019-03-30 13:45:00
201,2,1,1,0.004359185506751127,2019-03-30 13:30:00,2019-03-30 13:45:00
202,3,3,0,0.0026489266207130944,2019-03-30 13:30:00,2019-03-30 13:45:00
203,14,5,9,0.00559159439315041,2019-03-30 13:30:00,2019-03-30 13:45:00
1,15,7,8,0.006215537925743864,2019-03-30 13:45:00,2019-03-30 14:00:00
2,9,3,6,0.0036236957154507704,2019-03-30 13:45:00,2019-03-30 14:00:00
5,29,11,18,0.0036479775988469297,2019-03-30 13:45:00,2019-03-30 14:00:00
10,2,0,2,0.001530643328896653,2019-03-30 13:45:00,2019-03-30 14:00:00
11,3,0,3,0.001530643328896653,2019-03-30 13:45:00,2019-03-30 14:00:00
13,1,1,0,0.0032751323355410845,2019-03-30 13:45:00,2019-03-30 14:00:00
15,10,9,1,0.012042943960440367,2019-03-30 13:45:00,2019-03-30 14:00:00
16,16,12,4,0.01777951832470601,2019-03-30 13:45:00,2019-03-30 14:00:00
18,27,7,20,0.008366339858221383,2019-03-30 13:45:00,2019-03-30 14:00:00
19,9,1,8,0.0037138243465908967,2019-03-30 13:45:00,2019-03-30 14:00:00
20,29,13,16,0.020878420762254924,2019-03-30 13:45:00,2019-03-30 14:00:00
21,1,1,0,0.0020306460109246706,2019-03-30 13:45:00,2019-03-30 14:00:00
23,11,2,9,0.002637675936983942,2019-03-30 13:45:00,2019-03-30 14:00:00
26,17,8,9,0.005293926500627438,2019-03-30 13:45:00,2019-03-30 14:00:00
27,5,2,3,0.0035323768557018495,2019-03-30 13:45:00,2019-03-30 14:00:00
28,7,2,5,0.0041733136020578165,2019-03-30 13:45:00,2019-03-30 14:00:00
30,1,0,1,0.001530643328896653,2019-03-30 13:45:00,2019-03-30 14:00:00
35,12,6,6,0.013017987998252321,2019-03-30 13:45:00,2019-03-30 14:00:00
37,3,0,3,0.001530643328896653,2019-03-30 13:45:00,2019-03-30 14:00:00
40,10,1,9,0.001690284328415673,2019-03-30 13:45:00,2019-03-30 14:00:00
41,9,4,5,0.002841231257892889,2019-03-30 13:45:00,2019-03-30 14:00:00
46,21,13,8,0.018107835903488856,2019-03-30 13:45:00,2019-03-30 14:00:00
50,2,0,2,0.001530643328896653,2019-03-30 13:45:00,2019-03-30 14:00:00
57,7,4,3,0.0046355584099516765,2019-03-30 13:45:00,2019-03-30 14:00:00
58,7,2,5,0.004339335665945417,2019-03-30 13:45:00,2019-03-30 14:00:00
61,5,3,2,0.008844512144634583,2019-03-30 13:45:00,2019-03-30 14:00:00
62,32,21,11,0.022571522099350757,2019-03-30 13:45:00,2019-03-30 14:00:00
64,4,1,3,0.0026639999848655886,2019-03-30 13:45:00,2019-03-30 14:00:00
66,2,2,0,0.002207992294459296,2019-03-30 13:45:00,2019-03-30 14:00:00
67,22,13,9,0.009550733699241656,2019-03-30 13:45:00,2019-03-30 14:00:00
68,2,0,2,0.001530643328896653,2019-03-30 13:45:00,2019-03-30 14:00:00
69,11,5,6,0.003412833680129164,2019-03-30 13:45:00,2019-03-30 14:00:00
70,12,6,6,0.004235475398565237,2019-03-30 13:45:00,2019-03-30 14:00:00
74,20,8,12,0.0038296737641128342,2019-03-30 13:45:00,2019-03-30 14:00:00
75,13,3,10,0.003984009337041307,2019-03-30 13:45:00,2019-03-30 14:00:00
79,10,7,3,0.040302374264182185,2019-03-30 13:45:00,2019-03-30 14:00:00
80,5,2,3,0.0035323768557018495,2019-03-30 13:45:00,2019-03-30 14:00:00
85,7,2,5,0.0027330529364465216,2019-03-30 13:45:00,2019-03-30 14:00:00
86,12,4,8,0.0026045453952366934,2019-03-30 13:45:00,2019-03-30 14:00:00
87,8,7,1,0.10143740706236189,2019-03-30 13:45:00,2019-03-30 14:00:00
88,5,0,5,0.001530643328896653,2019-03-30 13:45:00,2019-03-30 14:00:00
89,3,2,1,0.002121131550115246,2019-03-30 13:45:00,2019-03-30 14:00:00
90,5,5,0,0.005613284727536893,2019-03-30 13:45:00,2019-03-30 14:00:00
101,4,2,2,0.010200850799377329,2019-03-30 13:45:00,2019-03-30 14:00:00
104,3,0,3,0.001530643328896653,2019-03-30 13:45:00,2019-03-30 14:00:00
106,10,5,5,0.005518634757165199,2019-03-30 13:45:00,2019-03-30 14:00:00
108,16,9,7,0.011925891401360621,2019-03-30 13:45:00,2019-03-30 14:00:00
109,18,10,8,0.010833517999921034,2019-03-30 13:45:00,2019-03-30 14:00:00
110,13,9,4,0.015541047164720309,2019-03-30 13:45:00,2019-03-30 14:00:00
111,10,7,3,0.007643079401294469,2019-03-30 13:45:00,2019-03-30 14:00:00
112,9,6,3,0.006825739371834197,2019-03-30 13:45:00,2019-03-30 14:00:00
113,6,3,3,0.003661842174576084,2019-03-30 13:45:00,2019-03-30 14:00:00
114,3,2,1,0.002028918213810554,2019-03-30 13:45:00,2019-03-30 14:00:00
115,18,13,5,0.010925588477447954,2019-03-30 13:45:00,2019-03-30 14:00:00
116,6,4,2,0.008560475682382078,2019-03-30 13:45:00,2019-03-30 14:00:00
118,1,0,1,0.001530643328896653,2019-03-30 13:45:00,2019-03-30 14:00:00
119,13,8,5,0.0055595540519866714,2019-03-30 13:45:00,2019-03-30 14:00:00
120,9,3,6,0.005530200815705967,2019-03-30 13:45:00,2019-03-30 14:00:00
122,4,0,4,0.001530643328896653,2019-03-30 13:45:00,2019-03-30 14:00:00
126,17,6,11,0.006876619982167604,2019-03-30 13:45:00,2019-03-30 14:00:00
127,7,4,3,0.004208221566747761,2019-03-30 13:45:00,2019-03-30 14:00:00
129,20,8,12,0.004662434621693165,2019-03-30 13:45:00,2019-03-30 14:00:00
133,2,0,2,0.001530643328896653,2019-03-30 13:45:00,2019-03-30 14:00:00
135,7,2,5,0.0023191816948451333,2019-03-30 13:45:00,2019-03-30 14:00:00
137,25,16,9,0.020975082455198114,2019-03-30 13:45:00,2019-03-30 14:00:00
138,47,25,22,0.029328613411136285,2019-03-30 13:45:00,2019-03-30 14:00:00
140,3,3,0,0.007474479400378688,2019-03-30 13:45:00,2019-03-30 14:00:00
141,2,1,1,0.001860917355129945,2019-03-30 13:45:00,2019-03-30 14:00:00
147,5,0,5,0.001530643328896653,2019-03-30 13:45:00,2019-03-30 14:00:00
151,5,2,3,0.0035323768557018495,2019-03-30 13:45:00,2019-03-30 14:00:00
153,22,11,11,0.00915459052214545,2019-03-30 13:45:00,2019-03-30 14:00:00
154,5,4,1,0.002742567692621713,2019-03-30 13:45:00,2019-03-30 14:00:00
157,11,5,6,0.005920418212294966,2019-03-30 13:45:00,2019-03-30 14:00:00
158,3,2,1,0.012565178447328462,2019-03-30 13:45:00,2019-03-30 14:00:00
159,11,7,4,0.004479129399716931,2019-03-30 13:45:00,2019-03-30 14:00:00
160,2,2,0,0.003434328639388524,2019-03-30 13:45:00,2019-03-30 14:00:00
161,8,4,4,0.010200850799377329,2019-03-30 13:45:00,2019-03-30 14:00:00
162,19,9,10,0.009956809826826556,2019-03-30 13:45:00,2019-03-30 14:00:00
164,13,9,4,0.011029315003340426,2019-03-30 13:45:00,2019-03-30 14:00:00
168,70,54,16,0.05872729419671955,2019-03-30 13:45:00,2019-03-30 14:00:00
169,44,20,24,0.03603310548934745,2019-03-30 13:45:00,2019-03-30 14:00:00
170,2,1,1,0.002568279184638523,2019-03-30 13:45:00,2019-03-30 14:00:00
171,4,2,2,0.004512415397688934,2019-03-30 13:45:00,2019-03-30 14:00:00
172,5,1,4,0.0018559110726282795,2019-03-30 13:45:00,2019-03-30 14:00:00
173,2,1,1,0.010200850799377329,2019-03-30 13:45:00,2019-03-30 14:00:00
175,9,5,4,0.01177505438415606,2019-03-30 13:45:00,2019-03-30 14:00:00
177,13,7,6,0.010886451206859922,2019-03-30 13:45:00,2019-03-30 14:00:00
189,20,12,8,0.020051722754534033,2019-03-30 13:45:00,2019-03-30 14:00:00
190,12,4,8,0.0054162607367823305,2019-03-30 13:45:00,2019-03-30 14:00:00
191,20,7,13,0.015138329649434366,2019-03-30 13:45:00,2019-03-30 14:00:00
196,3,1,2,0.001690284328415673,2019-03-30 13:45:00,2019-03-30 14:00:00
197,22,7,15,0.002537014328846902,2019-03-30 13:45:00,2019-03-30 14:00:00
199,5,1,4,0.001943684443307457,2019-03-30 13:45:00,2019-03-30 14:00:00
200,2,0,2,0.001530643328896653,2019-03-30 13:45:00,2019-03-30 14:00:00
201,1,1,0,0.0033336534356191547,2019-03-30 13:45:00,2019-03-30 14:00:00
202,4,3,1,0.002795154614342401,2019-03-30 13:45:00,2019-03-30 14:00:00
203,18,9,9,0.008361746491164534,2019-03-30 13:45:00,2019-03-30 14:00:00
1,12,7,5,0.009918267915983596,2019-03-30 14:00:00,2019-03-30 14:15:00
2,9,3,6,0.005786197483853801,2019-03-30 14:00:00,2019-03-30 14:15:00
5,21,9,12,0.004249776524623499,2019-03-30 14:00:00,2019-03-30 14:15:00
10,3,0,3,0.0016173723149118893,2019-03-30 14:00:00,2019-03-30 14:15:00
11,7,2,5,0.002450592955366065,2019-03-30 14:00:00,2019-03-30 14:15:00
13,2,2,0,0.004243652828741318,2019-03-30 14:00:00,2019-03-30 14:15:00
15,17,14,3,0.018503858469524462,2019-03-30 14:00:00,2019-03-30 14:15:00
16,16,13,3,0.015263291721380993,2019-03-30 14:00:00,2019-03-30 14:15:00
18,27,5,22,0.005961458781620406,2019-03-30 14:00:00,2019-03-30 14:15:00
19,8,1,7,0.0029909135067138185,2019-03-30 14:00:00,2019-03-30 14:15:00
20,20,9,11,0.016743185701412894,2019-03-30 14:00:00,2019-03-30 14:15:00
21,2,1,1,0.002524026760170258,2019-03-30 14:00:00,2019-03-30 14:15:00
23,8,3,5,0.006543039426434104,2019-03-30 14:00:00,2019-03-30 14:15:00
26,17,8,9,0.009598933730995341,2019-03-30 14:00:00,2019-03-30 14:15:00
27,6,3,3,0.008779965545436136,2019-03-30 14:00:00,2019-03-30 14:15:00
28,2,1,1,0.0025727093249721675,2019-03-30 14:00:00,2019-03-30 14:15:00
30,7,1,6,0.002447993688618523,2019-03-30 14:00:00,2019-03-30 14:15:00
35,11,5,6,0.01371676911982297,2019-03-30 14:00:00,2019-03-30 14:15:00
37,7,2,5,0.002450592955366065,2019-03-30 14:00:00,2019-03-30 14:15:00
40,6,1,5,0.0020635273370976813,2019-03-30 14:00:00,2019-03-30 14:15:00
41,12,3,9,0.0024509314721614848,2019-03-30 14:00:00,2019-03-30 14:15:00
46,18,10,8,0.008990461516654483,2019-03-30 14:00:00,2019-03-30 14:15:00
50,2,0,2,0.0016173723149118893,2019-03-30 14:00:00,2019-03-30 14:15:00
57,3,1,2,0.003231478575007124,2019-03-30 14:00:00,2019-03-30 14:15:00
58,8,2,6,0.0063513346655170114,2019-03-30 14:00:00,2019-03-30 14:15:00
61,2,1,1,0.0036834302339377504,2019-03-30 14:00:00,2019-03-30 14:15:00
62,28,19,9,0.025368767235317145,2019-03-30 14:00:00,2019-03-30 14:15:00
64,11,4,7,0.005083616231301268,2019-03-30 14:00:00,2019-03-30 14:15:00
66,2,2,0,0.0020504179681331237,2019-03-30 14:00:00,2019-03-30 14:15:00
67,16,7,9,0.008632315537590609,2019-03-30 14:00:00,2019-03-30 14:15:00
68,2,0,2,0.0016173723149118893,2019-03-30 14:00:00,2019-03-30 14:15:00
69,8,6,2,0.003893268667085786,2019-03-30 14:00:00,2019-03-30 14:15:00
70,10,5,5,0.005729734792241552,2019-03-30 14:00:00,2019-03-30 14:15:00
71,4,2,2,0.010775275231841876,2019-03-30 14:00:00,2019-03-30 14:15:00
74,18,7,11,0.004927240163886566,2019-03-30 14:00:00,2019-03-30 14:15:00
75,12,3,9,0.0022925413462260335,2019-03-30 14:00:00,2019-03-30 14:15:00
79,6,5,1,0.05351130130649113,2019-03-30 14:00:00,2019-03-30 14:15:00
80,6,2,4,0.0028128715334441094,2019-03-30 14:00:00,2019-03-30 14:15:00
85,12,5,7,0.004322382309686894,2019-03-30 14:00:00,2019-03-30 14:15:00
86,9,3,6,0.002788130701023096,2019-03-30 14:00:00,2019-03-30 14:15:00
87,3,3,0,0.006703299533311242,2019-03-30 14:00:00,2019-03-30 14:15:00
88,5,0,5,0.0016173723149118893,2019-03-30 14:00:00,2019-03-30 14:15:00
89,2,2,0,0.002283238603947092,2019-03-30 14:00:00,2019-03-30 14:15:00
90,7,6,1,0.004268625548772444,2019-03-30 14:00:00,2019-03-30 14:15:00
99,1,1,0,0.0024327058606078518,2019-03-30 14:00:00,2019-03-30 14:15:00
101,5,3,2,0.012327229328467132,2019-03-30 14:00:00,2019-03-30 14:15:00
104,2,1,1,0.003303734951359643,2019-03-30 14:00:00,2019-03-30 14:15:00
106,13,6,7,0.005009085853403995,2019-03-30 14:00:00,2019-03-30 14:15:00
108,17,8,9,0.00611819830699193,2019-03-30 14:00:00,2019-03-30 14:15:00
109,11,6,5,0.01000283706629185,2019-03-30 14:00:00,2019-03-30 14:15:00
110,12,10,2,0.019023006143758597,2019-03-30 14:00:00,2019-03-30 14:15:00
111,9,1,8,0.001968185223965904,2019-03-30 14:00:00,2019-03-30 14:15:00
112,14,7,7,0.005613603279473156,2019-03-30 14:00:00,2019-03-30 14:15:00
113,4,1,3,0.002931290363918564,2019-03-30 14:00:00,2019-03-30 14:15:00
114,3,2,1,0.0038423121617395897,2019-03-30 14:00:00,2019-03-30 14:15:00
115,27,15,12,0.015946132684025706,2019-03-30 14:00:00,2019-03-30 14:15:00
116,7,4,3,0.008377324250976962,2019-03-30 14:00:00,2019-03-30 14:15:00
119,14,9,5,0.015390959275158723,2019-03-30 14:00:00,2019-03-30 14:15:00
120,7,0,7,0.0016173723149118893,2019-03-30 14:00:00,2019-03-30 14:15:00
122,2,0,2,0.0016173723149118893,2019-03-30 14:00:00,2019-03-30 14:15:00
126,11,3,8,0.005068528689867409,2019-03-30 14:00:00,2019-03-30 14:15:00
127,7,3,4,0.004461984248454351,2019-03-30 14:00:00,2019-03-30 14:15:00
129,10,3,7,0.003219006377681725,2019-03-30 14:00:00,2019-03-30 14:15:00
133,2,0,2,0.0016173723149118893,2019-03-30 14:00:00,2019-03-30 14:15:00
135,2,0,2,0.0016173723149118893,2019-03-30 14:00:00,2019-03-30 14:15:00
137,25,16,9,0.016814169302940562,2019-03-30 14:00:00,2019-03-30 14:15:00
138,62,34,28,0.05316100022280733,2019-03-30 14:00:00,2019-03-30 14:15:00
140,4,4,0,0.007201839414936207,2019-03-30 14:00:00,2019-03-30 14:15:00
141,2,2,0,0.002689978344192754,2019-03-30 14:00:00,2019-03-30 14:15:00
147,5,0,5,0.0016173723149118893,2019-03-30 14:00:00,2019-03-30 14:15:00
151,2,1,1,0.010775275231841876,2019-03-30 14:00:00,2019-03-30 14:15:00
153,16,7,9,0.013909603433342056,2019-03-30 14:00:00,2019-03-30 14:15:00
154,5,5,0,0.003399487656180771,2019-03-30 14:00:00,2019-03-30 14:15:00
157,13,5,8,0.004198754980109599,2019-03-30 14:00:00,2019-03-30 14:15:00
158,4,3,1,0.013694972438215559,2019-03-30 14:00:00,2019-03-30 14:15:00
159,10,6,4,0.005250153678713475,2019-03-30 14:00:00,2019-03-30 14:15:00
160,2,2,0,0.003848770414672941,2019-03-30 14:00:00,2019-03-30 14:15:00
161,8,4,4,0.010775275231841876,2019-03-30 14:00:00,2019-03-30 14:15:00
162,22,9,13,0.010680525024972335,2019-03-30 14:00:00,2019-03-30 14:15:00
164,17,11,6,0.029705819203301155,2019-03-30 14:00:00,2019-03-30 14:15:00
168,63,46,17,0.0413150189116644,2019-03-30 14:00:00,2019-03-30 14:15:00
169,36,16,20,0.02299258056329283,2019-03-30 14:00:00,2019-03-30 14:15:00
170,1,1,0,0.002447993688618523,2019-03-30 14:00:00,2019-03-30 14:15:00
171,5,2,3,0.0032159875533933862,2019-03-30 14:00:00,2019-03-30 14:15:00
172,3,1,2,0.002304769573172695,2019-03-30 14:00:00,2019-03-30 14:15:00
173,2,1,1,0.010775275231841876,2019-03-30 14:00:00,2019-03-30 14:15:00
175,6,4,2,0.006748472780810585,2019-03-30 14:00:00,2019-03-30 14:15:00
177,11,5,6,0.009267772773334348,2019-03-30 14:00:00,2019-03-30 14:15:00
189,18,12,6,0.03749559676801114,2019-03-30 14:00:00,2019-03-30 14:15:00
190,9,3,6,0.005600793099707848,2019-03-30 14:00:00,2019-03-30 14:15:00
191,13,10,3,0.02151363114195471,2019-03-30 14:00:00,2019-03-30 14:15:00
197,17,6,11,0.0030155047487155796,2019-03-30 14:00:00,2019-03-30 14:15:00
199,3,1,2,0.0028128715334441094,2019-03-30 14:00:00,2019-03-30 14:15:00
201,2,1,1,0.002234751533676604,2019-03-30 14:00:00,2019-03-30 14:15:00
202,5,2,3,0.004597484261954908,2019-03-30 14:00:00,2019-03-30 14:15:00
203,19,11,8,0.014710397080880422,2019-03-30 14:00:00,2019-03-30 14:15:00
1,8,4,4,0.007578224556178556,2019-03-30 14:15:00,2019-03-30 14:30:00
2,10,5,5,0.0063762956292107535,2019-03-30 14:15:00,2019-03-30 14:30:00
5,19,8,11,0.0038314862776368257,2019-03-30 14:15:00,2019-03-30 14:30:00
10,3,1,2,0.0027491925313354844,2019-03-30 14:15:00,2019-03-30 14:30:00
11,5,1,4,0.0020073226877920796,2019-03-30 14:15:00,2019-03-30 14:30:00
13,2,2,0,0.0021605730064871496,2019-03-30 14:15:00,2019-03-30 14:30:00
15,21,13,8,0.013338532869733981,2019-03-30 14:15:00,2019-03-30 14:30:00
16,19,9,10,0.007979351845762605,2019-03-30 14:15:00,2019-03-30 14:30:00
18,14,3,11,0.006068583792671778,2019-03-30 14:15:00,2019-03-30 14:30:00
19,5,1,4,0.0020286479291886255,2019-03-30 14:15:00,2019-03-30 14:30:00
20,18,10,8,0.019491650154509266,2019-03-30 14:15:00,2019-03-30 14:30:00
21,2,0,2,0.0015807588945996594,2019-03-30 14:15:00,2019-03-30 14:30:00
23,6,4,2,0.009880294335104995,2019-03-30 14:15:00,2019-03-30 14:30:00
26,13,6,7,0.006017781789933283,2019-03-30 14:15:00,2019-03-30 14:30:00
27,7,4,3,0.005715459141348368,2019-03-30 14:15:00,2019-03-30 14:30:00
28,3,0,3,0.0015807588945996594,2019-03-30 14:15:00,2019-03-30 14:30:00
30,7,1,6,0.0020286479291886255,2019-03-30 14:15:00,2019-03-30 14:30:00
35,9,4,5,0.00461067196721535,2019-03-30 14:15:00,2019-03-30 14:30:00
37,4,2,2,0.010519969639023106,2019-03-30 14:15:00,2019-03-30 14:30:00
40,1,1,0,0.0029988724145532876,2019-03-30 14:15:00,2019-03-30 14:30:00
41,18,5,13,0.003626146438743133,2019-03-30 14:15:00,2019-03-30 14:30:00
46,22,13,9,0.011493474075223387,2019-03-30 14:15:00,2019-03-30 14:30:00
50,4,0,4,0.0015807588945996594,2019-03-30 14:15:00,2019-03-30 14:30:00
57,5,3,2,0.003646280067723595,2019-03-30 14:15:00,2019-03-30 14:30:00
58,9,2,7,0.003429967693282592,2019-03-30 14:15:00,2019-03-30 14:30:00
61,2,1,1,0.004912599549191007,2019-03-30 14:15:00,2019-03-30 14:30:00
62,23,13,10,0.01669360194761052,2019-03-30 14:15:00,2019-03-30 14:30:00
64,11,2,9,0.0031066732683575106,2019-03-30 14:15:00,2019-03-30 14:30:00
67,11,4,7,0.005362112907532772,2019-03-30 14:15:00,2019-03-30 14:30:00
68,2,1,1,0.002281873052555573,2019-03-30 14:15:00,2019-03-30 14:30:00
69,13,13,0,0.010120442524836352,2019-03-30 14:15:00,2019-03-30 14:30:00
70,11,4,7,0.002975141582203151,2019-03-30 14:15:00,2019-03-30 14:30:00
71,4,2,2,0.010519969639023106,2019-03-30 14:15:00,2019-03-30 14:30:00
74,16,6,10,0.004043342214570791,2019-03-30 14:15:00,2019-03-30 14:30:00
75,10,3,7,0.00238944386432874,2019-03-30 14:15:00,2019-03-30 14:30:00
79,8,5,3,0.009085226911555002,2019-03-30 14:15:00,2019-03-30 14:30:00
80,4,1,3,0.002205726729867867,2019-03-30 14:15:00,2019-03-30 14:30:00
85,12,4,8,0.003131830997712774,2019-03-30 14:15:00,2019-03-30 14:30:00
86,8,4,4,0.00397534076110951,2019-03-30 14:15:00,2019-03-30 14:30:00
87,5,4,1,0.00945447191836747,2019-03-30 14:15:00,2019-03-30 14:30:00
88,6,1,5,0.0019135354830825161,2019-03-30 14:15:00,2019-03-30 14:30:00
89,2,2,0,0.002415139349579933,2019-03-30 14:15:00,2019-03-30 14:30:00
90,12,11,1,0.010139594608803364,2019-03-30 14:15:00,2019-03-30 14:30:00
99,2,2,0,0.002521854291874385,2019-03-30 14:15:00,2019-03-30 14:30:00
101,5,3,2,0.01255865148490503,2019-03-30 14:15:00,2019-03-30 14:30:00
104,3,2,1,0.020917828245688257,2019-03-30 14:15:00,2019-03-30 14:30:00
106,14,6,8,0.00410833839858187,2019-03-30 14:15:00,2019-03-30 14:30:00
108,21,9,12,0.004867670203901997,2019-03-30 14:15:00,2019-03-30 14:30:00
109,14,6,8,0.015491525628331386,2019-03-30 14:15:00,2019-03-30 14:30:00
110,12,10,2,0.022502688584464966,2019-03-30 14:15:00,2019-03-30 14:30:00
111,7,0,7,0.0015807588945996594,2019-03-30 14:15:00,2019-03-30 14:30:00
112,7,3,4,0.0031819660493592225,2019-03-30 14:15:00,2019-03-30 14:30:00
113,3,0,3,0.0015807588945996594,2019-03-30 14:15:00,2019-03-30 14:30:00
114,4,2,2,0.003928973317985144,2019-03-30 14:15:00,2019-03-30 14:30:00
115,19,8,11,0.013992268616127282,2019-03-30 14:15:00,2019-03-30 14:30:00
116,6,3,3,0.011451433026725504,2019-03-30 14:15:00,2019-03-30 14:30:00
119,14,10,4,0.020170097176950855,2019-03-30 14:15:00,2019-03-30 14:30:00
120,5,0,5,0.0015807588945996594,2019-03-30 14:15:00,2019-03-30 14:30:00
122,2,0,2,0.0015807588945996594,2019-03-30 14:15:00,2019-03-30 14:30:00
126,8,2,6,0.002205726729867867,2019-03-30 14:15:00,2019-03-30 14:30:00
127,4,2,2,0.015732017677339775,2019-03-30 14:15:00,2019-03-30 14:30:00
129,11,4,7,0.0041920517050208295,2019-03-30 14:15:00,2019-03-30 14:30:00
133,2,0,2,0.0015807588945996594,2019-03-30 14:15:00,2019-03-30 14:30:00
135,2,0,2,0.0015807588945996594,2019-03-30 14:15:00,2019-03-30 14:30:00
137,37,16,21,0.02750575830342492,2019-03-30 14:15:00,2019-03-30 14:30:00
138,73,38,35,0.050740859320204605,2019-03-30 14:15:00,2019-03-30 14:30:00
140,5,4,1,0.00656757740994391,2019-03-30 14:15:00,2019-03-30 14:30:00
141,2,2,0,0.0027660377860375036,2019-03-30 14:15:00,2019-03-30 14:30:00
147,4,0,4,0.0015807588945996594,2019-03-30 14:15:00,2019-03-30 14:30:00
151,3,2,1,0.01477338956253536,2019-03-30 14:15:00,2019-03-30 14:30:00
153,15,10,5,0.019483700123341104,2019-03-30 14:15:00,2019-03-30 14:30:00
154,5,5,0,0.003313450312228023,2019-03-30 14:15:00,2019-03-30 14:30:00
157,12,7,5,0.008341039090633995,2019-03-30 14:15:00,2019-03-30 14:30:00
158,8,5,3,0.007558525237263462,2019-03-30 14:15:00,2019-03-30 14:30:00
159,14,8,6,0.0106075966886621,2019-03-30 14:15:00,2019-03-30 14:30:00
160,2,2,0,0.004586620633716754,2019-03-30 14:15:00,2019-03-30 14:30:00
161,8,4,4,0.010519969639023106,2019-03-30 14:15:00,2019-03-30 14:30:00
162,19,8,11,0.006535215024860007,2019-03-30 14:15:00,2019-03-30 14:30:00
164,19,14,5,0.0438976972688049,2019-03-30 14:15:00,2019-03-30 14:30:00
168,61,46,15,0.0587874067799766,2019-03-30 14:15:00,2019-03-30 14:30:00
169,41,21,20,0.030163863171624332,2019-03-30 14:15:00,2019-03-30 14:30:00
170,2,0,2,0.0015807588945996594,2019-03-30 14:15:00,2019-03-30 14:30:00
171,12,5,7,0.005773359871504933,2019-03-30 14:15:00,2019-03-30 14:30:00
172,3,1,2,0.0022525924464831086,2019-03-30 14:15:00,2019-03-30 14:30:00
173,2,1,1,0.010519969639023106,2019-03-30 14:15:00,2019-03-30 14:30:00
175,8,5,3,0.008892034012538262,2019-03-30 14:15:00,2019-03-30 14:30:00
177,14,5,9,0.0030695197817532014,2019-03-30 14:15:00,2019-03-30 14:30:00
189,20,9,11,0.006973499900900057,2019-03-30 14:15:00,2019-03-30 14:30:00
190,14,6,8,0.010322701329181522,2019-03-30 14:15:00,2019-03-30 14:30:00
191,13,9,4,0.014916701452509076,2019-03-30 14:15:00,2019-03-30 14:30:00
197,16,6,10,0.003627636415035618,2019-03-30 14:15:00,2019-03-30 14:30:00
199,4,2,2,0.0035281482891593675,2019-03-30 14:15:00,2019-03-30 14:30:00
201,4,3,1,0.006175857741187549,2019-03-30 14:15:00,2019-03-30 14:30:00
202,5,2,3,0.003631315262114352,2019-03-30 14:15:00,2019-03-30 14:30:00
203,20,11,9,0.022769546040511644,2019-03-30 14:15:00,2019-03-30 14:30:00
1,10,6,4,0.008502438994594508,2019-03-30 14:30:00,2019-03-30 14:45:00
2,14,7,7,0.00759368699035491,2019-03-30 14:30:00,2019-03-30 14:45:00
5,18,9,9,0.006337784807596109,2019-03-30 14:30:00,2019-03-30 14:45:00
10,2,1,1,0.010453685952058018,2019-03-30 14:30:00,2019-03-30 14:45:00
11,5,1,4,0.0019935976432589268,2019-03-30 14:30:00,2019-03-30 14:45:00
13,2,2,0,0.002423715526482194,2019-03-30 14:30:00,2019-03-30 14:45:00
15,16,8,8,0.011364849062918818,2019-03-30 14:30:00,2019-03-30 14:45:00
16,25,12,13,0.009951520582663806,2019-03-30 14:30:00,2019-03-30 14:45:00
18,9,1,8,0.0028083154397629674,2019-03-30 14:30:00,2019-03-30 14:45:00
19,5,2,3,0.003960460422820859,2019-03-30 14:30:00,2019-03-30 14:45:00
20,16,7,9,0.011578251519458797,2019-03-30 14:30:00,2019-03-30 14:45:00
21,4,0,4,0.0015699463414843115,2019-03-30 14:30:00,2019-03-30 14:45:00
23,6,6,0,0.014186172835823935,2019-03-30 14:30:00,2019-03-30 14:45:00
26,12,3,9,0.003609340044542349,2019-03-30 14:30:00,2019-03-30 14:45:00
27,7,3,4,0.0038908604251365222,2019-03-30 14:30:00,2019-03-30 14:45:00
28,2,0,2,0.0015699463414843115,2019-03-30 14:30:00,2019-03-30 14:45:00
30,6,2,4,0.0029164392837957845,2019-03-30 14:30:00,2019-03-30 14:45:00
35,10,4,6,0.0038623023940388907,2019-03-30 14:30:00,2019-03-30 14:45:00
37,5,3,2,0.02429961164400699,2019-03-30 14:30:00,2019-03-30 14:45:00
40,1,0,1,0.0015699463414843115,2019-03-30 14:30:00,2019-03-30 14:45:00
41,19,6,13,0.0038371953340621563,2019-03-30 14:30:00,2019-03-30 14:45:00
46,18,10,8,0.008709632275845952,2019-03-30 14:30:00,2019-03-30 14:45:00
50,2,0,2,0.0015699463414843115,2019-03-30 14:30:00,2019-03-30 14:45:00
57,6,3,3,0.0037033558831260794,2019-03-30 14:30:00,2019-03-30 14:45:00
58,11,3,8,0.005100724349303264,2019-03-30 14:30:00,2019-03-30 14:45:00
61,2,1,1,0.0036650230181545784,2019-03-30 14:30:00,2019-03-30 14:45:00
62,29,11,18,0.00901042837083437,2019-03-30 14:30:00,2019-03-30 14:45:00
64,12,2,10,0.0024581537569710356,2019-03-30 14:30:00,2019-03-30 14:45:00
66,3,1,2,0.002730403383310417,2019-03-30 14:30:00,2019-03-30 14:45:00
67,10,4,6,0.005849906411693285,2019-03-30 14:30:00,2019-03-30 14:45:00
68,3,2,1,0.005712434951684111,2019-03-30 14:30:00,2019-03-30 14:45:00
69,16,12,4,0.013874322187004691,2019-03-30 14:30:00,2019-03-30 14:45:00
70,10,6,4,0.016304432317241168,2019-03-30 14:30:00,2019-03-30 14:45:00
71,4,2,2,0.010453685952058018,2019-03-30 14:30:00,2019-03-30 14:45:00
74,16,5,11,0.0059172628175027525,2019-03-30 14:30:00,2019-03-30 14:45:00
75,6,3,3,0.009172900370501478,2019-03-30 14:30:00,2019-03-30 14:45:00
79,6,4,2,0.004286938752434056,2019-03-30 14:30:00,2019-03-30 14:45:00
80,6,3,3,0.0033729469436923256,2019-03-30 14:30:00,2019-03-30 14:45:00
85,12,2,10,0.002308171520821495,2019-03-30 14:30:00,2019-03-30 14:45:00
86,9,4,5,0.005809754368155724,2019-03-30 14:30:00,2019-03-30 14:45:00
87,11,7,4,0.00903625865609199,2019-03-30 14:30:00,2019-03-30 14:45:00
88,3,1,2,0.0017661525023042826,2019-03-30 14:30:00,2019-03-30 14:45:00
89,3,2,1,0.0029625511094810886,2019-03-30 14:30:00,2019-03-30 14:45:00
90,22,14,8,0.01621668052357588,2019-03-30 14:30:00,2019-03-30 14:45:00
99,4,3,1,0.0032525275300919424,2019-03-30 14:30:00,2019-03-30 14:45:00
101,5,3,2,0.013261377044662244,2019-03-30 14:30:00,2019-03-30 14:45:00
104,5,2,3,0.0036231190667814746,2019-03-30 14:30:00,2019-03-30 14:45:00
106,13,3,10,0.0021073309125008172,2019-03-30 14:30:00,2019-03-30 14:45:00
108,17,9,8,0.00932054401994622,2019-03-30 14:30:00,2019-03-30 14:45:00
109,19,9,10,0.01416563868944174,2019-03-30 14:30:00,2019-03-30 14:45:00
110,20,14,6,0.026433006214965412,2019-03-30 14:30:00,2019-03-30 14:45:00
111,4,3,1,0.004014618038053913,2019-03-30 14:30:00,2019-03-30 14:45:00
112,6,3,3,0.005116530348561409,2019-03-30 14:30:00,2019-03-30 14:45:00
113,2,0,2,0.0015699463414843115,2019-03-30 14:30:00,2019-03-30 14:45:00
114,5,3,2,0.006219983175504112,2019-03-30 14:30:00,2019-03-30 14:45:00
115,24,8,16,0.004933035657858748,2019-03-30 14:30:00,2019-03-30 14:45:00
116,5,4,1,0.005884110313123249,2019-03-30 14:30:00,2019-03-30 14:45:00
118,1,1,0,0.0019035687612713298,2019-03-30 14:30:00,2019-03-30 14:45:00
119,16,12,4,0.014304760741146727,2019-03-30 14:30:00,2019-03-30 14:45:00
120,7,2,5,0.003409651486047853,2019-03-30 14:30:00,2019-03-30 14:45:00
122,2,0,2,0.0015699463414843115,2019-03-30 14:30:00,2019-03-30 14:45:00
126,12,7,5,0.010142292333049658,2019-03-30 14:30:00,2019-03-30 14:45:00
127,4,0,4,0.0015699463414843115,2019-03-30 14:30:00,2019-03-30 14:45:00
129,8,3,5,0.003776046776507235,2019-03-30 14:30:00,2019-03-30 14:45:00
133,2,0,2,0.0015699463414843115,2019-03-30 14:30:00,2019-03-30 14:45:00
135,1,1,0,0.0017789056542335995,2019-03-30 14:30:00,2019-03-30 14:45:00
137,47,19,28,0.04078627978308369,2019-03-30 14:30:00,2019-03-30 14:45:00
138,64,27,37,0.029562578289069358,2019-03-30 14:30:00,2019-03-30 14:45:00
140,6,4,2,0.006489326373181203,2019-03-30 14:30:00,2019-03-30 14:45:00
141,3,1,2,0.0022119127429771996,2019-03-30 14:30:00,2019-03-30 14:45:00
147,3,1,2,0.0019035687612713298,2019-03-30 14:30:00,2019-03-30 14:45:00
151,7,4,3,0.005242916161165293,2019-03-30 14:30:00,2019-03-30 14:45:00
153,18,12,6,0.012220627812042644,2019-03-30 14:30:00,2019-03-30 14:45:00
154,5,5,0,0.0038049271864441098,2019-03-30 14:30:00,2019-03-30 14:45:00
157,10,9,1,0.05728759824934086,2019-03-30 14:30:00,2019-03-30 14:45:00
158,10,5,5,0.007800931176326665,2019-03-30 14:30:00,2019-03-30 14:45:00
159,12,5,7,0.0065861090268772,2019-03-30 14:30:00,2019-03-30 14:45:00
160,3,3,0,0.003596481292800795,2019-03-30 14:30:00,2019-03-30 14:45:00
161,10,5,5,0.010453685952058018,2019-03-30 14:30:00,2019-03-30 14:45:00
162,19,9,10,0.005810033332951736,2019-03-30 14:30:00,2019-03-30 14:45:00
164,17,14,3,0.0228839857977594,2019-03-30 14:30:00,2019-03-30 14:45:00
168,64,45,19,0.04682298253192154,2019-03-30 14:30:00,2019-03-30 14:45:00
169,54,30,24,0.026148084454761588,2019-03-30 14:30:00,2019-03-30 14:45:00
170,2,0,2,0.0015699463414843115,2019-03-30 14:30:00,2019-03-30 14:45:00
171,7,4,3,0.005289312077874423,2019-03-30 14:30:00,2019-03-30 14:45:00
172,3,1,2,0.0022371911810583484,2019-03-30 14:30:00,2019-03-30 14:45:00
173,3,2,1,0.01595603361816219,2019-03-30 14:30:00,2019-03-30 14:45:00
175,8,5,3,0.008231868569712806,2019-03-30 14:30:00,2019-03-30 14:45:00
177,17,6,11,0.005523929481431462,2019-03-30 14:30:00,2019-03-30 14:45:00
189,17,9,8,0.021781442687271446,2019-03-30 14:30:00,2019-03-30 14:45:00
190,11,4,7,0.005941710124633863,2019-03-30 14:30:00,2019-03-30 14:45:00
191,17,9,8,0.01261167934219599,2019-03-30 14:30:00,2019-03-30 14:45:00
196,7,4,3,0.004784228380371334,2019-03-30 14:30:00,2019-03-30 14:45:00
197,16,7,9,0.004476176486217059,2019-03-30 14:30:00,2019-03-30 14:45:00
199,3,1,2,0.002730403383310417,2019-03-30 14:30:00,2019-03-30 14:45:00
200,1,1,0,0.002557709981838641,2019-03-30 14:30:00,2019-03-30 14:45:00
201,4,4,0,0.005489324206578729,2019-03-30 14:30:00,2019-03-30 14:45:00
202,3,1,2,0.0023967809635233985,2019-03-30 14:30:00,2019-03-30 14:45:00
203,19,12,7,0.01419695523217909,2019-03-30 14:30:00,2019-03-30 14:45:00
1,10,5,5,0.004774270466658408,2019-03-30 14:45:00,2019-03-30 15:00:00
2,12,5,7,0.007313791313480658,2019-03-30 14:45:00,2019-03-30 15:00:00
5,23,13,10,0.010961234717860986,2019-03-30 14:45:00,2019-03-30 15:00:00
10,3,2,1,0.010560228470157624,2019-03-30 14:45:00,2019-03-30 15:00:00
11,6,1,5,0.0016846896995008267,2019-03-30 14:45:00,2019-03-30 15:00:00
13,2,2,0,0.002117025648488384,2019-03-30 14:45:00,2019-03-30 15:00:00
15,11,6,5,0.007611084364804186,2019-03-30 14:45:00,2019-03-30 15:00:00
16,24,13,11,0.010098294127508041,2019-03-30 14:45:00,2019-03-30 15:00:00
18,13,4,9,0.002524941421677872,2019-03-30 14:45:00,2019-03-30 15:00:00
19,3,2,1,0.0034346923552217587,2019-03-30 14:45:00,2019-03-30 15:00:00
20,17,9,8,0.00887046211947265,2019-03-30 14:45:00,2019-03-30 15:00:00
21,1,0,1,0.0013982916389239436,2019-03-30 14:45:00,2019-03-30 15:00:00
23,12,10,2,0.02353148462457929,2019-03-30 14:45:00,2019-03-30 15:00:00
26,11,2,9,0.0021798797513015024,2019-03-30 14:45:00,2019-03-30 15:00:00
27,7,3,4,0.0037880272643733242,2019-03-30 14:45:00,2019-03-30 15:00:00
28,3,3,0,0.0036876265409200443,2019-03-30 14:45:00,2019-03-30 15:00:00
30,3,1,2,0.0018809796904211246,2019-03-30 14:45:00,2019-03-30 15:00:00
35,13,5,8,0.0037892412148976644,2019-03-30 14:45:00,2019-03-30 15:00:00
37,4,2,2,0.009321116926326933,2019-03-30 14:45:00,2019-03-30 15:00:00
40,1,0,1,0.0013982916389239436,2019-03-30 14:45:00,2019-03-30 15:00:00
41,23,8,15,0.004084719252641518,2019-03-30 14:45:00,2019-03-30 15:00:00
46,24,12,12,0.01100526774113688,2019-03-30 14:45:00,2019-03-30 15:00:00
50,2,0,2,0.0013982916389239436,2019-03-30 14:45:00,2019-03-30 15:00:00
57,5,1,4,0.0023452744260933755,2019-03-30 14:45:00,2019-03-30 15:00:00
58,9,3,6,0.003809020060848882,2019-03-30 14:45:00,2019-03-30 15:00:00
61,6,3,3,0.005882675293694704,2019-03-30 14:45:00,2019-03-30 15:00:00
62,25,6,19,0.00806961532485777,2019-03-30 14:45:00,2019-03-30 15:00:00
64,10,3,7,0.0024843566873659316,2019-03-30 14:45:00,2019-03-30 15:00:00
66,3,1,2,0.0024318173340960926,2019-03-30 14:45:00,2019-03-30 15:00:00
67,11,3,8,0.005478740439710661,2019-03-30 14:45:00,2019-03-30 15:00:00
68,4,2,2,0.002603778969078079,2019-03-30 14:45:00,2019-03-30 15:00:00
69,13,9,4,0.005873622641602955,2019-03-30 14:45:00,2019-03-30 15:00:00
70,19,9,10,0.008246694749452955,2019-03-30 14:45:00,2019-03-30 15:00:00
71,4,2,2,0.009321116926326933,2019-03-30 14:45:00,2019-03-30 15:00:00
74,21,7,14,0.003628387305156456,2019-03-30 14:45:00,2019-03-30 15:00:00
75,13,9,4,0.015939865013825345,2019-03-30 14:45:00,2019-03-30 15:00:00
79,4,1,3,0.0019511068945791436,2019-03-30 14:45:00,2019-03-30 15:00:00
80,6,3,3,0.0027503584798140943,2019-03-30 14:45:00,2019-03-30 15:00:00
85,8,1,7,0.0019379666751933278,2019-03-30 14:45:00,2019-03-30 15:00:00
86,5,2,3,0.0024302757688261277,2019-03-30 14:45:00,2019-03-30 15:00:00
87,17,9,8,0.00985313288206725,2019-03-30 14:45:00,2019-03-30 15:00:00
88,6,3,3,0.002607868156167716,2019-03-30 14:45:00,2019-03-30 15:00:00
89,3,1,2,0.002137199464913926,2019-03-30 14:45:00,2019-03-30 15:00:00
90,17,10,7,0.014409392075878994,2019-03-30 14:45:00,2019-03-30 15:00:00
99,8,5,3,0.0036188320902953274,2019-03-30 14:45:00,2019-03-30 15:00:00
101,6,4,2,0.016657946276062093,2019-03-30 14:45:00,2019-03-30 15:00:00
104,1,0,1,0.0013982916389239436,2019-03-30 14:45:00,2019-03-30 15:00:00
106,10,2,8,0.0017756098079958493,2019-03-30 14:45:00,2019-03-30 15:00:00
108,23,17,6,0.04567626020198617,2019-03-30 14:45:00,2019-03-30 15:00:00
109,25,13,12,0.013366566393246088,2019-03-30 14:45:00,2019-03-30 15:00:00
110,20,13,7,0.017918215799391634,2019-03-30 14:45:00,2019-03-30 15:00:00
111,5,2,3,0.0026514027402180767,2019-03-30 14:45:00,2019-03-30 15:00:00
112,5,2,3,0.0028306403981066064,2019-03-30 14:45:00,2019-03-30 15:00:00
113,2,1,1,0.014712579993988978,2019-03-30 14:45:00,2019-03-30 15:00:00
114,4,1,3,0.0019511068945791436,2019-03-30 14:45:00,2019-03-30 15:00:00
115,14,3,11,0.0026664205045017226,2019-03-30 14:45:00,2019-03-30 15:00:00
116,5,4,1,0.004419832110113597,2019-03-30 14:45:00,2019-03-30 15:00:00
118,2,0,2,0.0013982916389239436,2019-03-30 14:45:00,2019-03-30 15:00:00
119,15,11,4,0.011324113342117657,2019-03-30 14:45:00,2019-03-30 15:00:00
120,7,4,3,0.00550258417122742,2019-03-30 14:45:00,2019-03-30 15:00:00
122,2,0,2,0.0013982916389239436,2019-03-30 14:45:00,2019-03-30 15:00:00
126,15,12,3,0.04698139430600863,2019-03-30 14:45:00,2019-03-30 15:00:00
127,2,0,2,0.0013982916389239436,2019-03-30 14:45:00,2019-03-30 15:00:00
129,6,3,3,0.005277592476902912,2019-03-30 14:45:00,2019-03-30 15:00:00
133,2,0,2,0.0013982916389239436,2019-03-30 14:45:00,2019-03-30 15:00:00
135,1,1,0,0.0016999801373963471,2019-03-30 14:45:00,2019-03-30 15:00:00
137,41,20,21,0.03742279472760329,2019-03-30 14:45:00,2019-03-30 15:00:00
138,60,25,35,0.01987221870116894,2019-03-30 14:45:00,2019-03-30 15:00:00
140,5,4,1,0.007693461805685799,2019-03-30 14:45:00,2019-03-30 15:00:00
141,4,2,2,0.0021204213960471594,2019-03-30 14:45:00,2019-03-30 15:00:00
147,3,0,3,0.0013982916389239436,2019-03-30 14:45:00,2019-03-30 15:00:00
151,13,6,7,0.00463414876665688,2019-03-30 14:45:00,2019-03-30 15:00:00
153,17,11,6,0.010499876850458622,2019-03-30 14:45:00,2019-03-30 15:00:00
154,13,7,6,0.009792091303247017,2019-03-30 14:45:00,2019-03-30 15:00:00
157,11,9,2,0.017798668114822697,2019-03-30 14:45:00,2019-03-30 15:00:00
158,6,2,4,0.0024318173340960926,2019-03-30 14:45:00,2019-03-30 15:00:00
159,14,5,9,0.0031648112496840794,2019-03-30 14:45:00,2019-03-30 15:00:00
160,5,5,0,0.002953258887227674,2019-03-30 14:45:00,2019-03-30 15:00:00
161,12,6,6,0.009321116926326933,2019-03-30 14:45:00,2019-03-30 15:00:00
162,18,9,9,0.0057273617850011555,2019-03-30 14:45:00,2019-03-30 15:00:00
164,21,16,5,0.018537707816883613,2019-03-30 14:45:00,2019-03-30 15:00:00
168,57,41,16,0.03774693850418521,2019-03-30 14:45:00,2019-03-30 15:00:00
169,56,30,26,0.0379844771726646,2019-03-30 14:45:00,2019-03-30 15:00:00
170,2,0,2,0.0013982916389239436,2019-03-30 14:45:00,2019-03-30 15:00:00
171,9,4,5,0.0038389959139179305,2019-03-30 14:45:00,2019-03-30 15:00:00
172,3,1,2,0.0019925671971980047,2019-03-30 14:45:00,2019-03-30 15:00:00
173,4,2,2,0.0038320033499137794,2019-03-30 14:45:00,2019-03-30 15:00:00
175,6,3,3,0.005417730077964476,2019-03-30 14:45:00,2019-03-30 15:00:00
177,17,7,10,0.0042277011309947155,2019-03-30 14:45:00,2019-03-30 15:00:00
189,21,10,11,0.01297823588666128,2019-03-30 14:45:00,2019-03-30 15:00:00
190,14,4,10,0.002187619306638508,2019-03-30 14:45:00,2019-03-30 15:00:00
191,21,9,12,0.005295217711935481,2019-03-30 14:45:00,2019-03-30 15:00:00
196,9,4,5,0.0036131975012980667,2019-03-30 14:45:00,2019-03-30 15:00:00
197,18,7,11,0.004203633419847745,2019-03-30 14:45:00,2019-03-30 15:00:00
199,3,1,2,0.0024318173340960926,2019-03-30 14:45:00,2019-03-30 15:00:00
200,1,1,0,0.0020868924570361944,2019-03-30 14:45:00,2019-03-30 15:00:00
201,9,8,1,0.09182747501179356,2019-03-30 14:45:00,2019-03-30 15:00:00
202,2,1,1,0.00220332110930677,2019-03-30 14:45:00,2019-03-30 15:00:00
203,22,13,9,0.017518190209341967,2019-03-30 14:45:00,2019-03-30 15:00:00
1,9,5,4,0.004561135515300648,2019-03-30 15:00:00,2019-03-30 15:15:00
2,10,5,5,0.006441046553862554,2019-03-30 15:00:00,2019-03-30 15:15:00
5,24,14,10,0.012843009397971939,2019-03-30 15:00:00,2019-03-30 15:15:00
10,3,2,1,0.012494632086224786,2019-03-30 15:00:00,2019-03-30 15:15:00
11,8,2,6,0.002122512988159522,2019-03-30 15:00:00,2019-03-30 15:15:00
15,12,7,5,0.007069067346708704,2019-03-30 15:00:00,2019-03-30 15:15:00
16,27,13,14,0.015714578346222134,2019-03-30 15:00:00,2019-03-30 15:15:00
18,13,4,9,0.0032599340899015262,2019-03-30 15:00:00,2019-03-30 15:15:00
19,4,2,2,0.003363963771884877,2019-03-30 15:00:00,2019-03-30 15:15:00
20,20,9,11,0.008561299234924812,2019-03-30 15:00:00,2019-03-30 15:15:00
21,2,0,2,0.0015211211036259972,2019-03-30 15:00:00,2019-03-30 15:15:00
22,1,0,1,0.0015211211036259972,2019-03-30 15:00:00,2019-03-30 15:15:00
23,7,4,3,0.0061995565468210626,2019-03-30 15:00:00,2019-03-30 15:15:00
26,12,3,9,0.002396672514692593,2019-03-30 15:00:00,2019-03-30 15:15:00
27,8,4,4,0.005181305200819488,2019-03-30 15:00:00,2019-03-30 15:15:00
28,3,3,0,0.003907600841328214,2019-03-30 15:00:00,2019-03-30 15:15:00
30,2,0,2,0.0015211211036259972,2019-03-30 15:00:00,2019-03-30 15:15:00
35,10,4,6,0.00430524695432326,2019-03-30 15:00:00,2019-03-30 15:15:00
37,4,2,2,0.010134196215551873,2019-03-30 15:00:00,2019-03-30 15:15:00
41,24,10,14,0.007390115957713263,2019-03-30 15:00:00,2019-03-30 15:15:00
46,26,10,16,0.007494922153467548,2019-03-30 15:00:00,2019-03-30 15:15:00
50,2,0,2,0.0015211211036259972,2019-03-30 15:00:00,2019-03-30 15:15:00
57,5,2,3,0.002888365500393036,2019-03-30 15:00:00,2019-03-30 15:15:00
58,10,4,6,0.004255609897160074,2019-03-30 15:00:00,2019-03-30 15:15:00
61,5,2,3,0.0038129276696294502,2019-03-30 15:00:00,2019-03-30 15:15:00
62,20,6,14,0.00910435478072749,2019-03-30 15:00:00,2019-03-30 15:15:00
64,14,4,10,0.0026135867622607994,2019-03-30 15:00:00,2019-03-30 15:15:00
66,1,0,1,0.0015211211036259972,2019-03-30 15:00:00,2019-03-30 15:15:00
67,14,5,9,0.007258418850485026,2019-03-30 15:00:00,2019-03-30 15:15:00
68,3,1,2,0.0024222345940910286,2019-03-30 15:00:00,2019-03-30 15:15:00
69,10,7,3,0.013504238761712186,2019-03-30 15:00:00,2019-03-30 15:15:00
70,19,8,11,0.011862845674946765,2019-03-30 15:00:00,2019-03-30 15:15:00
71,4,2,2,0.010134196215551873,2019-03-30 15:00:00,2019-03-30 15:15:00
74,16,4,12,0.0031734393187591503,2019-03-30 15:00:00,2019-03-30 15:15:00
75,11,8,3,0.01416683547335687,2019-03-30 15:00:00,2019-03-30 15:15:00
79,4,1,3,0.002122512988159522,2019-03-30 15:00:00,2019-03-30 15:15:00
80,6,3,3,0.0029616740552540063,2019-03-30 15:00:00,2019-03-30 15:15:00
85,5,1,4,0.0021240637653459444,2019-03-30 15:00:00,2019-03-30 15:15:00
86,9,6,3,0.015600343439717198,2019-03-30 15:00:00,2019-03-30 15:15:00
87,23,9,14,0.014740224872115505,2019-03-30 15:00:00,2019-03-30 15:15:00
88,5,2,3,0.00275237162661622,2019-03-30 15:00:00,2019-03-30 15:15:00
89,3,1,2,0.002300984974098067,2019-03-30 15:00:00,2019-03-30 15:15:00
90,18,10,8,0.014512160973964728,2019-03-30 15:00:00,2019-03-30 15:15:00
99,9,5,4,0.004890405808965799,2019-03-30 15:00:00,2019-03-30 15:15:00
101,6,4,2,0.02019523379513483,2019-03-30 15:00:00,2019-03-30 15:15:00
104,6,5,1,0.004359854918902767,2019-03-30 15:00:00,2019-03-30 15:15:00
106,8,1,7,0.0017313623172728187,2019-03-30 15:00:00,2019-03-30 15:15:00
108,21,16,5,0.03939693167768258,2019-03-30 15:00:00,2019-03-30 15:15:00
109,25,12,13,0.01168761734080029,2019-03-30 15:00:00,2019-03-30 15:15:00
110,25,18,7,0.029823972517584656,2019-03-30 15:00:00,2019-03-30 15:15:00
111,7,2,5,0.0035862550813818466,2019-03-30 15:00:00,2019-03-30 15:15:00
112,4,2,2,0.009174697487252696,2019-03-30 15:00:00,2019-03-30 15:15:00
113,5,5,0,0.007671044836071524,2019-03-30 15:00:00,2019-03-30 15:15:00
114,6,4,2,0.005724163834663862,2019-03-30 15:00:00,2019-03-30 15:15:00
115,8,4,4,0.004683122839963519,2019-03-30 15:00:00,2019-03-30 15:15:00
116,4,1,3,0.002490439307105072,2019-03-30 15:00:00,2019-03-30 15:15:00
118,5,3,2,0.0027157579306742513,2019-03-30 15:00:00,2019-03-30 15:15:00
119,23,14,9,0.011496789599094845,2019-03-30 15:00:00,2019-03-30 15:15:00
120,6,2,4,0.004015973089404301,2019-03-30 15:00:00,2019-03-30 15:15:00
122,5,3,2,0.005488586191199131,2019-03-30 15:00:00,2019-03-30 15:15:00
126,16,10,6,0.010564027988275349,2019-03-30 15:00:00,2019-03-30 15:15:00
127,2,2,0,0.0034712051961578293,2019-03-30 15:00:00,2019-03-30 15:15:00
129,5,3,2,0.0173906561400699,2019-03-30 15:00:00,2019-03-30 15:15:00
133,2,0,2,0.0015211211036259972,2019-03-30 15:00:00,2019-03-30 15:15:00
135,1,1,0,0.0017432866542932972,2019-03-30 15:00:00,2019-03-30 15:15:00
137,38,16,22,0.02060659554951213,2019-03-30 15:00:00,2019-03-30 15:15:00
138,48,19,29,0.014531472698600181,2019-03-30 15:00:00,2019-03-30 15:15:00
140,5,5,0,0.005453636834185188,2019-03-30 15:00:00,2019-03-30 15:15:00
141,10,8,2,0.007502275727690739,2019-03-30 15:00:00,2019-03-30 15:15:00
147,3,0,3,0.0015211211036259972,2019-03-30 15:00:00,2019-03-30 15:15:00
151,11,5,6,0.0041272769593771975,2019-03-30 15:00:00,2019-03-30 15:15:00
153,12,8,4,0.006135017455599077,2019-03-30 15:00:00,2019-03-30 15:15:00
154,12,6,6,0.006099103233260779,2019-03-30 15:00:00,2019-03-30 15:15:00
157,16,10,6,0.011346006705677186,2019-03-30 15:00:00,2019-03-30 15:15:00
158,3,2,1,0.01855038298750971,2019-03-30 15:00:00,2019-03-30 15:15:00
159,15,7,8,0.008308009364961986,2019-03-30 15:00:00,2019-03-30 15:15:00
160,7,5,2,0.005775824064330718,2019-03-30 15:00:00,2019-03-30 15:15:00
161,9,4,5,0.004753928107081758,2019-03-30 15:00:00,2019-03-30 15:15:00
162,14,6,8,0.004568531836449334,2019-03-30 15:00:00,2019-03-30 15:15:00
164,23,14,9,0.01343296579392211,2019-03-30 15:00:00,2019-03-30 15:15:00
168,59,41,18,0.028001793744951594,2019-03-30 15:00:00,2019-03-30 15:15:00
169,54,26,28,0.025420073555608193,2019-03-30 15:00:00,2019-03-30 15:15:00
170,6,3,3,0.0027280967536611024,2019-03-30 15:00:00,2019-03-30 15:15:00
171,7,3,4,0.00424015188528774,2019-03-30 15:00:00,2019-03-30 15:15:00
172,1,1,0,0.003854062755714688,2019-03-30 15:00:00,2019-03-30 15:15:00
173,3,2,1,0.017451165267058324,2019-03-30 15:00:00,2019-03-30 15:15:00
175,12,5,7,0.003872125938428306,2019-03-30 15:00:00,2019-03-30 15:15:00
177,12,6,6,0.005394881862738452,2019-03-30 15:00:00,2019-03-30 15:15:00
189,24,12,12,0.02639106055367494,2019-03-30 15:00:00,2019-03-30 15:15:00
190,14,4,10,0.004176620018118876,2019-03-30 15:00:00,2019-03-30 15:15:00
191,13,6,7,0.00574036231506294,2019-03-30 15:00:00,2019-03-30 15:15:00
196,3,0,3,0.0015211211036259972,2019-03-30 15:00:00,2019-03-30 15:15:00
197,13,6,7,0.004623887417985099,2019-03-30 15:00:00,2019-03-30 15:15:00
199,4,2,2,0.004894181569942459,2019-03-30 15:00:00,2019-03-30 15:15:00
201,9,8,1,0.06815389242839283,2019-03-30 15:00:00,2019-03-30 15:15:00
202,2,1,1,0.002622239688811583,2019-03-30 15:00:00,2019-03-30 15:15:00
203,27,15,12,0.016740758443613772,2019-03-30 15:00:00,2019-03-30 15:15:00
1,12,9,3,0.009410788390383663,2019-03-30 15:15:00,2019-03-30 15:30:00
2,8,5,3,0.010688106561265672,2019-03-30 15:15:00,2019-03-30 15:30:00
5,19,13,6,0.05402827833075438,2019-03-30 15:15:00,2019-03-30 15:30:00
10,3,2,1,0.0118306651914076,2019-03-30 15:15:00,2019-03-30 15:30:00
11,10,3,7,0.0024199773794447697,2019-03-30 15:15:00,2019-03-30 15:30:00
13,2,2,0,0.002523310892223678,2019-03-30 15:15:00,2019-03-30 15:30:00
15,17,10,7,0.008133437405679057,2019-03-30 15:15:00,2019-03-30 15:30:00
16,29,16,13,0.018637236862922915,2019-03-30 15:15:00,2019-03-30 15:30:00
18,10,4,6,0.005392304174980309,2019-03-30 15:15:00,2019-03-30 15:30:00
19,2,1,1,0.0018322565083295176,2019-03-30 15:15:00,2019-03-30 15:30:00
20,21,7,14,0.00964388341773505,2019-03-30 15:15:00,2019-03-30 15:30:00
21,1,0,1,0.0015383960727718914,2019-03-30 15:15:00,2019-03-30 15:30:00
22,2,0,2,0.0015383960727718914,2019-03-30 15:15:00,2019-03-30 15:30:00
23,6,4,2,0.004814792488392962,2019-03-30 15:15:00,2019-03-30 15:30:00
26,21,9,12,0.0058107837463036065,2019-03-30 15:15:00,2019-03-30 15:30:00
27,10,5,5,0.005667641902633624,2019-03-30 15:15:00,2019-03-30 15:30:00
28,8,6,2,0.026318916773063986,2019-03-30 15:15:00,2019-03-30 15:30:00
30,2,0,2,0.0015383960727718914,2019-03-30 15:15:00,2019-03-30 15:30:00
35,9,4,5,0.005627529566968234,2019-03-30 15:15:00,2019-03-30 15:30:00
37,4,2,2,0.010250551244140125,2019-03-30 15:15:00,2019-03-30 15:30:00
40,2,1,1,0.010250551244140125,2019-03-30 15:15:00,2019-03-30 15:30:00
41,15,7,8,0.006998636107244287,2019-03-30 15:15:00,2019-03-30 15:30:00
46,24,9,15,0.008870096559458588,2019-03-30 15:15:00,2019-03-30 15:30:00
57,5,1,4,0.002332718240200388,2019-03-30 15:15:00,2019-03-30 15:30:00
58,7,3,4,0.0037377854255973182,2019-03-30 15:15:00,2019-03-30 15:30:00
61,6,2,4,0.005017490188533115,2019-03-30 15:15:00,2019-03-30 15:30:00
62,31,10,21,0.008028346549956182,2019-03-30 15:15:00,2019-03-30 15:30:00
64,11,2,9,0.0018966610626558232,2019-03-30 15:15:00,2019-03-30 15:30:00
66,1,0,1,0.0015383960727718914,2019-03-30 15:15:00,2019-03-30 15:30:00
67,15,4,11,0.005922988853418966,2019-03-30 15:15:00,2019-03-30 15:30:00
68,3,2,1,0.003530612239245774,2019-03-30 15:15:00,2019-03-30 15:30:00
69,12,10,2,0.011664729439349104,2019-03-30 15:15:00,2019-03-30 15:30:00
70,18,6,12,0.004456259396153081,2019-03-30 15:15:00,2019-03-30 15:30:00
71,4,2,2,0.010250551244140125,2019-03-30 15:15:00,2019-03-30 15:30:00
74,15,4,11,0.005048605680534343,2019-03-30 15:15:00,2019-03-30 15:30:00
75,15,11,4,0.013533120839558673,2019-03-30 15:15:00,2019-03-30 15:30:00
79,10,5,5,0.006119192475178363,2019-03-30 15:15:00,2019-03-30 15:30:00
80,6,3,3,0.002966700390300918,2019-03-30 15:15:00,2019-03-30 15:30:00
85,3,1,2,0.002332718240200388,2019-03-30 15:15:00,2019-03-30 15:30:00
86,15,8,7,0.011494021808325868,2019-03-30 15:15:00,2019-03-30 15:30:00
87,33,9,24,0.013955885039761603,2019-03-30 15:15:00,2019-03-30 15:30:00
88,2,0,2,0.0015383960727718914,2019-03-30 15:15:00,2019-03-30 15:30:00
89,5,3,2,0.005504148196559163,2019-03-30 15:15:00,2019-03-30 15:30:00
90,20,8,12,0.009314995832306064,2019-03-30 15:15:00,2019-03-30 15:30:00
99,9,4,5,0.0036546503630196475,2019-03-30 15:15:00,2019-03-30 15:30:00
101,10,7,3,0.0193161923119504,2019-03-30 15:15:00,2019-03-30 15:30:00
104,5,5,0,0.0036285973783908537,2019-03-30 15:15:00,2019-03-30 15:30:00
106,9,2,7,0.0020318564730985246,2019-03-30 15:15:00,2019-03-30 15:30:00
108,19,14,5,0.02189950505980128,2019-03-30 15:15:00,2019-03-30 15:30:00
109,19,6,13,0.005491298607855242,2019-03-30 15:15:00,2019-03-30 15:30:00
110,30,22,8,0.03325593024900286,2019-03-30 15:15:00,2019-03-30 15:30:00
111,9,5,4,0.004221994303846046,2019-03-30 15:15:00,2019-03-30 15:30:00
112,3,3,0,0.011853591124016676,2019-03-30 15:15:00,2019-03-30 15:30:00
113,6,4,2,0.007654675666470578,2019-03-30 15:15:00,2019-03-30 15:30:00
114,6,4,2,0.005888907077350994,2019-03-30 15:15:00,2019-03-30 15:30:00
115,9,6,3,0.00670130074719966,2019-03-30 15:15:00,2019-03-30 15:30:00
116,5,2,3,0.002188378672235438,2019-03-30 15:15:00,2019-03-30 15:30:00
118,10,5,5,0.005483974641454281,2019-03-30 15:15:00,2019-03-30 15:30:00
119,16,6,10,0.004696162683138101,2019-03-30 15:15:00,2019-03-30 15:30:00
120,4,2,2,0.0038338108281559323,2019-03-30 15:15:00,2019-03-30 15:30:00
122,6,4,2,0.004469853249970797,2019-03-30 15:15:00,2019-03-30 15:30:00
126,12,6,6,0.006099479112586738,2019-03-30 15:15:00,2019-03-30 15:30:00
127,4,4,0,0.0036462688633328304,2019-03-30 15:15:00,2019-03-30 15:30:00
129,5,3,2,0.03027383904073465,2019-03-30 15:15:00,2019-03-30 15:30:00
133,2,0,2,0.0015383960727718914,2019-03-30 15:15:00,2019-03-30 15:30:00
135,3,1,2,0.0017175285677138573,2019-03-30 15:15:00,2019-03-30 15:30:00
137,33,18,15,0.018108516089184817,2019-03-30 15:15:00,2019-03-30 15:30:00
138,41,14,27,0.010386597102605448,2019-03-30 15:15:00,2019-03-30 15:30:00
140,7,4,3,0.004453975884070559,2019-03-30 15:15:00,2019-03-30 15:30:00
141,18,11,7,0.0060925966370447854,2019-03-30 15:15:00,2019-03-30 15:30:00
147,3,1,2,0.002470776041497912,2019-03-30 15:15:00,2019-03-30 15:30:00
151,14,7,7,0.005581504147124151,2019-03-30 15:15:00,2019-03-30 15:30:00
153,21,13,8,0.007622612501754876,2019-03-30 15:15:00,2019-03-30 15:30:00
154,9,3,6,0.0022097093763319853,2019-03-30 15:15:00,2019-03-30 15:30:00
157,13,7,6,0.005934716429983229,2019-03-30 15:15:00,2019-03-30 15:30:00
158,4,2,2,0.0034850663203186464,2019-03-30 15:15:00,2019-03-30 15:30:00
159,10,3,7,0.004119175135563801,2019-03-30 15:15:00,2019-03-30 15:30:00
160,5,3,2,0.003930119677904185,2019-03-30 15:15:00,2019-03-30 15:30:00
161,9,4,5,0.004807907221292523,2019-03-30 15:15:00,2019-03-30 15:30:00
162,20,10,10,0.005793105730054345,2019-03-30 15:15:00,2019-03-30 15:30:00
164,20,9,11,0.00602282741523188,2019-03-30 15:15:00,2019-03-30 15:30:00
168,67,38,29,0.027712201554262718,2019-03-30 15:15:00,2019-03-30 15:30:00
169,49,25,24,0.020266391817746407,2019-03-30 15:15:00,2019-03-30 15:30:00
170,6,3,3,0.0024299283463843045,2019-03-30 15:15:00,2019-03-30 15:30:00
171,7,4,3,0.005415529801199083,2019-03-30 15:15:00,2019-03-30 15:30:00
172,2,2,0,0.00424831758888267,2019-03-30 15:15:00,2019-03-30 15:30:00
173,6,5,1,0.02534907711165512,2019-03-30 15:15:00,2019-03-30 15:30:00
175,6,3,3,0.010250551244140125,2019-03-30 15:15:00,2019-03-30 15:30:00
177,4,2,2,0.0030885478911774978,2019-03-30 15:15:00,2019-03-30 15:30:00
189,27,15,12,0.022357237573555185,2019-03-30 15:15:00,2019-03-30 15:30:00
190,17,5,12,0.0033524878068643964,2019-03-30 15:15:00,2019-03-30 15:30:00
191,11,7,4,0.009624027838169435,2019-03-30 15:15:00,2019-03-30 15:30:00
197,13,7,6,0.008208049634400845,2019-03-30 15:15:00,2019-03-30 15:30:00
199,5,3,2,0.008451038773465099,2019-03-30 15:15:00,2019-03-30 15:30:00
201,9,7,2,0.0149194869432974,2019-03-30 15:15:00,2019-03-30 15:30:00
202,1,1,0,0.0025019874564719633,2019-03-30 15:15:00,2019-03-30 15:30:00
203,36,20,16,0.031163709701595856,2019-03-30 15:15:00,2019-03-30 15:30:00
1,11,10,1,0.011344338142970888,2019-03-30 15:30:00,2019-03-30 15:45:00
2,11,8,3,0.016728979918053187,2019-03-30 15:30:00,2019-03-30 15:45:00
5,24,14,10,0.012681850295286614,2019-03-30 15:30:00,2019-03-30 15:45:00
10,3,2,1,0.011605404229923455,2019-03-30 15:30:00,2019-03-30 15:45:00
11,9,3,6,0.002721061782312644,2019-03-30 15:30:00,2019-03-30 15:45:00
13,2,2,0,0.002167886165687113,2019-03-30 15:30:00,2019-03-30 15:45:00
15,18,12,6,0.00784259406042871,2019-03-30 15:30:00,2019-03-30 15:45:00
16,22,9,13,0.01005236258790071,2019-03-30 15:30:00,2019-03-30 15:45:00
18,8,2,6,0.0021831550441952056,2019-03-30 15:30:00,2019-03-30 15:45:00
19,5,3,2,0.0055619942816698105,2019-03-30 15:30:00,2019-03-30 15:45:00
20,12,3,9,0.0021831550441952056,2019-03-30 15:30:00,2019-03-30 15:45:00
21,1,0,1,0.0015645786448692865,2019-03-30 15:30:00,2019-03-30 15:45:00
22,1,0,1,0.0015645786448692865,2019-03-30 15:30:00,2019-03-30 15:45:00
23,6,4,2,0.006545096415215226,2019-03-30 15:30:00,2019-03-30 15:45:00
26,21,11,10,0.014294000718534705,2019-03-30 15:30:00,2019-03-30 15:45:00
27,8,3,5,0.007913500043770661,2019-03-30 15:30:00,2019-03-30 15:45:00
28,3,2,1,0.012475766447210624,2019-03-30 15:30:00,2019-03-30 15:45:00
30,1,0,1,0.0015645786448692865,2019-03-30 15:30:00,2019-03-30 15:45:00
35,9,4,5,0.005461171950178294,2019-03-30 15:30:00,2019-03-30 15:45:00
37,4,2,2,0.010417244166607541,2019-03-30 15:30:00,2019-03-30 15:45:00
41,17,7,10,0.007647763513290672,2019-03-30 15:30:00,2019-03-30 15:45:00
46,18,10,8,0.014381887791333845,2019-03-30 15:30:00,2019-03-30 15:45:00
57,6,2,4,0.0030924932949422065,2019-03-30 15:30:00,2019-03-30 15:45:00
58,5,1,4,0.002306227388083317,2019-03-30 15:30:00,2019-03-30 15:45:00
61,3,1,2,0.0023285359699057465,2019-03-30 15:30:00,2019-03-30 15:45:00
62,34,13,21,0.012230464507125236,2019-03-30 15:30:00,2019-03-30 15:45:00
64,9,2,7,0.0020664412943675763,2019-03-30 15:30:00,2019-03-30 15:45:00
66,1,0,1,0.0015645786448692865,2019-03-30 15:30:00,2019-03-30 15:45:00
67,19,7,12,0.007791094606254885,2019-03-30 15:30:00,2019-03-30 15:45:00
68,3,2,1,0.0032815408469806994,2019-03-30 15:30:00,2019-03-30 15:45:00
69,12,10,2,0.0119283566067139,2019-03-30 15:30:00,2019-03-30 15:45:00
70,11,0,11,0.0015645786448692865,2019-03-30 15:30:00,2019-03-30 15:45:00
71,10,5,5,0.010417244166607541,2019-03-30 15:30:00,2019-03-30 15:45:00
74,6,1,5,0.0018850439908632828,2019-03-30 15:30:00,2019-03-30 15:45:00
75,13,10,3,0.009233714381032163,2019-03-30 15:30:00,2019-03-30 15:45:00
79,14,7,7,0.007911237185228197,2019-03-30 15:30:00,2019-03-30 15:45:00
80,5,3,2,0.0035955702343401395,2019-03-30 15:30:00,2019-03-30 15:45:00
85,5,3,2,0.00367302576965199,2019-03-30 15:30:00,2019-03-30 15:45:00
86,6,2,4,0.004026088842448219,2019-03-30 15:30:00,2019-03-30 15:45:00
87,25,6,19,0.009566620970195141,2019-03-30 15:30:00,2019-03-30 15:45:00
88,1,0,1,0.0015645786448692865,2019-03-30 15:30:00,2019-03-30 15:45:00
89,3,3,0,0.005423823235912461,2019-03-30 15:30:00,2019-03-30 15:45:00
90,23,10,13,0.016219458291392236,2019-03-30 15:30:00,2019-03-30 15:45:00
99,9,5,4,0.012728313099377222,2019-03-30 15:30:00,2019-03-30 15:45:00
101,10,7,3,0.014905137431983758,2019-03-30 15:30:00,2019-03-30 15:45:00
104,5,5,0,0.012295279752540012,2019-03-30 15:30:00,2019-03-30 15:45:00
106,7,1,6,0.0018228173982018138,2019-03-30 15:30:00,2019-03-30 15:45:00
108,17,10,7,0.009318390890423996,2019-03-30 15:30:00,2019-03-30 15:45:00
109,17,12,5,0.009286643554326342,2019-03-30 15:30:00,2019-03-30 15:45:00
110,34,22,12,0.030295159898963756,2019-03-30 15:30:00,2019-03-30 15:45:00
111,9,5,4,0.006483327744194599,2019-03-30 15:30:00,2019-03-30 15:45:00
112,7,4,3,0.012968380627943208,2019-03-30 15:30:00,2019-03-30 15:45:00
113,6,4,2,0.007601220526735757,2019-03-30 15:30:00,2019-03-30 15:45:00
114,7,5,2,0.00997267816919439,2019-03-30 15:30:00,2019-03-30 15:45:00
115,7,5,2,0.005266336066967657,2019-03-30 15:30:00,2019-03-30 15:45:00
116,3,2,1,0.0025547759661649874,2019-03-30 15:30:00,2019-03-30 15:45:00
118,9,4,5,0.003951766967184649,2019-03-30 15:30:00,2019-03-30 15:45:00
119,16,6,10,0.00798075389771378,2019-03-30 15:30:00,2019-03-30 15:45:00
120,4,2,2,0.0040056585972925805,2019-03-30 15:30:00,2019-03-30 15:45:00
122,8,6,2,0.008616497836327789,2019-03-30 15:30:00,2019-03-30 15:45:00
126,5,3,2,0.004443346118574949,2019-03-30 15:30:00,2019-03-30 15:45:00
127,6,2,4,0.004069230319596162,2019-03-30 15:30:00,2019-03-30 15:45:00
129,5,3,2,0.0416208043038587,2019-03-30 15:30:00,2019-03-30 15:45:00
133,2,0,2,0.0015645786448692865,2019-03-30 15:30:00,2019-03-30 15:45:00
135,3,1,2,0.0018155099696184314,2019-03-30 15:30:00,2019-03-30 15:45:00
137,32,21,11,0.022691623265278366,2019-03-30 15:30:00,2019-03-30 15:45:00
138,60,24,36,0.022708871595233642,2019-03-30 15:30:00,2019-03-30 15:45:00
140,9,2,7,0.002165341072181767,2019-03-30 15:30:00,2019-03-30 15:45:00
141,14,4,10,0.003533600697621294,2019-03-30 15:30:00,2019-03-30 15:45:00
147,3,1,2,0.0022364432884963855,2019-03-30 15:30:00,2019-03-30 15:45:00
151,17,9,8,0.01029542055153762,2019-03-30 15:30:00,2019-03-30 15:45:00
153,18,12,6,0.01622223654580418,2019-03-30 15:30:00,2019-03-30 15:45:00
154,5,2,3,0.0020664412943675763,2019-03-30 15:30:00,2019-03-30 15:45:00
157,9,4,5,0.004362315623637338,2019-03-30 15:30:00,2019-03-30 15:45:00
158,2,1,1,0.010417244166607541,2019-03-30 15:30:00,2019-03-30 15:45:00
159,7,3,4,0.004426653693704563,2019-03-30 15:30:00,2019-03-30 15:45:00
160,6,4,2,0.006656385903348465,2019-03-30 15:30:00,2019-03-30 15:45:00
161,1,0,1,0.0015645786448692865,2019-03-30 15:30:00,2019-03-30 15:45:00
162,24,10,14,0.004968006049436292,2019-03-30 15:30:00,2019-03-30 15:45:00
164,19,12,7,0.015453414626571377,2019-03-30 15:30:00,2019-03-30 15:45:00
168,79,37,42,0.03774292960686079,2019-03-30 15:30:00,2019-03-30 15:45:00
169,60,32,28,0.026651529290052583,2019-03-30 15:30:00,2019-03-30 15:45:00
170,5,2,3,0.002552269651716941,2019-03-30 15:30:00,2019-03-30 15:45:00
171,9,5,4,0.005482284331268227,2019-03-30 15:30:00,2019-03-30 15:45:00
172,2,2,0,0.007525451765915953,2019-03-30 15:30:00,2019-03-30 15:45:00
173,8,5,3,0.006305604972742896,2019-03-30 15:30:00,2019-03-30 15:45:00
175,6,3,3,0.010417244166607541,2019-03-30 15:30:00,2019-03-30 15:45:00
177,3,1,2,0.0017430936710449104,2019-03-30 15:30:00,2019-03-30 15:45:00
189,20,8,12,0.008166292814264167,2019-03-30 15:30:00,2019-03-30 15:45:00
190,13,3,10,0.0021001237233961583,2019-03-30 15:30:00,2019-03-30 15:45:00
191,11,7,4,0.009008028176748657,2019-03-30 15:30:00,2019-03-30 15:45:00
197,16,9,7,0.010375049275990037,2019-03-30 15:30:00,2019-03-30 15:45:00
199,4,2,2,0.019495130976161183,2019-03-30 15:30:00,2019-03-30 15:45:00
201,13,10,3,0.018300584270685802,2019-03-30 15:30:00,2019-03-30 15:45:00
202,1,1,0,0.002910024338323264,2019-03-30 15:30:00,2019-03-30 15:45:00
203,38,20,18,0.02677643582669364,2019-03-30 15:30:00,2019-03-30 15:45:00
1,15,15,0,0.013052168946222128,2019-03-30 15:45:00,2019-03-30 16:00:00
2,11,7,4,0.012455839181138816,2019-03-30 15:45:00,2019-03-30 16:00:00
5,22,12,10,0.009612484477134826,2019-03-30 15:45:00,2019-03-30 16:00:00
11,7,2,5,0.0027077461230636266,2019-03-30 15:45:00,2019-03-30 16:00:00
15,24,17,7,0.015302358462754663,2019-03-30 15:45:00,2019-03-30 16:00:00
16,22,11,11,0.013710789536486261,2019-03-30 15:45:00,2019-03-30 16:00:00
18,9,6,3,0.01624842235404534,2019-03-30 15:45:00,2019-03-30 16:00:00
19,7,4,3,0.007462607857623609,2019-03-30 15:45:00,2019-03-30 16:00:00
20,14,5,9,0.0033861757969782273,2019-03-30 15:45:00,2019-03-30 16:00:00
21,1,1,0,0.002192185922649778,2019-03-30 15:45:00,2019-03-30 16:00:00
23,4,2,2,0.005714449312876036,2019-03-30 15:45:00,2019-03-30 16:00:00
26,22,12,10,0.009898734011900718,2019-03-30 15:45:00,2019-03-30 16:00:00
27,9,2,7,0.0033757372001173057,2019-03-30 15:45:00,2019-03-30 16:00:00
28,2,1,1,0.011880895829911246,2019-03-30 15:45:00,2019-03-30 16:00:00
30,1,0,1,0.0017870724911575844,2019-03-30 15:45:00,2019-03-30 16:00:00
35,13,5,8,0.005207871521495662,2019-03-30 15:45:00,2019-03-30 16:00:00
37,5,3,2,0.021974719168664905,2019-03-30 15:45:00,2019-03-30 16:00:00
40,1,1,0,0.0023816840483644316,2019-03-30 15:45:00,2019-03-30 16:00:00
41,16,4,12,0.0033880466514019034,2019-03-30 15:45:00,2019-03-30 16:00:00
46,16,11,5,0.01640933230855998,2019-03-30 15:45:00,2019-03-30 16:00:00
57,5,2,3,0.0031848934740514668,2019-03-30 15:45:00,2019-03-30 16:00:00
58,6,3,3,0.0023352654114258044,2019-03-30 15:45:00,2019-03-30 16:00:00
61,1,0,1,0.0017870724911575844,2019-03-30 15:45:00,2019-03-30 16:00:00
62,22,10,12,0.011341517062556372,2019-03-30 15:45:00,2019-03-30 16:00:00
64,12,3,9,0.00328861229528046,2019-03-30 15:45:00,2019-03-30 16:00:00
66,2,1,1,0.0026865212161056914,2019-03-30 15:45:00,2019-03-30 16:00:00
67,20,9,11,0.011390703826298846,2019-03-30 15:45:00,2019-03-30 16:00:00
68,4,2,2,0.003512481317655162,2019-03-30 15:45:00,2019-03-30 16:00:00
69,8,8,0,0.008319391791717451,2019-03-30 15:45:00,2019-03-30 16:00:00
70,6,0,6,0.0017870724911575844,2019-03-30 15:45:00,2019-03-30 16:00:00
71,10,5,5,0.011880895829911246,2019-03-30 15:45:00,2019-03-30 16:00:00
74,5,0,5,0.0017870724911575844,2019-03-30 15:45:00,2019-03-30 16:00:00
75,14,11,3,0.008107023158191345,2019-03-30 15:45:00,2019-03-30 16:00:00
79,13,5,8,0.0038126396486185513,2019-03-30 15:45:00,2019-03-30 16:00:00
80,9,5,4,0.00803137926006466,2019-03-30 15:45:00,2019-03-30 16:00:00
85,3,3,0,0.0039076189931901645,2019-03-30 15:45:00,2019-03-30 16:00:00
86,2,0,2,0.0017870724911575844,2019-03-30 15:45:00,2019-03-30 16:00:00
87,18,2,16,0.005989934161066126,2019-03-30 15:45:00,2019-03-30 16:00:00
88,5,2,3,0.0060165172385793254,2019-03-30 15:45:00,2019-03-30 16:00:00
89,3,1,2,0.0034919861884276262,2019-03-30 15:45:00,2019-03-30 16:00:00
90,19,8,11,0.00512429090796199,2019-03-30 15:45:00,2019-03-30 16:00:00
99,8,3,5,0.003500267166767011,2019-03-30 15:45:00,2019-03-30 16:00:00
101,11,7,4,0.03608800676158213,2019-03-30 15:45:00,2019-03-30 16:00:00
104,5,0,5,0.0017870724911575844,2019-03-30 15:45:00,2019-03-30 16:00:00
106,6,1,5,0.0021531172903576134,2019-03-30 15:45:00,2019-03-30 16:00:00
108,8,5,3,0.008298557883235523,2019-03-30 15:45:00,2019-03-30 16:00:00
109,21,16,5,0.022185664433586716,2019-03-30 15:45:00,2019-03-30 16:00:00
110,28,18,10,0.024718865901926658,2019-03-30 15:45:00,2019-03-30 16:00:00
111,8,6,2,0.01535207816875896,2019-03-30 15:45:00,2019-03-30 16:00:00
112,5,1,4,0.0023816840483644316,2019-03-30 15:45:00,2019-03-30 16:00:00
113,11,9,2,0.008970864895528735,2019-03-30 15:45:00,2019-03-30 16:00:00
114,11,7,4,0.0071928588378981214,2019-03-30 15:45:00,2019-03-30 16:00:00
115,8,7,1,0.008491367305206757,2019-03-30 15:45:00,2019-03-30 16:00:00
116,2,0,2,0.0017870724911575844,2019-03-30 15:45:00,2019-03-30 16:00:00
118,12,4,8,0.005000630575558497,2019-03-30 15:45:00,2019-03-30 16:00:00
119,21,12,9,0.013003991285806111,2019-03-30 15:45:00,2019-03-30 16:00:00
120,2,2,0,0.005929176102497156,2019-03-30 15:45:00,2019-03-30 16:00:00
122,8,5,3,0.004708210985647145,2019-03-30 15:45:00,2019-03-30 16:00:00
126,9,4,5,0.005076046895707667,2019-03-30 15:45:00,2019-03-30 16:00:00
127,4,0,4,0.0017870724911575844,2019-03-30 15:45:00,2019-03-30 16:00:00
129,8,4,4,0.010945283719275712,2019-03-30 15:45:00,2019-03-30 16:00:00
133,2,0,2,0.0017870724911575844,2019-03-30 15:45:00,2019-03-30 16:00:00
135,7,1,6,0.0020976887900536903,2019-03-30 15:45:00,2019-03-30 16:00:00
137,25,14,11,0.02457068190134927,2019-03-30 15:45:00,2019-03-30 16:00:00
138,60,26,34,0.023780708852285136,2019-03-30 15:45:00,2019-03-30 16:00:00
140,8,1,7,0.002777958655765655,2019-03-30 15:45:00,2019-03-30 16:00:00
141,8,3,5,0.00582796027187214,2019-03-30 15:45:00,2019-03-30 16:00:00
147,2,0,2,0.0017870724911575844,2019-03-30 15:45:00,2019-03-30 16:00:00
151,22,14,8,0.023181311036406384,2019-03-30 15:45:00,2019-03-30 16:00:00
153,21,12,9,0.012478838129984552,2019-03-30 15:45:00,2019-03-30 16:00:00
154,2,2,0,0.002408305088949796,2019-03-30 15:45:00,2019-03-30 16:00:00
157,10,2,8,0.003009305590145746,2019-03-30 15:45:00,2019-03-30 16:00:00
158,3,2,1,0.015233323131623013,2019-03-30 15:45:00,2019-03-30 16:00:00
159,7,3,4,0.0032982009661575783,2019-03-30 15:45:00,2019-03-30 16:00:00
160,4,2,2,0.005130777720382764,2019-03-30 15:45:00,2019-03-30 16:00:00
161,1,0,1,0.0017870724911575844,2019-03-30 15:45:00,2019-03-30 16:00:00
162,14,6,8,0.005903039935613268,2019-03-30 15:45:00,2019-03-30 16:00:00
164,28,17,11,0.02913708861202551,2019-03-30 15:45:00,2019-03-30 16:00:00
168,67,32,35,0.0287745866570526,2019-03-30 15:45:00,2019-03-30 16:00:00
169,57,26,31,0.02659867840202798,2019-03-30 15:45:00,2019-03-30 16:00:00
170,3,1,2,0.0025165014851164375,2019-03-30 15:45:00,2019-03-30 16:00:00
171,15,8,7,0.009831713206068784,2019-03-30 15:45:00,2019-03-30 16:00:00
172,2,2,0,0.004299931038712365,2019-03-30 15:45:00,2019-03-30 16:00:00
173,11,6,5,0.005290252001431141,2019-03-30 15:45:00,2019-03-30 16:00:00
175,6,3,3,0.011880895829911246,2019-03-30 15:45:00,2019-03-30 16:00:00
177,8,2,6,0.0027753452958890895,2019-03-30 15:45:00,2019-03-30 16:00:00
189,17,2,15,0.0020155055853126884,2019-03-30 15:45:00,2019-03-30 16:00:00
190,12,6,6,0.004349776064867262,2019-03-30 15:45:00,2019-03-30 16:00:00
191,13,9,4,0.012562504761753131,2019-03-30 15:45:00,2019-03-30 16:00:00
197,18,11,7,0.01572622940293574,2019-03-30 15:45:00,2019-03-30 16:00:00
199,5,3,2,0.004164844775067946,2019-03-30 15:45:00,2019-03-30 16:00:00
201,9,9,0,0.013659722834803004,2019-03-30 15:45:00,2019-03-30 16:00:00
202,1,0,1,0.0017870724911575844,2019-03-30 15:45:00,2019-03-30 16:00:00
203,32,15,17,0.014127814813856882,2019-03-30 15:45:00,2019-03-30 16:00:00
1,21,17,4,0.014816307458720245,2019-03-30 16:00:00,2019-03-30 16:15:00
2,18,9,9,0.01165372268652459,2019-03-30 16:00:00,2019-03-30 16:15:00
5,22,9,13,0.005836505664468418,2019-03-30 16:00:00,2019-03-30 16:15:00
10,2,2,0,0.0026402492874263014,2019-03-30 16:00:00,2019-03-30 16:15:00
11,7,2,5,0.002596474804755956,2019-03-30 16:00:00,2019-03-30 16:15:00
15,29,15,14,0.012592874195394052,2019-03-30 16:00:00,2019-03-30 16:15:00
16,25,15,10,0.014599434569254392,2019-03-30 16:00:00,2019-03-30 16:15:00
18,19,11,8,0.027701675246566988,2019-03-30 16:00:00,2019-03-30 16:15:00
19,5,2,3,0.004660588160022596,2019-03-30 16:00:00,2019-03-30 16:15:00
20,18,7,11,0.004127684785782131,2019-03-30 16:00:00,2019-03-30 16:15:00
21,1,1,0,0.002102102650267591,2019-03-30 16:00:00,2019-03-30 16:15:00
23,4,2,2,0.004866685681619471,2019-03-30 16:00:00,2019-03-30 16:15:00
26,17,7,10,0.006813195278533376,2019-03-30 16:00:00,2019-03-30 16:15:00
27,23,8,15,0.0045166521102871365,2019-03-30 16:00:00,2019-03-30 16:15:00
28,2,1,1,0.011393062093251517,2019-03-30 16:00:00,2019-03-30 16:15:00
30,1,0,1,0.0017136479188881804,2019-03-30 16:00:00,2019-03-30 16:15:00
35,5,2,3,0.0026402492874263014,2019-03-30 16:00:00,2019-03-30 16:15:00
37,5,3,2,0.025486801585102827,2019-03-30 16:00:00,2019-03-30 16:15:00
40,3,3,0,0.004779153629842447,2019-03-30 16:00:00,2019-03-30 16:15:00
41,13,3,10,0.002517375536388498,2019-03-30 16:00:00,2019-03-30 16:15:00
46,21,14,7,0.016513400582219857,2019-03-30 16:00:00,2019-03-30 16:15:00
50,1,1,0,0.0024016742890460158,2019-03-30 16:00:00,2019-03-30 16:15:00
57,7,5,2,0.014035253415377046,2019-03-30 16:00:00,2019-03-30 16:15:00
58,11,5,6,0.003898723338011424,2019-03-30 16:00:00,2019-03-30 16:15:00
62,27,9,18,0.008800583912897742,2019-03-30 16:00:00,2019-03-30 16:15:00
64,10,3,7,0.002875259974806341,2019-03-30 16:00:00,2019-03-30 16:15:00
66,3,1,2,0.0025474062654325343,2019-03-30 16:00:00,2019-03-30 16:15:00
67,26,10,16,0.008720083403651994,2019-03-30 16:00:00,2019-03-30 16:15:00
68,2,2,0,0.0027065623105122874,2019-03-30 16:00:00,2019-03-30 16:15:00
69,8,8,0,0.007042820061895615,2019-03-30 16:00:00,2019-03-30 16:15:00
70,7,1,6,0.002176948603157241,2019-03-30 16:00:00,2019-03-30 16:15:00
71,10,5,5,0.011393062093251517,2019-03-30 16:00:00,2019-03-30 16:15:00
74,3,0,3,0.0017136479188881804,2019-03-30 16:00:00,2019-03-30 16:15:00
75,9,8,1,0.016976461832274813,2019-03-30 16:00:00,2019-03-30 16:15:00
79,13,5,8,0.003655921575785233,2019-03-30 16:00:00,2019-03-30 16:15:00
80,7,5,2,0.007727818180307596,2019-03-30 16:00:00,2019-03-30 16:15:00
85,4,2,2,0.005209727930776975,2019-03-30 16:00:00,2019-03-30 16:15:00
86,13,6,7,0.005134164240324606,2019-03-30 16:00:00,2019-03-30 16:15:00
87,14,2,12,0.013150684533792974,2019-03-30 16:00:00,2019-03-30 16:15:00
88,9,6,3,0.006691392929184633,2019-03-30 16:00:00,2019-03-30 16:15:00
89,3,1,2,0.0036097079669218097,2019-03-30 16:00:00,2019-03-30 16:15:00
90,20,10,10,0.008448834849398136,2019-03-30 16:00:00,2019-03-30 16:15:00
99,6,3,3,0.004336089320757773,2019-03-30 16:00:00,2019-03-30 16:15:00
101,10,4,6,0.003954758236162023,2019-03-30 16:00:00,2019-03-30 16:15:00
104,7,0,7,0.0017136479188881804,2019-03-30 16:00:00,2019-03-30 16:15:00
106,2,1,1,0.011393062093251517,2019-03-30 16:00:00,2019-03-30 16:15:00
108,8,3,5,0.004377853046314842,2019-03-30 16:00:00,2019-03-30 16:15:00
109,25,15,10,0.013271108851082066,2019-03-30 16:00:00,2019-03-30 16:15:00
110,31,24,7,0.04708574889037144,2019-03-30 16:00:00,2019-03-30 16:15:00
111,7,6,1,0.010232243556537565,2019-03-30 16:00:00,2019-03-30 16:15:00
112,5,2,3,0.0034414544977863296,2019-03-30 16:00:00,2019-03-30 16:15:00
113,14,10,4,0.01359325418564669,2019-03-30 16:00:00,2019-03-30 16:15:00
114,12,5,7,0.005665512204676541,2019-03-30 16:00:00,2019-03-30 16:15:00
115,9,9,0,0.014204420958946699,2019-03-30 16:00:00,2019-03-30 16:15:00
116,5,4,1,0.013165663151932142,2019-03-30 16:00:00,2019-03-30 16:15:00
118,5,0,5,0.0017136479188881804,2019-03-30 16:00:00,2019-03-30 16:15:00
119,20,9,11,0.009632253680071257,2019-03-30 16:00:00,2019-03-30 16:15:00
120,2,2,0,0.003560977299387787,2019-03-30 16:00:00,2019-03-30 16:15:00
122,3,1,2,0.002458041703871271,2019-03-30 16:00:00,2019-03-30 16:15:00
126,7,3,4,0.006702567342081499,2019-03-30 16:00:00,2019-03-30 16:15:00
127,8,4,4,0.0035940478771282753,2019-03-30 16:00:00,2019-03-30 16:15:00
129,9,5,4,0.009713282287912128,2019-03-30 16:00:00,2019-03-30 16:15:00
133,2,0,2,0.0017136479188881804,2019-03-30 16:00:00,2019-03-30 16:15:00
135,7,1,6,0.0020628036047127306,2019-03-30 16:00:00,2019-03-30 16:15:00
137,23,10,13,0.01933003999362467,2019-03-30 16:00:00,2019-03-30 16:15:00
138,49,20,29,0.029469872262693646,2019-03-30 16:00:00,2019-03-30 16:15:00
140,6,2,4,0.0037221323125350217,2019-03-30 16:00:00,2019-03-30 16:15:00
141,10,4,6,0.006025576388721192,2019-03-30 16:00:00,2019-03-30 16:15:00
147,4,1,3,0.0024152345817208412,2019-03-30 16:00:00,2019-03-30 16:15:00
151,19,13,6,0.031284681814340604,2019-03-30 16:00:00,2019-03-30 16:15:00
153,20,10,10,0.009893709743189505,2019-03-30 16:00:00,2019-03-30 16:15:00
154,2,2,0,0.0024119592905372804,2019-03-30 16:00:00,2019-03-30 16:15:00
156,1,1,0,0.002397986086732527,2019-03-30 16:00:00,2019-03-30 16:15:00
157,8,1,7,0.0019505007700275935,2019-03-30 16:00:00,2019-03-30 16:15:00
158,4,2,2,0.00467646426383839,2019-03-30 16:00:00,2019-03-30 16:15:00
159,7,3,4,0.003162640033968214,2019-03-30 16:00:00,2019-03-30 16:15:00
160,1,1,0,0.002176948603157241,2019-03-30 16:00:00,2019-03-30 16:15:00
161,1,0,1,0.0017136479188881804,2019-03-30 16:00:00,2019-03-30 16:15:00
162,14,7,7,0.006478822415596044,2019-03-30 16:00:00,2019-03-30 16:15:00
164,24,17,7,0.018639670681308115,2019-03-30 16:00:00,2019-03-30 16:15:00
168,59,30,29,0.023309955788785097,2019-03-30 16:00:00,2019-03-30 16:15:00
169,48,19,29,0.013769148217532966,2019-03-30 16:00:00,2019-03-30 16:15:00
170,3,2,1,0.002970971937338703,2019-03-30 16:00:00,2019-03-30 16:15:00
171,9,4,5,0.004126823050924993,2019-03-30 16:00:00,2019-03-30 16:15:00
172,2,2,0,0.0035994291709582453,2019-03-30 16:00:00,2019-03-30 16:15:00
173,8,4,4,0.0039232374974292345,2019-03-30 16:00:00,2019-03-30 16:15:00
175,6,3,3,0.011393062093251517,2019-03-30 16:00:00,2019-03-30 16:15:00
177,6,1,5,0.002942293972383557,2019-03-30 16:00:00,2019-03-30 16:15:00
189,12,2,10,0.0031058583838452147,2019-03-30 16:00:00,2019-03-30 16:15:00
190,6,4,2,0.0034136099160619795,2019-03-30 16:00:00,2019-03-30 16:15:00
191,19,13,6,0.01924924568392125,2019-03-30 16:00:00,2019-03-30 16:15:00
197,15,11,4,0.02055232665053658,2019-03-30 16:00:00,2019-03-30 16:15:00
199,6,3,3,0.0029718906147039284,2019-03-30 16:00:00,2019-03-30 16:15:00
201,8,6,2,0.010926172110981056,2019-03-30 16:00:00,2019-03-30 16:15:00
202,2,1,1,0.002504682714756196,2019-03-30 16:00:00,2019-03-30 16:15:00
203,26,12,14,0.027633112493166138,2019-03-30 16:00:00,2019-03-30 16:15:00
1,21,14,7,0.01306638487043567,2019-03-30 16:15:00,2019-03-30 16:30:00
2,19,8,11,0.00737996728785103,2019-03-30 16:15:00,2019-03-30 16:30:00
5,24,9,15,0.0045629816561519555,2019-03-30 16:15:00,2019-03-30 16:30:00
10,2,2,0,0.0021148919880794653,2019-03-30 16:15:00,2019-03-30 16:30:00
11,7,4,3,0.004928103523250984,2019-03-30 16:15:00,2019-03-30 16:30:00
15,31,11,20,0.0073950136127551,2019-03-30 16:15:00,2019-03-30 16:30:00
16,25,17,8,0.01619000589808441,2019-03-30 16:15:00,2019-03-30 16:30:00
18,22,9,13,0.0070670154703541275,2019-03-30 16:15:00,2019-03-30 16:30:00
19,6,3,3,0.005267105959472336,2019-03-30 16:15:00,2019-03-30 16:30:00
20,12,5,7,0.0035781385192999744,2019-03-30 16:15:00,2019-03-30 16:30:00
23,4,3,1,0.00448910989998671,2019-03-30 16:15:00,2019-03-30 16:30:00
26,18,7,11,0.004228003945706323,2019-03-30 16:15:00,2019-03-30 16:30:00
27,14,5,9,0.006994992020130998,2019-03-30 16:15:00,2019-03-30 16:30:00
28,5,3,2,0.004253683133545721,2019-03-30 16:15:00,2019-03-30 16:30:00
30,1,0,1,0.0016180497907932537,2019-03-30 16:15:00,2019-03-30 16:30:00
35,3,2,1,0.0021148919880794653,2019-03-30 16:15:00,2019-03-30 16:30:00
37,4,2,2,0.010783603996014537,2019-03-30 16:15:00,2019-03-30 16:30:00
40,3,3,0,0.0031726125925674387,2019-03-30 16:15:00,2019-03-30 16:30:00
41,8,2,6,0.002186408575513252,2019-03-30 16:15:00,2019-03-30 16:30:00
46,25,21,4,0.02936329454881997,2019-03-30 16:15:00,2019-03-30 16:30:00
57,10,5,5,0.006651599912466568,2019-03-30 16:15:00,2019-03-30 16:30:00
58,10,4,6,0.005435267516724696,2019-03-30 16:15:00,2019-03-30 16:30:00
62,18,5,13,0.005665080097298154,2019-03-30 16:15:00,2019-03-30 16:30:00
64,12,4,8,0.0027398337138938252,2019-03-30 16:15:00,2019-03-30 16:30:00
66,2,0,2,0.0016180497907932537,2019-03-30 16:15:00,2019-03-30 16:30:00
67,18,5,13,0.0037989800305121336,2019-03-30 16:15:00,2019-03-30 16:30:00
68,5,5,0,0.004521025312415432,2019-03-30 16:15:00,2019-03-30 16:30:00
69,9,8,1,0.005347594175966352,2019-03-30 16:15:00,2019-03-30 16:30:00
70,6,0,6,0.0016180497907932537,2019-03-30 16:15:00,2019-03-30 16:30:00
71,4,2,2,0.010783603996014537,2019-03-30 16:15:00,2019-03-30 16:30:00
74,2,0,2,0.0016180497907932537,2019-03-30 16:15:00,2019-03-30 16:30:00
75,13,8,5,0.0076433896932549955,2019-03-30 16:15:00,2019-03-30 16:30:00
79,8,3,5,0.0033022691792789693,2019-03-30 16:15:00,2019-03-30 16:30:00
80,4,2,2,0.00213525525638533,2019-03-30 16:15:00,2019-03-30 16:30:00
85,11,7,4,0.00709126868161695,2019-03-30 16:15:00,2019-03-30 16:30:00
86,12,3,9,0.002335476535050882,2019-03-30 16:15:00,2019-03-30 16:30:00
87,7,3,4,0.007250608287229554,2019-03-30 16:15:00,2019-03-30 16:30:00
88,7,6,1,0.005465928702423956,2019-03-30 16:15:00,2019-03-30 16:30:00
89,3,3,0,0.006893435337564823,2019-03-30 16:15:00,2019-03-30 16:30:00
90,21,10,11,0.013322176796515418,2019-03-30 16:15:00,2019-03-30 16:30:00
99,18,11,7,0.012488268240179599,2019-03-30 16:15:00,2019-03-30 16:30:00
101,19,8,11,0.0042380778185804584,2019-03-30 16:15:00,2019-03-30 16:30:00
104,6,0,6,0.0016180497907932537,2019-03-30 16:15:00,2019-03-30 16:30:00
108,10,3,7,0.0031818076627187376,2019-03-30 16:15:00,2019-03-30 16:30:00
109,30,17,13,0.008704746302146538,2019-03-30 16:15:00,2019-03-30 16:30:00
110,31,23,8,0.01925040578410456,2019-03-30 16:15:00,2019-03-30 16:30:00
111,7,5,2,0.006653815107677787,2019-03-30 16:15:00,2019-03-30 16:30:00
112,5,3,2,0.0028594893171359544,2019-03-30 16:15:00,2019-03-30 16:30:00
113,14,10,4,0.008067415866855204,2019-03-30 16:15:00,2019-03-30 16:30:00
114,9,1,8,0.0018104113181023195,2019-03-30 16:15:00,2019-03-30 16:30:00
115,13,11,2,0.013042009723054422,2019-03-30 16:15:00,2019-03-30 16:30:00
116,7,6,1,0.04621640763031041,2019-03-30 16:15:00,2019-03-30 16:30:00
118,6,1,5,0.003415801224849512,2019-03-30 16:15:00,2019-03-30 16:30:00
119,17,7,10,0.007832661381926707,2019-03-30 16:15:00,2019-03-30 16:30:00
120,6,6,0,0.0045021204719718115,2019-03-30 16:15:00,2019-03-30 16:30:00
122,4,1,3,0.002283948013077516,2019-03-30 16:15:00,2019-03-30 16:30:00
126,6,3,3,0.004989003633631715,2019-03-30 16:15:00,2019-03-30 16:30:00
127,17,9,8,0.00797786264491628,2019-03-30 16:15:00,2019-03-30 16:30:00
129,10,8,2,0.13876709975401214,2019-03-30 16:15:00,2019-03-30 16:30:00
133,2,0,2,0.0016180497907932537,2019-03-30 16:15:00,2019-03-30 16:30:00
135,5,1,4,0.0019091707322790754,2019-03-30 16:15:00,2019-03-30 16:30:00
137,44,23,21,0.03090189564127537,2019-03-30 16:15:00,2019-03-30 16:30:00
138,60,23,37,0.018010186343126778,2019-03-30 16:15:00,2019-03-30 16:30:00
140,7,3,4,0.005371356629534546,2019-03-30 16:15:00,2019-03-30 16:30:00
141,12,7,5,0.008841384140814628,2019-03-30 16:15:00,2019-03-30 16:30:00
147,5,1,4,0.002054682400617234,2019-03-30 16:15:00,2019-03-30 16:30:00
151,23,15,8,0.037644913694132746,2019-03-30 16:15:00,2019-03-30 16:30:00
153,19,12,7,0.00940279637617342,2019-03-30 16:15:00,2019-03-30 16:30:00
154,2,2,0,0.0022002916737648972,2019-03-30 16:15:00,2019-03-30 16:30:00
156,1,1,0,0.002054682400617234,2019-03-30 16:15:00,2019-03-30 16:30:00
157,6,1,5,0.0019494688947111801,2019-03-30 16:15:00,2019-03-30 16:30:00
158,5,3,2,0.006748843795486905,2019-03-30 16:15:00,2019-03-30 16:30:00
159,5,3,2,0.004766870352961728,2019-03-30 16:15:00,2019-03-30 16:30:00
160,1,1,0,0.0018664708894363595,2019-03-30 16:15:00,2019-03-30 16:30:00
161,2,1,1,0.010783603996014537,2019-03-30 16:15:00,2019-03-30 16:30:00
162,15,7,8,0.0044890473455167605,2019-03-30 16:15:00,2019-03-30 16:30:00
164,24,17,7,0.01217341705081955,2019-03-30 16:15:00,2019-03-30 16:30:00
168,71,31,40,0.025091077058027784,2019-03-30 16:15:00,2019-03-30 16:30:00
169,26,4,22,0.003027918024660031,2019-03-30 16:15:00,2019-03-30 16:30:00
170,1,0,1,0.0016180497907932537,2019-03-30 16:15:00,2019-03-30 16:30:00
171,8,4,4,0.004371070790172491,2019-03-30 16:15:00,2019-03-30 16:30:00
172,2,2,0,0.0034071616418217265,2019-03-30 16:15:00,2019-03-30 16:30:00
173,12,7,5,0.004821333608352471,2019-03-30 16:15:00,2019-03-30 16:30:00
175,6,3,3,0.010783603996014537,2019-03-30 16:15:00,2019-03-30 16:30:00
177,13,1,12,0.0031346392334388904,2019-03-30 16:15:00,2019-03-30 16:30:00
189,9,4,5,0.003632527514580638,2019-03-30 16:15:00,2019-03-30 16:30:00
190,5,3,2,0.004396303258119536,2019-03-30 16:15:00,2019-03-30 16:30:00
191,17,10,7,0.01348050804482908,2019-03-30 16:15:00,2019-03-30 16:30:00
195,1,1,0,0.002278761197694386,2019-03-30 16:15:00,2019-03-30 16:30:00
196,2,1,1,0.0024377720322287235,2019-03-30 16:15:00,2019-03-30 16:30:00
197,13,10,3,0.011507249667685897,2019-03-30 16:15:00,2019-03-30 16:30:00
199,5,3,2,0.0036114147862234686,2019-03-30 16:15:00,2019-03-30 16:30:00
201,10,4,6,0.0038028599512510202,2019-03-30 16:15:00,2019-03-30 16:30:00
202,1,1,0,0.002759722606814263,2019-03-30 16:15:00,2019-03-30 16:30:00
203,27,13,14,0.011174814102027976,2019-03-30 16:15:00,2019-03-30 16:30:00
1,23,12,11,0.012894320953850135,2019-03-30 16:30:00,2019-03-30 16:45:00
2,16,4,12,0.0032528390870270726,2019-03-30 16:30:00,2019-03-30 16:45:00
5,28,13,15,0.009562064615778734,2019-03-30 16:30:00,2019-03-30 16:45:00
10,2,2,0,0.0030253518808969824,2019-03-30 16:30:00,2019-03-30 16:45:00
11,6,4,2,0.017502772776007508,2019-03-30 16:30:00,2019-03-30 16:45:00
15,28,10,18,0.012910495096638799,2019-03-30 16:30:00,2019-03-30 16:45:00
16,32,16,16,0.01135022075224783,2019-03-30 16:30:00,2019-03-30 16:45:00
18,15,9,6,0.011190368978255812,2019-03-30 16:30:00,2019-03-30 16:45:00
19,6,3,3,0.004872062168662111,2019-03-30 16:30:00,2019-03-30 16:45:00
20,5,3,2,0.003928359633177309,2019-03-30 16:30:00,2019-03-30 16:45:00
21,1,0,1,0.0015475671966672432,2019-03-30 16:30:00,2019-03-30 16:45:00
23,13,8,5,0.006477155859790459,2019-03-30 16:30:00,2019-03-30 16:45:00
26,21,8,13,0.00553588027130207,2019-03-30 16:30:00,2019-03-30 16:45:00
27,8,3,5,0.005567104304833343,2019-03-30 16:30:00,2019-03-30 16:45:00
28,6,4,2,0.005554956656217612,2019-03-30 16:30:00,2019-03-30 16:45:00
30,1,0,1,0.0015475671966672432,2019-03-30 16:30:00,2019-03-30 16:45:00
35,6,3,3,0.003764244223011852,2019-03-30 16:30:00,2019-03-30 16:45:00
37,8,6,2,0.03239242436544384,2019-03-30 16:30:00,2019-03-30 16:45:00
40,3,3,0,0.0024756231103898927,2019-03-30 16:30:00,2019-03-30 16:45:00
41,8,4,4,0.003842471754553476,2019-03-30 16:30:00,2019-03-30 16:45:00
46,25,22,3,0.07828649697243129,2019-03-30 16:30:00,2019-03-30 16:45:00
50,2,2,0,0.0029936331557623404,2019-03-30 16:30:00,2019-03-30 16:45:00
57,5,0,5,0.0015475671966672432,2019-03-30 16:30:00,2019-03-30 16:45:00
58,3,1,2,0.0021536993314664517,2019-03-30 16:30:00,2019-03-30 16:45:00
61,4,3,1,0.02353381224023311,2019-03-30 16:30:00,2019-03-30 16:45:00
62,21,8,13,0.007158692129968534,2019-03-30 16:30:00,2019-03-30 16:45:00
64,12,4,8,0.0033564099522512283,2019-03-30 16:30:00,2019-03-30 16:45:00
66,1,0,1,0.0015475671966672432,2019-03-30 16:30:00,2019-03-30 16:45:00
67,19,7,12,0.010429689264830053,2019-03-30 16:30:00,2019-03-30 16:45:00
68,5,5,0,0.004653414189919154,2019-03-30 16:30:00,2019-03-30 16:45:00
69,11,9,2,0.008332280191306921,2019-03-30 16:30:00,2019-03-30 16:45:00
70,5,3,2,0.003932442813506387,2019-03-30 16:30:00,2019-03-30 16:45:00
71,4,2,2,0.010312828828480341,2019-03-30 16:30:00,2019-03-30 16:45:00
74,4,2,2,0.002374087987012446,2019-03-30 16:30:00,2019-03-30 16:45:00
75,16,8,8,0.007337026074010649,2019-03-30 16:30:00,2019-03-30 16:45:00
79,8,3,5,0.0031583862434634404,2019-03-30 16:30:00,2019-03-30 16:45:00
80,5,2,3,0.0026314779529172,2019-03-30 16:30:00,2019-03-30 16:45:00
85,9,5,4,0.0059133864620977625,2019-03-30 16:30:00,2019-03-30 16:45:00
86,12,2,10,0.002201931147994891,2019-03-30 16:30:00,2019-03-30 16:45:00
87,14,8,6,0.012222479086885143,2019-03-30 16:30:00,2019-03-30 16:45:00
88,8,6,2,0.005728325986353953,2019-03-30 16:30:00,2019-03-30 16:45:00
89,3,2,1,0.005652190718104958,2019-03-30 16:30:00,2019-03-30 16:45:00
90,14,5,9,0.012554847576193595,2019-03-30 16:30:00,2019-03-30 16:45:00
99,15,9,6,0.015567966933131637,2019-03-30 16:30:00,2019-03-30 16:45:00
101,14,5,9,0.0029322981661648265,2019-03-30 16:30:00,2019-03-30 16:45:00
104,5,1,4,0.0026647939613219174,2019-03-30 16:30:00,2019-03-30 16:45:00
106,3,2,1,0.014009473238545095,2019-03-30 16:30:00,2019-03-30 16:45:00
108,15,4,11,0.00534729107749982,2019-03-30 16:30:00,2019-03-30 16:45:00
109,35,17,18,0.014676516765551486,2019-03-30 16:30:00,2019-03-30 16:45:00
110,32,20,12,0.017106157100601788,2019-03-30 16:30:00,2019-03-30 16:45:00
111,14,7,7,0.009198659953430749,2019-03-30 16:30:00,2019-03-30 16:45:00
112,8,6,2,0.007239150440676183,2019-03-30 16:30:00,2019-03-30 16:45:00
113,9,3,6,0.002433898801172551,2019-03-30 16:30:00,2019-03-30 16:45:00
114,4,2,2,0.0037405571503539336,2019-03-30 16:30:00,2019-03-30 16:45:00
115,12,6,6,0.006611779749056298,2019-03-30 16:30:00,2019-03-30 16:45:00
116,8,6,2,0.010003370483552616,2019-03-30 16:30:00,2019-03-30 16:45:00
118,5,1,4,0.002614239553778771,2019-03-30 16:30:00,2019-03-30 16:45:00
119,19,9,10,0.008717976062128948,2019-03-30 16:30:00,2019-03-30 16:45:00
120,6,6,0,0.004677807835864615,2019-03-30 16:30:00,2019-03-30 16:45:00
122,2,0,2,0.0015475671966672432,2019-03-30 16:30:00,2019-03-30 16:45:00
126,4,2,2,0.003505824767465797,2019-03-30 16:30:00,2019-03-30 16:45:00
127,10,4,6,0.0038683364532294427,2019-03-30 16:30:00,2019-03-30 16:45:00
129,12,9,3,0.010235909787432735,2019-03-30 16:30:00,2019-03-30 16:45:00
133,2,0,2,0.0015475671966672432,2019-03-30 16:30:00,2019-03-30 16:45:00
135,5,1,4,0.0019042173344902818,2019-03-30 16:30:00,2019-03-30 16:45:00
137,26,18,8,0.021878957331957917,2019-03-30 16:30:00,2019-03-30 16:45:00
138,53,22,31,0.017035846818029197,2019-03-30 16:30:00,2019-03-30 16:45:00
140,6,3,3,0.008523084143638233,2019-03-30 16:30:00,2019-03-30 16:45:00
141,10,5,5,0.006139345669215115,2019-03-30 16:30:00,2019-03-30 16:45:00
147,3,1,2,0.004624751337850212,2019-03-30 16:30:00,2019-03-30 16:45:00
151,23,16,7,0.04206620789935359,2019-03-30 16:30:00,2019-03-30 16:45:00
153,19,13,6,0.010226815995170464,2019-03-30 16:30:00,2019-03-30 16:45:00
154,3,3,0,0.0033621052425311126,2019-03-30 16:30:00,2019-03-30 16:45:00
157,7,2,5,0.002594865986326018,2019-03-30 16:30:00,2019-03-30 16:45:00
158,4,3,1,0.01381893348120558,2019-03-30 16:30:00,2019-03-30 16:45:00
159,4,3,1,0.017467271413497243,2019-03-30 16:30:00,2019-03-30 16:45:00
160,1,1,0,0.002286459538782113,2019-03-30 16:30:00,2019-03-30 16:45:00
161,6,3,3,0.010312828828480341,2019-03-30 16:30:00,2019-03-30 16:45:00
162,20,10,10,0.012215994700526563,2019-03-30 16:30:00,2019-03-30 16:45:00
164,26,18,8,0.018918207521592158,2019-03-30 16:30:00,2019-03-30 16:45:00
168,71,32,39,0.027805044940312752,2019-03-30 16:30:00,2019-03-30 16:45:00
169,25,6,19,0.0045107018934750515,2019-03-30 16:30:00,2019-03-30 16:45:00
170,2,0,2,0.0015475671966672432,2019-03-30 16:30:00,2019-03-30 16:45:00
171,11,5,6,0.006888360517808561,2019-03-30 16:30:00,2019-03-30 16:45:00
172,2,2,0,0.0036543856813751868,2019-03-30 16:30:00,2019-03-30 16:45:00
173,10,4,6,0.005024054655166152,2019-03-30 16:30:00,2019-03-30 16:45:00
175,6,3,3,0.010312828828480341,2019-03-30 16:30:00,2019-03-30 16:45:00
177,14,1,13,0.002586183774553646,2019-03-30 16:30:00,2019-03-30 16:45:00
189,9,3,6,0.002891627765362583,2019-03-30 16:30:00,2019-03-30 16:45:00
190,7,3,4,0.0034613251921418453,2019-03-30 16:30:00,2019-03-30 16:45:00
191,16,10,6,0.014292362142685575,2019-03-30 16:30:00,2019-03-30 16:45:00
195,1,1,0,0.002494090915729417,2019-03-30 16:30:00,2019-03-30 16:45:00
196,1,0,1,0.0015475671966672432,2019-03-30 16:30:00,2019-03-30 16:45:00
197,7,5,2,0.006072142349163066,2019-03-30 16:30:00,2019-03-30 16:45:00
199,8,5,3,0.009855855310581028,2019-03-30 16:30:00,2019-03-30 16:45:00
201,6,0,6,0.0015475671966672432,2019-03-30 16:30:00,2019-03-30 16:45:00
203,18,10,8,0.00954151770621656,2019-03-30 16:30:00,2019-03-30 16:45:00
1,15,6,9,0.005100396485718781,2019-03-30 16:45:00,2019-03-30 17:00:00
2,19,7,12,0.00906144097318873,2019-03-30 16:45:00,2019-03-30 17:00:00
5,28,14,14,0.01478760031397782,2019-03-30 16:45:00,2019-03-30 17:00:00
10,8,5,3,0.01858856025338863,2019-03-30 16:45:00,2019-03-30 17:00:00
11,6,4,2,0.02219657088902799,2019-03-30 16:45:00,2019-03-30 17:00:00
13,1,1,0,0.0019379895498952758,2019-03-30 16:45:00,2019-03-30 17:00:00
15,24,5,19,0.011406387992322511,2019-03-30 16:45:00,2019-03-30 17:00:00
16,25,13,12,0.01622662806735646,2019-03-30 16:45:00,2019-03-30 17:00:00
18,16,11,5,0.02447130836810539,2019-03-30 16:45:00,2019-03-30 17:00:00
19,4,1,3,0.002552903367854041,2019-03-30 16:45:00,2019-03-30 17:00:00
20,9,5,4,0.01367827785986047,2019-03-30 16:45:00,2019-03-30 17:00:00
21,3,0,3,0.0015524409288934643,2019-03-30 16:45:00,2019-03-30 17:00:00
22,1,0,1,0.0015524409288934643,2019-03-30 16:45:00,2019-03-30 17:00:00
23,14,7,7,0.0068740430306074496,2019-03-30 16:45:00,2019-03-30 17:00:00
26,21,9,12,0.012386797991397643,2019-03-30 16:45:00,2019-03-30 17:00:00
27,7,2,5,0.0026953203927732273,2019-03-30 16:45:00,2019-03-30 17:00:00
28,5,3,2,0.004787825003498013,2019-03-30 16:45:00,2019-03-30 17:00:00
30,1,0,1,0.0015524409288934643,2019-03-30 16:45:00,2019-03-30 17:00:00
35,4,2,2,0.00280655497684256,2019-03-30 16:45:00,2019-03-30 17:00:00
37,8,5,3,0.004291333941319923,2019-03-30 16:45:00,2019-03-30 17:00:00
40,3,3,0,0.0035083809748266653,2019-03-30 16:45:00,2019-03-30 17:00:00
41,7,4,3,0.005199044421449577,2019-03-30 16:45:00,2019-03-30 17:00:00
46,32,24,8,0.025470989133272268,2019-03-30 16:45:00,2019-03-30 17:00:00
50,3,3,0,0.0037175888190469778,2019-03-30 16:45:00,2019-03-30 17:00:00
57,5,0,5,0.0015524409288934643,2019-03-30 16:45:00,2019-03-30 17:00:00
58,5,5,0,0.004813668250558954,2019-03-30 16:45:00,2019-03-30 17:00:00
61,3,1,2,0.0026999389935886023,2019-03-30 16:45:00,2019-03-30 17:00:00
62,14,5,9,0.006751638377196616,2019-03-30 16:45:00,2019-03-30 17:00:00
64,10,4,6,0.0037906334241333806,2019-03-30 16:45:00,2019-03-30 17:00:00
66,3,2,1,0.0025731228660254143,2019-03-30 16:45:00,2019-03-30 17:00:00
67,24,9,15,0.011064102741696726,2019-03-30 16:45:00,2019-03-30 17:00:00
68,11,7,4,0.009011934812832294,2019-03-30 16:45:00,2019-03-30 17:00:00
69,13,12,1,0.00957118574240343,2019-03-30 16:45:00,2019-03-30 17:00:00
70,8,5,3,0.004546692852572463,2019-03-30 16:45:00,2019-03-30 17:00:00
71,4,2,2,0.010335864903013046,2019-03-30 16:45:00,2019-03-30 17:00:00
74,4,0,4,0.0015524409288934643,2019-03-30 16:45:00,2019-03-30 17:00:00
75,18,7,11,0.008269575752052942,2019-03-30 16:45:00,2019-03-30 17:00:00
79,9,3,6,0.0026999389935886023,2019-03-30 16:45:00,2019-03-30 17:00:00
80,5,2,3,0.003348277707164965,2019-03-30 16:45:00,2019-03-30 17:00:00
85,10,5,5,0.005057406874926981,2019-03-30 16:45:00,2019-03-30 17:00:00
86,9,2,7,0.0025319918995149356,2019-03-30 16:45:00,2019-03-30 17:00:00
87,15,6,9,0.010204057856784887,2019-03-30 16:45:00,2019-03-30 17:00:00
88,9,7,2,0.0058006729389615385,2019-03-30 16:45:00,2019-03-30 17:00:00
89,10,7,3,0.02907033651347805,2019-03-30 16:45:00,2019-03-30 17:00:00
90,13,6,7,0.014490497093906604,2019-03-30 16:45:00,2019-03-30 17:00:00
99,13,9,4,0.011556495653791472,2019-03-30 16:45:00,2019-03-30 17:00:00
101,10,3,7,0.0024420701458017845,2019-03-30 16:45:00,2019-03-30 17:00:00
104,8,6,2,0.0057860959496329354,2019-03-30 16:45:00,2019-03-30 17:00:00
106,3,2,1,0.012531720896542945,2019-03-30 16:45:00,2019-03-30 17:00:00
108,18,5,13,0.005007809039342399,2019-03-30 16:45:00,2019-03-30 17:00:00
109,27,13,14,0.016475217524301533,2019-03-30 16:45:00,2019-03-30 17:00:00
110,26,19,7,0.01550883992156948,2019-03-30 16:45:00,2019-03-30 17:00:00
111,9,3,6,0.0031862818169410556,2019-03-30 16:45:00,2019-03-30 17:00:00
112,10,6,4,0.010112185921267098,2019-03-30 16:45:00,2019-03-30 17:00:00
113,4,0,4,0.0015524409288934643,2019-03-30 16:45:00,2019-03-30 17:00:00
114,2,0,2,0.0015524409288934643,2019-03-30 16:45:00,2019-03-30 17:00:00
115,9,6,3,0.009386461097812784,2019-03-30 16:45:00,2019-03-30 17:00:00
116,10,7,3,0.005631201944883367,2019-03-30 16:45:00,2019-03-30 17:00:00
118,4,0,4,0.0015524409288934643,2019-03-30 16:45:00,2019-03-30 17:00:00
119,15,9,6,0.010930543028526859,2019-03-30 16:45:00,2019-03-30 17:00:00
120,9,6,3,0.007461676941225878,2019-03-30 16:45:00,2019-03-30 17:00:00
122,3,1,2,0.0026999389935886023,2019-03-30 16:45:00,2019-03-30 17:00:00
126,18,10,8,0.01574545409824328,2019-03-30 16:45:00,2019-03-30 17:00:00
127,9,1,8,0.002003865872467502,2019-03-30 16:45:00,2019-03-30 17:00:00
129,13,9,4,0.016723893613250513,2019-03-30 16:45:00,2019-03-30 17:00:00
135,5,1,4,0.0020894860859819206,2019-03-30 16:45:00,2019-03-30 17:00:00
137,31,15,16,0.013212676020632835,2019-03-30 16:45:00,2019-03-30 17:00:00
138,62,29,33,0.026088676706565013,2019-03-30 16:45:00,2019-03-30 17:00:00
140,8,4,4,0.004808105598595485,2019-03-30 16:45:00,2019-03-30 17:00:00
141,11,9,2,0.011917129662881323,2019-03-30 16:45:00,2019-03-30 17:00:00
147,3,1,2,0.003701581499845385,2019-03-30 16:45:00,2019-03-30 17:00:00
151,24,16,8,0.03812185011594803,2019-03-30 16:45:00,2019-03-30 17:00:00
153,23,10,13,0.008006263859262312,2019-03-30 16:45:00,2019-03-30 17:00:00
154,4,4,0,0.003673621771768936,2019-03-30 16:45:00,2019-03-30 17:00:00
156,1,1,0,0.0028720394866020944,2019-03-30 16:45:00,2019-03-30 17:00:00
157,8,2,6,0.002554099692361449,2019-03-30 16:45:00,2019-03-30 17:00:00
158,4,3,1,0.013849234492660881,2019-03-30 16:45:00,2019-03-30 17:00:00
159,5,4,1,0.018354290167335877,2019-03-30 16:45:00,2019-03-30 17:00:00
160,1,1,0,0.002179497952868012,2019-03-30 16:45:00,2019-03-30 17:00:00
161,6,3,3,0.010335864903013046,2019-03-30 16:45:00,2019-03-30 17:00:00
162,19,10,9,0.016241725110797883,2019-03-30 16:45:00,2019-03-30 17:00:00
164,24,17,7,0.01415843449578557,2019-03-30 16:45:00,2019-03-30 17:00:00
168,80,33,47,0.035370249555103365,2019-03-30 16:45:00,2019-03-30 17:00:00
169,23,4,19,0.004240740832523779,2019-03-30 16:45:00,2019-03-30 17:00:00
170,1,1,0,0.0022544750011218974,2019-03-30 16:45:00,2019-03-30 17:00:00
171,7,3,4,0.005574172095014141,2019-03-30 16:45:00,2019-03-30 17:00:00
172,6,6,0,0.006867518476948733,2019-03-30 16:45:00,2019-03-30 17:00:00
173,9,4,5,0.0040271946475351214,2019-03-30 16:45:00,2019-03-30 17:00:00
175,6,3,3,0.010335864903013046,2019-03-30 16:45:00,2019-03-30 17:00:00
177,7,1,6,0.003086587446542376,2019-03-30 16:45:00,2019-03-30 17:00:00
189,7,3,4,0.0036783015011977154,2019-03-30 16:45:00,2019-03-30 17:00:00
190,7,2,5,0.002267889189322433,2019-03-30 16:45:00,2019-03-30 17:00:00
191,15,10,5,0.010263195316978606,2019-03-30 16:45:00,2019-03-30 17:00:00
196,1,0,1,0.0015524409288934643,2019-03-30 16:45:00,2019-03-30 17:00:00
197,16,10,6,0.009052202062408816,2019-03-30 16:45:00,2019-03-30 17:00:00
199,6,3,3,0.005105344335940114,2019-03-30 16:45:00,2019-03-30 17:00:00
201,11,3,8,0.008246763374994075,2019-03-30 16:45:00,2019-03-30 17:00:00
203,11,7,4,0.005814542027487387,2019-03-30 16:45:00,2019-03-30 17:00:00
1,17,6,11,0.006453428301086616,2019-03-30 17:00:00,2019-03-30 17:15:00
2,18,8,10,0.01112176786708114,2019-03-30 17:00:00,2019-03-30 17:15:00
5,25,14,11,0.017300147429019447,2019-03-30 17:00:00,2019-03-30 17:15:00
10,9,5,4,0.007705704912144694,2019-03-30 17:00:00,2019-03-30 17:15:00
11,4,2,2,0.011211939516873496,2019-03-30 17:00:00,2019-03-30 17:15:00
13,1,1,0,0.0030703539810368816,2019-03-30 17:00:00,2019-03-30 17:15:00
15,15,2,13,0.0037767204774850228,2019-03-30 17:00:00,2019-03-30 17:15:00
16,26,15,11,0.0171954341918767,2019-03-30 17:00:00,2019-03-30 17:15:00
18,16,8,8,0.004892099957978591,2019-03-30 17:00:00,2019-03-30 17:15:00
19,3,2,1,0.014828333635154217,2019-03-30 17:00:00,2019-03-30 17:15:00
20,8,3,5,0.00449549857331414,2019-03-30 17:00:00,2019-03-30 17:15:00
21,4,0,4,0.001684404054854037,2019-03-30 17:00:00,2019-03-30 17:15:00
23,11,5,6,0.006891373458010892,2019-03-30 17:00:00,2019-03-30 17:15:00
26,23,11,12,0.00927244187286541,2019-03-30 17:00:00,2019-03-30 17:15:00
27,7,1,6,0.001962423643827856,2019-03-30 17:00:00,2019-03-30 17:15:00
28,9,3,6,0.0031649866972049156,2019-03-30 17:00:00,2019-03-30 17:15:00
30,1,0,1,0.001684404054854037,2019-03-30 17:00:00,2019-03-30 17:15:00
35,7,4,3,0.004968072278956018,2019-03-30 17:00:00,2019-03-30 17:15:00
37,7,2,5,0.0027811656473009736,2019-03-30 17:00:00,2019-03-30 17:15:00
40,4,4,0,0.006314862802263249,2019-03-30 17:00:00,2019-03-30 17:15:00
41,9,7,2,0.00787032490977504,2019-03-30 17:00:00,2019-03-30 17:15:00
46,36,21,15,0.01805675389156526,2019-03-30 17:00:00,2019-03-30 17:15:00
50,4,3,1,0.003915532599066018,2019-03-30 17:00:00,2019-03-30 17:15:00
57,8,5,3,0.0034521572242942823,2019-03-30 17:00:00,2019-03-30 17:15:00
58,8,8,0,0.009480295462364001,2019-03-30 17:00:00,2019-03-30 17:15:00
62,13,5,8,0.0060879249127704805,2019-03-30 17:00:00,2019-03-30 17:15:00
64,10,4,6,0.004131119931836021,2019-03-30 17:00:00,2019-03-30 17:15:00
66,3,2,1,0.002178331948500256,2019-03-30 17:00:00,2019-03-30 17:15:00
67,19,7,12,0.009751880317499944,2019-03-30 17:00:00,2019-03-30 17:15:00
68,9,4,5,0.01075540633337437,2019-03-30 17:00:00,2019-03-30 17:15:00
69,13,11,2,0.007169978654729122,2019-03-30 17:00:00,2019-03-30 17:15:00
70,10,4,6,0.00671200203958259,2019-03-30 17:00:00,2019-03-30 17:15:00
71,8,4,4,0.011211939516873496,2019-03-30 17:00:00,2019-03-30 17:15:00
74,6,2,4,0.009716176918984059,2019-03-30 17:00:00,2019-03-30 17:15:00
75,14,6,8,0.004148018189113262,2019-03-30 17:00:00,2019-03-30 17:15:00
79,5,1,4,0.00213894609257551,2019-03-30 17:00:00,2019-03-30 17:15:00
80,3,2,1,0.004358390960432147,2019-03-30 17:00:00,2019-03-30 17:15:00
85,10,4,6,0.003870630265933141,2019-03-30 17:00:00,2019-03-30 17:15:00
86,9,3,6,0.0031678881869721433,2019-03-30 17:00:00,2019-03-30 17:15:00
87,11,4,7,0.004859511558273429,2019-03-30 17:00:00,2019-03-30 17:15:00
88,9,4,5,0.002941909242021016,2019-03-30 17:00:00,2019-03-30 17:15:00
89,6,2,4,0.003731167193801028,2019-03-30 17:00:00,2019-03-30 17:15:00
90,14,8,6,0.015479626097094808,2019-03-30 17:00:00,2019-03-30 17:15:00
99,14,10,4,0.01889568389212856,2019-03-30 17:00:00,2019-03-30 17:15:00
101,8,2,6,0.002350364814038156,2019-03-30 17:00:00,2019-03-30 17:15:00
104,10,7,3,0.007395643703108237,2019-03-30 17:00:00,2019-03-30 17:15:00
106,2,1,1,0.011211939516873496,2019-03-30 17:00:00,2019-03-30 17:15:00
108,12,3,9,0.002350364814038156,2019-03-30 17:00:00,2019-03-30 17:15:00
109,26,11,15,0.009507652840622544,2019-03-30 17:00:00,2019-03-30 17:15:00
110,26,19,7,0.012404694201182004,2019-03-30 17:00:00,2019-03-30 17:15:00
111,9,5,4,0.006788847887450317,2019-03-30 17:00:00,2019-03-30 17:15:00
112,12,8,4,0.006802230950817598,2019-03-30 17:00:00,2019-03-30 17:15:00
113,2,0,2,0.001684404054854037,2019-03-30 17:00:00,2019-03-30 17:15:00
114,1,1,0,0.002270253040771153,2019-03-30 17:00:00,2019-03-30 17:15:00
115,11,8,3,0.010891328759870153,2019-03-30 17:00:00,2019-03-30 17:15:00
116,8,6,2,0.008296804665905815,2019-03-30 17:00:00,2019-03-30 17:15:00
118,2,1,1,0.0026353900506764383,2019-03-30 17:00:00,2019-03-30 17:15:00
119,14,10,4,0.01321968306116982,2019-03-30 17:00:00,2019-03-30 17:15:00
120,9,6,3,0.011924596926353597,2019-03-30 17:00:00,2019-03-30 17:15:00
122,2,0,2,0.001684404054854037,2019-03-30 17:00:00,2019-03-30 17:15:00
126,17,9,8,0.005135314830077283,2019-03-30 17:00:00,2019-03-30 17:15:00
127,1,1,0,0.003127209978578761,2019-03-30 17:00:00,2019-03-30 17:15:00
129,15,10,5,0.024773448428768687,2019-03-30 17:00:00,2019-03-30 17:15:00
135,7,3,4,0.0038531374976399917,2019-03-30 17:00:00,2019-03-30 17:15:00
137,36,21,15,0.021032726607000597,2019-03-30 17:00:00,2019-03-30 17:15:00
138,49,22,27,0.0186066771883899,2019-03-30 17:00:00,2019-03-30 17:15:00
140,7,4,3,0.006589444930844833,2019-03-30 17:00:00,2019-03-30 17:15:00
141,16,10,6,0.009393385449609413,2019-03-30 17:00:00,2019-03-30 17:15:00
147,5,1,4,0.0026353900506764383,2019-03-30 17:00:00,2019-03-30 17:15:00
151,24,14,10,0.03293413278588165,2019-03-30 17:00:00,2019-03-30 17:15:00
153,14,1,13,0.00213894609257551,2019-03-30 17:00:00,2019-03-30 17:15:00
154,3,2,1,0.002854982562022966,2019-03-30 17:00:00,2019-03-30 17:15:00
157,7,1,6,0.001962423643827856,2019-03-30 17:00:00,2019-03-30 17:15:00
158,4,3,1,0.0242137016372206,2019-03-30 17:00:00,2019-03-30 17:15:00
159,8,7,1,0.03673315534187163,2019-03-30 17:00:00,2019-03-30 17:15:00
160,2,2,0,0.005422774900956092,2019-03-30 17:00:00,2019-03-30 17:15:00
161,6,3,3,0.011211939516873496,2019-03-30 17:00:00,2019-03-30 17:15:00
162,21,11,10,0.022637911067151323,2019-03-30 17:00:00,2019-03-30 17:15:00
164,16,11,5,0.012666567178656241,2019-03-30 17:00:00,2019-03-30 17:15:00
168,87,33,54,0.02512366151349786,2019-03-30 17:00:00,2019-03-30 17:15:00
169,29,2,27,0.002856102026688269,2019-03-30 17:00:00,2019-03-30 17:15:00
170,3,3,0,0.005091857141188904,2019-03-30 17:00:00,2019-03-30 17:15:00
171,5,3,2,0.009470698656662422,2019-03-30 17:00:00,2019-03-30 17:15:00
172,3,3,0,0.006853240675293252,2019-03-30 17:00:00,2019-03-30 17:15:00
173,12,6,6,0.00839554542680721,2019-03-30 17:00:00,2019-03-30 17:15:00
175,2,1,1,0.011211939516873496,2019-03-30 17:00:00,2019-03-30 17:15:00
177,23,10,13,0.008925176736975972,2019-03-30 17:00:00,2019-03-30 17:15:00
189,9,5,4,0.006654438272558625,2019-03-30 17:00:00,2019-03-30 17:15:00
190,7,3,4,0.006521285326483507,2019-03-30 17:00:00,2019-03-30 17:15:00
191,17,12,5,0.009902709027948315,2019-03-30 17:00:00,2019-03-30 17:15:00
195,4,3,1,0.005699688442397715,2019-03-30 17:00:00,2019-03-30 17:15:00
197,18,12,6,0.00962858538387308,2019-03-30 17:00:00,2019-03-30 17:15:00
199,1,1,0,0.002341282009650899,2019-03-30 17:00:00,2019-03-30 17:15:00
201,15,6,9,0.011384100650433352,2019-03-30 17:00:00,2019-03-30 17:15:00
202,1,1,0,0.002184567194349044,2019-03-30 17:00:00,2019-03-30 17:15:00
203,12,8,4,0.009956047295270989,2019-03-30 17:00:00,2019-03-30 17:15:00
1,16,9,7,0.008621942097574265,2019-03-30 17:15:00,2019-03-30 17:30:00
2,26,15,11,0.02096324097061932,2019-03-30 17:15:00,2019-03-30 17:30:00
5,17,7,10,0.006944657074036034,2019-03-30 17:15:00,2019-03-30 17:30:00
10,9,5,4,0.008841568142955185,2019-03-30 17:15:00,2019-03-30 17:30:00
11,3,2,1,0.02983866741935845,2019-03-30 17:15:00,2019-03-30 17:30:00
13,1,1,0,0.002750436418845006,2019-03-30 17:15:00,2019-03-30 17:30:00
15,24,10,14,0.020081184591767783,2019-03-30 17:15:00,2019-03-30 17:30:00
16,39,18,21,0.015056168591903384,2019-03-30 17:15:00,2019-03-30 17:30:00
18,17,12,5,0.015777464851798956,2019-03-30 17:15:00,2019-03-30 17:30:00
19,5,4,1,0.0032870432914965564,2019-03-30 17:15:00,2019-03-30 17:30:00
20,7,2,5,0.002938843747856206,2019-03-30 17:15:00,2019-03-30 17:30:00
23,11,5,6,0.004916242695125672,2019-03-30 17:15:00,2019-03-30 17:30:00
26,18,9,9,0.009886231754534394,2019-03-30 17:15:00,2019-03-30 17:30:00
27,6,1,5,0.0019239868776493691,2019-03-30 17:15:00,2019-03-30 17:30:00
28,6,1,5,0.0025307126258327234,2019-03-30 17:15:00,2019-03-30 17:30:00
30,1,0,1,0.001596900795883985,2019-03-30 17:15:00,2019-03-30 17:30:00
35,7,4,3,0.004710754209668917,2019-03-30 17:15:00,2019-03-30 17:30:00
37,4,2,2,0.002804839769989029,2019-03-30 17:15:00,2019-03-30 17:30:00
40,4,4,0,0.006842778383726895,2019-03-30 17:15:00,2019-03-30 17:30:00
41,19,11,8,0.015646926899704223,2019-03-30 17:15:00,2019-03-30 17:30:00
46,26,11,15,0.010225314418956737,2019-03-30 17:15:00,2019-03-30 17:30:00
50,4,3,1,0.0036116750463939273,2019-03-30 17:15:00,2019-03-30 17:30:00
57,12,9,3,0.006028140702070421,2019-03-30 17:15:00,2019-03-30 17:30:00
58,10,7,3,0.005617483010937155,2019-03-30 17:15:00,2019-03-30 17:30:00
62,15,5,10,0.010815639634623071,2019-03-30 17:15:00,2019-03-30 17:30:00
64,9,3,6,0.0027772777095582636,2019-03-30 17:15:00,2019-03-30 17:30:00
66,4,3,1,0.0056558461641158745,2019-03-30 17:15:00,2019-03-30 17:30:00
67,17,6,11,0.009598297736933986,2019-03-30 17:15:00,2019-03-30 17:30:00
68,5,3,2,0.01101253016645854,2019-03-30 17:15:00,2019-03-30 17:30:00
69,18,10,8,0.014645602943184717,2019-03-30 17:15:00,2019-03-30 17:30:00
70,7,2,5,0.006502004428510734,2019-03-30 17:15:00,2019-03-30 17:30:00
71,4,2,2,0.010634661787230538,2019-03-30 17:15:00,2019-03-30 17:30:00
74,8,4,4,0.007170634797036744,2019-03-30 17:15:00,2019-03-30 17:30:00
75,14,4,10,0.002697327870292951,2019-03-30 17:15:00,2019-03-30 17:30:00
79,5,1,4,0.0020278246375828907,2019-03-30 17:15:00,2019-03-30 17:30:00
80,3,2,1,0.0027775963858645064,2019-03-30 17:15:00,2019-03-30 17:30:00
85,12,4,8,0.005683772748945095,2019-03-30 17:15:00,2019-03-30 17:30:00
86,8,3,5,0.0032590864039854965,2019-03-30 17:15:00,2019-03-30 17:30:00
87,7,4,3,0.0034690217439728634,2019-03-30 17:15:00,2019-03-30 17:30:00
88,10,2,8,0.0023303237606888878,2019-03-30 17:15:00,2019-03-30 17:30:00
89,7,2,5,0.002755935129043172,2019-03-30 17:15:00,2019-03-30 17:30:00
90,14,6,8,0.0064369030160952145,2019-03-30 17:15:00,2019-03-30 17:30:00
99,16,8,8,0.011884966526557968,2019-03-30 17:15:00,2019-03-30 17:30:00
101,7,3,4,0.004401501206711577,2019-03-30 17:15:00,2019-03-30 17:30:00
104,16,9,7,0.010155585449213737,2019-03-30 17:15:00,2019-03-30 17:30:00
106,3,1,2,0.0027772777095582636,2019-03-30 17:15:00,2019-03-30 17:30:00
108,11,3,8,0.002344104103622874,2019-03-30 17:15:00,2019-03-30 17:30:00
109,23,11,12,0.005176677180007855,2019-03-30 17:15:00,2019-03-30 17:30:00
110,27,19,8,0.01772209376412023,2019-03-30 17:15:00,2019-03-30 17:30:00
111,11,4,7,0.0025346082334711715,2019-03-30 17:15:00,2019-03-30 17:30:00
112,14,11,3,0.010293156355732112,2019-03-30 17:15:00,2019-03-30 17:30:00
113,4,2,2,0.0022387541608904055,2019-03-30 17:15:00,2019-03-30 17:30:00
114,2,2,0,0.003643233857580266,2019-03-30 17:15:00,2019-03-30 17:30:00
115,18,12,6,0.01730946495375024,2019-03-30 17:15:00,2019-03-30 17:30:00
116,6,4,2,0.0059866003449303064,2019-03-30 17:15:00,2019-03-30 17:30:00
118,4,3,1,0.0048382096690039655,2019-03-30 17:15:00,2019-03-30 17:30:00
119,26,17,9,0.0189002902691989,2019-03-30 17:15:00,2019-03-30 17:30:00
120,13,8,5,0.014220893174189342,2019-03-30 17:15:00,2019-03-30 17:30:00
122,6,2,4,0.0027772777095582636,2019-03-30 17:15:00,2019-03-30 17:30:00
126,12,8,4,0.005186034241349892,2019-03-30 17:15:00,2019-03-30 17:30:00
127,1,1,0,0.0019046897491872632,2019-03-30 17:15:00,2019-03-30 17:30:00
129,14,9,5,0.011914969580963376,2019-03-30 17:15:00,2019-03-30 17:30:00
135,7,3,4,0.005304678782961127,2019-03-30 17:15:00,2019-03-30 17:30:00
137,34,17,17,0.012300962412394938,2019-03-30 17:15:00,2019-03-30 17:30:00
138,57,32,25,0.03008845467501107,2019-03-30 17:15:00,2019-03-30 17:30:00
140,1,1,0,0.0026200673267321255,2019-03-30 17:15:00,2019-03-30 17:30:00
141,11,4,7,0.004875404777616275,2019-03-30 17:15:00,2019-03-30 17:30:00
147,6,4,2,0.006434033760438225,2019-03-30 17:15:00,2019-03-30 17:30:00
151,24,13,11,0.020057580067523263,2019-03-30 17:15:00,2019-03-30 17:30:00
153,16,5,11,0.006903199911410037,2019-03-30 17:15:00,2019-03-30 17:30:00
154,3,2,1,0.002383818738333504,2019-03-30 17:15:00,2019-03-30 17:30:00
157,5,2,3,0.00461186954936566,2019-03-30 17:15:00,2019-03-30 17:30:00
158,4,3,1,0.03328196801521283,2019-03-30 17:15:00,2019-03-30 17:30:00
159,9,8,1,0.034145990747067374,2019-03-30 17:15:00,2019-03-30 17:30:00
160,2,2,0,0.0038949757433806185,2019-03-30 17:15:00,2019-03-30 17:30:00
161,8,5,3,0.013950884860673604,2019-03-30 17:15:00,2019-03-30 17:30:00
162,25,13,12,0.016222111715471436,2019-03-30 17:15:00,2019-03-30 17:30:00
164,20,12,8,0.00924513861008843,2019-03-30 17:15:00,2019-03-30 17:30:00
168,79,28,51,0.019253317673383924,2019-03-30 17:15:00,2019-03-30 17:30:00
169,47,10,37,0.0070101690460914745,2019-03-30 17:15:00,2019-03-30 17:30:00
170,3,3,0,0.005747050737389157,2019-03-30 17:15:00,2019-03-30 17:30:00
171,6,4,2,0.008813617807669736,2019-03-30 17:15:00,2019-03-30 17:30:00
172,5,2,3,0.0029727127546332883,2019-03-30 17:15:00,2019-03-30 17:30:00
173,13,5,8,0.007903275745828223,2019-03-30 17:15:00,2019-03-30 17:30:00
175,2,1,1,0.010634661787230538,2019-03-30 17:15:00,2019-03-30 17:30:00
177,19,9,10,0.009828034120825268,2019-03-30 17:15:00,2019-03-30 17:30:00
189,11,5,6,0.003035780034347383,2019-03-30 17:15:00,2019-03-30 17:30:00
190,7,3,4,0.005427906376195223,2019-03-30 17:15:00,2019-03-30 17:30:00
191,16,13,3,0.02235490919888591,2019-03-30 17:15:00,2019-03-30 17:30:00
195,4,1,3,0.0022282570107972403,2019-03-30 17:15:00,2019-03-30 17:30:00
196,2,2,0,0.002815882797425371,2019-03-30 17:15:00,2019-03-30 17:30:00
197,16,12,4,0.0136871816611769,2019-03-30 17:15:00,2019-03-30 17:30:00
199,1,1,0,0.0025307126258327234,2019-03-30 17:15:00,2019-03-30 17:30:00
201,13,4,9,0.002760147319005198,2019-03-30 17:15:00,2019-03-30 17:30:00
202,1,1,0,0.0018445095543719345,2019-03-30 17:15:00,2019-03-30 17:30:00
203,16,8,8,0.012864667611470114,2019-03-30 17:15:00,2019-03-30 17:30:00
1,11,8,3,0.011405934517971034,2019-03-30 17:30:00,2019-03-30 17:45:00
2,21,13,8,0.011064947375306186,2019-03-30 17:30:00,2019-03-30 17:45:00
5,12,3,9,0.002587211341199004,2019-03-30 17:30:00,2019-03-30 17:45:00
10,8,6,2,0.03378671409136901,2019-03-30 17:30:00,2019-03-30 17:45:00
11,3,2,1,0.021704565891077218,2019-03-30 17:30:00,2019-03-30 17:45:00
13,2,1,1,0.003759747134967092,2019-03-30 17:30:00,2019-03-30 17:45:00
15,28,12,16,0.016981897091392452,2019-03-30 17:30:00,2019-03-30 17:45:00
16,25,10,15,0.008937311297074767,2019-03-30 17:30:00,2019-03-30 17:45:00
18,24,14,10,0.010406196942463461,2019-03-30 17:30:00,2019-03-30 17:45:00
19,4,4,0,0.0032346020633294116,2019-03-30 17:30:00,2019-03-30 17:45:00
20,8,5,3,0.0052339272054812095,2019-03-30 17:30:00,2019-03-30 17:45:00
23,7,2,5,0.0032820916441087702,2019-03-30 17:30:00,2019-03-30 17:45:00
26,17,9,8,0.009224450025757091,2019-03-30 17:30:00,2019-03-30 17:45:00
27,7,2,5,0.0021404899995386695,2019-03-30 17:30:00,2019-03-30 17:45:00
28,4,1,3,0.0024546332288710787,2019-03-30 17:30:00,2019-03-30 17:45:00
30,1,0,1,0.0014744187625314316,2019-03-30 17:30:00,2019-03-30 17:45:00
35,6,4,2,0.0033144375917047867,2019-03-30 17:30:00,2019-03-30 17:45:00
37,6,2,4,0.0022708761447269897,2019-03-30 17:30:00,2019-03-30 17:45:00
40,4,3,1,0.00462261402742769,2019-03-30 17:30:00,2019-03-30 17:45:00
41,8,4,4,0.003514847512066621,2019-03-30 17:30:00,2019-03-30 17:45:00
46,25,11,14,0.008868857425844093,2019-03-30 17:30:00,2019-03-30 17:45:00
50,3,3,0,0.00410653265571095,2019-03-30 17:30:00,2019-03-30 17:45:00
57,13,10,3,0.008109404272722666,2019-03-30 17:30:00,2019-03-30 17:45:00
58,8,5,3,0.004824903502150037,2019-03-30 17:30:00,2019-03-30 17:45:00
61,1,0,1,0.0014744187625314316,2019-03-30 17:30:00,2019-03-30 17:45:00
62,12,5,7,0.01548926344671547,2019-03-30 17:30:00,2019-03-30 17:45:00
64,5,1,4,0.0018722853788484838,2019-03-30 17:30:00,2019-03-30 17:45:00
66,5,4,1,0.005730416987237913,2019-03-30 17:30:00,2019-03-30 17:45:00
67,12,4,8,0.004507772483445836,2019-03-30 17:30:00,2019-03-30 17:45:00
68,5,3,2,0.008248783687096216,2019-03-30 17:30:00,2019-03-30 17:45:00
69,20,9,11,0.016504469838301575,2019-03-30 17:30:00,2019-03-30 17:45:00
70,8,5,3,0.004934421446556426,2019-03-30 17:30:00,2019-03-30 17:45:00
71,4,2,2,0.009827053839397904,2019-03-30 17:30:00,2019-03-30 17:45:00
74,12,8,4,0.009505190029705162,2019-03-30 17:30:00,2019-03-30 17:45:00
75,18,8,10,0.009555086499317132,2019-03-30 17:30:00,2019-03-30 17:45:00
79,2,1,1,0.009827053839397904,2019-03-30 17:30:00,2019-03-30 17:45:00
80,2,2,0,0.001963136405414387,2019-03-30 17:30:00,2019-03-30 17:45:00
85,9,2,7,0.00327908705983306,2019-03-30 17:30:00,2019-03-30 17:45:00
86,4,1,3,0.002057341103819743,2019-03-30 17:30:00,2019-03-30 17:45:00
87,7,3,4,0.0029365585638825554,2019-03-30 17:30:00,2019-03-30 17:45:00
88,8,2,6,0.002429139424595914,2019-03-30 17:30:00,2019-03-30 17:45:00
89,18,7,11,0.0069721575375818684,2019-03-30 17:30:00,2019-03-30 17:45:00
90,15,7,8,0.00525784705373335,2019-03-30 17:30:00,2019-03-30 17:45:00
99,11,1,10,0.0016113887797878468,2019-03-30 17:30:00,2019-03-30 17:45:00
101,7,3,4,0.004269184296889069,2019-03-30 17:30:00,2019-03-30 17:45:00
104,16,7,9,0.006629300774985166,2019-03-30 17:30:00,2019-03-30 17:45:00
106,3,1,2,0.002564238673724733,2019-03-30 17:30:00,2019-03-30 17:45:00
108,8,3,5,0.004849930738387813,2019-03-30 17:30:00,2019-03-30 17:45:00
109,19,10,9,0.0056346380552058685,2019-03-30 17:30:00,2019-03-30 17:45:00
110,39,25,14,0.02025083787703848,2019-03-30 17:30:00,2019-03-30 17:45:00
111,15,9,6,0.009731345632608163,2019-03-30 17:30:00,2019-03-30 17:45:00
112,8,7,1,0.0060951165750161105,2019-03-30 17:30:00,2019-03-30 17:45:00
113,9,6,3,0.00544105423074542,2019-03-30 17:30:00,2019-03-30 17:45:00
114,4,3,1,0.003693573492365234,2019-03-30 17:30:00,2019-03-30 17:45:00
115,15,7,8,0.006032909530380239,2019-03-30 17:30:00,2019-03-30 17:45:00
116,5,4,1,0.007624550057121628,2019-03-30 17:30:00,2019-03-30 17:45:00
118,4,3,1,0.004686735894688609,2019-03-30 17:30:00,2019-03-30 17:45:00
119,27,16,11,0.018140617762343297,2019-03-30 17:30:00,2019-03-30 17:45:00
120,12,9,3,0.012233917165813683,2019-03-30 17:30:00,2019-03-30 17:45:00
122,5,3,2,0.013541394978154774,2019-03-30 17:30:00,2019-03-30 17:45:00
126,7,6,1,0.0036198338930031352,2019-03-30 17:30:00,2019-03-30 17:45:00
127,1,1,0,0.0028532802750430523,2019-03-30 17:30:00,2019-03-30 17:45:00
129,14,11,3,0.06228432150338429,2019-03-30 17:30:00,2019-03-30 17:45:00
135,5,1,4,0.0018722853788484838,2019-03-30 17:30:00,2019-03-30 17:45:00
137,26,9,17,0.010394887882009575,2019-03-30 17:30:00,2019-03-30 17:45:00
138,61,30,31,0.029043031886318373,2019-03-30 17:30:00,2019-03-30 17:45:00
140,11,4,7,0.0034790260768078835,2019-03-30 17:30:00,2019-03-30 17:45:00
141,12,5,7,0.008754751067347384,2019-03-30 17:30:00,2019-03-30 17:45:00
147,6,5,1,0.006276946330983186,2019-03-30 17:30:00,2019-03-30 17:45:00
151,18,10,8,0.008458056947726831,2019-03-30 17:30:00,2019-03-30 17:45:00
153,13,6,7,0.007293536981945579,2019-03-30 17:30:00,2019-03-30 17:45:00
154,18,10,8,0.008678968550398375,2019-03-30 17:30:00,2019-03-30 17:45:00
157,4,3,1,0.01690495657848609,2019-03-30 17:30:00,2019-03-30 17:45:00
158,5,4,1,0.04625810660960271,2019-03-30 17:30:00,2019-03-30 17:45:00
159,5,5,0,0.004160869121128558,2019-03-30 17:30:00,2019-03-30 17:45:00
160,2,2,0,0.0020903914977152636,2019-03-30 17:30:00,2019-03-30 17:45:00
161,8,5,3,0.020800489475832334,2019-03-30 17:30:00,2019-03-30 17:45:00
162,23,13,10,0.014310441644286742,2019-03-30 17:30:00,2019-03-30 17:45:00
164,19,9,10,0.007012599210258355,2019-03-30 17:30:00,2019-03-30 17:45:00
168,51,13,38,0.013506284126192543,2019-03-30 17:30:00,2019-03-30 17:45:00
169,47,11,36,0.01360903345761761,2019-03-30 17:30:00,2019-03-30 17:45:00
170,5,3,2,0.00481704233167529,2019-03-30 17:30:00,2019-03-30 17:45:00
171,7,4,3,0.0053454165887194885,2019-03-30 17:30:00,2019-03-30 17:45:00
172,5,1,4,0.0018722853788484838,2019-03-30 17:30:00,2019-03-30 17:45:00
173,4,2,2,0.003949707924167484,2019-03-30 17:30:00,2019-03-30 17:45:00
175,2,1,1,0.009827053839397904,2019-03-30 17:30:00,2019-03-30 17:45:00
177,14,6,8,0.006796363255322246,2019-03-30 17:30:00,2019-03-30 17:45:00
189,13,7,6,0.0065065105618525,2019-03-30 17:30:00,2019-03-30 17:45:00
190,6,3,3,0.008065093669280453,2019-03-30 17:30:00,2019-03-30 17:45:00
191,14,12,2,0.018831494215815245,2019-03-30 17:30:00,2019-03-30 17:45:00
195,2,0,2,0.0014744187625314316,2019-03-30 17:30:00,2019-03-30 17:45:00
196,7,4,3,0.007765072336561492,2019-03-30 17:30:00,2019-03-30 17:45:00
197,14,9,5,0.01051848129055487,2019-03-30 17:30:00,2019-03-30 17:45:00
199,2,1,1,0.0022709043989468576,2019-03-30 17:30:00,2019-03-30 17:45:00
201,11,4,7,0.002745598958752643,2019-03-30 17:30:00,2019-03-30 17:45:00
203,19,10,9,0.014126983229251159,2019-03-30 17:30:00,2019-03-30 17:45:00
1,11,7,4,0.005435418018655351,2019-03-30 17:45:00,2019-03-30 18:00:00
2,26,19,7,0.019409166827586092,2019-03-30 17:45:00,2019-03-30 18:00:00
5,15,6,9,0.006634383217098853,2019-03-30 17:45:00,2019-03-30 18:00:00
10,8,6,2,0.028957126236165816,2019-03-30 17:45:00,2019-03-30 18:00:00
11,1,1,0,0.001827328804923141,2019-03-30 17:45:00,2019-03-30 18:00:00
13,1,0,1,0.0015129096498815032,2019-03-30 17:45:00,2019-03-30 18:00:00
15,25,11,14,0.012789589179931619,2019-03-30 17:45:00,2019-03-30 18:00:00
16,27,12,15,0.010389137968166748,2019-03-30 17:45:00,2019-03-30 18:00:00
18,22,10,12,0.007890499700894997,2019-03-30 17:45:00,2019-03-30 18:00:00
19,9,8,1,0.03563597359483348,2019-03-30 17:45:00,2019-03-30 18:00:00
20,8,5,3,0.004345799696356379,2019-03-30 17:45:00,2019-03-30 18:00:00
23,6,3,3,0.004215841581182133,2019-03-30 17:45:00,2019-03-30 18:00:00
26,16,9,7,0.01292677455245681,2019-03-30 17:45:00,2019-03-30 18:00:00
27,7,2,5,0.0022008130814008438,2019-03-30 17:45:00,2019-03-30 18:00:00
28,3,2,1,0.00251369119406292,2019-03-30 17:45:00,2019-03-30 18:00:00
35,6,5,1,0.006999878403304583,2019-03-30 17:45:00,2019-03-30 18:00:00
37,5,1,4,0.008053398416795702,2019-03-30 17:45:00,2019-03-30 18:00:00
40,4,3,1,0.006708722339503802,2019-03-30 17:45:00,2019-03-30 18:00:00
41,7,4,3,0.004203305323946189,2019-03-30 17:45:00,2019-03-30 18:00:00
46,21,7,14,0.01099677568756117,2019-03-30 17:45:00,2019-03-30 18:00:00
50,3,3,0,0.004978545075886607,2019-03-30 17:45:00,2019-03-30 18:00:00
57,14,9,5,0.008305367104716545,2019-03-30 17:45:00,2019-03-30 18:00:00
58,9,4,5,0.004710025012494693,2019-03-30 17:45:00,2019-03-30 18:00:00
61,1,0,1,0.0015129096498815032,2019-03-30 17:45:00,2019-03-30 18:00:00
62,17,7,10,0.0072661189163717955,2019-03-30 17:45:00,2019-03-30 18:00:00
64,7,3,4,0.00417378812792216,2019-03-30 17:45:00,2019-03-30 18:00:00
66,5,4,1,0.006909983368090003,2019-03-30 17:45:00,2019-03-30 18:00:00
67,18,11,7,0.014652128945954551,2019-03-30 17:45:00,2019-03-30 18:00:00
68,3,1,2,0.0035334109243479322,2019-03-30 17:45:00,2019-03-30 18:00:00
69,13,5,8,0.013988380717116975,2019-03-30 17:45:00,2019-03-30 18:00:00
70,8,5,3,0.011670354129556753,2019-03-30 17:45:00,2019-03-30 18:00:00
71,4,2,2,0.010080341052783185,2019-03-30 17:45:00,2019-03-30 18:00:00
74,7,5,2,0.006550556775313393,2019-03-30 17:45:00,2019-03-30 18:00:00
75,19,10,9,0.008105334784074734,2019-03-30 17:45:00,2019-03-30 18:00:00
79,2,1,1,0.010080341052783185,2019-03-30 17:45:00,2019-03-30 18:00:00
80,4,2,2,0.0027661562570484126,2019-03-30 17:45:00,2019-03-30 18:00:00
85,5,2,3,0.003066184567812876,2019-03-30 17:45:00,2019-03-30 18:00:00
86,1,0,1,0.0015129096498815032,2019-03-30 17:45:00,2019-03-30 18:00:00
87,11,5,6,0.006283425738232976,2019-03-30 17:45:00,2019-03-30 18:00:00
88,3,1,2,0.0019676096049386586,2019-03-30 17:45:00,2019-03-30 18:00:00
89,12,3,9,0.003145547735881365,2019-03-30 17:45:00,2019-03-30 18:00:00
90,7,2,5,0.0028299029501373738,2019-03-30 17:45:00,2019-03-30 18:00:00
99,8,2,6,0.002748302275440576,2019-03-30 17:45:00,2019-03-30 18:00:00
101,3,1,2,0.0030827376462257434,2019-03-30 17:45:00,2019-03-30 18:00:00
104,13,5,8,0.004216981894703927,2019-03-30 17:45:00,2019-03-30 18:00:00
106,2,1,1,0.010080341052783185,2019-03-30 17:45:00,2019-03-30 18:00:00
108,12,5,7,0.007056832701431697,2019-03-30 17:45:00,2019-03-30 18:00:00
109,24,15,9,0.01506533131047,2019-03-30 17:45:00,2019-03-30 18:00:00
110,33,15,18,0.012256805861816175,2019-03-30 17:45:00,2019-03-30 18:00:00
111,15,8,7,0.00925263862483059,2019-03-30 17:45:00,2019-03-30 18:00:00
112,12,8,4,0.006915986480645973,2019-03-30 17:45:00,2019-03-30 18:00:00
113,7,3,4,0.003989688870628565,2019-03-30 17:45:00,2019-03-30 18:00:00
114,3,1,2,0.001961008317589032,2019-03-30 17:45:00,2019-03-30 18:00:00
115,6,4,2,0.006848205139681797,2019-03-30 17:45:00,2019-03-30 18:00:00
116,4,3,1,0.003308235891268176,2019-03-30 17:45:00,2019-03-30 18:00:00
118,3,3,0,0.006974275260609649,2019-03-30 17:45:00,2019-03-30 18:00:00
119,23,16,7,0.020346907651237995,2019-03-30 17:45:00,2019-03-30 18:00:00
120,12,8,4,0.015950694680065044,2019-03-30 17:45:00,2019-03-30 18:00:00
122,5,3,2,0.012053709336113515,2019-03-30 17:45:00,2019-03-30 18:00:00
126,11,10,1,0.00666358481726867,2019-03-30 17:45:00,2019-03-30 18:00:00
127,5,3,2,0.004350768478963239,2019-03-30 17:45:00,2019-03-30 18:00:00
129,15,10,5,0.022685638950722727,2019-03-30 17:45:00,2019-03-30 18:00:00
135,2,2,0,0.0027428133590271784,2019-03-30 17:45:00,2019-03-30 18:00:00
137,22,11,11,0.015703918942193425,2019-03-30 17:45:00,2019-03-30 18:00:00
138,57,27,30,0.01799546187404708,2019-03-30 17:45:00,2019-03-30 18:00:00
140,10,3,7,0.0037444108481247077,2019-03-30 17:45:00,2019-03-30 18:00:00
141,10,5,5,0.012628708806179377,2019-03-30 17:45:00,2019-03-30 18:00:00
147,6,5,1,0.007504440755424745,2019-03-30 17:45:00,2019-03-30 18:00:00
151,13,5,8,0.0032276307322087854,2019-03-30 17:45:00,2019-03-30 18:00:00
153,17,7,10,0.008970125711108747,2019-03-30 17:45:00,2019-03-30 18:00:00
154,10,4,6,0.004776227877997109,2019-03-30 17:45:00,2019-03-30 18:00:00
157,10,8,2,0.015386361987291096,2019-03-30 17:45:00,2019-03-30 18:00:00
158,6,4,2,0.013440638948502162,2019-03-30 17:45:00,2019-03-30 18:00:00
159,6,4,2,0.004183967267545762,2019-03-30 17:45:00,2019-03-30 18:00:00
160,3,3,0,0.0054591053818206295,2019-03-30 17:45:00,2019-03-30 18:00:00
161,6,4,2,0.02145422494481592,2019-03-30 17:45:00,2019-03-30 18:00:00
162,13,7,6,0.008336317461231067,2019-03-30 17:45:00,2019-03-30 18:00:00
164,19,8,11,0.007046020678412986,2019-03-30 17:45:00,2019-03-30 18:00:00
168,52,16,36,0.013285743837131455,2019-03-30 17:45:00,2019-03-30 18:00:00
169,47,8,39,0.006641141115886916,2019-03-30 17:45:00,2019-03-30 18:00:00
170,7,3,4,0.005342476505509782,2019-03-30 17:45:00,2019-03-30 18:00:00
171,7,4,3,0.007130077330557702,2019-03-30 17:45:00,2019-03-30 18:00:00
172,5,0,5,0.0015129096498815032,2019-03-30 17:45:00,2019-03-30 18:00:00
173,3,2,1,0.013461723212379147,2019-03-30 17:45:00,2019-03-30 18:00:00
175,2,1,1,0.010080341052783185,2019-03-30 17:45:00,2019-03-30 18:00:00
177,16,12,4,0.036551049779082176,2019-03-30 17:45:00,2019-03-30 18:00:00
189,13,7,6,0.007196617372681328,2019-03-30 17:45:00,2019-03-30 18:00:00
190,6,4,2,0.03066605298855123,2019-03-30 17:45:00,2019-03-30 18:00:00
191,16,9,7,0.007581345563576759,2019-03-30 17:45:00,2019-03-30 18:00:00
195,3,0,3,0.0015129096498815032,2019-03-30 17:45:00,2019-03-30 18:00:00
196,4,2,2,0.007434829821580976,2019-03-30 17:45:00,2019-03-30 18:00:00
197,20,7,13,0.004808186192738202,2019-03-30 17:45:00,2019-03-30 18:00:00
199,3,2,1,0.0027854169624961338,2019-03-30 17:45:00,2019-03-30 18:00:00
201,9,4,5,0.003243170129084033,2019-03-30 17:45:00,2019-03-30 18:00:00
203,18,11,7,0.014201040914870115,2019-03-30 17:45:00,2019-03-30 18:00:00
1,9,6,3,0.008400384783692531,2019-03-30 18:00:00,2019-03-30 18:15:00
2,28,19,9,0.018142584546625474,2019-03-30 18:00:00,2019-03-30 18:15:00
5,8,5,3,0.006654718014217862,2019-03-30 18:00:00,2019-03-30 18:15:00
10,2,2,0,0.006091003292562205,2019-03-30 18:00:00,2019-03-30 18:15:00
11,4,2,2,0.010961274646134856,2019-03-30 18:00:00,2019-03-30 18:15:00
15,23,11,12,0.018207719802320374,2019-03-30 18:00:00,2019-03-30 18:15:00
16,28,12,16,0.016057853864208032,2019-03-30 18:00:00,2019-03-30 18:15:00
18,16,6,10,0.009240538909733595,2019-03-30 18:00:00,2019-03-30 18:15:00
19,13,9,4,0.06038988389803535,2019-03-30 18:00:00,2019-03-30 18:15:00
20,6,5,1,0.00456109869239969,2019-03-30 18:00:00,2019-03-30 18:15:00
23,8,5,3,0.011998888555597,2019-03-30 18:00:00,2019-03-30 18:15:00
26,10,6,4,0.016919769173991118,2019-03-30 18:00:00,2019-03-30 18:15:00
27,5,3,2,0.004050432945973855,2019-03-30 18:00:00,2019-03-30 18:15:00
28,3,3,0,0.005970876233115814,2019-03-30 18:00:00,2019-03-30 18:15:00
35,7,2,5,0.0042437049994520915,2019-03-30 18:00:00,2019-03-30 18:15:00
37,3,1,2,0.008909969158388053,2019-03-30 18:00:00,2019-03-30 18:15:00
40,4,2,2,0.0050737238381665,2019-03-30 18:00:00,2019-03-30 18:15:00
41,7,5,2,0.005228841868105575,2019-03-30 18:00:00,2019-03-30 18:15:00
46,18,6,12,0.005542645769319076,2019-03-30 18:00:00,2019-03-30 18:15:00
50,3,3,0,0.006724489043326171,2019-03-30 18:00:00,2019-03-30 18:15:00
57,12,4,8,0.003368242738943692,2019-03-30 18:00:00,2019-03-30 18:15:00
58,11,6,5,0.004894704220318525,2019-03-30 18:00:00,2019-03-30 18:15:00
61,2,2,0,0.0019943918351952635,2019-03-30 18:00:00,2019-03-30 18:15:00
62,16,6,10,0.006886451820401377,2019-03-30 18:00:00,2019-03-30 18:15:00
64,19,9,10,0.0070084914435006255,2019-03-30 18:00:00,2019-03-30 18:15:00
66,4,3,1,0.005079305089028751,2019-03-30 18:00:00,2019-03-30 18:15:00
67,21,14,7,0.01548024541284361,2019-03-30 18:00:00,2019-03-30 18:15:00
68,3,1,2,0.002851792241613314,2019-03-30 18:00:00,2019-03-30 18:15:00
69,11,5,6,0.017304040299757913,2019-03-30 18:00:00,2019-03-30 18:15:00
70,6,2,4,0.003963113940892474,2019-03-30 18:00:00,2019-03-30 18:15:00
71,4,2,2,0.010961274646134856,2019-03-30 18:00:00,2019-03-30 18:15:00
74,14,9,5,0.01717851209881142,2019-03-30 18:00:00,2019-03-30 18:15:00
75,17,10,7,0.006815360970364537,2019-03-30 18:00:00,2019-03-30 18:15:00
79,2,1,1,0.010961274646134856,2019-03-30 18:00:00,2019-03-30 18:15:00
80,2,0,2,0.0016461473120438761,2019-03-30 18:00:00,2019-03-30 18:15:00
85,4,2,2,0.00422606989621791,2019-03-30 18:00:00,2019-03-30 18:15:00
86,2,1,1,0.0020452513513812614,2019-03-30 18:00:00,2019-03-30 18:15:00
87,8,3,5,0.003324596605407971,2019-03-30 18:00:00,2019-03-30 18:15:00
88,3,0,3,0.0016461473120438761,2019-03-30 18:00:00,2019-03-30 18:15:00
89,9,3,6,0.003763124777378956,2019-03-30 18:00:00,2019-03-30 18:15:00
90,8,5,3,0.005969441267863809,2019-03-30 18:00:00,2019-03-30 18:15:00
99,8,2,6,0.002816988315876791,2019-03-30 18:00:00,2019-03-30 18:15:00
101,1,1,0,0.0045669702155129045,2019-03-30 18:00:00,2019-03-30 18:15:00
104,9,5,4,0.007456021974915482,2019-03-30 18:00:00,2019-03-30 18:15:00
106,2,1,1,0.010961274646134856,2019-03-30 18:00:00,2019-03-30 18:15:00
108,9,1,8,0.0018418490484141702,2019-03-30 18:00:00,2019-03-30 18:15:00
109,25,13,12,0.01165543323356448,2019-03-30 18:00:00,2019-03-30 18:15:00
110,33,7,26,0.0046584822051185006,2019-03-30 18:00:00,2019-03-30 18:15:00
111,9,4,5,0.006966447643766737,2019-03-30 18:00:00,2019-03-30 18:15:00
112,14,7,7,0.010219850849174318,2019-03-30 18:00:00,2019-03-30 18:15:00
113,6,3,3,0.0030082264767055415,2019-03-30 18:00:00,2019-03-30 18:15:00
115,5,2,3,0.004088246776840592,2019-03-30 18:00:00,2019-03-30 18:15:00
116,12,10,2,0.01363701214950986,2019-03-30 18:00:00,2019-03-30 18:15:00
118,4,3,1,0.005332901594425151,2019-03-30 18:00:00,2019-03-30 18:15:00
119,19,12,7,0.016266041415761063,2019-03-30 18:00:00,2019-03-30 18:15:00
120,11,8,3,0.014316737498204403,2019-03-30 18:00:00,2019-03-30 18:15:00
122,6,4,2,0.01964789499152021,2019-03-30 18:00:00,2019-03-30 18:15:00
126,15,6,9,0.005299959183057269,2019-03-30 18:00:00,2019-03-30 18:15:00
127,7,5,2,0.005500682650100376,2019-03-30 18:00:00,2019-03-30 18:15:00
129,17,9,8,0.012530447688264869,2019-03-30 18:00:00,2019-03-30 18:15:00
135,3,3,0,0.0028934771933007597,2019-03-30 18:00:00,2019-03-30 18:15:00
137,20,10,10,0.018516502606147546,2019-03-30 18:00:00,2019-03-30 18:15:00
138,51,22,29,0.026674124892489666,2019-03-30 18:00:00,2019-03-30 18:15:00
140,6,2,4,0.002578988641915509,2019-03-30 18:00:00,2019-03-30 18:15:00
141,12,6,6,0.013683365732828441,2019-03-30 18:00:00,2019-03-30 18:15:00
147,6,5,1,0.007202615825931978,2019-03-30 18:00:00,2019-03-30 18:15:00
151,15,6,9,0.003449054240246016,2019-03-30 18:00:00,2019-03-30 18:15:00
153,11,6,5,0.005939493364907431,2019-03-30 18:00:00,2019-03-30 18:15:00
154,7,3,4,0.004172331391017655,2019-03-30 18:00:00,2019-03-30 18:15:00
157,10,8,2,0.017087710300539467,2019-03-30 18:00:00,2019-03-30 18:15:00
158,5,3,2,0.006419071213868383,2019-03-30 18:00:00,2019-03-30 18:15:00
159,4,2,2,0.002431465358630372,2019-03-30 18:00:00,2019-03-30 18:15:00
160,5,4,1,0.027334607541956053,2019-03-30 18:00:00,2019-03-30 18:15:00
161,6,4,2,0.013566824816912194,2019-03-30 18:00:00,2019-03-30 18:15:00
162,15,7,8,0.005892934295046668,2019-03-30 18:00:00,2019-03-30 18:15:00
164,16,11,5,0.018385686860241217,2019-03-30 18:00:00,2019-03-30 18:15:00
168,49,18,31,0.010577067052275312,2019-03-30 18:00:00,2019-03-30 18:15:00
169,34,7,27,0.0055305406475735204,2019-03-30 18:00:00,2019-03-30 18:15:00
170,8,3,5,0.004220200393032485,2019-03-30 18:00:00,2019-03-30 18:15:00
171,5,3,2,0.002836637412660339,2019-03-30 18:00:00,2019-03-30 18:15:00
172,4,1,3,0.003220345884818959,2019-03-30 18:00:00,2019-03-30 18:15:00
173,5,3,2,0.0041847955389056595,2019-03-30 18:00:00,2019-03-30 18:15:00
175,2,1,1,0.010961274646134856,2019-03-30 18:00:00,2019-03-30 18:15:00
177,22,14,8,0.011710688493028525,2019-03-30 18:00:00,2019-03-30 18:15:00
189,11,7,4,0.00840797537359473,2019-03-30 18:00:00,2019-03-30 18:15:00
190,5,3,2,0.008739608954763091,2019-03-30 18:00:00,2019-03-30 18:15:00
191,7,3,4,0.003526739959241251,2019-03-30 18:00:00,2019-03-30 18:15:00
195,3,0,3,0.0016461473120438761,2019-03-30 18:00:00,2019-03-30 18:15:00
196,7,5,2,0.007637732159344235,2019-03-30 18:00:00,2019-03-30 18:15:00
197,14,5,9,0.004845849939375145,2019-03-30 18:00:00,2019-03-30 18:15:00
199,4,4,0,0.009569199823113736,2019-03-30 18:00:00,2019-03-30 18:15:00
201,7,4,3,0.005138099411922813,2019-03-30 18:00:00,2019-03-30 18:15:00
202,1,0,1,0.0016461473120438761,2019-03-30 18:00:00,2019-03-30 18:15:00
203,13,7,6,0.005140493254766967,2019-03-30 18:00:00,2019-03-30 18:15:00
1,7,5,2,0.006915041834364407,2019-03-30 18:15:00,2019-03-30 18:30:00
2,30,18,12,0.029321097078336876,2019-03-30 18:15:00,2019-03-30 18:30:00
5,5,4,1,0.006117951321146417,2019-03-30 18:15:00,2019-03-30 18:30:00
10,8,5,3,0.007775341486533799,2019-03-30 18:15:00,2019-03-30 18:30:00
11,5,3,2,0.015912054030913638,2019-03-30 18:15:00,2019-03-30 18:30:00
15,20,13,7,0.018813764574332426,2019-03-30 18:15:00,2019-03-30 18:30:00
16,22,9,13,0.013279394280673724,2019-03-30 18:15:00,2019-03-30 18:30:00
18,14,8,6,0.013339329401247145,2019-03-30 18:15:00,2019-03-30 18:30:00
19,10,3,7,0.00576198798783581,2019-03-30 18:15:00,2019-03-30 18:30:00
20,9,6,3,0.0073598052459768444,2019-03-30 18:15:00,2019-03-30 18:30:00
23,9,5,4,0.017841649276503408,2019-03-30 18:15:00,2019-03-30 18:30:00
26,9,4,5,0.006059653744442249,2019-03-30 18:15:00,2019-03-30 18:30:00
27,6,5,1,0.024411258342346944,2019-03-30 18:15:00,2019-03-30 18:30:00
28,8,3,5,0.008975693480782204,2019-03-30 18:15:00,2019-03-30 18:30:00
35,10,5,5,0.004931123823003753,2019-03-30 18:15:00,2019-03-30 18:30:00
37,2,0,2,0.0016919673340398114,2019-03-30 18:15:00,2019-03-30 18:30:00
40,4,2,2,0.005846530024716039,2019-03-30 18:15:00,2019-03-30 18:30:00
41,6,4,2,0.0055650078020074,2019-03-30 18:15:00,2019-03-30 18:30:00
46,7,3,4,0.004873443785860665,2019-03-30 18:15:00,2019-03-30 18:30:00
50,3,3,0,0.006972005458826586,2019-03-30 18:15:00,2019-03-30 18:30:00
57,5,1,4,0.002775657475118337,2019-03-30 18:15:00,2019-03-30 18:30:00
58,9,4,5,0.006773614790500582,2019-03-30 18:15:00,2019-03-30 18:30:00
61,2,2,0,0.0024877268255369214,2019-03-30 18:15:00,2019-03-30 18:30:00
62,14,6,8,0.00917028944263722,2019-03-30 18:15:00,2019-03-30 18:30:00
64,4,2,2,0.011266986033116464,2019-03-30 18:15:00,2019-03-30 18:30:00
66,7,7,0,0.009809581420683186,2019-03-30 18:15:00,2019-03-30 18:30:00
67,14,7,7,0.008923274520239954,2019-03-30 18:15:00,2019-03-30 18:30:00
68,3,1,2,0.002361849487595167,2019-03-30 18:15:00,2019-03-30 18:30:00
69,6,4,2,0.010350840626800967,2019-03-30 18:15:00,2019-03-30 18:30:00
70,9,2,7,0.0033584494252178604,2019-03-30 18:15:00,2019-03-30 18:30:00
71,4,2,2,0.011266986033116464,2019-03-30 18:15:00,2019-03-30 18:30:00
74,10,4,6,0.009012494949240541,2019-03-30 18:15:00,2019-03-30 18:30:00
75,12,10,2,0.00540929432488918,2019-03-30 18:15:00,2019-03-30 18:30:00
79,4,2,2,0.019017377836395146,2019-03-30 18:15:00,2019-03-30 18:30:00
80,2,0,2,0.0016919673340398114,2019-03-30 18:15:00,2019-03-30 18:30:00
85,5,3,2,0.008330407695367118,2019-03-30 18:15:00,2019-03-30 18:30:00
86,2,1,1,0.004787112945294944,2019-03-30 18:15:00,2019-03-30 18:30:00
87,8,3,5,0.00345316719765504,2019-03-30 18:15:00,2019-03-30 18:30:00
88,4,0,4,0.0016919673340398114,2019-03-30 18:15:00,2019-03-30 18:30:00
89,12,6,6,0.009872568893526636,2019-03-30 18:15:00,2019-03-30 18:30:00
90,7,5,2,0.01057385762662472,2019-03-30 18:15:00,2019-03-30 18:30:00
99,3,2,1,0.003640939120127762,2019-03-30 18:15:00,2019-03-30 18:30:00
101,4,2,2,0.00516367816663615,2019-03-30 18:15:00,2019-03-30 18:30:00
104,7,5,2,0.03996353960581938,2019-03-30 18:15:00,2019-03-30 18:30:00
106,2,1,1,0.011266986033116464,2019-03-30 18:15:00,2019-03-30 18:30:00
108,8,2,6,0.003458955817427757,2019-03-30 18:15:00,2019-03-30 18:30:00
109,21,5,16,0.005163651409117011,2019-03-30 18:15:00,2019-03-30 18:30:00
110,28,6,22,0.005706051482277759,2019-03-30 18:15:00,2019-03-30 18:30:00
111,9,4,5,0.0049208337506677306,2019-03-30 18:15:00,2019-03-30 18:30:00
112,9,4,5,0.003474278228787206,2019-03-30 18:15:00,2019-03-30 18:30:00
113,7,4,3,0.00428337198893033,2019-03-30 18:15:00,2019-03-30 18:30:00
115,2,1,1,0.002824115239627576,2019-03-30 18:15:00,2019-03-30 18:30:00
116,11,10,1,0.012618004999702028,2019-03-30 18:15:00,2019-03-30 18:30:00
118,6,6,0,0.015157081631025809,2019-03-30 18:15:00,2019-03-30 18:30:00
119,31,15,16,0.012607640541449564,2019-03-30 18:15:00,2019-03-30 18:30:00
120,6,3,3,0.003618063588727713,2019-03-30 18:15:00,2019-03-30 18:30:00
122,2,2,0,0.004310736233922283,2019-03-30 18:15:00,2019-03-30 18:30:00
126,10,2,8,0.0033584494252178604,2019-03-30 18:15:00,2019-03-30 18:30:00
127,8,6,2,0.006282765844957298,2019-03-30 18:15:00,2019-03-30 18:30:00
129,20,10,10,0.011083261526167267,2019-03-30 18:15:00,2019-03-30 18:30:00
133,1,1,0,0.002361849487595167,2019-03-30 18:15:00,2019-03-30 18:30:00
135,4,0,4,0.0016919673340398114,2019-03-30 18:15:00,2019-03-30 18:30:00
137,18,12,6,0.013863168662595887,2019-03-30 18:15:00,2019-03-30 18:30:00
138,51,24,27,0.03874507590486164,2019-03-30 18:15:00,2019-03-30 18:30:00
140,5,3,2,0.0069056096878551245,2019-03-30 18:15:00,2019-03-30 18:30:00
141,9,4,5,0.008652201986510823,2019-03-30 18:15:00,2019-03-30 18:30:00
147,8,5,3,0.006018606219121628,2019-03-30 18:15:00,2019-03-30 18:30:00
151,9,4,5,0.004265309536984232,2019-03-30 18:15:00,2019-03-30 18:30:00
153,9,6,3,0.0075759528000087645,2019-03-30 18:15:00,2019-03-30 18:30:00
154,8,2,6,0.0024347964302492853,2019-03-30 18:15:00,2019-03-30 18:30:00
157,13,8,5,0.013646899157909599,2019-03-30 18:15:00,2019-03-30 18:30:00
158,5,2,3,0.003995338595693747,2019-03-30 18:15:00,2019-03-30 18:30:00
159,3,2,1,0.010878775824084258,2019-03-30 18:15:00,2019-03-30 18:30:00
160,5,2,3,0.0039048044388699833,2019-03-30 18:15:00,2019-03-30 18:30:00
161,2,2,0,0.0026720912454659394,2019-03-30 18:15:00,2019-03-30 18:30:00
162,12,6,6,0.005347819383255251,2019-03-30 18:15:00,2019-03-30 18:30:00
164,18,11,7,0.017034381545139154,2019-03-30 18:15:00,2019-03-30 18:30:00
168,42,12,30,0.012379267390845203,2019-03-30 18:15:00,2019-03-30 18:30:00
169,18,5,13,0.006084554840378192,2019-03-30 18:15:00,2019-03-30 18:30:00
170,4,1,3,0.001966320599032904,2019-03-30 18:15:00,2019-03-30 18:30:00
171,11,6,5,0.004663991840449562,2019-03-30 18:15:00,2019-03-30 18:30:00
172,2,1,1,0.0036562509186836628,2019-03-30 18:15:00,2019-03-30 18:30:00
173,12,9,3,0.011621105132651936,2019-03-30 18:15:00,2019-03-30 18:30:00
177,16,8,8,0.006819719719978064,2019-03-30 18:15:00,2019-03-30 18:30:00
189,12,6,6,0.005880942519844109,2019-03-30 18:15:00,2019-03-30 18:30:00
190,8,6,2,0.008552297757122043,2019-03-30 18:15:00,2019-03-30 18:30:00
191,7,1,6,0.0020898470797883666,2019-03-30 18:15:00,2019-03-30 18:30:00
195,1,0,1,0.0016919673340398114,2019-03-30 18:15:00,2019-03-30 18:30:00
196,6,4,2,0.006395236554702225,2019-03-30 18:15:00,2019-03-30 18:30:00
197,5,4,1,0.007420968243289185,2019-03-30 18:15:00,2019-03-30 18:30:00
199,8,2,6,0.005851169126102669,2019-03-30 18:15:00,2019-03-30 18:30:00
201,5,2,3,0.0039048044388699833,2019-03-30 18:15:00,2019-03-30 18:30:00
202,1,0,1,0.0016919673340398114,2019-03-30 18:15:00,2019-03-30 18:30:00
203,9,8,1,0.048474589686291605,2019-03-30 18:15:00,2019-03-30 18:30:00
1,11,10,1,0.009717491927704075,2019-03-30 18:30:00,2019-03-30 18:45:00
2,12,4,8,0.006153530026055527,2019-03-30 18:30:00,2019-03-30 18:45:00
5,4,1,3,0.003980433466664292,2019-03-30 18:30:00,2019-03-30 18:45:00
10,8,4,4,0.006403091536610491,2019-03-30 18:30:00,2019-03-30 18:45:00
11,5,3,2,0.021583231051929358,2019-03-30 18:30:00,2019-03-30 18:45:00
15,25,12,13,0.015942276745742105,2019-03-30 18:30:00,2019-03-30 18:45:00
16,9,2,7,0.004784601113631769,2019-03-30 18:30:00,2019-03-30 18:45:00
18,10,6,4,0.008798517694314301,2019-03-30 18:30:00,2019-03-30 18:45:00
19,11,3,8,0.013121974168330133,2019-03-30 18:30:00,2019-03-30 18:45:00
20,6,3,3,0.005174239954410757,2019-03-30 18:30:00,2019-03-30 18:45:00
23,8,3,5,0.017671362413460144,2019-03-30 18:30:00,2019-03-30 18:45:00
26,10,5,5,0.007315830248120729,2019-03-30 18:30:00,2019-03-30 18:45:00
27,2,2,0,0.003317622066589739,2019-03-30 18:30:00,2019-03-30 18:45:00
28,4,0,4,0.001852218921818753,2019-03-30 18:30:00,2019-03-30 18:45:00
35,7,6,1,0.007062593304038498,2019-03-30 18:30:00,2019-03-30 18:45:00
37,2,0,2,0.001852218921818753,2019-03-30 18:30:00,2019-03-30 18:45:00
40,5,1,4,0.003578271776743276,2019-03-30 18:30:00,2019-03-30 18:45:00
41,8,4,4,0.0057024269377377295,2019-03-30 18:30:00,2019-03-30 18:45:00
46,9,4,5,0.010774811023721853,2019-03-30 18:30:00,2019-03-30 18:45:00
50,4,4,0,0.007977279295049407,2019-03-30 18:30:00,2019-03-30 18:45:00
57,4,4,0,0.0090318751659634,2019-03-30 18:30:00,2019-03-30 18:45:00
58,7,3,4,0.007079045353434745,2019-03-30 18:30:00,2019-03-30 18:45:00
61,3,3,0,0.0039878010098557855,2019-03-30 18:30:00,2019-03-30 18:45:00
62,16,8,8,0.008133405547147289,2019-03-30 18:30:00,2019-03-30 18:45:00
64,8,4,4,0.012331015785936,2019-03-30 18:30:00,2019-03-30 18:45:00
66,4,4,0,0.006337873239021151,2019-03-30 18:30:00,2019-03-30 18:45:00
67,17,7,10,0.011702473191460002,2019-03-30 18:30:00,2019-03-30 18:45:00
68,2,0,2,0.001852218921818753,2019-03-30 18:30:00,2019-03-30 18:45:00
69,5,4,1,0.037339796369438724,2019-03-30 18:30:00,2019-03-30 18:45:00
70,8,2,6,0.003450771080278628,2019-03-30 18:30:00,2019-03-30 18:45:00
74,7,3,4,0.005416414579721686,2019-03-30 18:30:00,2019-03-30 18:45:00
75,15,10,5,0.00765611639435729,2019-03-30 18:30:00,2019-03-30 18:45:00
79,2,2,0,0.004465882089008071,2019-03-30 18:30:00,2019-03-30 18:45:00
85,5,3,2,0.00525915081157938,2019-03-30 18:30:00,2019-03-30 18:45:00
86,1,0,1,0.001852218921818753,2019-03-30 18:30:00,2019-03-30 18:45:00
87,9,5,4,0.010013752125409725,2019-03-30 18:30:00,2019-03-30 18:45:00
88,4,0,4,0.001852218921818753,2019-03-30 18:30:00,2019-03-30 18:45:00
89,12,6,6,0.008580865912721084,2019-03-30 18:30:00,2019-03-30 18:45:00
90,13,10,3,0.011854143920338265,2019-03-30 18:30:00,2019-03-30 18:45:00
99,6,2,4,0.003580779440828835,2019-03-30 18:30:00,2019-03-30 18:45:00
101,1,0,1,0.001852218921818753,2019-03-30 18:30:00,2019-03-30 18:45:00
104,7,4,3,0.014950715001965313,2019-03-30 18:30:00,2019-03-30 18:45:00
106,4,3,1,0.015324957747112355,2019-03-30 18:30:00,2019-03-30 18:45:00
108,7,0,7,0.001852218921818753,2019-03-30 18:30:00,2019-03-30 18:45:00
109,16,6,10,0.010162457065580775,2019-03-30 18:30:00,2019-03-30 18:45:00
110,29,13,16,0.01621152291036864,2019-03-30 18:30:00,2019-03-30 18:45:00
111,6,3,3,0.006091552879669412,2019-03-30 18:30:00,2019-03-30 18:45:00
112,8,4,4,0.004094122685884962,2019-03-30 18:30:00,2019-03-30 18:45:00
113,8,3,5,0.006637592744368048,2019-03-30 18:30:00,2019-03-30 18:45:00
114,1,0,1,0.001852218921818753,2019-03-30 18:30:00,2019-03-30 18:45:00
116,17,9,8,0.008390367294116076,2019-03-30 18:30:00,2019-03-30 18:45:00
118,7,5,2,0.011850529009109146,2019-03-30 18:30:00,2019-03-30 18:45:00
119,28,15,13,0.01714858828383372,2019-03-30 18:30:00,2019-03-30 18:45:00
120,9,4,5,0.007046747000665139,2019-03-30 18:30:00,2019-03-30 18:45:00
122,3,1,2,0.003068021846001548,2019-03-30 18:30:00,2019-03-30 18:45:00
126,9,7,2,0.01020721798368473,2019-03-30 18:30:00,2019-03-30 18:45:00
127,12,8,4,0.011507455105420051,2019-03-30 18:30:00,2019-03-30 18:45:00
129,16,10,6,0.015135683517012494,2019-03-30 18:30:00,2019-03-30 18:45:00
133,1,1,0,0.002973632501119352,2019-03-30 18:30:00,2019-03-30 18:45:00
135,6,2,4,0.0038419580837184605,2019-03-30 18:30:00,2019-03-30 18:45:00
137,16,9,7,0.013028332278432718,2019-03-30 18:30:00,2019-03-30 18:45:00
138,33,20,13,0.0329903034370538,2019-03-30 18:30:00,2019-03-30 18:45:00
140,8,8,0,0.008805759713741248,2019-03-30 18:30:00,2019-03-30 18:45:00
141,10,5,5,0.0050365281607122475,2019-03-30 18:30:00,2019-03-30 18:45:00
147,6,3,3,0.005159400256744579,2019-03-30 18:30:00,2019-03-30 18:45:00
151,6,4,2,0.016206462339697917,2019-03-30 18:30:00,2019-03-30 18:45:00
153,10,9,1,0.01680576142230622,2019-03-30 18:30:00,2019-03-30 18:45:00
154,7,1,6,0.0021327817178356566,2019-03-30 18:30:00,2019-03-30 18:45:00
157,5,3,2,0.0048943595937806835,2019-03-30 18:30:00,2019-03-30 18:45:00
158,6,2,4,0.005016723692697547,2019-03-30 18:30:00,2019-03-30 18:45:00
159,4,1,3,0.005544623992245437,2019-03-30 18:30:00,2019-03-30 18:45:00
160,5,3,2,0.00868693819909989,2019-03-30 18:30:00,2019-03-30 18:45:00
162,10,5,5,0.0067144667749276295,2019-03-30 18:30:00,2019-03-30 18:45:00
164,18,10,8,0.012440245814954658,2019-03-30 18:30:00,2019-03-30 18:45:00
168,38,13,25,0.01686349252071463,2019-03-30 18:30:00,2019-03-30 18:45:00
169,16,3,13,0.004290623812554356,2019-03-30 18:30:00,2019-03-30 18:45:00
170,1,0,1,0.001852218921818753,2019-03-30 18:30:00,2019-03-30 18:45:00
171,11,6,5,0.0067706406258669,2019-03-30 18:30:00,2019-03-30 18:45:00
172,1,1,0,0.00343447130725815,2019-03-30 18:30:00,2019-03-30 18:45:00
173,5,3,2,0.00530693985710399,2019-03-30 18:30:00,2019-03-30 18:45:00
177,14,6,8,0.007192802175585071,2019-03-30 18:30:00,2019-03-30 18:45:00
189,12,5,7,0.006581478618709247,2019-03-30 18:30:00,2019-03-30 18:45:00
190,8,7,1,0.0596652013528931,2019-03-30 18:30:00,2019-03-30 18:45:00
191,13,4,9,0.007756888249570515,2019-03-30 18:30:00,2019-03-30 18:45:00
195,1,0,1,0.001852218921818753,2019-03-30 18:30:00,2019-03-30 18:45:00
196,11,5,6,0.006229194953674683,2019-03-30 18:30:00,2019-03-30 18:45:00
197,5,5,0,0.006887133054657681,2019-03-30 18:30:00,2019-03-30 18:45:00
199,4,0,4,0.001852218921818753,2019-03-30 18:30:00,2019-03-30 18:45:00
201,9,2,7,0.002446364489092346,2019-03-30 18:30:00,2019-03-30 18:45:00
203,10,5,5,0.009808629011942521,2019-03-30 18:30:00,2019-03-30 18:45:00
1,11,7,4,0.007548916712222631,2019-03-30 18:45:00,2019-03-30 19:00:00
2,13,4,9,0.005674938718338153,2019-03-30 18:45:00,2019-03-30 19:00:00
5,6,2,4,0.005607958899754415,2019-03-30 18:45:00,2019-03-30 19:00:00
10,4,0,4,0.0016761205927902979,2019-03-30 18:45:00,2019-03-30 19:00:00
11,7,5,2,0.04712935313277163,2019-03-30 18:45:00,2019-03-30 19:00:00
15,23,11,12,0.021702526187348473,2019-03-30 18:45:00,2019-03-30 19:00:00
16,14,9,5,0.01248211887606634,2019-03-30 18:45:00,2019-03-30 19:00:00
18,6,4,2,0.0049625905036742995,2019-03-30 18:45:00,2019-03-30 19:00:00
19,12,5,7,0.013160676100096993,2019-03-30 18:45:00,2019-03-30 19:00:00
20,8,2,6,0.0040596732187416305,2019-03-30 18:45:00,2019-03-30 19:00:00
23,7,5,2,0.01162183000001636,2019-03-30 18:45:00,2019-03-30 19:00:00
26,5,3,2,0.007226020679977261,2019-03-30 18:45:00,2019-03-30 19:00:00
27,2,2,0,0.0022944593367603214,2019-03-30 18:45:00,2019-03-30 19:00:00
28,2,1,1,0.002364375482392116,2019-03-30 18:45:00,2019-03-30 19:00:00
30,5,5,0,0.009614142087219292,2019-03-30 18:45:00,2019-03-30 19:00:00
35,6,5,1,0.00821052240403855,2019-03-30 18:45:00,2019-03-30 19:00:00
37,2,0,2,0.0016761205927902979,2019-03-30 18:45:00,2019-03-30 19:00:00
40,2,0,2,0.0016761205927902979,2019-03-30 18:45:00,2019-03-30 19:00:00
41,8,5,3,0.009333137495031259,2019-03-30 18:45:00,2019-03-30 19:00:00
46,10,3,7,0.006296553013347978,2019-03-30 18:45:00,2019-03-30 19:00:00
50,2,1,1,0.0028678969057659644,2019-03-30 18:45:00,2019-03-30 19:00:00
57,6,5,1,0.00905807378429858,2019-03-30 18:45:00,2019-03-30 19:00:00
58,2,0,2,0.0016761205927902979,2019-03-30 18:45:00,2019-03-30 19:00:00
61,3,3,0,0.008860783113676692,2019-03-30 18:45:00,2019-03-30 19:00:00
62,11,5,6,0.005850594853089268,2019-03-30 18:45:00,2019-03-30 19:00:00
64,4,2,2,0.011165451655649578,2019-03-30 18:45:00,2019-03-30 19:00:00
66,3,2,1,0.005480719652415212,2019-03-30 18:45:00,2019-03-30 19:00:00
67,8,4,4,0.006972422924022599,2019-03-30 18:45:00,2019-03-30 19:00:00
68,5,3,2,0.02979067662376688,2019-03-30 18:45:00,2019-03-30 19:00:00
69,8,5,3,0.009890194613098686,2019-03-30 18:45:00,2019-03-30 19:00:00
70,6,2,4,0.0024544279375158084,2019-03-30 18:45:00,2019-03-30 19:00:00
74,4,0,4,0.0016761205927902979,2019-03-30 18:45:00,2019-03-30 19:00:00
75,9,4,5,0.004638026188432733,2019-03-30 18:45:00,2019-03-30 19:00:00
79,2,2,0,0.005691481097496907,2019-03-30 18:45:00,2019-03-30 19:00:00
85,4,2,2,0.004751084941083304,2019-03-30 18:45:00,2019-03-30 19:00:00
87,9,5,4,0.0070297975651905705,2019-03-30 18:45:00,2019-03-30 19:00:00
88,4,1,3,0.0021776057993762553,2019-03-30 18:45:00,2019-03-30 19:00:00
89,13,6,7,0.012049682088444378,2019-03-30 18:45:00,2019-03-30 19:00:00
90,17,8,9,0.010448390480735327,2019-03-30 18:45:00,2019-03-30 19:00:00
99,4,0,4,0.0016761205927902979,2019-03-30 18:45:00,2019-03-30 19:00:00
104,7,2,5,0.004440928321163372,2019-03-30 18:45:00,2019-03-30 19:00:00
106,8,5,3,0.01614045746520781,2019-03-30 18:45:00,2019-03-30 19:00:00
108,6,1,5,0.0021977181984504696,2019-03-30 18:45:00,2019-03-30 19:00:00
109,20,10,10,0.009450527116520632,2019-03-30 18:45:00,2019-03-30 19:00:00
110,16,8,8,0.013690678534393225,2019-03-30 18:45:00,2019-03-30 19:00:00
111,10,8,2,0.015951462936763677,2019-03-30 18:45:00,2019-03-30 19:00:00
112,5,3,2,0.005692821975783963,2019-03-30 18:45:00,2019-03-30 19:00:00
113,6,3,3,0.004233797028842078,2019-03-30 18:45:00,2019-03-30 19:00:00
114,4,3,1,0.008116118469880878,2019-03-30 18:45:00,2019-03-30 19:00:00
115,3,3,0,0.003415535800042896,2019-03-30 18:45:00,2019-03-30 19:00:00
116,15,5,10,0.011011418248470949,2019-03-30 18:45:00,2019-03-30 19:00:00
118,5,2,3,0.0024233728549086808,2019-03-30 18:45:00,2019-03-30 19:00:00
119,21,11,10,0.012096283439086296,2019-03-30 18:45:00,2019-03-30 19:00:00
120,8,3,5,0.004267595529786949,2019-03-30 18:45:00,2019-03-30 19:00:00
122,4,1,3,0.003139498015902252,2019-03-30 18:45:00,2019-03-30 19:00:00
126,18,12,6,0.018290393056454548,2019-03-30 18:45:00,2019-03-30 19:00:00
127,10,6,4,0.00952570994691232,2019-03-30 18:45:00,2019-03-30 19:00:00
129,17,11,6,0.0184962023708966,2019-03-30 18:45:00,2019-03-30 19:00:00
135,4,2,2,0.004639812568114609,2019-03-30 18:45:00,2019-03-30 19:00:00
137,17,4,13,0.007668762557937234,2019-03-30 18:45:00,2019-03-30 19:00:00
138,38,22,16,0.0404018766681394,2019-03-30 18:45:00,2019-03-30 19:00:00
140,10,7,3,0.007236812399660134,2019-03-30 18:45:00,2019-03-30 19:00:00
141,9,4,5,0.011188441882404197,2019-03-30 18:45:00,2019-03-30 19:00:00
147,6,3,3,0.006693898752450047,2019-03-30 18:45:00,2019-03-30 19:00:00
151,6,4,2,0.030898439061507327,2019-03-30 18:45:00,2019-03-30 19:00:00
153,13,8,5,0.01941608103227932,2019-03-30 18:45:00,2019-03-30 19:00:00
154,4,3,1,0.0033233396953267803,2019-03-30 18:45:00,2019-03-30 19:00:00
157,6,5,1,0.009496458456961164,2019-03-30 18:45:00,2019-03-30 19:00:00
158,3,2,1,0.0026790910059622123,2019-03-30 18:45:00,2019-03-30 19:00:00
159,2,1,1,0.002915059758070351,2019-03-30 18:45:00,2019-03-30 19:00:00
160,3,1,2,0.002915059758070351,2019-03-30 18:45:00,2019-03-30 19:00:00
162,9,7,2,0.011468521137573915,2019-03-30 18:45:00,2019-03-30 19:00:00
164,16,12,4,0.016505391908667903,2019-03-30 18:45:00,2019-03-30 19:00:00
168,36,14,22,0.020662976682847875,2019-03-30 18:45:00,2019-03-30 19:00:00
169,10,0,10,0.0016761205927902979,2019-03-30 18:45:00,2019-03-30 19:00:00
170,2,1,1,0.006543183647318417,2019-03-30 18:45:00,2019-03-30 19:00:00
171,3,3,0,0.0034550694055276365,2019-03-30 18:45:00,2019-03-30 19:00:00
172,3,2,1,0.005725165329086037,2019-03-30 18:45:00,2019-03-30 19:00:00
173,6,3,3,0.00551390217455857,2019-03-30 18:45:00,2019-03-30 19:00:00
177,9,4,5,0.013371632433077736,2019-03-30 18:45:00,2019-03-30 19:00:00
189,11,3,8,0.003662215464209261,2019-03-30 18:45:00,2019-03-30 19:00:00
190,5,4,1,0.03474854962258386,2019-03-30 18:45:00,2019-03-30 19:00:00
191,6,1,5,0.0018185946009866881,2019-03-30 18:45:00,2019-03-30 19:00:00
195,1,0,1,0.0016761205927902979,2019-03-30 18:45:00,2019-03-30 19:00:00
196,7,3,4,0.0036377900175601253,2019-03-30 18:45:00,2019-03-30 19:00:00
197,20,10,10,0.022535577964150996,2019-03-30 18:45:00,2019-03-30 19:00:00
199,5,1,4,0.0032385780910262015,2019-03-30 18:45:00,2019-03-30 19:00:00
201,10,2,8,0.002128423170221979,2019-03-30 18:45:00,2019-03-30 19:00:00
203,10,4,6,0.006624718866399216,2019-03-30 18:45:00,2019-03-30 19:00:00
1,7,5,2,0.011538070331427862,2019-03-30 19:00:00,2019-03-30 19:15:00
2,10,3,7,0.003894982208386756,2019-03-30 19:00:00,2019-03-30 19:15:00
5,4,4,0,0.005695783015437994,2019-03-30 19:00:00,2019-03-30 19:15:00
11,3,2,1,0.007472549690886798,2019-03-30 19:00:00,2019-03-30 19:15:00
15,20,9,11,0.024218953045416346,2019-03-30 19:00:00,2019-03-30 19:15:00
16,18,10,8,0.010270879594806956,2019-03-30 19:00:00,2019-03-30 19:15:00
18,9,5,4,0.006438035012391869,2019-03-30 19:00:00,2019-03-30 19:15:00
19,5,1,4,0.006918810581363082,2019-03-30 19:00:00,2019-03-30 19:15:00
20,7,0,7,0.0020145940977940157,2019-03-30 19:00:00,2019-03-30 19:15:00
23,5,5,0,0.015230293753375646,2019-03-30 19:00:00,2019-03-30 19:15:00
26,5,3,2,0.006787515738503015,2019-03-30 19:00:00,2019-03-30 19:15:00
27,2,2,0,0.00410492296638677,2019-03-30 19:00:00,2019-03-30 19:15:00
28,2,0,2,0.0020145940977940157,2019-03-30 19:00:00,2019-03-30 19:15:00
30,3,1,2,0.0031174549428915964,2019-03-30 19:00:00,2019-03-30 19:15:00
35,6,4,2,0.006292105721846517,2019-03-30 19:00:00,2019-03-30 19:15:00
37,2,0,2,0.0020145940977940157,2019-03-30 19:00:00,2019-03-30 19:15:00
41,8,6,2,0.013476945356087906,2019-03-30 19:00:00,2019-03-30 19:15:00
46,6,2,4,0.003745279920445865,2019-03-30 19:00:00,2019-03-30 19:15:00
50,1,0,1,0.0020145940977940157,2019-03-30 19:00:00,2019-03-30 19:15:00
57,9,4,5,0.005849413143223847,2019-03-30 19:00:00,2019-03-30 19:15:00
61,2,2,0,0.0029034933373111396,2019-03-30 19:00:00,2019-03-30 19:15:00
62,13,6,7,0.010222965577639366,2019-03-30 19:00:00,2019-03-30 19:15:00
66,3,2,1,0.003526627201842849,2019-03-30 19:00:00,2019-03-30 19:15:00
70,6,2,4,0.004147491480063983,2019-03-30 19:00:00,2019-03-30 19:15:00
74,4,1,3,0.0028111280794319384,2019-03-30 19:00:00,2019-03-30 19:15:00
75,5,1,4,0.0024875941487452024,2019-03-30 19:00:00,2019-03-30 19:15:00
79,2,2,0,0.005302692692928379,2019-03-30 19:00:00,2019-03-30 19:15:00
85,2,0,2,0.0020145940977940157,2019-03-30 19:00:00,2019-03-30 19:15:00
87,10,5,5,0.005455565356559287,2019-03-30 19:00:00,2019-03-30 19:15:00
88,4,3,1,0.0034522510171348863,2019-03-30 19:00:00,2019-03-30 19:15:00
89,7,3,4,0.0033666261556470484,2019-03-30 19:00:00,2019-03-30 19:15:00
90,10,2,8,0.0036268592646968123,2019-03-30 19:00:00,2019-03-30 19:15:00
99,2,0,2,0.0020145940977940157,2019-03-30 19:00:00,2019-03-30 19:15:00
104,6,2,4,0.0036455757512198015,2019-03-30 19:00:00,2019-03-30 19:15:00
106,6,3,3,0.013421227403374456,2019-03-30 19:00:00,2019-03-30 19:15:00
108,2,1,1,0.0028960297652876783,2019-03-30 19:00:00,2019-03-30 19:15:00
109,19,9,10,0.008278020162359935,2019-03-30 19:00:00,2019-03-30 19:15:00
110,4,0,4,0.0020145940977940157,2019-03-30 19:00:00,2019-03-30 19:15:00
111,7,6,1,0.04929057919751385,2019-03-30 19:00:00,2019-03-30 19:15:00
112,4,1,3,0.0028111280794319384,2019-03-30 19:00:00,2019-03-30 19:15:00
113,4,2,2,0.0038425292669354216,2019-03-30 19:00:00,2019-03-30 19:15:00
114,4,4,0,0.007559081486865485,2019-03-30 19:00:00,2019-03-30 19:15:00
115,5,5,0,0.006390722254010158,2019-03-30 19:00:00,2019-03-30 19:15:00
116,5,3,2,0.005904228496910408,2019-03-30 19:00:00,2019-03-30 19:15:00
118,4,1,3,0.0023999757823583434,2019-03-30 19:00:00,2019-03-30 19:15:00
119,10,4,6,0.005425821371018198,2019-03-30 19:00:00,2019-03-30 19:15:00
120,12,5,7,0.006993809764534619,2019-03-30 19:00:00,2019-03-30 19:15:00
122,2,1,1,0.002730051136868969,2019-03-30 19:00:00,2019-03-30 19:15:00
126,7,2,5,0.003052512754789824,2019-03-30 19:00:00,2019-03-30 19:15:00
127,9,4,5,0.015182847716110505,2019-03-30 19:00:00,2019-03-30 19:15:00
129,12,9,3,0.016160762149451148,2019-03-30 19:00:00,2019-03-30 19:15:00
137,24,12,12,0.009416086522921275,2019-03-30 19:00:00,2019-03-30 19:15:00
138,21,12,9,0.016480550004644205,2019-03-30 19:00:00,2019-03-30 19:15:00
140,5,0,5,0.0020145940977940157,2019-03-30 19:00:00,2019-03-30 19:15:00
141,10,2,8,0.0071147285183631856,2019-03-30 19:00:00,2019-03-30 19:15:00
147,3,3,0,0.008147012075912098,2019-03-30 19:00:00,2019-03-30 19:15:00
151,12,8,4,0.05337364202500157,2019-03-30 19:00:00,2019-03-30 19:15:00
153,7,2,5,0.006229531206521397,2019-03-30 19:00:00,2019-03-30 19:15:00
154,4,3,1,0.0032052366610902123,2019-03-30 19:00:00,2019-03-30 19:15:00
157,5,4,1,0.005546225735109617,2019-03-30 19:00:00,2019-03-30 19:15:00
158,2,2,0,0.003348660429694673,2019-03-30 19:00:00,2019-03-30 19:15:00
159,6,3,3,0.004998139259210162,2019-03-30 19:00:00,2019-03-30 19:15:00
160,3,2,1,0.024289589052988197,2019-03-30 19:00:00,2019-03-30 19:15:00
161,4,2,2,0.013421227403374456,2019-03-30 19:00:00,2019-03-30 19:15:00
162,7,6,1,0.009463887767164449,2019-03-30 19:00:00,2019-03-30 19:15:00
164,9,6,3,0.006520174206486184,2019-03-30 19:00:00,2019-03-30 19:15:00
168,31,14,17,0.0174858766600271,2019-03-30 19:00:00,2019-03-30 19:15:00
169,13,4,9,0.004705445789940082,2019-03-30 19:00:00,2019-03-30 19:15:00
170,3,2,1,0.08308309858163634,2019-03-30 19:00:00,2019-03-30 19:15:00
171,2,2,0,0.0029034933373111396,2019-03-30 19:00:00,2019-03-30 19:15:00
172,5,4,1,0.012341312506187918,2019-03-30 19:00:00,2019-03-30 19:15:00
173,5,2,3,0.003892187981439002,2019-03-30 19:00:00,2019-03-30 19:15:00
177,8,4,4,0.02776714591603601,2019-03-30 19:00:00,2019-03-30 19:15:00
189,5,2,3,0.003763468513340955,2019-03-30 19:00:00,2019-03-30 19:15:00
190,6,4,2,0.010004323139697366,2019-03-30 19:00:00,2019-03-30 19:15:00
191,3,1,2,0.0024590437175525774,2019-03-30 19:00:00,2019-03-30 19:15:00
195,2,1,1,0.002783325306796775,2019-03-30 19:00:00,2019-03-30 19:15:00
196,4,3,1,0.004285598244391721,2019-03-30 19:00:00,2019-03-30 19:15:00
197,17,8,9,0.028889770902112782,2019-03-30 19:00:00,2019-03-30 19:15:00
199,2,0,2,0.0020145940977940157,2019-03-30 19:00:00,2019-03-30 19:15:00
201,2,0,2,0.0020145940977940157,2019-03-30 19:00:00,2019-03-30 19:15:00
203,10,7,3,0.017800011654524918,2019-03-30 19:00:00,2019-03-30 19:15:00
1,8,4,4,0.010739682547490907,2019-03-30 19:15:00,2019-03-30 19:30:00
2,8,3,5,0.006371176798348138,2019-03-30 19:15:00,2019-03-30 19:30:00
5,2,2,0,0.009827610378945702,2019-03-30 19:15:00,2019-03-30 19:30:00
10,1,0,1,0.0024383692222408127,2019-03-30 19:15:00,2019-03-30 19:30:00
11,1,0,1,0.0024383692222408127,2019-03-30 19:15:00,2019-03-30 19:30:00
15,12,4,8,0.007771537823708799,2019-03-30 19:15:00,2019-03-30 19:30:00
16,21,10,11,0.0297300965090052,2019-03-30 19:15:00,2019-03-30 19:30:00
18,6,4,2,0.00551137661150354,2019-03-30 19:15:00,2019-03-30 19:30:00
19,5,2,3,0.00614568954376368,2019-03-30 19:15:00,2019-03-30 19:30:00
20,3,2,1,0.005231878364731272,2019-03-30 19:15:00,2019-03-30 19:30:00
23,9,9,0,0.014914950877147908,2019-03-30 19:15:00,2019-03-30 19:30:00
26,4,2,2,0.009372681636739067,2019-03-30 19:15:00,2019-03-30 19:30:00
27,2,2,0,0.004747755488759609,2019-03-30 19:15:00,2019-03-30 19:30:00
28,1,0,1,0.0024383692222408127,2019-03-30 19:15:00,2019-03-30 19:30:00
30,5,1,4,0.003474755352710515,2019-03-30 19:15:00,2019-03-30 19:30:00
35,3,2,1,0.007234174036945991,2019-03-30 19:15:00,2019-03-30 19:30:00
37,2,0,2,0.0024383692222408127,2019-03-30 19:15:00,2019-03-30 19:30:00
41,5,5,0,0.007649436817573193,2019-03-30 19:15:00,2019-03-30 19:30:00
46,9,7,2,0.027522890173177054,2019-03-30 19:15:00,2019-03-30 19:30:00
57,9,1,8,0.004808636440058145,2019-03-30 19:15:00,2019-03-30 19:30:00
58,2,0,2,0.0024383692222408127,2019-03-30 19:15:00,2019-03-30 19:30:00
62,10,4,6,0.0104113338242356,2019-03-30 19:15:00,2019-03-30 19:30:00
66,1,1,0,0.003913533732940065,2019-03-30 19:15:00,2019-03-30 19:30:00
67,1,0,1,0.0024383692222408127,2019-03-30 19:15:00,2019-03-30 19:30:00
70,4,3,1,0.006123139934899914,2019-03-30 19:15:00,2019-03-30 19:30:00
74,6,3,3,0.01041192011888864,2019-03-30 19:15:00,2019-03-30 19:30:00
75,5,1,4,0.0035215964425965437,2019-03-30 19:15:00,2019-03-30 19:30:00
79,1,1,0,0.003563688881318812,2019-03-30 19:15:00,2019-03-30 19:30:00
85,2,0,2,0.0024383692222408127,2019-03-30 19:15:00,2019-03-30 19:30:00
87,5,3,2,0.004683604334216536,2019-03-30 19:15:00,2019-03-30 19:30:00
88,3,3,0,0.004494631941203754,2019-03-30 19:15:00,2019-03-30 19:30:00
89,4,0,4,0.0024383692222408127,2019-03-30 19:15:00,2019-03-30 19:30:00
90,6,4,2,0.007459780447570793,2019-03-30 19:15:00,2019-03-30 19:30:00
104,2,0,2,0.0024383692222408127,2019-03-30 19:15:00,2019-03-30 19:30:00
109,9,3,6,0.010056160775303125,2019-03-30 19:15:00,2019-03-30 19:30:00
110,7,0,7,0.0024383692222408127,2019-03-30 19:15:00,2019-03-30 19:30:00
111,7,5,2,0.04847990678259961,2019-03-30 19:15:00,2019-03-30 19:30:00
112,3,2,1,0.00346032721992759,2019-03-30 19:15:00,2019-03-30 19:30:00
113,3,1,2,0.004808636440058145,2019-03-30 19:15:00,2019-03-30 19:30:00
114,1,1,0,0.0031975833190198994,2019-03-30 19:15:00,2019-03-30 19:30:00
115,4,4,0,0.008552208437160688,2019-03-30 19:15:00,2019-03-30 19:30:00
116,4,2,2,0.0062112392436209155,2019-03-30 19:15:00,2019-03-30 19:30:00
118,2,1,1,0.005609090928874896,2019-03-30 19:15:00,2019-03-30 19:30:00
119,8,7,1,0.010863879242928828,2019-03-30 19:15:00,2019-03-30 19:30:00
120,11,5,6,0.012219654236694296,2019-03-30 19:15:00,2019-03-30 19:30:00
122,2,1,1,0.0029565622874756638,2019-03-30 19:15:00,2019-03-30 19:30:00
127,2,1,1,0.008405652486162811,2019-03-30 19:15:00,2019-03-30 19:30:00
129,9,7,2,0.040385027942698964,2019-03-30 19:15:00,2019-03-30 19:30:00
135,1,1,0,0.004537750808445618,2019-03-30 19:15:00,2019-03-30 19:30:00
137,25,14,11,0.017411741993553394,2019-03-30 19:15:00,2019-03-30 19:30:00
138,8,5,3,0.010077511516543097,2019-03-30 19:15:00,2019-03-30 19:30:00
140,5,0,5,0.0024383692222408127,2019-03-30 19:15:00,2019-03-30 19:30:00
141,4,0,4,0.0024383692222408127,2019-03-30 19:15:00,2019-03-30 19:30:00
147,3,3,0,0.02155204558243761,2019-03-30 19:15:00,2019-03-30 19:30:00
151,15,8,7,0.017285298057625645,2019-03-30 19:15:00,2019-03-30 19:30:00
153,11,5,6,0.016729026154171055,2019-03-30 19:15:00,2019-03-30 19:30:00
158,1,1,0,0.003474755352710515,2019-03-30 19:15:00,2019-03-30 19:30:00
159,6,3,3,0.003971306218770979,2019-03-30 19:15:00,2019-03-30 19:30:00
160,2,2,0,0.005466879318239559,2019-03-30 19:15:00,2019-03-30 19:30:00
161,4,2,2,0.01622347577700495,2019-03-30 19:15:00,2019-03-30 19:30:00
162,3,2,1,0.005388698243639316,2019-03-30 19:15:00,2019-03-30 19:30:00
164,11,8,3,0.01217519633491112,2019-03-30 19:15:00,2019-03-30 19:30:00
168,22,8,14,0.012502795027563417,2019-03-30 19:15:00,2019-03-30 19:30:00
169,10,4,6,0.007239835481754373,2019-03-30 19:15:00,2019-03-30 19:30:00
170,2,1,1,0.01622347577700495,2019-03-30 19:15:00,2019-03-30 19:30:00
171,2,2,0,0.00448989802100839,2019-03-30 19:15:00,2019-03-30 19:30:00
172,1,1,0,0.003952456609166578,2019-03-30 19:15:00,2019-03-30 19:30:00
173,4,1,3,0.003474755352710515,2019-03-30 19:15:00,2019-03-30 19:30:00
177,2,1,1,0.007019387386586987,2019-03-30 19:15:00,2019-03-30 19:30:00
189,5,0,5,0.0024383692222408127,2019-03-30 19:15:00,2019-03-30 19:30:00
190,4,3,1,0.03934687398236883,2019-03-30 19:15:00,2019-03-30 19:30:00
191,7,3,4,0.005433321822874983,2019-03-30 19:15:00,2019-03-30 19:30:00
195,2,1,1,0.011674023714999322,2019-03-30 19:15:00,2019-03-30 19:30:00
196,6,3,3,0.005343269238421168,2019-03-30 19:15:00,2019-03-30 19:30:00
197,8,4,4,0.01181630720742357,2019-03-30 19:15:00,2019-03-30 19:30:00
199,2,0,2,0.0024383692222408127,2019-03-30 19:15:00,2019-03-30 19:30:00
201,2,0,2,0.0024383692222408127,2019-03-30 19:15:00,2019-03-30 19:30:00
202,1,0,1,0.0024383692222408127,2019-03-30 19:15:00,2019-03-30 19:30:00
203,5,3,2,0.010097997060862823,2019-03-30 19:15:00,2019-03-30 19:30:00
1,5,3,2,0.008620450622262587,2019-03-30 19:30:00,2019-03-30 19:45:00
2,8,4,4,0.007865667204491871,2019-03-30 19:30:00,2019-03-30 19:45:00
5,1,1,0,0.003547547868690804,2019-03-30 19:30:00,2019-03-30 19:45:00
10,3,0,3,0.0026422600902763164,2019-03-30 19:30:00,2019-03-30 19:45:00
11,1,0,1,0.0026422600902763164,2019-03-30 19:30:00,2019-03-30 19:45:00
15,6,4,2,0.032456269853434035,2019-03-30 19:30:00,2019-03-30 19:45:00
16,19,9,10,0.02056063703817822,2019-03-30 19:30:00,2019-03-30 19:45:00
18,9,5,4,0.009653421814285515,2019-03-30 19:30:00,2019-03-30 19:45:00
19,8,1,7,0.0035441786354544307,2019-03-30 19:30:00,2019-03-30 19:45:00
20,4,2,2,0.007194917110422952,2019-03-30 19:30:00,2019-03-30 19:45:00
23,4,4,0,0.021024841974312924,2019-03-30 19:30:00,2019-03-30 19:45:00
26,4,2,2,0.012770655874377566,2019-03-30 19:30:00,2019-03-30 19:45:00
28,2,2,0,0.005613900345011641,2019-03-30 19:30:00,2019-03-30 19:45:00
35,1,1,0,0.0051909148687439574,2019-03-30 19:30:00,2019-03-30 19:45:00
37,1,0,1,0.0026422600902763164,2019-03-30 19:30:00,2019-03-30 19:45:00
41,2,0,2,0.0026422600902763164,2019-03-30 19:30:00,2019-03-30 19:45:00
46,9,9,0,0.012434554195035946,2019-03-30 19:30:00,2019-03-30 19:45:00
57,11,5,6,0.006271398078191432,2019-03-30 19:30:00,2019-03-30 19:45:00
58,4,1,3,0.0048883727171585515,2019-03-30 19:30:00,2019-03-30 19:45:00
61,1,0,1,0.0026422600902763164,2019-03-30 19:30:00,2019-03-30 19:45:00
62,6,3,3,0.011109165563166497,2019-03-30 19:30:00,2019-03-30 19:45:00
64,2,2,0,0.0059856004698083665,2019-03-30 19:30:00,2019-03-30 19:45:00
66,1,1,0,0.0057903085141558395,2019-03-30 19:30:00,2019-03-30 19:45:00
67,2,1,1,0.004370351710177842,2019-03-30 19:30:00,2019-03-30 19:45:00
69,8,5,3,0.010958679331073877,2019-03-30 19:30:00,2019-03-30 19:45:00
70,5,4,1,0.011061106325382614,2019-03-30 19:30:00,2019-03-30 19:45:00
74,4,2,2,0.011057495222267474,2019-03-30 19:30:00,2019-03-30 19:45:00
75,2,1,1,0.004313930280042341,2019-03-30 19:30:00,2019-03-30 19:45:00
79,1,1,0,0.007154469248546696,2019-03-30 19:30:00,2019-03-30 19:45:00
80,2,2,0,0.007961117139286975,2019-03-30 19:30:00,2019-03-30 19:45:00
85,2,0,2,0.0026422600902763164,2019-03-30 19:30:00,2019-03-30 19:45:00
87,1,0,1,0.0026422600902763164,2019-03-30 19:30:00,2019-03-30 19:45:00
89,2,0,2,0.0026422600902763164,2019-03-30 19:30:00,2019-03-30 19:45:00
90,6,3,3,0.008601627721425939,2019-03-30 19:30:00,2019-03-30 19:45:00
104,2,1,1,0.006036550667235553,2019-03-30 19:30:00,2019-03-30 19:45:00
106,4,2,2,0.017549264971855178,2019-03-30 19:30:00,2019-03-30 19:45:00
109,10,3,7,0.007426750365720365,2019-03-30 19:30:00,2019-03-30 19:45:00
110,8,3,5,0.014108561469933122,2019-03-30 19:30:00,2019-03-30 19:45:00
111,11,2,9,0.0032576487835821602,2019-03-30 19:30:00,2019-03-30 19:45:00
112,8,3,5,0.005324641549010608,2019-03-30 19:30:00,2019-03-30 19:45:00
113,1,0,1,0.0026422600902763164,2019-03-30 19:30:00,2019-03-30 19:45:00
114,3,1,2,0.003495684999977502,2019-03-30 19:30:00,2019-03-30 19:45:00
115,4,4,0,0.007844909577865291,2019-03-30 19:30:00,2019-03-30 19:45:00
116,3,1,2,0.0043901599243696176,2019-03-30 19:30:00,2019-03-30 19:45:00
118,2,2,0,0.006382485947046804,2019-03-30 19:30:00,2019-03-30 19:45:00
119,4,3,1,0.009187839424789457,2019-03-30 19:30:00,2019-03-30 19:45:00
120,5,2,3,0.006098443330079367,2019-03-30 19:30:00,2019-03-30 19:45:00
122,3,3,0,0.0052627248216389234,2019-03-30 19:30:00,2019-03-30 19:45:00
126,1,0,1,0.0026422600902763164,2019-03-30 19:30:00,2019-03-30 19:45:00
127,3,2,1,0.009468006850200408,2019-03-30 19:30:00,2019-03-30 19:45:00
129,4,3,1,0.028848229175566,2019-03-30 19:30:00,2019-03-30 19:45:00
135,2,1,1,0.003506305900227079,2019-03-30 19:30:00,2019-03-30 19:45:00
137,18,9,9,0.020194796164617737,2019-03-30 19:30:00,2019-03-30 19:45:00
138,10,4,6,0.009194725211791136,2019-03-30 19:30:00,2019-03-30 19:45:00
140,4,0,4,0.0026422600902763164,2019-03-30 19:30:00,2019-03-30 19:45:00
141,1,0,1,0.0026422600902763164,2019-03-30 19:30:00,2019-03-30 19:45:00
147,3,3,0,0.019720034031410143,2019-03-30 19:30:00,2019-03-30 19:45:00
151,10,4,6,0.006098443330079367,2019-03-30 19:30:00,2019-03-30 19:45:00
153,9,7,2,0.017135842639054894,2019-03-30 19:30:00,2019-03-30 19:45:00
154,2,0,2,0.0026422600902763164,2019-03-30 19:30:00,2019-03-30 19:45:00
158,1,0,1,0.0026422600902763164,2019-03-30 19:30:00,2019-03-30 19:45:00
159,4,3,1,0.005307900610756023,2019-03-30 19:30:00,2019-03-30 19:45:00
160,3,3,0,0.00896221863984736,2019-03-30 19:30:00,2019-03-30 19:45:00
161,4,2,2,0.017549264971855178,2019-03-30 19:30:00,2019-03-30 19:45:00
162,2,1,1,0.003506305900227079,2019-03-30 19:30:00,2019-03-30 19:45:00
164,7,4,3,0.008994062286770842,2019-03-30 19:30:00,2019-03-30 19:45:00
168,23,10,13,0.013050633693513095,2019-03-30 19:30:00,2019-03-30 19:45:00
169,4,2,2,0.017549264971855178,2019-03-30 19:30:00,2019-03-30 19:45:00
170,2,1,1,0.017549264971855178,2019-03-30 19:30:00,2019-03-30 19:45:00
172,3,2,1,0.003992898583474717,2019-03-30 19:30:00,2019-03-30 19:45:00
173,7,3,4,0.009584428399676225,2019-03-30 19:30:00,2019-03-30 19:45:00
177,6,3,3,0.01297830994745327,2019-03-30 19:30:00,2019-03-30 19:45:00
189,3,0,3,0.0026422600902763164,2019-03-30 19:30:00,2019-03-30 19:45:00
190,2,2,0,0.003503072712022541,2019-03-30 19:30:00,2019-03-30 19:45:00
191,2,2,0,0.006716106012965126,2019-03-30 19:30:00,2019-03-30 19:45:00
195,1,0,1,0.0026422600902763164,2019-03-30 19:30:00,2019-03-30 19:45:00
196,7,2,5,0.005412595844728545,2019-03-30 19:30:00,2019-03-30 19:45:00
197,13,7,6,0.018770003588531113,2019-03-30 19:30:00,2019-03-30 19:45:00
201,1,0,1,0.0026422600902763164,2019-03-30 19:30:00,2019-03-30 19:45:00
202,2,1,1,0.0048883727171585515,2019-03-30 19:30:00,2019-03-30 19:45:00
203,5,3,2,0.008592994556912785,2019-03-30 19:30:00,2019-03-30 19:45:00
1,6,5,1,0.05500349274021156,2019-03-30 19:45:00,2019-03-30 20:00:00
2,5,3,2,0.0050279032864562,2019-03-30 19:45:00,2019-03-30 20:00:00
5,2,2,0,0.011979705462049154,2019-03-30 19:45:00,2019-03-30 20:00:00
10,4,0,4,0.002614524173864806,2019-03-30 19:45:00,2019-03-30 20:00:00
15,1,1,0,0.003320104858590557,2019-03-30 19:45:00,2019-03-30 20:00:00
16,16,9,7,0.011877015968187913,2019-03-30 19:45:00,2019-03-30 20:00:00
18,9,5,4,0.005808049495425776,2019-03-30 19:45:00,2019-03-30 20:00:00
19,11,1,10,0.002857424631771432,2019-03-30 19:45:00,2019-03-30 20:00:00
20,2,0,2,0.002614524173864806,2019-03-30 19:45:00,2019-03-30 20:00:00
23,5,1,4,0.003320104858590557,2019-03-30 19:45:00,2019-03-30 20:00:00
26,4,2,2,0.007908998971816574,2019-03-30 19:45:00,2019-03-30 20:00:00
27,1,1,0,0.003960203019183807,2019-03-30 19:45:00,2019-03-30 20:00:00
35,1,1,0,0.008322824732191769,2019-03-30 19:45:00,2019-03-30 20:00:00
37,1,0,1,0.002614524173864806,2019-03-30 19:45:00,2019-03-30 20:00:00
41,4,2,2,0.004969779469665382,2019-03-30 19:45:00,2019-03-30 20:00:00
46,7,6,1,0.00748802306503916,2019-03-30 19:45:00,2019-03-30 20:00:00
50,1,1,0,0.003100027139947231,2019-03-30 19:45:00,2019-03-30 20:00:00
57,16,7,9,0.005737340267804807,2019-03-30 19:45:00,2019-03-30 20:00:00
58,10,5,5,0.01506623736301801,2019-03-30 19:45:00,2019-03-30 20:00:00
61,2,0,2,0.002614524173864806,2019-03-30 19:45:00,2019-03-30 20:00:00
62,5,2,3,0.006749611513618858,2019-03-30 19:45:00,2019-03-30 20:00:00
64,2,2,0,0.006888690271198504,2019-03-30 19:45:00,2019-03-30 20:00:00
66,1,1,0,0.003100027139947231,2019-03-30 19:45:00,2019-03-30 20:00:00
67,4,3,1,0.020974466852000814,2019-03-30 19:45:00,2019-03-30 20:00:00
69,6,4,2,0.010648183180333922,2019-03-30 19:45:00,2019-03-30 20:00:00
70,2,2,0,0.011666625872585566,2019-03-30 19:45:00,2019-03-30 20:00:00
74,3,1,2,0.004547308502086593,2019-03-30 19:45:00,2019-03-30 20:00:00
79,2,2,0,0.006959932286138842,2019-03-30 19:45:00,2019-03-30 20:00:00
80,2,2,0,0.01370516098402648,2019-03-30 19:45:00,2019-03-30 20:00:00
85,2,0,2,0.002614524173864806,2019-03-30 19:45:00,2019-03-30 20:00:00
87,1,0,1,0.002614524173864806,2019-03-30 19:45:00,2019-03-30 20:00:00
88,1,1,0,0.00854751838896095,2019-03-30 19:45:00,2019-03-30 20:00:00
89,8,2,6,0.003648296008803319,2019-03-30 19:45:00,2019-03-30 20:00:00
90,9,6,3,0.010660660030730743,2019-03-30 19:45:00,2019-03-30 20:00:00
104,6,2,4,0.010043312793063546,2019-03-30 19:45:00,2019-03-30 20:00:00
106,4,2,2,0.017371580001842267,2019-03-30 19:45:00,2019-03-30 20:00:00
108,2,0,2,0.002614524173864806,2019-03-30 19:45:00,2019-03-30 20:00:00
109,9,5,4,0.016580868152534508,2019-03-30 19:45:00,2019-03-30 20:00:00
110,5,4,1,0.007945128039918542,2019-03-30 19:45:00,2019-03-30 20:00:00
111,10,0,10,0.002614524173864806,2019-03-30 19:45:00,2019-03-30 20:00:00
112,6,3,3,0.030432543644888614,2019-03-30 19:45:00,2019-03-30 20:00:00
113,3,0,3,0.002614524173864806,2019-03-30 19:45:00,2019-03-30 20:00:00
114,5,3,2,0.0053225465293433505,2019-03-30 19:45:00,2019-03-30 20:00:00
116,3,1,2,0.00405689735429135,2019-03-30 19:45:00,2019-03-30 20:00:00
118,6,5,1,0.027698878708624083,2019-03-30 19:45:00,2019-03-30 20:00:00
119,1,0,1,0.002614524173864806,2019-03-30 19:45:00,2019-03-30 20:00:00
120,2,0,2,0.002614524173864806,2019-03-30 19:45:00,2019-03-30 20:00:00
122,3,3,0,0.004242669786032122,2019-03-30 19:45:00,2019-03-30 20:00:00
126,3,0,3,0.002614524173864806,2019-03-30 19:45:00,2019-03-30 20:00:00
127,3,2,1,0.006979189400168487,2019-03-30 19:45:00,2019-03-30 20:00:00
129,2,1,1,0.017371580001842267,2019-03-30 19:45:00,2019-03-30 20:00:00
135,1,0,1,0.002614524173864806,2019-03-30 19:45:00,2019-03-30 20:00:00
137,14,5,9,0.012494975566019991,2019-03-30 19:45:00,2019-03-30 20:00:00
138,15,7,8,0.01890049879908453,2019-03-30 19:45:00,2019-03-30 20:00:00
140,1,1,0,0.003131410091334062,2019-03-30 19:45:00,2019-03-30 20:00:00
141,1,1,0,0.004323374199431978,2019-03-30 19:45:00,2019-03-30 20:00:00
147,1,1,0,0.005976214643594787,2019-03-30 19:45:00,2019-03-30 20:00:00
151,9,4,5,0.008172817811533188,2019-03-30 19:45:00,2019-03-30 20:00:00
153,8,8,0,0.01664074976708005,2019-03-30 19:45:00,2019-03-30 20:00:00
158,7,3,4,0.00804063897661643,2019-03-30 19:45:00,2019-03-30 20:00:00
159,4,3,1,0.004240267164999936,2019-03-30 19:45:00,2019-03-30 20:00:00
160,3,3,0,0.006046721660968181,2019-03-30 19:45:00,2019-03-30 20:00:00
161,4,2,2,0.017371580001842267,2019-03-30 19:45:00,2019-03-30 20:00:00
162,4,1,3,0.004004097583281902,2019-03-30 19:45:00,2019-03-30 20:00:00
164,6,5,1,0.006714965823600099,2019-03-30 19:45:00,2019-03-30 20:00:00
168,20,8,12,0.00685343068732258,2019-03-30 19:45:00,2019-03-30 20:00:00
169,4,2,2,0.017371580001842267,2019-03-30 19:45:00,2019-03-30 20:00:00
170,3,1,2,0.004547308502086593,2019-03-30 19:45:00,2019-03-30 20:00:00
171,2,0,2,0.002614524173864806,2019-03-30 19:45:00,2019-03-30 20:00:00
172,7,5,2,0.008738864326561624,2019-03-30 19:45:00,2019-03-30 20:00:00
173,4,1,3,0.00474896488704281,2019-03-30 19:45:00,2019-03-30 20:00:00
177,6,3,3,0.00865333749369579,2019-03-30 19:45:00,2019-03-30 20:00:00
189,1,0,1,0.002614524173864806,2019-03-30 19:45:00,2019-03-30 20:00:00
190,10,5,5,0.005287585367334556,2019-03-30 19:45:00,2019-03-30 20:00:00
191,2,1,1,0.017371580001842267,2019-03-30 19:45:00,2019-03-30 20:00:00
196,5,3,2,0.008848930638830516,2019-03-30 19:45:00,2019-03-30 20:00:00
197,7,5,2,0.013046216012977016,2019-03-30 19:45:00,2019-03-30 20:00:00
199,1,0,1,0.002614524173864806,2019-03-30 19:45:00,2019-03-30 20:00:00
201,1,0,1,0.002614524173864806,2019-03-30 19:45:00,2019-03-30 20:00:00
202,1,1,0,0.004837043563260926,2019-03-30 19:45:00,2019-03-30 20:00:00
203,1,1,0,0.003100027139947231,2019-03-30 19:45:00,2019-03-30 20:00:00
1,4,3,1,0.03180385004047017,2019-03-30 20:00:00,2019-03-30 20:15:00
2,4,2,2,0.003524746557591437,2019-03-30 20:00:00,2019-03-30 20:15:00
5,2,2,0,0.007732088677244359,2019-03-30 20:00:00,2019-03-30 20:15:00
10,5,0,5,0.0026208965806154964,2019-03-30 20:00:00,2019-03-30 20:15:00
15,3,2,1,0.008290672558387169,2019-03-30 20:00:00,2019-03-30 20:15:00
16,10,5,5,0.006990356230669388,2019-03-30 20:00:00,2019-03-30 20:15:00
18,9,5,4,0.005607695486644463,2019-03-30 20:00:00,2019-03-30 20:15:00
19,7,0,7,0.0026208965806154964,2019-03-30 20:00:00,2019-03-30 20:15:00
20,1,0,1,0.0026208965806154964,2019-03-30 20:00:00,2019-03-30 20:15:00
23,8,1,7,0.002983171841506098,2019-03-30 20:00:00,2019-03-30 20:15:00
26,4,2,2,0.007928471854554182,2019-03-30 20:00:00,2019-03-30 20:15:00
28,1,1,0,0.004677233884621964,2019-03-30 20:00:00,2019-03-30 20:15:00
35,4,4,0,0.008470282631705137,2019-03-30 20:00:00,2019-03-30 20:15:00
37,1,0,1,0.0026208965806154964,2019-03-30 20:00:00,2019-03-30 20:15:00
41,1,1,0,0.0029391763434531808,2019-03-30 20:00:00,2019-03-30 20:15:00
46,3,2,1,0.00418046741852015,2019-03-30 20:00:00,2019-03-30 20:15:00
50,1,1,0,0.0030728215691034665,2019-03-30 20:00:00,2019-03-30 20:15:00
57,15,6,9,0.005911436606059277,2019-03-30 20:00:00,2019-03-30 20:15:00
58,1,1,0,0.01649173555059711,2019-03-30 20:00:00,2019-03-30 20:15:00
62,6,3,3,0.011191712104634299,2019-03-30 20:00:00,2019-03-30 20:15:00
64,2,2,0,0.005617233750797335,2019-03-30 20:00:00,2019-03-30 20:15:00
66,1,1,0,0.0030728215691034665,2019-03-30 20:00:00,2019-03-30 20:15:00
67,5,3,2,0.00848323490814289,2019-03-30 20:00:00,2019-03-30 20:15:00
68,2,1,1,0.006243406532768472,2019-03-30 20:00:00,2019-03-30 20:15:00
74,3,1,2,0.004558439139526235,2019-03-30 20:00:00,2019-03-30 20:15:00
79,1,1,0,0.004193696700382739,2019-03-30 20:00:00,2019-03-30 20:15:00
85,2,0,2,0.0026208965806154964,2019-03-30 20:00:00,2019-03-30 20:15:00
88,1,1,0,0.00610231770258049,2019-03-30 20:00:00,2019-03-30 20:15:00
89,2,0,2,0.0026208965806154964,2019-03-30 20:00:00,2019-03-30 20:15:00
90,7,7,0,0.01591454578307496,2019-03-30 20:00:00,2019-03-30 20:15:00
99,4,2,2,0.01744476481846925,2019-03-30 20:00:00,2019-03-30 20:15:00
104,4,0,4,0.0026208965806154964,2019-03-30 20:00:00,2019-03-30 20:15:00
106,4,2,2,0.01744476481846925,2019-03-30 20:00:00,2019-03-30 20:15:00
108,2,0,2,0.0026208965806154964,2019-03-30 20:00:00,2019-03-30 20:15:00
109,9,5,4,0.012979191343887524,2019-03-30 20:00:00,2019-03-30 20:15:00
110,2,1,1,0.0030728215691034665,2019-03-30 20:00:00,2019-03-30 20:15:00
111,9,4,5,0.00511889728863778,2019-03-30 20:00:00,2019-03-30 20:15:00
112,8,3,5,0.012094073894590402,2019-03-30 20:00:00,2019-03-30 20:15:00
113,2,0,2,0.0026208965806154964,2019-03-30 20:00:00,2019-03-30 20:15:00
114,4,2,2,0.004848854920479287,2019-03-30 20:00:00,2019-03-30 20:15:00
115,6,4,2,0.010827764512877931,2019-03-30 20:00:00,2019-03-30 20:15:00
116,4,1,3,0.0038093919424779456,2019-03-30 20:00:00,2019-03-30 20:15:00
118,3,2,1,0.009832755356774161,2019-03-30 20:00:00,2019-03-30 20:15:00
120,4,1,3,0.006174633959181676,2019-03-30 20:00:00,2019-03-30 20:15:00
122,2,2,0,0.003512079916561013,2019-03-30 20:00:00,2019-03-30 20:15:00
126,3,1,2,0.00370033675961348,2019-03-30 20:00:00,2019-03-30 20:15:00
127,5,3,2,0.008190457355026437,2019-03-30 20:00:00,2019-03-30 20:15:00
129,3,2,1,0.06430246401771222,2019-03-30 20:00:00,2019-03-30 20:15:00
135,1,0,1,0.0026208965806154964,2019-03-30 20:00:00,2019-03-30 20:15:00
137,5,1,4,0.004848854920479287,2019-03-30 20:00:00,2019-03-30 20:15:00
138,21,11,10,0.019458876517955654,2019-03-30 20:00:00,2019-03-30 20:15:00
141,3,2,1,0.00905431432663685,2019-03-30 20:00:00,2019-03-30 20:15:00
147,1,1,0,0.005990929295643444,2019-03-30 20:00:00,2019-03-30 20:15:00
151,9,4,5,0.008193288370310425,2019-03-30 20:00:00,2019-03-30 20:15:00
153,9,8,1,0.016316125573129243,2019-03-30 20:00:00,2019-03-30 20:15:00
157,1,1,0,0.00610231770258049,2019-03-30 20:00:00,2019-03-30 20:15:00
158,8,4,4,0.015134618751346226,2019-03-30 20:00:00,2019-03-30 20:15:00
162,4,1,3,0.0040139945280392286,2019-03-30 20:00:00,2019-03-30 20:15:00
164,15,7,8,0.008344640835115415,2019-03-30 20:00:00,2019-03-30 20:15:00
168,13,3,10,0.005316167067178079,2019-03-30 20:00:00,2019-03-30 20:15:00
169,4,2,2,0.01744476481846925,2019-03-30 20:00:00,2019-03-30 20:15:00
170,5,4,1,0.05681407151806014,2019-03-30 20:00:00,2019-03-30 20:15:00
172,7,7,0,0.010886307894082074,2019-03-30 20:00:00,2019-03-30 20:15:00
173,4,3,1,0.02907645762877891,2019-03-30 20:00:00,2019-03-30 20:15:00
177,2,1,1,0.0037583436436746656,2019-03-30 20:00:00,2019-03-30 20:15:00
190,10,5,5,0.005847689707045257,2019-03-30 20:00:00,2019-03-30 20:15:00
191,3,1,2,0.004848854920479287,2019-03-30 20:00:00,2019-03-30 20:15:00
196,3,1,2,0.004370560300129955,2019-03-30 20:00:00,2019-03-30 20:15:00
197,6,4,2,0.008324674304788077,2019-03-30 20:00:00,2019-03-30 20:15:00
199,1,0,1,0.0026208965806154964,2019-03-30 20:00:00,2019-03-30 20:15:00
201,1,0,1,0.0026208965806154964,2019-03-30 20:00:00,2019-03-30 20:15:00
202,1,1,0,0.004848854920479287,2019-03-30 20:00:00,2019-03-30 20:15:00
203,3,2,1,0.004261316930965916,2019-03-30 20:00:00,2019-03-30 20:15:00
1,4,2,2,0.008935372203186295,2019-03-30 20:15:00,2019-03-30 20:30:00
5,1,0,1,0.002491183694754495,2019-03-30 20:15:00,2019-03-30 20:30:00
10,1,0,1,0.002491183694754495,2019-03-30 20:15:00,2019-03-30 20:30:00
15,1,1,0,0.011106262588546585,2019-03-30 20:15:00,2019-03-30 20:30:00
16,14,6,8,0.005850224508486251,2019-03-30 20:15:00,2019-03-30 20:30:00
18,11,6,5,0.004608867680861473,2019-03-30 20:15:00,2019-03-30 20:30:00
19,7,2,5,0.0037344963957987943,2019-03-30 20:15:00,2019-03-30 20:30:00
20,3,3,0,0.005003751802951438,2019-03-30 20:15:00,2019-03-30 20:30:00
23,7,2,5,0.0033204164203544536,2019-03-30 20:15:00,2019-03-30 20:30:00
26,6,2,4,0.005502171761864995,2019-03-30 20:15:00,2019-03-30 20:30:00
28,2,2,0,0.003989631861439263,2019-03-30 20:15:00,2019-03-30 20:30:00
35,6,3,3,0.00784615244882495,2019-03-30 20:15:00,2019-03-30 20:30:00
37,1,0,1,0.002491183694754495,2019-03-30 20:15:00,2019-03-30 20:30:00
41,2,2,0,0.004597538942213175,2019-03-30 20:15:00,2019-03-30 20:30:00
46,8,6,2,0.020802666679770692,2019-03-30 20:15:00,2019-03-30 20:30:00
50,3,1,2,0.0030206046912812394,2019-03-30 20:15:00,2019-03-30 20:30:00
57,11,2,9,0.0037610439099803497,2019-03-30 20:15:00,2019-03-30 20:30:00
58,4,3,1,0.006699838555339956,2019-03-30 20:15:00,2019-03-30 20:30:00
62,8,3,5,0.005084663786065641,2019-03-30 20:15:00,2019-03-30 20:30:00
64,1,1,0,0.0040000814171014636,2019-03-30 20:15:00,2019-03-30 20:30:00
66,2,0,2,0.002491183694754495,2019-03-30 20:15:00,2019-03-30 20:30:00
67,2,0,2,0.002491183694754495,2019-03-30 20:15:00,2019-03-30 20:30:00
68,5,4,1,0.010134219432601923,2019-03-30 20:15:00,2019-03-30 20:30:00
70,1,0,1,0.002491183694754495,2019-03-30 20:15:00,2019-03-30 20:30:00
74,3,1,2,0.004332828443949803,2019-03-30 20:15:00,2019-03-30 20:30:00
79,1,1,0,0.004436769291481917,2019-03-30 20:15:00,2019-03-30 20:30:00
85,2,0,2,0.002491183694754495,2019-03-30 20:15:00,2019-03-30 20:30:00
87,3,0,3,0.002491183694754495,2019-03-30 20:15:00,2019-03-30 20:30:00
88,10,7,3,0.008903740617299746,2019-03-30 20:15:00,2019-03-30 20:30:00
90,4,1,3,0.002930824060178124,2019-03-30 20:15:00,2019-03-30 20:30:00
99,4,2,2,0.016592491309590746,2019-03-30 20:15:00,2019-03-30 20:30:00
104,1,0,1,0.002491183694754495,2019-03-30 20:15:00,2019-03-30 20:30:00
106,4,2,2,0.016592491309590746,2019-03-30 20:15:00,2019-03-30 20:30:00
108,3,1,2,0.0035500256878079842,2019-03-30 20:15:00,2019-03-30 20:30:00
109,9,6,3,0.02378694057922005,2019-03-30 20:15:00,2019-03-30 20:30:00
110,5,1,4,0.010486464868231397,2019-03-30 20:15:00,2019-03-30 20:30:00
111,9,2,7,0.003620228149427667,2019-03-30 20:15:00,2019-03-30 20:30:00
112,8,3,5,0.006723937127870274,2019-03-30 20:15:00,2019-03-30 20:30:00
114,3,3,0,0.007149894284633435,2019-03-30 20:15:00,2019-03-30 20:30:00
115,11,9,2,0.017752418398405013,2019-03-30 20:15:00,2019-03-30 20:30:00
116,2,1,1,0.003112840045276645,2019-03-30 20:15:00,2019-03-30 20:30:00
118,3,1,2,0.0036343866706846995,2019-03-30 20:15:00,2019-03-30 20:30:00
119,17,5,12,0.003857524817825306,2019-03-30 20:15:00,2019-03-30 20:30:00
120,1,1,0,0.011334374382180688,2019-03-30 20:15:00,2019-03-30 20:30:00
122,3,1,2,0.004332828443949803,2019-03-30 20:15:00,2019-03-30 20:30:00
126,6,3,3,0.00686589805184308,2019-03-30 20:15:00,2019-03-30 20:30:00
127,10,5,5,0.007143680448027439,2019-03-30 20:15:00,2019-03-30 20:30:00
137,6,5,1,0.009405033003946711,2019-03-30 20:15:00,2019-03-30 20:30:00
138,19,12,7,0.014697997892873953,2019-03-30 20:15:00,2019-03-30 20:30:00
140,1,1,0,0.003112840045276645,2019-03-30 20:15:00,2019-03-30 20:30:00
141,3,3,0,0.007483715809543861,2019-03-30 20:15:00,2019-03-30 20:30:00
147,1,1,0,0.0036605270126696867,2019-03-30 20:15:00,2019-03-30 20:30:00
151,5,3,2,0.02364314511700887,2019-03-30 20:15:00,2019-03-30 20:30:00
153,5,2,3,0.005790378831133942,2019-03-30 20:15:00,2019-03-30 20:30:00
157,3,3,0,0.005117537399006396,2019-03-30 20:15:00,2019-03-30 20:30:00
158,6,3,3,0.011756778131191845,2019-03-30 20:15:00,2019-03-30 20:30:00
162,2,0,2,0.002491183694754495,2019-03-30 20:15:00,2019-03-30 20:30:00
164,14,7,7,0.005621919422432697,2019-03-30 20:15:00,2019-03-30 20:30:00
168,4,0,4,0.002491183694754495,2019-03-30 20:15:00,2019-03-30 20:30:00
170,7,6,1,0.15556025559604897,2019-03-30 20:15:00,2019-03-30 20:30:00
172,5,5,0,0.005919654227951043,2019-03-30 20:15:00,2019-03-30 20:30:00
173,8,6,2,0.06494408732218696,2019-03-30 20:15:00,2019-03-30 20:30:00
177,3,1,2,0.0035500256878079842,2019-03-30 20:15:00,2019-03-30 20:30:00
190,4,4,0,0.006099730545810733,2019-03-30 20:15:00,2019-03-30 20:30:00
191,8,0,8,0.002491183694754495,2019-03-30 20:15:00,2019-03-30 20:30:00
196,4,1,3,0.009232381029260472,2019-03-30 20:15:00,2019-03-30 20:30:00
197,2,1,1,0.004436769291481917,2019-03-30 20:15:00,2019-03-30 20:30:00
203,3,2,1,0.0036422610418033892,2019-03-30 20:15:00,2019-03-30 20:30:00
1,2,1,1,0.00362427792879543,2019-03-30 20:30:00,2019-03-30 20:45:00
5,1,0,1,0.0029077599048486363,2019-03-30 20:30:00,2019-03-30 20:45:00
10,1,0,1,0.0029077599048486363,2019-03-30 20:30:00,2019-03-30 20:45:00
15,1,1,0,0.0038098134557870314,2019-03-30 20:30:00,2019-03-30 20:45:00
16,10,3,7,0.010733618409793873,2019-03-30 20:30:00,2019-03-30 20:45:00
18,10,4,6,0.007008318509540985,2019-03-30 20:30:00,2019-03-30 20:45:00
19,6,4,2,0.007361637773191482,2019-03-30 20:30:00,2019-03-30 20:45:00
20,7,5,2,0.014447293170954667,2019-03-30 20:30:00,2019-03-30 20:45:00
23,10,4,6,0.006517667035337052,2019-03-30 20:30:00,2019-03-30 20:45:00
26,6,2,4,0.0064221524731366535,2019-03-30 20:30:00,2019-03-30 20:45:00
28,7,4,3,0.01097407456891077,2019-03-30 20:30:00,2019-03-30 20:45:00
35,5,0,5,0.0029077599048486363,2019-03-30 20:30:00,2019-03-30 20:45:00
37,1,0,1,0.0029077599048486363,2019-03-30 20:30:00,2019-03-30 20:45:00
41,4,2,2,0.0056416893939213,2019-03-30 20:30:00,2019-03-30 20:45:00
46,6,6,0,0.018462417654642224,2019-03-30 20:30:00,2019-03-30 20:45:00
50,2,0,2,0.0029077599048486363,2019-03-30 20:30:00,2019-03-30 20:45:00
57,2,0,2,0.0029077599048486363,2019-03-30 20:30:00,2019-03-30 20:45:00
58,3,2,1,0.005379548435662477,2019-03-30 20:30:00,2019-03-30 20:45:00
61,1,1,0,0.005988654973284784,2019-03-30 20:30:00,2019-03-30 20:45:00
62,6,4,2,0.005623942448958247,2019-03-30 20:30:00,2019-03-30 20:45:00
64,1,1,0,0.004668958128896749,2019-03-30 20:30:00,2019-03-30 20:45:00
66,2,0,2,0.0029077599048486363,2019-03-30 20:30:00,2019-03-30 20:45:00
67,8,3,5,0.005488795166631397,2019-03-30 20:30:00,2019-03-30 20:45:00
68,5,4,1,0.006139252260793248,2019-03-30 20:30:00,2019-03-30 20:45:00
70,1,0,1,0.0029077599048486363,2019-03-30 20:30:00,2019-03-30 20:45:00
74,3,1,2,0.005057313976689017,2019-03-30 20:30:00,2019-03-30 20:45:00
85,2,0,2,0.0029077599048486363,2019-03-30 20:30:00,2019-03-30 20:45:00
87,6,4,2,0.02633395185723837,2019-03-30 20:30:00,2019-03-30 20:45:00
88,12,6,6,0.005444725991932649,2019-03-30 20:30:00,2019-03-30 20:45:00
89,1,1,0,0.004211265354852441,2019-03-30 20:30:00,2019-03-30 20:45:00
90,8,3,5,0.00547014518651758,2019-03-30 20:30:00,2019-03-30 20:45:00
104,2,1,1,0.006017483752712085,2019-03-30 20:30:00,2019-03-30 20:45:00
106,4,2,2,0.019301803443510814,2019-03-30 20:30:00,2019-03-30 20:45:00
108,3,1,2,0.0038409361460888364,2019-03-30 20:30:00,2019-03-30 20:45:00
109,13,9,4,0.01961256748446076,2019-03-30 20:30:00,2019-03-30 20:45:00
110,4,1,3,0.005847845228311835,2019-03-30 20:30:00,2019-03-30 20:45:00
111,5,2,3,0.0044817704444625765,2019-03-30 20:30:00,2019-03-30 20:45:00
112,6,4,2,0.009971290603482872,2019-03-30 20:30:00,2019-03-30 20:45:00
114,7,6,1,0.009777522162109975,2019-03-30 20:30:00,2019-03-30 20:45:00
115,15,6,9,0.009480655095660411,2019-03-30 20:30:00,2019-03-30 20:45:00
116,1,1,0,0.004211265354852441,2019-03-30 20:30:00,2019-03-30 20:45:00
118,3,1,2,0.007146039235472407,2019-03-30 20:30:00,2019-03-30 20:45:00
119,7,0,7,0.0029077599048486363,2019-03-30 20:30:00,2019-03-30 20:45:00
120,2,2,0,0.003968716896653572,2019-03-30 20:30:00,2019-03-30 20:45:00
122,6,3,3,0.00621032216563383,2019-03-30 20:30:00,2019-03-30 20:45:00
126,9,3,6,0.005057313976689017,2019-03-30 20:30:00,2019-03-30 20:45:00
127,8,3,5,0.005729915120701685,2019-03-30 20:30:00,2019-03-30 20:45:00
137,12,8,4,0.013834223671949513,2019-03-30 20:30:00,2019-03-30 20:45:00
138,14,12,2,0.025922808903873638,2019-03-30 20:30:00,2019-03-30 20:45:00
141,9,3,6,0.005554796658501272,2019-03-30 20:30:00,2019-03-30 20:45:00
147,1,1,0,0.004272598401296273,2019-03-30 20:30:00,2019-03-30 20:45:00
151,1,1,0,0.0038409361460888364,2019-03-30 20:30:00,2019-03-30 20:45:00
153,8,0,8,0.0029077599048486363,2019-03-30 20:30:00,2019-03-30 20:45:00
154,2,2,0,0.0035257070375520963,2019-03-30 20:30:00,2019-03-30 20:45:00
157,3,3,0,0.026288036807285673,2019-03-30 20:30:00,2019-03-30 20:45:00
158,1,1,0,0.007480764270227246,2019-03-30 20:30:00,2019-03-30 20:45:00
159,3,0,3,0.0029077599048486363,2019-03-30 20:30:00,2019-03-30 20:45:00
162,2,0,2,0.0029077599048486363,2019-03-30 20:30:00,2019-03-30 20:45:00
164,9,2,7,0.004368254142673937,2019-03-30 20:30:00,2019-03-30 20:45:00
168,6,4,2,0.017124348928622447,2019-03-30 20:30:00,2019-03-30 20:45:00
170,9,6,3,0.038557241979773574,2019-03-30 20:30:00,2019-03-30 20:45:00
172,6,6,0,0.01474063002679774,2019-03-30 20:30:00,2019-03-30 20:45:00
173,5,4,1,0.0655120507281937,2019-03-30 20:30:00,2019-03-30 20:45:00
177,3,1,2,0.004143654170255556,2019-03-30 20:30:00,2019-03-30 20:45:00
190,4,4,0,0.011895498515096735,2019-03-30 20:30:00,2019-03-30 20:45:00
191,6,1,5,0.005305702472138976,2019-03-30 20:30:00,2019-03-30 20:45:00
196,4,1,3,0.004057474827293196,2019-03-30 20:30:00,2019-03-30 20:45:00
197,1,0,1,0.0029077599048486363,2019-03-30 20:30:00,2019-03-30 20:45:00
203,2,2,0,0.011946325318813003,2019-03-30 20:30:00,2019-03-30 20:45:00
1,1,1,0,0.0050684801139539055,2019-03-30 20:45:00,2019-03-30 21:00:00
10,4,2,2,0.0193702212118098,2019-03-30 20:45:00,2019-03-30 21:00:00
15,8,1,7,0.00644435375456095,2019-03-30 20:45:00,2019-03-30 21:00:00
16,8,4,4,0.020877157344173697,2019-03-30 20:45:00,2019-03-30 21:00:00
18,4,1,3,0.007351105533903092,2019-03-30 20:45:00,2019-03-30 21:00:00
19,7,3,4,0.011216751280828248,2019-03-30 20:45:00,2019-03-30 21:00:00
20,6,3,3,0.019111972840111006,2019-03-30 20:45:00,2019-03-30 21:00:00
23,12,6,6,0.010187037149753515,2019-03-30 20:45:00,2019-03-30 21:00:00
26,4,2,2,0.0064363274208001425,2019-03-30 20:45:00,2019-03-30 21:00:00
28,6,4,2,0.015710163682395417,2019-03-30 20:45:00,2019-03-30 21:00:00
30,1,1,0,0.005298093352605249,2019-03-30 20:45:00,2019-03-30 21:00:00
35,6,0,6,0.002914185843169466,2019-03-30 20:45:00,2019-03-30 21:00:00
37,1,0,1,0.002914185843169466,2019-03-30 20:45:00,2019-03-30 21:00:00
41,2,0,2,0.002914185843169466,2019-03-30 20:45:00,2019-03-30 21:00:00
58,11,6,5,0.01864323557077473,2019-03-30 20:45:00,2019-03-30 21:00:00
62,1,1,0,0.0039086131147439375,2019-03-30 20:45:00,2019-03-30 21:00:00
64,1,1,0,0.004679269798865208,2019-03-30 20:45:00,2019-03-30 21:00:00
67,9,5,4,0.010549891332731601,2019-03-30 20:45:00,2019-03-30 21:00:00
68,5,4,1,0.00716673297910245,2019-03-30 20:45:00,2019-03-30 21:00:00
70,1,0,1,0.002914185843169466,2019-03-30 20:45:00,2019-03-30 21:00:00
74,5,1,4,0.0037006328071076677,2019-03-30 20:45:00,2019-03-30 21:00:00
85,4,2,2,0.009253845058021388,2019-03-30 20:45:00,2019-03-30 21:00:00
87,4,4,0,0.008728076899591736,2019-03-30 20:45:00,2019-03-30 21:00:00
88,3,1,2,0.003566091342327034,2019-03-30 20:45:00,2019-03-30 21:00:00
90,4,2,2,0.0036219698716205098,2019-03-30 20:45:00,2019-03-30 21:00:00
104,2,2,0,0.016269411950382777,2019-03-30 20:45:00,2019-03-30 21:00:00
106,6,4,2,0.02981661348161123,2019-03-30 20:45:00,2019-03-30 21:00:00
108,3,1,2,0.005156330742289126,2019-03-30 20:45:00,2019-03-30 21:00:00
109,15,6,9,0.006901865907690791,2019-03-30 20:45:00,2019-03-30 21:00:00
110,3,3,0,0.012887960050263082,2019-03-30 20:45:00,2019-03-30 21:00:00
111,4,2,2,0.005804679876003187,2019-03-30 20:45:00,2019-03-30 21:00:00
112,3,2,1,0.0037399338763623507,2019-03-30 20:45:00,2019-03-30 21:00:00
114,4,3,1,0.007916863663696537,2019-03-30 20:45:00,2019-03-30 21:00:00
115,7,0,7,0.002914185843169466,2019-03-30 20:45:00,2019-03-30 21:00:00
116,1,1,0,0.007351105533903092,2019-03-30 20:45:00,2019-03-30 21:00:00
118,1,1,0,0.006456629842996739,2019-03-30 20:45:00,2019-03-30 21:00:00
119,6,4,2,0.01419492318690226,2019-03-30 20:45:00,2019-03-30 21:00:00
120,3,2,1,0.0053914299427481206,2019-03-30 20:45:00,2019-03-30 21:00:00
122,2,2,0,0.005945613571983404,2019-03-30 20:45:00,2019-03-30 21:00:00
126,3,1,2,0.0050684801139539055,2019-03-30 20:45:00,2019-03-30 21:00:00
127,5,1,4,0.004679269798865208,2019-03-30 20:45:00,2019-03-30 21:00:00
137,11,5,6,0.02038922705815309,2019-03-30 20:45:00,2019-03-30 21:00:00
138,14,9,5,0.02083491095500095,2019-03-30 20:45:00,2019-03-30 21:00:00
140,3,1,2,0.005803072050608538,2019-03-30 20:45:00,2019-03-30 21:00:00
141,8,3,5,0.008500564087017805,2019-03-30 20:45:00,2019-03-30 21:00:00
147,1,1,0,0.00564988045686194,2019-03-30 20:45:00,2019-03-30 21:00:00
151,1,1,0,0.005156330742289126,2019-03-30 20:45:00,2019-03-30 21:00:00
153,5,2,3,0.004479378435460072,2019-03-30 20:45:00,2019-03-30 21:00:00
154,5,4,1,0.01751996546732849,2019-03-30 20:45:00,2019-03-30 21:00:00
157,2,2,0,0.005649144952442571,2019-03-30 20:45:00,2019-03-30 21:00:00
158,2,2,0,0.00846792296003121,2019-03-30 20:45:00,2019-03-30 21:00:00
159,4,0,4,0.002914185843169466,2019-03-30 20:45:00,2019-03-30 21:00:00
162,2,0,2,0.002914185843169466,2019-03-30 20:45:00,2019-03-30 21:00:00
164,2,0,2,0.002914185843169466,2019-03-30 20:45:00,2019-03-30 21:00:00
168,9,5,4,0.012992629148002761,2019-03-30 20:45:00,2019-03-30 21:00:00
170,5,2,3,0.0051584806511090426,2019-03-30 20:45:00,2019-03-30 21:00:00
172,3,3,0,0.008073412237573364,2019-03-30 20:45:00,2019-03-30 21:00:00
173,8,7,1,0.06986363917890397,2019-03-30 20:45:00,2019-03-30 21:00:00
177,3,1,2,0.004152807892958793,2019-03-30 20:45:00,2019-03-30 21:00:00
191,2,1,1,0.004152807892958793,2019-03-30 20:45:00,2019-03-30 21:00:00
196,4,1,3,0.004066437099718864,2019-03-30 20:45:00,2019-03-30 21:00:00
203,6,3,3,0.010576192415559767,2019-03-30 20:45:00,2019-03-30 21:00:00
13,1,0,1,0.0031538595656343776,2019-03-30 21:00:00,2019-03-30 21:15:00
15,10,3,7,0.006796625050374041,2019-03-30 21:00:00,2019-03-30 21:15:00
16,6,3,3,0.015376912694344881,2019-03-30 21:00:00,2019-03-30 21:15:00
18,7,5,2,0.014771491870119894,2019-03-30 21:00:00,2019-03-30 21:15:00
19,3,0,3,0.0031538595656343776,2019-03-30 21:00:00,2019-03-30 21:15:00
20,7,4,3,0.021740307281801062,2019-03-30 21:00:00,2019-03-30 21:15:00
23,7,2,5,0.005364448363774383,2019-03-30 21:00:00,2019-03-30 21:15:00
26,7,4,3,0.010862077268093004,2019-03-30 21:00:00,2019-03-30 21:15:00
28,7,3,4,0.008791030571579875,2019-03-30 21:00:00,2019-03-30 21:15:00
30,1,1,0,0.004047522950909711,2019-03-30 21:00:00,2019-03-30 21:15:00
37,1,0,1,0.0031538595656343776,2019-03-30 21:00:00,2019-03-30 21:15:00
41,3,0,3,0.0031538595656343776,2019-03-30 21:00:00,2019-03-30 21:15:00
46,1,1,0,0.004047522950909711,2019-03-30 21:00:00,2019-03-30 21:15:00
57,2,2,0,0.015711033557529692,2019-03-30 21:00:00,2019-03-30 21:15:00
58,6,2,4,0.0061100404157538755,2019-03-30 21:00:00,2019-03-30 21:15:00
64,1,1,0,0.005064118535266024,2019-03-30 21:00:00,2019-03-30 21:15:00
66,1,1,0,0.008658698618096077,2019-03-30 21:00:00,2019-03-30 21:15:00
67,9,6,3,0.019425914252414137,2019-03-30 21:00:00,2019-03-30 21:15:00
68,2,2,0,0.008218416610858963,2019-03-30 21:00:00,2019-03-30 21:15:00
74,3,0,3,0.0031538595656343776,2019-03-30 21:00:00,2019-03-30 21:15:00
85,6,2,4,0.005750939218029853,2019-03-30 21:00:00,2019-03-30 21:15:00
86,1,1,0,0.007091434295942854,2019-03-30 21:00:00,2019-03-30 21:15:00
87,4,2,2,0.006300686514742049,2019-03-30 21:00:00,2019-03-30 21:15:00
88,9,4,5,0.007866370661998719,2019-03-30 21:00:00,2019-03-30 21:15:00
89,3,3,0,0.007166156237785657,2019-03-30 21:00:00,2019-03-30 21:15:00
90,4,1,3,0.0038241071045908774,2019-03-30 21:00:00,2019-03-30 21:15:00
104,2,2,0,0.006890467001467147,2019-03-30 21:00:00,2019-03-30 21:15:00
106,6,4,2,0.03282963576054572,2019-03-30 21:00:00,2019-03-30 21:15:00
109,13,3,10,0.011222618449523939,2019-03-30 21:00:00,2019-03-30 21:15:00
110,4,3,1,0.008791030571579875,2019-03-30 21:00:00,2019-03-30 21:15:00
111,4,0,4,0.0031538595656343776,2019-03-30 21:00:00,2019-03-30 21:15:00
112,1,0,1,0.0031538595656343776,2019-03-30 21:00:00,2019-03-30 21:15:00
114,4,1,3,0.0038241071045908774,2019-03-30 21:00:00,2019-03-30 21:15:00
116,6,4,2,0.05584610397015308,2019-03-30 21:00:00,2019-03-30 21:15:00
118,2,1,1,0.004631949990694126,2019-03-30 21:00:00,2019-03-30 21:15:00
119,6,4,2,0.010304777076024538,2019-03-30 21:00:00,2019-03-30 21:15:00
120,1,0,1,0.0031538595656343776,2019-03-30 21:00:00,2019-03-30 21:15:00
126,3,3,0,0.005890006481461181,2019-03-30 21:00:00,2019-03-30 21:15:00
127,4,2,2,0.005957781920541357,2019-03-30 21:00:00,2019-03-30 21:15:00
137,9,5,4,0.020600533077963338,2019-03-30 21:00:00,2019-03-30 21:15:00
138,14,6,8,0.01390952446967497,2019-03-30 21:00:00,2019-03-30 21:15:00
140,3,1,2,0.007532096074358657,2019-03-30 21:00:00,2019-03-30 21:15:00
141,3,3,0,0.005448416609295984,2019-03-30 21:00:00,2019-03-30 21:15:00
147,1,1,0,0.006231806446984902,2019-03-30 21:00:00,2019-03-30 21:15:00
151,1,1,0,0.008658698618096077,2019-03-30 21:00:00,2019-03-30 21:15:00
153,4,2,2,0.004804661937613314,2019-03-30 21:00:00,2019-03-30 21:15:00
154,5,4,1,0.015998388359679053,2019-03-30 21:00:00,2019-03-30 21:15:00
158,5,5,0,0.012180264381106587,2019-03-30 21:00:00,2019-03-30 21:15:00
159,4,0,4,0.0031538595656343776,2019-03-30 21:00:00,2019-03-30 21:15:00
162,2,0,2,0.0031538595656343776,2019-03-30 21:00:00,2019-03-30 21:15:00
164,1,1,0,0.005834849721460377,2019-03-30 21:00:00,2019-03-30 21:15:00
168,9,3,6,0.008570135522782088,2019-03-30 21:00:00,2019-03-30 21:15:00
170,5,2,3,0.005552674226177681,2019-03-30 21:00:00,2019-03-30 21:15:00
172,1,1,0,0.004494354643547378,2019-03-30 21:00:00,2019-03-30 21:15:00
173,4,4,0,0.0064554643095922504,2019-03-30 21:00:00,2019-03-30 21:15:00
177,3,1,2,0.004494354643547378,2019-03-30 21:00:00,2019-03-30 21:15:00
190,2,1,1,0.02095932528258119,2019-03-30 21:00:00,2019-03-30 21:15:00
191,1,1,0,0.004047522950909711,2019-03-30 21:00:00,2019-03-30 21:15:00
200,1,1,0,0.0038241071045908774,2019-03-30 21:00:00,2019-03-30 21:15:00
201,1,0,1,0.0031538595656343776,2019-03-30 21:00:00,2019-03-30 21:15:00
203,7,4,3,0.01238025559521442,2019-03-30 21:00:00,2019-03-30 21:15:00
1,2,1,1,0.004726547696387405,2019-03-30 21:15:00,2019-03-30 21:30:00
5,1,1,0,0.005774020707848348,2019-03-30 21:15:00,2019-03-30 21:30:00
13,1,0,1,0.0033167844682277037,2019-03-30 21:15:00,2019-03-30 21:30:00
15,7,5,2,0.016242770997054155,2019-03-30 21:15:00,2019-03-30 21:30:00
16,8,2,6,0.004628253741374565,2019-03-30 21:15:00,2019-03-30 21:30:00
18,12,6,6,0.01734321628459024,2019-03-30 21:15:00,2019-03-30 21:30:00
19,1,0,1,0.0033167844682277037,2019-03-30 21:15:00,2019-03-30 21:30:00
20,6,1,5,0.007150112157899393,2019-03-30 21:15:00,2019-03-30 21:30:00
23,8,4,4,0.006110820909712774,2019-03-30 21:15:00,2019-03-30 21:30:00
26,6,3,3,0.01352758125260904,2019-03-30 21:15:00,2019-03-30 21:30:00
28,4,3,1,0.006396428505290294,2019-03-30 21:15:00,2019-03-30 21:30:00
37,1,0,1,0.0033167844682277037,2019-03-30 21:15:00,2019-03-30 21:30:00
41,3,0,3,0.0033167844682277037,2019-03-30 21:15:00,2019-03-30 21:30:00
46,2,2,0,0.005622508371029079,2019-03-30 21:15:00,2019-03-30 21:30:00
57,2,2,0,0.008231256947468991,2019-03-30 21:15:00,2019-03-30 21:30:00
58,1,0,1,0.0033167844682277037,2019-03-30 21:15:00,2019-03-30 21:30:00
62,1,0,1,0.0033167844682277037,2019-03-30 21:15:00,2019-03-30 21:30:00
66,2,2,0,0.01531986087179621,2019-03-30 21:15:00,2019-03-30 21:30:00
67,4,2,2,0.007796841111439832,2019-03-30 21:15:00,2019-03-30 21:30:00
68,2,2,0,0.006048547969617518,2019-03-30 21:15:00,2019-03-30 21:30:00
70,1,1,0,0.003736592325955967,2019-03-30 21:15:00,2019-03-30 21:30:00
74,3,0,3,0.0033167844682277037,2019-03-30 21:15:00,2019-03-30 21:30:00
79,1,1,0,0.004532459455460012,2019-03-30 21:15:00,2019-03-30 21:30:00
85,5,0,5,0.0033167844682277037,2019-03-30 21:15:00,2019-03-30 21:30:00
86,1,1,0,0.006136310924547108,2019-03-30 21:15:00,2019-03-30 21:30:00
88,4,0,4,0.0033167844682277037,2019-03-30 21:15:00,2019-03-30 21:30:00
89,5,3,2,0.005431429310467257,2019-03-30 21:15:00,2019-03-30 21:30:00
90,4,3,1,0.009343719646272368,2019-03-30 21:15:00,2019-03-30 21:30:00
106,6,4,2,0.03442866463214306,2019-03-30 21:15:00,2019-03-30 21:30:00
109,11,6,5,0.017353476585185258,2019-03-30 21:15:00,2019-03-30 21:30:00
110,4,3,1,0.006975926640003634,2019-03-30 21:15:00,2019-03-30 21:30:00
111,2,0,2,0.0033167844682277037,2019-03-30 21:15:00,2019-03-30 21:30:00
112,2,0,2,0.0033167844682277037,2019-03-30 21:15:00,2019-03-30 21:30:00
114,3,0,3,0.0033167844682277037,2019-03-30 21:15:00,2019-03-30 21:30:00
115,5,1,4,0.004211900206951789,2019-03-30 21:15:00,2019-03-30 21:30:00
116,7,5,2,0.031879753662913304,2019-03-30 21:15:00,2019-03-30 21:30:00
118,1,0,1,0.0033167844682277037,2019-03-30 21:15:00,2019-03-30 21:30:00
119,3,3,0,0.01102638388264734,2019-03-30 21:15:00,2019-03-30 21:30:00
120,3,2,1,0.004628253741374565,2019-03-30 21:15:00,2019-03-30 21:30:00
126,3,3,0,0.0072128427365930415,2019-03-30 21:15:00,2019-03-30 21:30:00
127,9,3,6,0.009640465156392188,2019-03-30 21:15:00,2019-03-30 21:30:00
137,16,8,8,0.021079639920386084,2019-03-30 21:15:00,2019-03-30 21:30:00
138,11,2,9,0.004444595050755465,2019-03-30 21:15:00,2019-03-30 21:30:00
140,4,3,1,0.006002131684399961,2019-03-30 21:15:00,2019-03-30 21:30:00
147,1,1,0,0.007150112157899393,2019-03-30 21:15:00,2019-03-30 21:30:00
151,1,1,0,0.006630892632974914,2019-03-30 21:15:00,2019-03-30 21:30:00
153,6,3,3,0.008868074425936921,2019-03-30 21:15:00,2019-03-30 21:30:00
154,4,4,0,0.014243746041122073,2019-03-30 21:15:00,2019-03-30 21:30:00
157,1,1,0,0.0038806897594915847,2019-03-30 21:15:00,2019-03-30 21:30:00
158,1,1,0,0.006136310924547108,2019-03-30 21:15:00,2019-03-30 21:30:00
162,2,0,2,0.0033167844682277037,2019-03-30 21:15:00,2019-03-30 21:30:00
164,3,1,2,0.006136310924547108,2019-03-30 21:15:00,2019-03-30 21:30:00
168,7,1,6,0.018137729703562634,2019-03-30 21:15:00,2019-03-30 21:30:00
170,2,1,1,0.021983912566576908,2019-03-30 21:15:00,2019-03-30 21:30:00
172,3,3,0,0.007157897670852021,2019-03-30 21:15:00,2019-03-30 21:30:00
173,2,1,1,0.010220896263862175,2019-03-30 21:15:00,2019-03-30 21:30:00
177,2,1,1,0.004726547696387405,2019-03-30 21:15:00,2019-03-30 21:30:00
190,1,1,0,0.005829680634786364,2019-03-30 21:15:00,2019-03-30 21:30:00
191,3,3,0,0.009171099099575461,2019-03-30 21:15:00,2019-03-30 21:30:00
196,1,1,0,0.004726547696387405,2019-03-30 21:15:00,2019-03-30 21:30:00
199,1,1,0,0.007334741253590813,2019-03-30 21:15:00,2019-03-30 21:30:00
200,1,1,0,0.004726547696387405,2019-03-30 21:15:00,2019-03-30 21:30:00
201,1,0,1,0.0033167844682277037,2019-03-30 21:15:00,2019-03-30 21:30:00
202,1,1,0,0.008419120420277926,2019-03-30 21:15:00,2019-03-30 21:30:00
203,4,3,1,0.017434236769373234,2019-03-30 21:15:00,2019-03-30 21:30:00
1,5,0,5,0.0031319441284843636,2019-03-30 21:30:00,2019-03-30 21:45:00
5,6,2,4,0.007408456147681082,2019-03-30 21:30:00,2019-03-30 21:45:00
10,1,1,0,0.004744298229732743,2019-03-30 21:30:00,2019-03-30 21:45:00
11,1,1,0,0.004706475006682522,2019-03-30 21:30:00,2019-03-30 21:45:00
13,1,0,1,0.0031319441284843636,2019-03-30 21:30:00,2019-03-30 21:45:00
15,7,4,3,0.009055795104794217,2019-03-30 21:30:00,2019-03-30 21:45:00
16,12,4,8,0.010494842247760044,2019-03-30 21:30:00,2019-03-30 21:45:00
18,4,2,2,0.0063566523309811235,2019-03-30 21:30:00,2019-03-30 21:45:00
19,2,2,0,0.0051859747274996155,2019-03-30 21:30:00,2019-03-30 21:45:00
20,1,0,1,0.0031319441284843636,2019-03-30 21:30:00,2019-03-30 21:45:00
23,3,3,0,0.005915728962987395,2019-03-30 21:30:00,2019-03-30 21:45:00
26,4,2,2,0.03363108515661595,2019-03-30 21:30:00,2019-03-30 21:45:00
27,1,1,0,0.004744298229732743,2019-03-30 21:30:00,2019-03-30 21:45:00
28,1,1,0,0.004562250867132667,2019-03-30 21:30:00,2019-03-30 21:45:00
30,1,0,1,0.0031319441284843636,2019-03-30 21:30:00,2019-03-30 21:45:00
37,1,0,1,0.0031319441284843636,2019-03-30 21:30:00,2019-03-30 21:45:00
41,1,0,1,0.0031319441284843636,2019-03-30 21:30:00,2019-03-30 21:45:00
46,3,2,1,0.007756978189538982,2019-03-30 21:30:00,2019-03-30 21:45:00
57,1,1,0,0.004562250867132667,2019-03-30 21:30:00,2019-03-30 21:45:00
62,1,0,1,0.0031319441284843636,2019-03-30 21:30:00,2019-03-30 21:45:00
66,1,1,0,0.0057943673117339745,2019-03-30 21:30:00,2019-03-30 21:45:00
67,3,2,1,0.005992557605780971,2019-03-30 21:30:00,2019-03-30 21:45:00
68,2,2,0,0.007057165884094378,2019-03-30 21:30:00,2019-03-30 21:45:00
70,4,3,1,0.018767242915029656,2019-03-30 21:30:00,2019-03-30 21:45:00
74,2,1,1,0.01907867633469743,2019-03-30 21:30:00,2019-03-30 21:45:00
79,5,4,1,0.055009999713580136,2019-03-30 21:30:00,2019-03-30 21:45:00
85,3,0,3,0.0031319441284843636,2019-03-30 21:30:00,2019-03-30 21:45:00
88,2,0,2,0.0031319441284843636,2019-03-30 21:30:00,2019-03-30 21:45:00
89,5,3,2,0.006693671132301203,2019-03-30 21:30:00,2019-03-30 21:45:00
90,8,4,4,0.015345208851747474,2019-03-30 21:30:00,2019-03-30 21:45:00
106,4,2,2,0.020837430469743713,2019-03-30 21:30:00,2019-03-30 21:45:00
109,14,7,7,0.013276089207246934,2019-03-30 21:30:00,2019-03-30 21:45:00
111,1,0,1,0.0031319441284843636,2019-03-30 21:30:00,2019-03-30 21:45:00
112,2,2,0,0.006281005884880679,2019-03-30 21:30:00,2019-03-30 21:45:00
116,7,5,2,0.039336779277827374,2019-03-30 21:30:00,2019-03-30 21:45:00
119,1,1,0,0.005447351128503112,2019-03-30 21:30:00,2019-03-30 21:45:00
120,1,1,0,0.00424720183458038,2019-03-30 21:30:00,2019-03-30 21:45:00
122,4,4,0,0.005261882675084052,2019-03-30 21:30:00,2019-03-30 21:45:00
126,3,3,0,0.01316243469154734,2019-03-30 21:30:00,2019-03-30 21:45:00
127,4,1,3,0.006926038290059918,2019-03-30 21:30:00,2019-03-30 21:45:00
137,10,3,7,0.011777429167409372,2019-03-30 21:30:00,2019-03-30 21:45:00
138,7,2,5,0.004906892917317438,2019-03-30 21:30:00,2019-03-30 21:45:00
141,1,1,0,0.008057709268385862,2019-03-30 21:30:00,2019-03-30 21:45:00
147,3,1,2,0.017419556495284972,2019-03-30 21:30:00,2019-03-30 21:45:00
151,1,1,0,0.00822628572299228,2019-03-30 21:30:00,2019-03-30 21:45:00
153,9,2,7,0.008456790494983586,2019-03-30 21:30:00,2019-03-30 21:45:00
154,2,2,0,0.0051859747274996155,2019-03-30 21:30:00,2019-03-30 21:45:00
157,2,1,1,0.004019418522900901,2019-03-30 21:30:00,2019-03-30 21:45:00
159,4,1,3,0.004370347567166639,2019-03-30 21:30:00,2019-03-30 21:45:00
160,2,1,1,0.020837430469743713,2019-03-30 21:30:00,2019-03-30 21:45:00
162,2,0,2,0.0031319441284843636,2019-03-30 21:30:00,2019-03-30 21:45:00
164,2,1,1,0.0057943673117339745,2019-03-30 21:30:00,2019-03-30 21:45:00
168,3,0,3,0.0031319441284843636,2019-03-30 21:30:00,2019-03-30 21:45:00
170,3,1,2,0.005447351128503112,2019-03-30 21:30:00,2019-03-30 21:45:00
172,1,1,0,0.004463155720109169,2019-03-30 21:30:00,2019-03-30 21:45:00
173,1,0,1,0.0031319441284843636,2019-03-30 21:30:00,2019-03-30 21:45:00
177,2,1,1,0.004463155720109169,2019-03-30 21:30:00,2019-03-30 21:45:00
190,6,4,2,0.011172518345608552,2019-03-30 21:30:00,2019-03-30 21:45:00
191,2,1,1,0.005833925269482924,2019-03-30 21:30:00,2019-03-30 21:45:00
196,1,1,0,0.009726171858568285,2019-03-30 21:30:00,2019-03-30 21:45:00
200,1,1,0,0.0057943673117339745,2019-03-30 21:30:00,2019-03-30 21:45:00
203,2,2,0,0.00782367866019291,2019-03-30 21:30:00,2019-03-30 21:45:00
1,7,2,5,0.011115151543546972,2019-03-30 21:45:00,2019-03-30 22:00:00
5,3,0,3,0.0034638625052421925,2019-03-30 21:45:00,2019-03-30 22:00:00
10,2,2,0,0.00839640285435328,2019-03-30 21:45:00,2019-03-30 22:00:00
11,1,1,0,0.00444537507826764,2019-03-30 21:45:00,2019-03-30 22:00:00
15,1,1,0,0.0074042033387036205,2019-03-30 21:45:00,2019-03-30 22:00:00
16,6,2,4,0.005426887651293087,2019-03-30 21:45:00,2019-03-30 22:00:00
18,5,2,3,0.009295981144067073,2019-03-30 21:45:00,2019-03-30 22:00:00
19,4,2,2,0.007095630358953021,2019-03-30 21:45:00,2019-03-30 22:00:00
20,1,0,1,0.0034638625052421925,2019-03-30 21:45:00,2019-03-30 22:00:00
23,1,0,1,0.0034638625052421925,2019-03-30 21:45:00,2019-03-30 22:00:00
26,12,8,4,0.01800100501190761,2019-03-30 21:45:00,2019-03-30 22:00:00
27,1,1,0,0.006379921824654632,2019-03-30 21:45:00,2019-03-30 22:00:00
28,1,1,0,0.0050540156736534215,2019-03-30 21:45:00,2019-03-30 22:00:00
30,1,0,1,0.0034638625052421925,2019-03-30 21:45:00,2019-03-30 22:00:00
37,1,0,1,0.0034638625052421925,2019-03-30 21:45:00,2019-03-30 22:00:00
41,3,1,2,0.005279746432097607,2019-03-30 21:45:00,2019-03-30 22:00:00
46,3,0,3,0.0034638625052421925,2019-03-30 21:45:00,2019-03-30 22:00:00
57,3,2,1,0.007998553392729764,2019-03-30 21:45:00,2019-03-30 22:00:00
62,2,2,0,0.010373480809300924,2019-03-30 21:45:00,2019-03-30 22:00:00
66,2,2,0,0.008911514285808435,2019-03-30 21:45:00,2019-03-30 22:00:00
67,2,2,0,0.00664416884206465,2019-03-30 21:45:00,2019-03-30 22:00:00
68,2,2,0,0.008122603080011963,2019-03-30 21:45:00,2019-03-30 22:00:00
70,2,2,0,0.009660633104051079,2019-03-30 21:45:00,2019-03-30 22:00:00
74,1,0,1,0.0034638625052421925,2019-03-30 21:45:00,2019-03-30 22:00:00
79,10,4,6,0.00964443436785581,2019-03-30 21:45:00,2019-03-30 22:00:00
85,2,0,2,0.0034638625052421925,2019-03-30 21:45:00,2019-03-30 22:00:00
88,3,2,1,0.009495747189916524,2019-03-30 21:45:00,2019-03-30 22:00:00
89,4,4,0,0.01695880903062373,2019-03-30 21:45:00,2019-03-30 22:00:00
90,7,4,3,0.013905237372024173,2019-03-30 21:45:00,2019-03-30 22:00:00
109,11,6,5,0.017151168574489707,2019-03-30 21:45:00,2019-03-30 22:00:00
111,2,1,1,0.010263299652869248,2019-03-30 21:45:00,2019-03-30 22:00:00
112,4,2,2,0.005426887651293087,2019-03-30 21:45:00,2019-03-30 22:00:00
114,1,1,0,0.0060980514151764385,2019-03-30 21:45:00,2019-03-30 22:00:00
115,6,2,4,0.006024555705101317,2019-03-30 21:45:00,2019-03-30 22:00:00
116,3,3,0,0.012227233034123668,2019-03-30 21:45:00,2019-03-30 22:00:00
118,1,0,1,0.0034638625052421925,2019-03-30 21:45:00,2019-03-30 22:00:00
119,2,1,1,0.006579924563897609,2019-03-30 21:45:00,2019-03-30 22:00:00
120,2,1,1,0.0046171826119262615,2019-03-30 21:45:00,2019-03-30 22:00:00
122,5,5,0,0.012317498204601256,2019-03-30 21:45:00,2019-03-30 22:00:00
126,14,6,8,0.012181499669604577,2019-03-30 21:45:00,2019-03-30 22:00:00
127,3,1,2,0.00548034353494084,2019-03-30 21:45:00,2019-03-30 22:00:00
135,1,1,0,0.005770502718610331,2019-03-30 21:45:00,2019-03-30 22:00:00
137,7,2,5,0.009352937943394878,2019-03-30 21:45:00,2019-03-30 22:00:00
138,4,2,2,0.006408400224318536,2019-03-30 21:45:00,2019-03-30 22:00:00
141,1,1,0,0.004936131364780364,2019-03-30 21:45:00,2019-03-30 22:00:00
147,3,1,2,0.0072895070243945825,2019-03-30 21:45:00,2019-03-30 22:00:00
153,4,1,3,0.006408400224318536,2019-03-30 21:45:00,2019-03-30 22:00:00
157,1,0,1,0.0034638625052421925,2019-03-30 21:45:00,2019-03-30 22:00:00
159,5,1,4,0.004398663666269936,2019-03-30 21:45:00,2019-03-30 22:00:00
160,2,1,1,0.02291304072000049,2019-03-30 21:45:00,2019-03-30 22:00:00
162,6,2,4,0.006024555705101317,2019-03-30 21:45:00,2019-03-30 22:00:00
164,2,0,2,0.0034638625052421925,2019-03-30 21:45:00,2019-03-30 22:00:00
168,2,0,2,0.0034638625052421925,2019-03-30 21:45:00,2019-03-30 22:00:00
170,7,4,3,0.010996731142512123,2019-03-30 21:45:00,2019-03-30 22:00:00
172,2,2,0,0.008669176404105087,2019-03-30 21:45:00,2019-03-30 22:00:00
177,3,1,2,0.004744209105171754,2019-03-30 21:45:00,2019-03-30 22:00:00
190,2,0,2,0.0034638625052421925,2019-03-30 21:45:00,2019-03-30 22:00:00
191,5,3,2,0.010976345926048351,2019-03-30 21:45:00,2019-03-30 22:00:00
196,2,2,0,0.007389912797343983,2019-03-30 21:45:00,2019-03-30 22:00:00
197,1,0,1,0.0034638625052421925,2019-03-30 21:45:00,2019-03-30 22:00:00
200,1,1,0,0.012188594879009147,2019-03-30 21:45:00,2019-03-30 22:00:00
202,1,1,0,0.0050540156736534215,2019-03-30 21:45:00,2019-03-30 22:00:00
203,3,2,1,0.038139176659273626,2019-03-30 21:45:00,2019-03-30 22:00:00
1,8,3,5,0.010293215211807111,2019-03-30 22:00:00,2019-03-30 22:15:00
2,1,1,0,0.00572421455582336,2019-03-30 22:00:00,2019-03-30 22:15:00
5,2,0,2,0.003094061615149088,2019-03-30 22:00:00,2019-03-30 22:15:00
10,3,2,1,0.007963736522047151,2019-03-30 22:00:00,2019-03-30 22:15:00
15,1,1,0,0.007960046592696826,2019-03-30 22:00:00,2019-03-30 22:15:00
16,6,4,2,0.006991782527971077,2019-03-30 22:00:00,2019-03-30 22:15:00
18,3,0,3,0.003094061615149088,2019-03-30 22:00:00,2019-03-30 22:15:00
19,5,2,3,0.009686306638172146,2019-03-30 22:00:00,2019-03-30 22:15:00
20,1,0,1,0.003094061615149088,2019-03-30 22:00:00,2019-03-30 22:15:00
23,1,0,1,0.003094061615149088,2019-03-30 22:00:00,2019-03-30 22:15:00
26,13,8,5,0.016025229463644347,2019-03-30 22:00:00,2019-03-30 22:15:00
27,1,1,0,0.004102632724843799,2019-03-30 22:00:00,2019-03-30 22:15:00
35,2,0,2,0.003094061615149088,2019-03-30 22:00:00,2019-03-30 22:15:00
37,1,0,1,0.003094061615149088,2019-03-30 22:00:00,2019-03-30 22:15:00
40,4,4,0,0.007128346053927932,2019-03-30 22:00:00,2019-03-30 22:15:00
41,5,3,2,0.03891591654569599,2019-03-30 22:00:00,2019-03-30 22:15:00
46,2,0,2,0.003094061615149088,2019-03-30 22:00:00,2019-03-30 22:15:00
50,2,0,2,0.003094061615149088,2019-03-30 22:00:00,2019-03-30 22:15:00
57,2,1,1,0.021404291315906702,2019-03-30 22:00:00,2019-03-30 22:15:00
58,2,1,1,0.009860707326983381,2019-03-30 22:00:00,2019-03-30 22:15:00
62,4,2,2,0.021695879590299564,2019-03-30 22:00:00,2019-03-30 22:15:00
66,2,2,0,0.012368055492611668,2019-03-30 22:00:00,2019-03-30 22:15:00
68,2,2,0,0.007530564208905662,2019-03-30 22:00:00,2019-03-30 22:15:00
70,2,0,2,0.003094061615149088,2019-03-30 22:00:00,2019-03-30 22:15:00
74,1,0,1,0.003094061615149088,2019-03-30 22:00:00,2019-03-30 22:15:00
79,5,0,5,0.003094061615149088,2019-03-30 22:00:00,2019-03-30 22:15:00
85,2,0,2,0.003094061615149088,2019-03-30 22:00:00,2019-03-30 22:15:00
88,3,2,1,0.008583637034860777,2019-03-30 22:00:00,2019-03-30 22:15:00
89,1,1,0,0.006318403610466754,2019-03-30 22:00:00,2019-03-30 22:15:00
90,1,1,0,0.010391027598394316,2019-03-30 22:00:00,2019-03-30 22:15:00
109,12,6,6,0.007118698386012904,2019-03-30 22:00:00,2019-03-30 22:15:00
110,1,0,1,0.003094061615149088,2019-03-30 22:00:00,2019-03-30 22:15:00
111,1,1,0,0.021290737850871957,2019-03-30 22:00:00,2019-03-30 22:15:00
112,6,3,3,0.007039291026160495,2019-03-30 22:00:00,2019-03-30 22:15:00
115,4,2,2,0.013446585930012012,2019-03-30 22:00:00,2019-03-30 22:15:00
116,5,4,1,0.011326126974966521,2019-03-30 22:00:00,2019-03-30 22:15:00
118,3,2,1,0.00572421455582336,2019-03-30 22:00:00,2019-03-30 22:15:00
119,6,1,5,0.00572421455582336,2019-03-30 22:00:00,2019-03-30 22:15:00
120,2,1,1,0.006065821093617979,2019-03-30 22:00:00,2019-03-30 22:15:00
122,6,6,0,0.013235066180635321,2019-03-30 22:00:00,2019-03-30 22:15:00
126,7,1,6,0.003604778781563977,2019-03-30 22:00:00,2019-03-30 22:15:00
127,3,1,2,0.005218948812191306,2019-03-30 22:00:00,2019-03-30 22:15:00
135,1,1,0,0.005088695280477245,2019-03-30 22:00:00,2019-03-30 22:15:00
137,2,1,1,0.00572421455582336,2019-03-30 22:00:00,2019-03-30 22:15:00
138,14,9,5,0.027273408740283327,2019-03-30 22:00:00,2019-03-30 22:15:00
140,1,1,0,0.004409138085486224,2019-03-30 22:00:00,2019-03-30 22:15:00
141,1,1,0,0.00572421455582336,2019-03-30 22:00:00,2019-03-30 22:15:00
147,1,1,0,0.0058186216061784654,2019-03-30 22:00:00,2019-03-30 22:15:00
153,3,2,1,0.014716761592080102,2019-03-30 22:00:00,2019-03-30 22:15:00
154,1,0,1,0.003094061615149088,2019-03-30 22:00:00,2019-03-30 22:15:00
159,2,1,1,0.0058186216061784654,2019-03-30 22:00:00,2019-03-30 22:15:00
160,2,1,1,0.02044950373692025,2019-03-30 22:00:00,2019-03-30 22:15:00
162,7,3,4,0.008964848153124138,2019-03-30 22:00:00,2019-03-30 22:15:00
164,1,0,1,0.003094061615149088,2019-03-30 22:00:00,2019-03-30 22:15:00
168,6,1,5,0.0037278456012229465,2019-03-30 22:00:00,2019-03-30 22:15:00
170,5,3,2,0.007585971582614471,2019-03-30 22:00:00,2019-03-30 22:15:00
172,2,2,0,0.010155680214011725,2019-03-30 22:00:00,2019-03-30 22:15:00
177,3,1,2,0.0049992779761558,2019-03-30 22:00:00,2019-03-30 22:15:00
191,4,2,2,0.0048474969089319355,2019-03-30 22:00:00,2019-03-30 22:15:00
196,2,1,1,0.007960046592696826,2019-03-30 22:00:00,2019-03-30 22:15:00
197,3,2,1,0.021538145154308873,2019-03-30 22:00:00,2019-03-30 22:15:00
203,3,2,1,0.03359729570139243,2019-03-30 22:00:00,2019-03-30 22:15:00
1,7,1,6,0.0038854512757258678,2019-03-30 22:15:00,2019-03-30 22:30:00
2,1,1,0,0.006624644999891043,2019-03-30 22:15:00,2019-03-30 22:30:00
5,2,0,2,0.0033349655003099454,2019-03-30 22:15:00,2019-03-30 22:30:00
10,3,2,1,0.021479754635713146,2019-03-30 22:15:00,2019-03-30 22:30:00
15,7,2,5,0.011063307969988221,2019-03-30 22:15:00,2019-03-30 22:30:00
16,5,4,1,0.007805612629669481,2019-03-30 22:15:00,2019-03-30 22:30:00
19,2,1,1,0.01129809634628627,2019-03-30 22:15:00,2019-03-30 22:30:00
26,10,2,8,0.006903482176080156,2019-03-30 22:15:00,2019-03-30 22:30:00
28,1,1,0,0.0038854512757258678,2019-03-30 22:15:00,2019-03-30 22:30:00
35,1,0,1,0.0033349655003099454,2019-03-30 22:15:00,2019-03-30 22:30:00
37,1,0,1,0.0033349655003099454,2019-03-30 22:15:00,2019-03-30 22:30:00
40,4,4,0,0.005474625179200776,2019-03-30 22:15:00,2019-03-30 22:30:00
41,5,2,3,0.030136083194466895,2019-03-30 22:15:00,2019-03-30 22:30:00
50,2,0,2,0.0033349655003099454,2019-03-30 22:15:00,2019-03-30 22:30:00
58,2,1,1,0.006169920061413188,2019-03-30 22:15:00,2019-03-30 22:30:00
62,5,2,3,0.013292671742473328,2019-03-30 22:15:00,2019-03-30 22:30:00
67,1,0,1,0.0033349655003099454,2019-03-30 22:15:00,2019-03-30 22:30:00
68,2,2,0,0.007677905679966167,2019-03-30 22:15:00,2019-03-30 22:30:00
70,2,0,2,0.0033349655003099454,2019-03-30 22:15:00,2019-03-30 22:30:00
74,1,0,1,0.0033349655003099454,2019-03-30 22:15:00,2019-03-30 22:30:00
79,4,2,2,0.004802089729643882,2019-03-30 22:15:00,2019-03-30 22:30:00
85,2,0,2,0.0033349655003099454,2019-03-30 22:15:00,2019-03-30 22:30:00
88,4,1,3,0.008127807305653623,2019-03-30 22:15:00,2019-03-30 22:30:00
90,2,1,1,0.0056380811254440055,2019-03-30 22:15:00,2019-03-30 22:30:00
109,9,2,7,0.0044047953397553605,2019-03-30 22:15:00,2019-03-30 22:30:00
110,2,1,1,0.0038698804200326528,2019-03-30 22:15:00,2019-03-30 22:30:00
112,3,2,1,0.006169920061413188,2019-03-30 22:15:00,2019-03-30 22:30:00
114,2,0,2,0.0033349655003099454,2019-03-30 22:15:00,2019-03-30 22:30:00
115,2,1,1,0.009367288308880953,2019-03-30 22:15:00,2019-03-30 22:30:00
116,4,3,1,0.01280537031164645,2019-03-30 22:15:00,2019-03-30 22:30:00
118,2,2,0,0.006169920061413188,2019-03-30 22:15:00,2019-03-30 22:30:00
119,6,1,5,0.006169920061413188,2019-03-30 22:15:00,2019-03-30 22:30:00
122,7,7,0,0.03477669768963687,2019-03-30 22:15:00,2019-03-30 22:30:00
126,4,3,1,0.02396472939675013,2019-03-30 22:15:00,2019-03-30 22:30:00
127,4,1,3,0.007663247708018885,2019-03-30 22:15:00,2019-03-30 22:30:00
129,2,2,0,0.007941196750578066,2019-03-30 22:15:00,2019-03-30 22:30:00
137,4,3,1,0.006878658701688998,2019-03-30 22:15:00,2019-03-30 22:30:00
138,15,11,4,0.028384127005024618,2019-03-30 22:15:00,2019-03-30 22:30:00
140,1,1,0,0.006169920061413188,2019-03-30 22:15:00,2019-03-30 22:30:00
141,1,1,0,0.009367929017736575,2019-03-30 22:15:00,2019-03-30 22:30:00
147,1,1,0,0.004068527614976914,2019-03-30 22:15:00,2019-03-30 22:30:00
153,3,2,1,0.01946558605179528,2019-03-30 22:15:00,2019-03-30 22:30:00
154,1,0,1,0.0033349655003099454,2019-03-30 22:15:00,2019-03-30 22:30:00
159,4,4,0,0.006269213958977818,2019-03-30 22:15:00,2019-03-30 22:30:00
162,7,3,4,0.008265734440825517,2019-03-30 22:15:00,2019-03-30 22:30:00
164,3,2,1,0.00709687398939367,2019-03-30 22:15:00,2019-03-30 22:30:00
168,8,0,8,0.0033349655003099454,2019-03-30 22:15:00,2019-03-30 22:30:00
170,4,3,1,0.02666097408677452,2019-03-30 22:15:00,2019-03-30 22:30:00
172,2,2,0,0.006140591628757876,2019-03-30 22:15:00,2019-03-30 22:30:00
173,4,4,0,0.012108322185877377,2019-03-30 22:15:00,2019-03-30 22:30:00
177,2,1,1,0.005091611330291922,2019-03-30 22:15:00,2019-03-30 22:30:00
191,2,0,2,0.0033349655003099454,2019-03-30 22:15:00,2019-03-30 22:30:00
196,1,0,1,0.0033349655003099454,2019-03-30 22:15:00,2019-03-30 22:30:00
197,2,2,0,0.010868829569582102,2019-03-30 22:15:00,2019-03-30 22:30:00
203,2,1,1,0.0219957723694816,2019-03-30 22:15:00,2019-03-30 22:30:00
10,2,2,0,0.00756052508609183,2019-03-30 22:30:00,2019-03-30 22:45:00
15,6,1,5,0.004503654036202861,2019-03-30 22:30:00,2019-03-30 22:45:00
16,7,5,2,0.008214417719803802,2019-03-30 22:30:00,2019-03-30 22:45:00
23,1,0,1,0.003737955271356914,2019-03-30 22:30:00,2019-03-30 22:45:00
26,9,2,7,0.00787144963485878,2019-03-30 22:30:00,2019-03-30 22:45:00
27,6,3,3,0.02463140811392537,2019-03-30 22:30:00,2019-03-30 22:45:00
37,1,0,1,0.003737955271356914,2019-03-30 22:30:00,2019-03-30 22:45:00
41,3,0,3,0.003737955271356914,2019-03-30 22:30:00,2019-03-30 22:45:00
46,3,1,2,0.006501334511164399,2019-03-30 22:30:00,2019-03-30 22:45:00
58,3,2,1,0.0058563364212117774,2019-03-30 22:30:00,2019-03-30 22:45:00
62,1,0,1,0.003737955271356914,2019-03-30 22:30:00,2019-03-30 22:45:00
66,1,1,0,0.006915526996139209,2019-03-30 22:30:00,2019-03-30 22:45:00
67,1,0,1,0.003737955271356914,2019-03-30 22:30:00,2019-03-30 22:45:00
68,2,2,0,0.012186033890387471,2019-03-30 22:30:00,2019-03-30 22:45:00
74,1,0,1,0.003737955271356914,2019-03-30 22:30:00,2019-03-30 22:45:00
79,4,2,2,0.005649800548796057,2019-03-30 22:30:00,2019-03-30 22:45:00
85,2,0,2,0.003737955271356914,2019-03-30 22:30:00,2019-03-30 22:45:00
87,1,0,1,0.003737955271356914,2019-03-30 22:30:00,2019-03-30 22:45:00
88,1,1,0,0.006915526996139209,2019-03-30 22:30:00,2019-03-30 22:45:00
90,1,0,1,0.003737955271356914,2019-03-30 22:30:00,2019-03-30 22:45:00
104,1,1,0,0.007229472502860294,2019-03-30 22:30:00,2019-03-30 22:45:00
109,8,4,4,0.01469831542473107,2019-03-30 22:30:00,2019-03-30 22:45:00
110,4,4,0,0.01098147166452258,2019-03-30 22:30:00,2019-03-30 22:45:00
112,1,0,1,0.003737955271356914,2019-03-30 22:30:00,2019-03-30 22:45:00
115,3,1,2,0.006501334511164399,2019-03-30 22:30:00,2019-03-30 22:45:00
116,2,1,1,0.007229472502860294,2019-03-30 22:30:00,2019-03-30 22:45:00
119,2,0,2,0.003737955271356914,2019-03-30 22:30:00,2019-03-30 22:45:00
120,2,2,0,0.006915526996139209,2019-03-30 22:30:00,2019-03-30 22:45:00
122,2,2,0,0.019427481846330037,2019-03-30 22:30:00,2019-03-30 22:45:00
126,2,2,0,0.008540804523508992,2019-03-30 22:30:00,2019-03-30 22:45:00
127,3,1,2,0.00993762110815589,2019-03-30 22:30:00,2019-03-30 22:45:00
129,2,1,1,0.02463140811392537,2019-03-30 22:30:00,2019-03-30 22:45:00
137,5,3,2,0.008271806052503057,2019-03-30 22:30:00,2019-03-30 22:45:00
138,11,8,3,0.04415293917339899,2019-03-30 22:30:00,2019-03-30 22:45:00
141,2,2,0,0.010769769526753707,2019-03-30 22:30:00,2019-03-30 22:45:00
147,1,1,0,0.0046938779100764855,2019-03-30 22:30:00,2019-03-30 22:45:00
153,1,1,0,0.009883709236648688,2019-03-30 22:30:00,2019-03-30 22:45:00
154,2,0,2,0.003737955271356914,2019-03-30 22:30:00,2019-03-30 22:45:00
159,3,3,0,0.006605723187515629,2019-03-30 22:30:00,2019-03-30 22:45:00
162,7,3,4,0.016726466500444723,2019-03-30 22:30:00,2019-03-30 22:45:00
164,2,2,0,0.005269352801048807,2019-03-30 22:30:00,2019-03-30 22:45:00
168,11,2,9,0.007179474039346323,2019-03-30 22:30:00,2019-03-30 22:45:00
170,3,1,2,0.006501334511164399,2019-03-30 22:30:00,2019-03-30 22:45:00
172,2,2,0,0.010470372757007058,2019-03-30 22:30:00,2019-03-30 22:45:00
173,2,1,1,0.006915526996139209,2019-03-30 22:30:00,2019-03-30 22:45:00
177,2,1,1,0.007292801032224763,2019-03-30 22:30:00,2019-03-30 22:45:00
191,2,1,1,0.006915526996139209,2019-03-30 22:30:00,2019-03-30 22:45:00
10,1,1,0,0.004304052622459574,2019-03-30 22:45:00,2019-03-30 23:00:00
15,4,1,3,0.004679821100062823,2019-03-30 22:45:00,2019-03-30 23:00:00
16,3,0,3,0.0033537392334662885,2019-03-30 22:45:00,2019-03-30 23:00:00
19,1,0,1,0.0033537392334662885,2019-03-30 22:45:00,2019-03-30 23:00:00
23,5,4,1,0.005634491367050175,2019-03-30 22:45:00,2019-03-30 23:00:00
26,4,2,2,0.008312374569264532,2019-03-30 22:45:00,2019-03-30 23:00:00
27,6,3,3,0.02228796415491121,2019-03-30 22:45:00,2019-03-30 23:00:00
28,1,0,1,0.0033537392334662885,2019-03-30 22:45:00,2019-03-30 23:00:00
35,1,0,1,0.0033537392334662885,2019-03-30 22:45:00,2019-03-30 23:00:00
37,1,0,1,0.0033537392334662885,2019-03-30 22:45:00,2019-03-30 23:00:00
40,5,0,5,0.0033537392334662885,2019-03-30 22:45:00,2019-03-30 23:00:00
41,2,0,2,0.0033537392334662885,2019-03-30 22:45:00,2019-03-30 23:00:00
46,3,0,3,0.0033537392334662885,2019-03-30 22:45:00,2019-03-30 23:00:00
57,1,1,0,0.006204679400446146,2019-03-30 22:45:00,2019-03-30 23:00:00
58,2,2,0,0.006204679400446146,2019-03-30 22:45:00,2019-03-30 23:00:00
61,1,1,0,0.006204679400446146,2019-03-30 22:45:00,2019-03-30 23:00:00
62,7,2,5,0.007953243945103834,2019-03-30 22:45:00,2019-03-30 23:00:00
66,1,1,0,0.006204679400446146,2019-03-30 22:45:00,2019-03-30 23:00:00
67,3,0,3,0.0033537392334662885,2019-03-30 22:45:00,2019-03-30 23:00:00
68,2,2,0,0.011871425910649536,2019-03-30 22:45:00,2019-03-30 23:00:00
70,2,1,1,0.02228796415491121,2019-03-30 22:45:00,2019-03-30 23:00:00
74,2,0,2,0.0033537392334662885,2019-03-30 22:45:00,2019-03-30 23:00:00
85,2,0,2,0.0033537392334662885,2019-03-30 22:45:00,2019-03-30 23:00:00
87,1,0,1,0.0033537392334662885,2019-03-30 22:45:00,2019-03-30 23:00:00
88,2,2,0,0.00525436601145286,2019-03-30 22:45:00,2019-03-30 23:00:00
90,1,1,0,0.00392392726686226,2019-03-30 22:45:00,2019-03-30 23:00:00
104,3,3,0,0.0070085273882585924,2019-03-30 22:45:00,2019-03-30 23:00:00
108,1,1,0,0.004779209316956218,2019-03-30 22:45:00,2019-03-30 23:00:00
109,4,2,2,0.015154564405686084,2019-03-30 22:45:00,2019-03-30 23:00:00
110,1,1,0,0.009795310329126651,2019-03-30 22:45:00,2019-03-30 23:00:00
111,1,0,1,0.0033537392334662885,2019-03-30 22:45:00,2019-03-30 23:00:00
112,2,1,1,0.0086282468617886,2019-03-30 22:45:00,2019-03-30 23:00:00
115,1,0,1,0.0033537392334662885,2019-03-30 22:45:00,2019-03-30 23:00:00
116,2,1,1,0.004304052622459574,2019-03-30 22:45:00,2019-03-30 23:00:00
119,3,2,1,0.006304318857797943,2019-03-30 22:45:00,2019-03-30 23:00:00
120,5,3,2,0.032515792328526215,2019-03-30 22:45:00,2019-03-30 23:00:00
122,3,3,0,0.006204679400446146,2019-03-30 22:45:00,2019-03-30 23:00:00
126,1,1,0,0.009315015969734664,2019-03-30 22:45:00,2019-03-30 23:00:00
127,5,2,3,0.015028818438493324,2019-03-30 22:45:00,2019-03-30 23:00:00
129,3,1,2,0.00583305690136541,2019-03-30 22:45:00,2019-03-30 23:00:00
137,1,1,0,0.006204679400446146,2019-03-30 22:45:00,2019-03-30 23:00:00
138,24,13,11,0.029757285066918587,2019-03-30 22:45:00,2019-03-30 23:00:00
140,1,1,0,0.00583305690136541,2019-03-30 22:45:00,2019-03-30 23:00:00
141,2,1,1,0.006204679400446146,2019-03-30 22:45:00,2019-03-30 23:00:00
147,1,1,0,0.006886904485774603,2019-03-30 22:45:00,2019-03-30 23:00:00
151,2,1,1,0.02228796415491121,2019-03-30 22:45:00,2019-03-30 23:00:00
153,2,1,1,0.00701253522089363,2019-03-30 22:45:00,2019-03-30 23:00:00
154,2,0,2,0.0033537392334662885,2019-03-30 22:45:00,2019-03-30 23:00:00
158,1,1,0,0.006204679400446146,2019-03-30 22:45:00,2019-03-30 23:00:00
162,9,5,4,0.014446164851353943,2019-03-30 22:45:00,2019-03-30 23:00:00
164,6,2,4,0.00583305690136541,2019-03-30 22:45:00,2019-03-30 23:00:00
168,3,1,2,0.006204679400446146,2019-03-30 22:45:00,2019-03-30 23:00:00
170,2,1,1,0.02228796415491121,2019-03-30 22:45:00,2019-03-30 23:00:00
172,2,2,0,0.011213788133958014,2019-03-30 22:45:00,2019-03-30 23:00:00
173,3,1,2,0.0047059766163657975,2019-03-30 22:45:00,2019-03-30 23:00:00
177,3,2,1,0.008723746353722965,2019-03-30 22:45:00,2019-03-30 23:00:00
191,1,1,0,0.010688554185626798,2019-03-30 22:45:00,2019-03-30 23:00:00
197,2,2,0,0.0060582139992653074,2019-03-30 22:45:00,2019-03-30 23:00:00
201,1,1,0,0.005653491589285062,2019-03-30 22:45:00,2019-03-30 23:00:00
203,3,2,1,0.03099436090274112,2019-03-30 22:45:00,2019-03-30 23:00:00
1,1,0,1,0.003706801892393667,2019-03-30 23:00:00,2019-03-30 23:15:00
15,4,1,3,0.005164238144656057,2019-03-30 23:00:00,2019-03-30 23:15:00
16,3,1,2,0.005170143203440991,2019-03-30 23:00:00,2019-03-30 23:15:00
23,9,4,5,0.0062276502768726545,2019-03-30 23:00:00,2019-03-30 23:15:00
26,4,2,2,0.009187407074521765,2019-03-30 23:00:00,2019-03-30 23:15:00
27,6,3,3,0.024589959321113325,2019-03-30 23:00:00,2019-03-30 23:15:00
35,1,0,1,0.003706801892393667,2019-03-30 23:00:00,2019-03-30 23:15:00
37,1,0,1,0.003706801892393667,2019-03-30 23:00:00,2019-03-30 23:15:00
40,5,0,5,0.003706801892393667,2019-03-30 23:00:00,2019-03-30 23:15:00
41,4,0,4,0.003706801892393667,2019-03-30 23:00:00,2019-03-30 23:15:00
46,2,0,2,0.003706801892393667,2019-03-30 23:00:00,2019-03-30 23:15:00
50,2,2,0,0.005282332132693034,2019-03-30 23:00:00,2019-03-30 23:15:00
58,2,2,0,0.005282332132693034,2019-03-30 23:00:00,2019-03-30 23:15:00
61,3,3,0,0.008079110649180836,2019-03-30 23:00:00,2019-03-30 23:15:00
62,8,3,5,0.009394889934794957,2019-03-30 23:00:00,2019-03-30 23:15:00
66,1,1,0,0.006857862372992402,2019-03-30 23:00:00,2019-03-30 23:15:00
67,2,0,2,0.003706801892393667,2019-03-30 23:00:00,2019-03-30 23:15:00
68,2,2,0,0.012662454698035374,2019-03-30 23:00:00,2019-03-30 23:15:00
74,2,0,2,0.003706801892393667,2019-03-30 23:00:00,2019-03-30 23:15:00
85,2,0,2,0.003706801892393667,2019-03-30 23:00:00,2019-03-30 23:15:00
87,1,0,1,0.003706801892393667,2019-03-30 23:00:00,2019-03-30 23:15:00
88,2,2,0,0.006857862372992402,2019-03-30 23:00:00,2019-03-30 23:15:00
90,1,1,0,0.004337013988513414,2019-03-30 23:00:00,2019-03-30 23:15:00
104,2,2,0,0.006901465216289437,2019-03-30 23:00:00,2019-03-30 23:15:00
108,1,1,0,0.005282332132693034,2019-03-30 23:00:00,2019-03-30 23:15:00
109,4,2,2,0.024589959321113325,2019-03-30 23:00:00,2019-03-30 23:15:00
111,1,0,1,0.003706801892393667,2019-03-30 23:00:00,2019-03-30 23:15:00
112,2,1,1,0.00565005022874352,2019-03-30 23:00:00,2019-03-30 23:15:00
113,2,2,0,0.006857862372992402,2019-03-30 23:00:00,2019-03-30 23:15:00
115,2,2,0,0.007593298565093373,2019-03-30 23:00:00,2019-03-30 23:15:00
116,1,1,0,0.005904323511685842,2019-03-30 23:00:00,2019-03-30 23:15:00
118,2,0,2,0.003706801892393667,2019-03-30 23:00:00,2019-03-30 23:15:00
120,1,1,0,0.006857862372992402,2019-03-30 23:00:00,2019-03-30 23:15:00
122,2,2,0,0.006857862372992402,2019-03-30 23:00:00,2019-03-30 23:15:00
126,1,1,0,0.006857862372992402,2019-03-30 23:00:00,2019-03-30 23:15:00
127,5,2,3,0.015801858073579807,2019-03-30 23:00:00,2019-03-30 23:15:00
129,1,0,1,0.003706801892393667,2019-03-30 23:00:00,2019-03-30 23:15:00
137,1,1,0,0.006857862372992402,2019-03-30 23:00:00,2019-03-30 23:15:00
138,23,13,10,0.024060262397877476,2019-03-30 23:00:00,2019-03-30 23:15:00
140,1,1,0,0.006857862372992402,2019-03-30 23:00:00,2019-03-30 23:15:00
141,4,1,3,0.006857862372992402,2019-03-30 23:00:00,2019-03-30 23:15:00
147,1,1,0,0.007611876834222399,2019-03-30 23:00:00,2019-03-30 23:15:00
151,4,2,2,0.024589959321113325,2019-03-30 23:00:00,2019-03-30 23:15:00
153,1,0,1,0.003706801892393667,2019-03-30 23:00:00,2019-03-30 23:15:00
154,2,0,2,0.003706801892393667,2019-03-30 23:00:00,2019-03-30 23:15:00
158,1,1,0,0.006857862372992402,2019-03-30 23:00:00,2019-03-30 23:15:00
162,9,5,4,0.015095129377904023,2019-03-30 23:00:00,2019-03-30 23:15:00
164,6,2,4,0.006447104483457717,2019-03-30 23:00:00,2019-03-30 23:15:00
168,1,1,0,0.005904323511685842,2019-03-30 23:00:00,2019-03-30 23:15:00
170,2,1,1,0.024589959321113325,2019-03-30 23:00:00,2019-03-30 23:15:00
171,2,2,0,0.006857862372992402,2019-03-30 23:00:00,2019-03-30 23:15:00
172,2,2,0,0.00797373684966005,2019-03-30 23:00:00,2019-03-30 23:15:00
177,3,2,1,0.008960313419214872,2019-03-30 23:00:00,2019-03-30 23:15:00
191,1,1,0,0.00850981364305005,2019-03-30 23:00:00,2019-03-30 23:15:00
196,5,1,4,0.006857862372992402,2019-03-30 23:00:00,2019-03-30 23:15:00
197,2,2,0,0.006901465216289437,2019-03-30 23:00:00,2019-03-30 23:15:00
201,1,1,0,0.00575218008262037,2019-03-30 23:00:00,2019-03-30 23:15:00
203,1,0,1,0.003706801892393667,2019-03-30 23:00:00,2019-03-30 23:15:00
15,6,0,6,0.003913506778651334,2019-03-30 23:15:00,2019-03-30 23:30:00
16,4,2,2,0.007794761560055652,2019-03-30 23:15:00,2019-03-30 23:30:00
18,4,3,1,0.01127400029687142,2019-03-30 23:15:00,2019-03-30 23:30:00
19,2,1,1,0.025920161343839263,2019-03-30 23:15:00,2019-03-30 23:30:00
23,5,0,5,0.003913506778651334,2019-03-30 23:15:00,2019-03-30 23:30:00
26,4,2,2,0.012592914913533955,2019-03-30 23:15:00,2019-03-30 23:30:00
27,6,2,4,0.006806642823612208,2019-03-30 23:15:00,2019-03-30 23:30:00
35,2,1,1,0.0044679717474233795,2019-03-30 23:15:00,2019-03-30 23:30:00
37,1,0,1,0.003913506778651334,2019-03-30 23:15:00,2019-03-30 23:30:00
41,1,0,1,0.003913506778651334,2019-03-30 23:15:00,2019-03-30 23:30:00
46,9,0,9,0.003913506778651334,2019-03-30 23:15:00,2019-03-30 23:30:00
50,2,2,0,0.004652793403680728,2019-03-30 23:15:00,2019-03-30 23:30:00
57,2,2,0,0.006559624874932827,2019-03-30 23:15:00,2019-03-30 23:30:00
61,3,3,0,0.00786875973343061,2019-03-30 23:15:00,2019-03-30 23:30:00
62,2,1,1,0.025920161343839263,2019-03-30 23:15:00,2019-03-30 23:30:00
67,2,0,2,0.003913506778651334,2019-03-30 23:15:00,2019-03-30 23:30:00
68,8,8,0,0.014569152386420843,2019-03-30 23:15:00,2019-03-30 23:30:00
69,1,1,0,0.0072402965912836065,2019-03-30 23:15:00,2019-03-30 23:30:00
70,2,0,2,0.003913506778651334,2019-03-30 23:15:00,2019-03-30 23:30:00
74,1,0,1,0.003913506778651334,2019-03-30 23:15:00,2019-03-30 23:30:00
85,2,0,2,0.003913506778651334,2019-03-30 23:15:00,2019-03-30 23:30:00
88,2,2,0,0.0072402965912836065,2019-03-30 23:15:00,2019-03-30 23:30:00
104,1,0,1,0.003913506778651334,2019-03-30 23:15:00,2019-03-30 23:30:00
109,6,3,3,0.010103175925222271,2019-03-30 23:15:00,2019-03-30 23:30:00
110,1,0,1,0.003913506778651334,2019-03-30 23:15:00,2019-03-30 23:30:00
111,1,1,0,0.013497542347469652,2019-03-30 23:15:00,2019-03-30 23:30:00
114,1,1,0,0.00523656582679208,2019-03-30 23:15:00,2019-03-30 23:30:00
115,2,0,2,0.003913506778651334,2019-03-30 23:15:00,2019-03-30 23:30:00
116,1,1,0,0.007226617433103356,2019-03-30 23:15:00,2019-03-30 23:30:00
127,2,0,2,0.003913506778651334,2019-03-30 23:15:00,2019-03-30 23:30:00
129,1,1,0,0.010629059052980828,2019-03-30 23:15:00,2019-03-30 23:30:00
137,1,1,0,0.0072402965912836065,2019-03-30 23:15:00,2019-03-30 23:30:00
138,21,11,10,0.015563607946467106,2019-03-30 23:15:00,2019-03-30 23:30:00
140,3,2,1,0.007899746057963085,2019-03-30 23:15:00,2019-03-30 23:30:00
141,1,1,0,0.0077116439478938596,2019-03-30 23:15:00,2019-03-30 23:30:00
147,1,1,0,0.009266125100901683,2019-03-30 23:15:00,2019-03-30 23:30:00
159,2,2,0,0.0072402965912836065,2019-03-30 23:15:00,2019-03-30 23:30:00
162,10,5,5,0.009614965465021687,2019-03-30 23:15:00,2019-03-30 23:30:00
164,10,6,4,0.009378319308021873,2019-03-30 23:15:00,2019-03-30 23:30:00
168,1,1,0,0.007226617433103356,2019-03-30 23:15:00,2019-03-30 23:30:00
170,2,1,1,0.025920161343839263,2019-03-30 23:15:00,2019-03-30 23:30:00
172,2,2,0,0.006213599591520546,2019-03-30 23:15:00,2019-03-30 23:30:00
173,2,0,2,0.003913506778651334,2019-03-30 23:15:00,2019-03-30 23:30:00
177,2,2,0,0.006871300677134838,2019-03-30 23:15:00,2019-03-30 23:30:00
196,5,2,3,0.004652793403680728,2019-03-30 23:15:00,2019-03-30 23:30:00
197,1,1,0,0.0072402965912836065,2019-03-30 23:15:00,2019-03-30 23:30:00
199,1,1,0,0.00523656582679208,2019-03-30 23:15:00,2019-03-30 23:30:00
1,2,2,0,0.009463989255414453,2019-03-30 23:30:00,2019-03-30 23:45:00
10,2,1,1,0.004165449550528708,2019-03-30 23:30:00,2019-03-30 23:45:00
15,4,0,4,0.0035896687003109783,2019-03-30 23:30:00,2019-03-30 23:45:00
16,5,2,3,0.007658357130357028,2019-03-30 23:30:00,2019-03-30 23:45:00
18,10,4,6,0.01221775809500439,2019-03-30 23:30:00,2019-03-30 23:45:00
19,9,2,7,0.004741230400746437,2019-03-30 23:30:00,2019-03-30 23:45:00
23,5,1,4,0.004558436325638665,2019-03-30 23:30:00,2019-03-30 23:45:00
26,4,2,2,0.011550951643196337,2019-03-30 23:30:00,2019-03-30 23:45:00
27,3,1,2,0.004165449550528708,2019-03-30 23:30:00,2019-03-30 23:45:00
28,3,1,2,0.006641185022845516,2019-03-30 23:30:00,2019-03-30 23:45:00
35,2,2,0,0.005624012915334003,2019-03-30 23:30:00,2019-03-30 23:45:00
37,1,0,1,0.0035896687003109783,2019-03-30 23:30:00,2019-03-30 23:45:00
41,3,3,0,0.010182176159874837,2019-03-30 23:30:00,2019-03-30 23:45:00
46,6,3,3,0.010432765788004878,2019-03-30 23:30:00,2019-03-30 23:45:00
50,2,2,0,0.009502307428038724,2019-03-30 23:30:00,2019-03-30 23:45:00
57,2,2,0,0.006382888008789174,2019-03-30 23:30:00,2019-03-30 23:45:00
58,4,2,2,0.006853210939918733,2019-03-30 23:30:00,2019-03-30 23:45:00
61,2,0,2,0.0035896687003109783,2019-03-30 23:30:00,2019-03-30 23:45:00
67,3,0,3,0.0035896687003109783,2019-03-30 23:30:00,2019-03-30 23:45:00
68,6,6,0,0.018252616962285674,2019-03-30 23:30:00,2019-03-30 23:45:00
69,1,1,0,0.006641185022845516,2019-03-30 23:30:00,2019-03-30 23:45:00
74,1,0,1,0.0035896687003109783,2019-03-30 23:30:00,2019-03-30 23:45:00
85,1,0,1,0.0035896687003109783,2019-03-30 23:30:00,2019-03-30 23:45:00
88,4,4,0,0.013628273626057844,2019-03-30 23:30:00,2019-03-30 23:45:00
89,2,1,1,0.023820331375594916,2019-03-30 23:30:00,2019-03-30 23:45:00
104,1,0,1,0.0035896687003109783,2019-03-30 23:30:00,2019-03-30 23:45:00
109,8,4,4,0.01209268037066965,2019-03-30 23:30:00,2019-03-30 23:45:00
110,1,0,1,0.0035896687003109783,2019-03-30 23:30:00,2019-03-30 23:45:00
111,3,2,1,0.03526866261865881,2019-03-30 23:30:00,2019-03-30 23:45:00
112,1,0,1,0.0035896687003109783,2019-03-30 23:30:00,2019-03-30 23:45:00
114,1,0,1,0.0035896687003109783,2019-03-30 23:30:00,2019-03-30 23:45:00
115,2,2,0,0.007051854403589371,2019-03-30 23:30:00,2019-03-30 23:45:00
116,1,1,0,0.005759770648979529,2019-03-30 23:30:00,2019-03-30 23:45:00
126,1,0,1,0.0035896687003109783,2019-03-30 23:30:00,2019-03-30 23:45:00
127,4,2,2,0.011288227744513182,2019-03-30 23:30:00,2019-03-30 23:45:00
129,3,1,2,0.009415593680493366,2019-03-30 23:30:00,2019-03-30 23:45:00
137,1,1,0,0.006641185022845516,2019-03-30 23:30:00,2019-03-30 23:45:00
138,11,4,7,0.011499980380363007,2019-03-30 23:30:00,2019-03-30 23:45:00
140,3,2,1,0.006853210939918733,2019-03-30 23:30:00,2019-03-30 23:45:00
147,1,1,0,0.008499435320661799,2019-03-30 23:30:00,2019-03-30 23:45:00
153,1,0,1,0.0035896687003109783,2019-03-30 23:30:00,2019-03-30 23:45:00
156,1,1,0,0.006412472932879915,2019-03-30 23:30:00,2019-03-30 23:45:00
158,4,2,2,0.023820331375594916,2019-03-30 23:30:00,2019-03-30 23:45:00
159,2,2,0,0.007828489980712595,2019-03-30 23:30:00,2019-03-30 23:45:00
162,9,4,5,0.007751106355796777,2019-03-30 23:30:00,2019-03-30 23:45:00
164,7,2,5,0.009597504386709388,2019-03-30 23:30:00,2019-03-30 23:45:00
168,1,1,0,0.005759770648979529,2019-03-30 23:30:00,2019-03-30 23:45:00
170,2,1,1,0.023820331375594916,2019-03-30 23:30:00,2019-03-30 23:45:00
172,2,2,0,0.00587627607274793,2019-03-30 23:30:00,2019-03-30 23:45:00
173,3,1,2,0.004986278354550076,2019-03-30 23:30:00,2019-03-30 23:45:00
177,2,2,0,0.006304118101659342,2019-03-30 23:30:00,2019-03-30 23:45:00
191,7,5,2,0.010932821597959518,2019-03-30 23:30:00,2019-03-30 23:45:00
195,1,1,0,0.004558436325638665,2019-03-30 23:30:00,2019-03-30 23:45:00
196,3,0,3,0.0035896687003109783,2019-03-30 23:30:00,2019-03-30 23:45:00
199,1,1,0,0.004986278354550076,2019-03-30 23:30:00,2019-03-30 23:45:00
203,1,1,0,0.004986278354550076,2019-03-30 23:30:00,2019-03-30 23:45:00
2,1,1,0,0.004719081679426264,2019-03-30 23:45:00,2019-03-31 00:00:00
5,1,1,0,0.006781375403253854,2019-03-30 23:45:00,2019-03-31 00:00:00
10,2,1,1,0.004590724451017405,2019-03-30 23:45:00,2019-03-31 00:00:00
15,1,0,1,0.0037861056482440493,2019-03-30 23:45:00,2019-03-31 00:00:00
16,2,1,1,0.0048589307186085225,2019-03-30 23:45:00,2019-03-31 00:00:00
18,4,1,3,0.0048589307186085225,2019-03-30 23:45:00,2019-03-31 00:00:00
19,4,0,4,0.0037861056482440493,2019-03-30 23:45:00,2019-03-31 00:00:00
23,7,2,5,0.006603854896915541,2019-03-30 23:45:00,2019-03-31 00:00:00
26,4,2,2,0.012182889928883986,2019-03-30 23:45:00,2019-03-31 00:00:00
27,1,1,0,0.004590724451017405,2019-03-30 23:45:00,2019-03-31 00:00:00
28,1,0,1,0.0037861056482440493,2019-03-30 23:45:00,2019-03-31 00:00:00
35,2,2,0,0.005931755788972997,2019-03-30 23:45:00,2019-03-31 00:00:00
37,1,0,1,0.0037861056482440493,2019-03-30 23:45:00,2019-03-31 00:00:00
40,1,1,0,0.005639216920629548,2019-03-30 23:45:00,2019-03-31 00:00:00
41,4,3,1,0.010907054230993175,2019-03-30 23:45:00,2019-03-31 00:00:00
46,3,3,0,0.016718599955439808,2019-03-30 23:45:00,2019-03-31 00:00:00
50,1,1,0,0.013058037593969847,2019-03-30 23:45:00,2019-03-31 00:00:00
57,3,3,0,0.005491008793422752,2019-03-30 23:45:00,2019-03-31 00:00:00
58,5,3,2,0.011426911945680195,2019-03-30 23:45:00,2019-03-31 00:00:00
61,2,0,2,0.0037861056482440493,2019-03-30 23:45:00,2019-03-31 00:00:00
67,1,0,1,0.0037861056482440493,2019-03-30 23:45:00,2019-03-31 00:00:00
68,3,2,1,0.00977664515826366,2019-03-30 23:45:00,2019-03-31 00:00:00
69,2,0,2,0.0037861056482440493,2019-03-30 23:45:00,2019-03-31 00:00:00
70,1,1,0,0.012097204280337774,2019-03-30 23:45:00,2019-03-31 00:00:00
74,1,0,1,0.0037861056482440493,2019-03-30 23:45:00,2019-03-31 00:00:00
88,2,2,0,0.008590834843337385,2019-03-30 23:45:00,2019-03-31 00:00:00
89,9,3,6,0.0065850337417906945,2019-03-30 23:45:00,2019-03-31 00:00:00
109,7,4,3,0.01295539419603221,2019-03-30 23:45:00,2019-03-31 00:00:00
110,3,0,3,0.0037861056482440493,2019-03-30 23:45:00,2019-03-31 00:00:00
112,1,0,1,0.0037861056482440493,2019-03-30 23:45:00,2019-03-31 00:00:00
113,2,1,1,0.02507619577790782,2019-03-30 23:45:00,2019-03-31 00:00:00
115,5,2,3,0.006539754153917249,2019-03-30 23:45:00,2019-03-31 00:00:00
116,1,1,0,0.00791657840675385,2019-03-30 23:45:00,2019-03-31 00:00:00
122,1,1,0,0.0048589307186085225,2019-03-30 23:45:00,2019-03-31 00:00:00
126,1,1,0,0.005770928266024901,2019-03-30 23:45:00,2019-03-31 00:00:00
127,4,1,3,0.010570380497323777,2019-03-30 23:45:00,2019-03-31 00:00:00
129,4,2,2,0.0056520577106084794,2019-03-30 23:45:00,2019-03-31 00:00:00
137,1,1,0,0.007004580859337471,2019-03-30 23:45:00,2019-03-31 00:00:00
138,9,1,8,0.0042362478194467226,2019-03-30 23:45:00,2019-03-31 00:00:00
141,2,2,0,0.007492328193015047,2019-03-30 23:45:00,2019-03-31 00:00:00
147,1,1,0,0.008964414717790564,2019-03-30 23:45:00,2019-03-31 00:00:00
151,3,3,0,0.01117752445644428,2019-03-30 23:45:00,2019-03-31 00:00:00
153,4,3,1,0.007980685214032862,2019-03-30 23:45:00,2019-03-31 00:00:00
156,1,1,0,0.007004580859337471,2019-03-30 23:45:00,2019-03-31 00:00:00
158,4,2,2,0.02507619577790782,2019-03-30 23:45:00,2019-03-31 00:00:00
159,2,2,0,0.008152567334921375,2019-03-30 23:45:00,2019-03-31 00:00:00
162,3,0,3,0.0037861056482440493,2019-03-30 23:45:00,2019-03-31 00:00:00
164,4,1,3,0.007004580859337471,2019-03-30 23:45:00,2019-03-31 00:00:00
168,2,2,0,0.005931755788972997,2019-03-30 23:45:00,2019-03-31 00:00:00
170,2,1,1,0.02507619577790782,2019-03-30 23:45:00,2019-03-31 00:00:00
172,5,2,3,0.005981699585772287,2019-03-30 23:45:00,2019-03-31 00:00:00
173,5,3,2,0.00513653216185207,2019-03-30 23:45:00,2019-03-31 00:00:00
177,1,1,0,0.0048589307186085225,2019-03-30 23:45:00,2019-03-31 00:00:00
191,2,2,0,0.006031643382571577,2019-03-30 23:45:00,2019-03-31 00:00:00
195,2,1,1,0.004908874515407813,2019-03-30 23:45:00,2019-03-31 00:00:00
196,3,0,3,0.0037861056482440493,2019-03-30 23:45:00,2019-03-31 00:00:00
203,2,2,0,0.007454723030540145,2019-03-30 23:45:00,2019-03-31 00:00:00
1,1,0,1,0.003937930739453348,2019-03-31 00:00:00,2019-03-31 00:15:00
5,1,1,0,0.004774822092249542,2019-03-31 00:00:00,2019-03-31 00:15:00
15,1,0,1,0.003937930739453348,2019-03-31 00:00:00,2019-03-31 00:15:00
16,7,1,6,0.004587956092552137,2019-03-31 00:00:00,2019-03-31 00:15:00
18,3,1,2,0.005351546974261215,2019-03-31 00:00:00,2019-03-31 00:15:00
19,2,0,2,0.003937930739453348,2019-03-31 00:00:00,2019-03-31 00:15:00
23,3,0,3,0.003937930739453348,2019-03-31 00:00:00,2019-03-31 00:15:00
26,4,2,2,0.012671562556772657,2019-03-31 00:00:00,2019-03-31 00:15:00
27,1,0,1,0.003937930739453348,2019-03-31 00:00:00,2019-03-31 00:15:00
28,4,4,0,0.011647541257206209,2019-03-31 00:00:00,2019-03-31 00:15:00
30,1,1,0,0.008234081528719473,2019-03-31 00:00:00,2019-03-31 00:15:00
35,1,1,0,0.004587956092552137,2019-03-31 00:00:00,2019-03-31 00:15:00
37,1,0,1,0.003937930739453348,2019-03-31 00:00:00,2019-03-31 00:15:00
40,1,1,0,0.007285496150638126,2019-03-31 00:00:00,2019-03-31 00:15:00
41,2,1,1,0.010131252284882169,2019-03-31 00:00:00,2019-03-31 00:15:00
46,3,3,0,0.015035900716313964,2019-03-31 00:00:00,2019-03-31 00:15:00
50,1,1,0,0.012550471790827574,2019-03-31 00:00:00,2019-03-31 00:15:00
57,7,1,6,0.005611713445045737,2019-03-31 00:00:00,2019-03-31 00:15:00
58,4,1,3,0.005495013759700365,2019-03-31 00:00:00,2019-03-31 00:15:00
62,7,2,5,0.005966890130219955,2019-03-31 00:00:00,2019-03-31 00:15:00
67,2,1,1,0.007285496150638126,2019-03-31 00:00:00,2019-03-31 00:15:00
68,3,2,1,0.005611713445045737,2019-03-31 00:00:00,2019-03-31 00:15:00
69,2,0,2,0.003937930739453348,2019-03-31 00:00:00,2019-03-31 00:15:00
70,1,1,0,0.008708374217760148,2019-03-31 00:00:00,2019-03-31 00:15:00
74,1,0,1,0.003937930739453348,2019-03-31 00:00:00,2019-03-31 00:15:00
80,2,2,0,0.007285496150638126,2019-03-31 00:00:00,2019-03-31 00:15:00
88,3,3,0,0.009517206424761311,2019-03-31 00:00:00,2019-03-31 00:15:00
89,1,1,0,0.004587956092552137,2019-03-31 00:00:00,2019-03-31 00:15:00
109,7,3,4,0.006651597680458792,2019-03-31 00:00:00,2019-03-31 00:15:00
110,5,2,3,0.006765163209069083,2019-03-31 00:00:00,2019-03-31 00:15:00
111,1,1,0,0.005495013759700365,2019-03-31 00:00:00,2019-03-31 00:15:00
115,1,0,1,0.003937930739453348,2019-03-31 00:00:00,2019-03-31 00:15:00
116,1,1,0,0.004587956092552137,2019-03-31 00:00:00,2019-03-31 00:15:00
118,1,0,1,0.003937930739453348,2019-03-31 00:00:00,2019-03-31 00:15:00
120,1,0,1,0.003937930739453348,2019-03-31 00:00:00,2019-03-31 00:15:00
122,2,2,0,0.009202502029853572,2019-03-31 00:00:00,2019-03-31 00:15:00
126,2,1,1,0.00505378587651494,2019-03-31 00:00:00,2019-03-31 00:15:00
127,4,0,4,0.003937930739453348,2019-03-31 00:00:00,2019-03-31 00:15:00
129,1,0,1,0.003937930739453348,2019-03-31 00:00:00,2019-03-31 00:15:00
137,1,1,0,0.007285496150638126,2019-03-31 00:00:00,2019-03-31 00:15:00
138,11,5,6,0.008823401027238099,2019-03-31 00:00:00,2019-03-31 00:15:00
141,1,1,0,0.004774822092249542,2019-03-31 00:00:00,2019-03-31 00:15:00
147,1,1,0,0.009323997145587879,2019-03-31 00:00:00,2019-03-31 00:15:00
151,3,3,0,0.010633061561822903,2019-03-31 00:00:00,2019-03-31 00:15:00
153,3,3,0,0.011330742301433884,2019-03-31 00:00:00,2019-03-31 00:15:00
156,1,0,1,0.003937930739453348,2019-03-31 00:00:00,2019-03-31 00:15:00
159,2,2,0,0.014284432519591446,2019-03-31 00:00:00,2019-03-31 00:15:00
160,2,0,2,0.003937930739453348,2019-03-31 00:00:00,2019-03-31 00:15:00
162,2,0,2,0.003937930739453348,2019-03-31 00:00:00,2019-03-31 00:15:00
164,3,0,3,0.003937930739453348,2019-03-31 00:00:00,2019-03-31 00:15:00
168,2,2,0,0.007771942497884241,2019-03-31 00:00:00,2019-03-31 00:15:00
170,2,1,1,0.02569288002013127,2019-03-31 00:00:00,2019-03-31 00:15:00
171,2,2,0,0.0064381792880847,2019-03-31 00:00:00,2019-03-31 00:15:00
172,4,2,2,0.006727568582107329,2019-03-31 00:00:00,2019-03-31 00:15:00
173,8,6,2,0.012170966438422876,2019-03-31 00:00:00,2019-03-31 00:15:00
177,5,5,0,0.012885409003159817,2019-03-31 00:00:00,2019-03-31 00:15:00
190,2,1,1,0.007285496150638126,2019-03-31 00:00:00,2019-03-31 00:15:00
191,4,2,2,0.006169641013576533,2019-03-31 00:00:00,2019-03-31 00:15:00
195,1,0,1,0.003937930739453348,2019-03-31 00:00:00,2019-03-31 00:15:00
196,1,0,1,0.003937930739453348,2019-03-31 00:00:00,2019-03-31 00:15:00
197,2,0,2,0.003937930739453348,2019-03-31 00:00:00,2019-03-31 00:15:00
202,3,3,0,0.011834787675053686,2019-03-31 00:00:00,2019-03-31 00:15:00
2,1,1,0,0.009925932657971884,2019-03-31 00:15:00,2019-03-31 00:30:00
10,1,0,1,0.0038581445451627274,2019-03-31 00:15:00,2019-03-31 00:30:00
15,1,0,1,0.0038581445451627274,2019-03-31 00:15:00,2019-03-31 00:30:00
16,5,2,3,0.008904793577846758,2019-03-31 00:15:00,2019-03-31 00:30:00
18,6,1,5,0.004620905835788515,2019-03-31 00:15:00,2019-03-31 00:30:00
23,4,0,4,0.0038581445451627274,2019-03-31 00:15:00,2019-03-31 00:30:00
26,4,2,2,0.012414731348614014,2019-03-31 00:15:00,2019-03-31 00:30:00
27,1,0,1,0.0038581445451627274,2019-03-31 00:15:00,2019-03-31 00:30:00
28,6,6,0,0.013036353553467456,2019-03-31 00:15:00,2019-03-31 00:30:00
37,1,0,1,0.0038581445451627274,2019-03-31 00:15:00,2019-03-31 00:30:00
40,1,1,0,0.007137867299614079,2019-03-31 00:15:00,2019-03-31 00:30:00
41,1,1,0,0.007137867299614079,2019-03-31 00:15:00,2019-03-31 00:30:00
46,6,3,3,0.018589257923181963,2019-03-31 00:15:00,2019-03-31 00:30:00
57,8,3,5,0.011917426567979141,2019-03-31 00:15:00,2019-03-31 00:30:00
58,1,0,1,0.0038581445451627274,2019-03-31 00:15:00,2019-03-31 00:30:00
62,3,0,3,0.0038581445451627274,2019-03-31 00:15:00,2019-03-31 00:30:00
67,2,1,1,0.007274251875586224,2019-03-31 00:15:00,2019-03-31 00:30:00
68,3,3,0,0.007137867299614079,2019-03-31 00:15:00,2019-03-31 00:30:00
70,1,0,1,0.0038581445451627274,2019-03-31 00:15:00,2019-03-31 00:30:00
74,1,0,1,0.0038581445451627274,2019-03-31 00:15:00,2019-03-31 00:30:00
80,2,2,0,0.006285259790286391,2019-03-31 00:15:00,2019-03-31 00:30:00
88,4,4,0,0.010087110426540768,2019-03-31 00:15:00,2019-03-31 00:30:00
90,3,2,1,0.007137867299614079,2019-03-31 00:15:00,2019-03-31 00:30:00
104,1,1,0,0.013020866498118216,2019-03-31 00:15:00,2019-03-31 00:30:00
109,8,2,6,0.005383667126414302,2019-03-31 00:15:00,2019-03-31 00:30:00
111,5,4,1,0.010778540167299573,2019-03-31 00:15:00,2019-03-31 00:30:00
112,2,2,0,0.005429402644803943,2019-03-31 00:15:00,2019-03-31 00:30:00
113,1,1,0,0.004678075233775565,2019-03-31 00:15:00,2019-03-31 00:30:00
115,1,0,1,0.0038581445451627274,2019-03-31 00:15:00,2019-03-31 00:30:00
116,1,1,0,0.006381469061504742,2019-03-31 00:15:00,2019-03-31 00:30:00
118,4,2,2,0.008037013166212012,2019-03-31 00:15:00,2019-03-31 00:30:00
120,2,0,2,0.0038581445451627274,2019-03-31 00:15:00,2019-03-31 00:30:00
127,3,0,3,0.0038581445451627274,2019-03-31 00:15:00,2019-03-31 00:30:00
129,1,0,1,0.0038581445451627274,2019-03-31 00:15:00,2019-03-31 00:30:00
137,1,1,0,0.007137867299614079,2019-03-31 00:15:00,2019-03-31 00:30:00
138,8,2,6,0.005383667126414302,2019-03-31 00:15:00,2019-03-31 00:30:00
140,1,0,1,0.0038581445451627274,2019-03-31 00:15:00,2019-03-31 00:30:00
141,2,2,0,0.0057713161519260155,2019-03-31 00:15:00,2019-03-31 00:30:00
147,1,1,0,0.009135008594162664,2019-03-31 00:15:00,2019-03-31 00:30:00
153,4,3,1,0.0099840087293484,2019-03-31 00:15:00,2019-03-31 00:30:00
154,3,1,2,0.012345477307748074,2019-03-31 00:15:00,2019-03-31 00:30:00
156,1,0,1,0.0038581445451627274,2019-03-31 00:15:00,2019-03-31 00:30:00
159,2,2,0,0.01230545223017429,2019-03-31 00:15:00,2019-03-31 00:30:00
160,2,0,2,0.0038581445451627274,2019-03-31 00:15:00,2019-03-31 00:30:00
162,2,0,2,0.0038581445451627274,2019-03-31 00:15:00,2019-03-31 00:30:00
164,3,0,3,0.0038581445451627274,2019-03-31 00:15:00,2019-03-31 00:30:00
168,1,1,0,0.007137867299614079,2019-03-31 00:15:00,2019-03-31 00:30:00
170,2,1,1,0.02518167356500009,2019-03-31 00:15:00,2019-03-31 00:30:00
171,3,3,0,0.008663389880865653,2019-03-31 00:15:00,2019-03-31 00:30:00
172,3,3,0,0.011565378842875562,2019-03-31 00:15:00,2019-03-31 00:30:00
173,5,3,2,0.00993677676852718,2019-03-31 00:15:00,2019-03-31 00:30:00
177,6,6,0,0.011726971803766442,2019-03-31 00:15:00,2019-03-31 00:30:00
190,1,0,1,0.0038581445451627274,2019-03-31 00:15:00,2019-03-31 00:30:00
191,2,0,2,0.0038581445451627274,2019-03-31 00:15:00,2019-03-31 00:30:00
195,1,0,1,0.0038581445451627274,2019-03-31 00:15:00,2019-03-31 00:30:00
197,6,1,5,0.007137867299614079,2019-03-31 00:15:00,2019-03-31 00:30:00
201,2,2,0,0.01439334145990788,2019-03-31 00:15:00,2019-03-31 00:30:00
202,3,3,0,0.008709125399255294,2019-03-31 00:15:00,2019-03-31 00:30:00
1,2,2,0,0.009871136137047081,2019-03-31 00:30:00,2019-03-31 00:45:00
2,1,1,0,0.007439946992943112,2019-03-31 00:30:00,2019-03-31 00:45:00
16,1,0,1,0.003936794141307548,2019-03-31 00:30:00,2019-03-31 00:45:00
18,6,0,6,0.003936794141307548,2019-03-31 00:30:00,2019-03-31 00:45:00
23,6,0,6,0.003936794141307548,2019-03-31 00:30:00,2019-03-31 00:45:00
26,7,5,2,0.015578193348795599,2019-03-31 00:30:00,2019-03-31 00:45:00
27,1,0,1,0.003936794141307548,2019-03-31 00:30:00,2019-03-31 00:45:00
28,3,3,0,0.013167117781447414,2019-03-31 00:30:00,2019-03-31 00:45:00
37,1,0,1,0.003936794141307548,2019-03-31 00:30:00,2019-03-31 00:45:00
40,1,1,0,0.007283381495468411,2019-03-31 00:30:00,2019-03-31 00:45:00
46,4,1,3,0.00549341946854849,2019-03-31 00:30:00,2019-03-31 00:45:00
57,7,5,2,0.02010070773476148,2019-03-31 00:30:00,2019-03-31 00:45:00
58,2,1,1,0.007283381495468411,2019-03-31 00:30:00,2019-03-31 00:45:00
61,1,0,1,0.003936794141307548,2019-03-31 00:30:00,2019-03-31 00:45:00
62,1,1,0,0.0069039651391773135,2019-03-31 00:30:00,2019-03-31 00:45:00
67,1,1,0,0.007422555754190159,2019-03-31 00:30:00,2019-03-31 00:45:00
68,3,3,0,0.010472847805214947,2019-03-31 00:30:00,2019-03-31 00:45:00
74,1,0,1,0.003936794141307548,2019-03-31 00:30:00,2019-03-31 00:45:00
88,1,1,0,0.007283381495468411,2019-03-31 00:30:00,2019-03-31 00:45:00
90,3,1,2,0.008241789569107705,2019-03-31 00:30:00,2019-03-31 00:45:00
104,2,2,0,0.00711615664647062,2019-03-31 00:30:00,2019-03-31 00:45:00
109,8,2,6,0.00549341946854849,2019-03-31 00:30:00,2019-03-31 00:45:00
111,6,3,3,0.007283381495468411,2019-03-31 00:30:00,2019-03-31 00:45:00
112,2,2,0,0.005052323259361169,2019-03-31 00:30:00,2019-03-31 00:45:00
113,2,1,1,0.004494558700334358,2019-03-31 00:30:00,2019-03-31 00:45:00
114,1,1,0,0.007283381495468411,2019-03-31 00:30:00,2019-03-31 00:45:00
115,1,0,1,0.003936794141307548,2019-03-31 00:30:00,2019-03-31 00:45:00
116,2,2,0,0.010250552493338177,2019-03-31 00:30:00,2019-03-31 00:45:00
118,4,2,2,0.00820086841781063,2019-03-31 00:30:00,2019-03-31 00:45:00
120,1,0,1,0.003936794141307548,2019-03-31 00:30:00,2019-03-31 00:45:00
122,1,0,1,0.003936794141307548,2019-03-31 00:30:00,2019-03-31 00:45:00
126,1,1,0,0.007283381495468411,2019-03-31 00:30:00,2019-03-31 00:45:00
127,3,0,3,0.003936794141307548,2019-03-31 00:30:00,2019-03-31 00:45:00
129,1,0,1,0.003936794141307548,2019-03-31 00:30:00,2019-03-31 00:45:00
137,1,1,0,0.007283381495468411,2019-03-31 00:30:00,2019-03-31 00:45:00
138,5,2,3,0.010381815135932613,2019-03-31 00:30:00,2019-03-31 00:45:00
140,1,0,1,0.003936794141307548,2019-03-31 00:30:00,2019-03-31 00:45:00
141,2,2,0,0.0056100878183879795,2019-03-31 00:30:00,2019-03-31 00:45:00
147,1,1,0,0.010558312317554303,2019-03-31 00:30:00,2019-03-31 00:45:00
153,12,6,6,0.02094194073521946,2019-03-31 00:30:00,2019-03-31 00:45:00
154,3,1,2,0.0069039651391773135,2019-03-31 00:30:00,2019-03-31 00:45:00
156,1,0,1,0.003936794141307548,2019-03-31 00:30:00,2019-03-31 00:45:00
157,2,2,0,0.00549341946854849,2019-03-31 00:30:00,2019-03-31 00:45:00
158,1,0,1,0.003936794141307548,2019-03-31 00:30:00,2019-03-31 00:45:00
159,2,2,0,0.00616785237741479,2019-03-31 00:30:00,2019-03-31 00:45:00
162,2,0,2,0.003936794141307548,2019-03-31 00:30:00,2019-03-31 00:45:00
164,3,1,2,0.010128294302635902,2019-03-31 00:30:00,2019-03-31 00:45:00
168,1,1,0,0.007283381495468411,2019-03-31 00:30:00,2019-03-31 00:45:00
170,2,1,1,0.025695479949841553,2019-03-31 00:30:00,2019-03-31 00:45:00
172,3,3,0,0.009102392207350075,2019-03-31 00:30:00,2019-03-31 00:45:00
173,3,0,3,0.003936794141307548,2019-03-31 00:30:00,2019-03-31 00:45:00
177,2,2,0,0.006388400482008451,2019-03-31 00:30:00,2019-03-31 00:45:00
197,3,0,3,0.003936794141307548,2019-03-31 00:30:00,2019-03-31 00:45:00
201,2,2,0,0.007050044795789433,2019-03-31 00:30:00,2019-03-31 00:45:00
202,1,1,0,0.007283381495468411,2019-03-31 00:30:00,2019-03-31 00:45:00
203,1,1,0,0.007283381495468411,2019-03-31 00:30:00,2019-03-31 00:45:00
1,4,4,0,0.014655603667099783,2019-03-31 00:45:00,2019-03-31 01:00:00
10,1,1,0,0.005079786373782633,2019-03-31 00:45:00,2019-03-31 01:00:00
15,1,1,0,0.008374601982471856,2019-03-31 00:45:00,2019-03-31 01:00:00
16,1,0,1,0.004000223375856197,2019-03-31 00:45:00,2019-03-31 01:00:00
18,4,0,4,0.004000223375856197,2019-03-31 00:45:00,2019-03-31 01:00:00
23,2,0,2,0.004000223375856197,2019-03-31 00:45:00,2019-03-31 01:00:00
26,4,3,1,0.0065506089902852525,2019-03-31 00:45:00,2019-03-31 01:00:00
28,1,1,0,0.004850351913999215,2019-03-31 00:45:00,2019-03-31 01:00:00
30,1,1,0,0.004680326206370612,2019-03-31 00:45:00,2019-03-31 01:00:00
37,1,0,1,0.004000223375856197,2019-03-31 00:45:00,2019-03-31 01:00:00
40,1,1,0,0.007400737528428271,2019-03-31 00:45:00,2019-03-31 01:00:00
41,5,1,4,0.005079786373782633,2019-03-31 00:45:00,2019-03-31 01:00:00
46,6,1,5,0.004819644114022653,2019-03-31 00:45:00,2019-03-31 01:00:00
57,2,2,0,0.007400737528428271,2019-03-31 00:45:00,2019-03-31 01:00:00
58,1,0,1,0.004000223375856197,2019-03-31 00:45:00,2019-03-31 01:00:00
61,2,2,0,0.009236213206695616,2019-03-31 00:45:00,2019-03-31 01:00:00
67,1,1,0,0.007400737528428271,2019-03-31 00:45:00,2019-03-31 01:00:00
68,5,2,3,0.005360429036885026,2019-03-31 00:45:00,2019-03-31 01:00:00
69,1,1,0,0.00824985006647384,2019-03-31 00:45:00,2019-03-31 01:00:00
88,1,1,0,0.00479107879904361,2019-03-31 00:45:00,2019-03-31 01:00:00
90,3,1,2,0.01029150151800285,2019-03-31 00:45:00,2019-03-31 01:00:00
104,1,1,0,0.00824985006647384,2019-03-31 00:45:00,2019-03-31 01:00:00
108,2,1,1,0.026400101748553072,2019-03-31 00:45:00,2019-03-31 01:00:00
109,8,4,4,0.01572952276913743,2019-03-31 00:45:00,2019-03-31 01:00:00
111,2,0,2,0.004000223375856197,2019-03-31 00:45:00,2019-03-31 01:00:00
112,3,3,0,0.0085570431242581,2019-03-31 00:45:00,2019-03-31 01:00:00
113,5,1,4,0.005079786373782633,2019-03-31 00:45:00,2019-03-31 01:00:00
114,1,1,0,0.01029150151800285,2019-03-31 00:45:00,2019-03-31 01:00:00
115,1,0,1,0.004000223375856197,2019-03-31 00:45:00,2019-03-31 01:00:00
116,3,2,1,0.008534242245952296,2019-03-31 00:45:00,2019-03-31 01:00:00
118,1,0,1,0.004000223375856197,2019-03-31 00:45:00,2019-03-31 01:00:00
119,4,4,0,0.007277906328522021,2019-03-31 00:45:00,2019-03-31 01:00:00
120,2,0,2,0.004000223375856197,2019-03-31 00:45:00,2019-03-31 01:00:00
122,3,2,1,0.007400737528428271,2019-03-31 00:45:00,2019-03-31 01:00:00
126,4,2,2,0.0061593493717090695,2019-03-31 00:45:00,2019-03-31 01:00:00
127,5,0,5,0.004000223375856197,2019-03-31 00:45:00,2019-03-31 01:00:00
129,8,2,6,0.005581934222231022,2019-03-31 00:45:00,2019-03-31 01:00:00
137,1,1,0,0.007400737528428271,2019-03-31 00:45:00,2019-03-31 01:00:00
138,8,5,3,0.014996794942651739,2019-03-31 00:45:00,2019-03-31 01:00:00
140,2,0,2,0.004000223375856197,2019-03-31 00:45:00,2019-03-31 01:00:00
141,2,2,0,0.0063805832826566485,2019-03-31 00:45:00,2019-03-31 01:00:00
147,1,1,0,0.009568810520609206,2019-03-31 00:45:00,2019-03-31 01:00:00
153,3,0,3,0.004000223375856197,2019-03-31 00:45:00,2019-03-31 01:00:00
159,2,2,0,0.006267232810904246,2019-03-31 00:45:00,2019-03-31 01:00:00
162,2,0,2,0.004000223375856197,2019-03-31 00:45:00,2019-03-31 01:00:00
164,2,1,1,0.007400737528428271,2019-03-31 00:45:00,2019-03-31 01:00:00
170,2,1,1,0.026400101748553072,2019-03-31 00:45:00,2019-03-31 01:00:00
172,2,2,0,0.007400737528428271,2019-03-31 00:45:00,2019-03-31 01:00:00
173,3,0,3,0.004000223375856197,2019-03-31 00:45:00,2019-03-31 01:00:00
177,2,2,0,0.0090434945578073,2019-03-31 00:45:00,2019-03-31 01:00:00
197,4,4,0,0.00791901520014992,2019-03-31 00:45:00,2019-03-31 01:00:00
203,1,1,0,0.005700480452142233,2019-03-31 00:45:00,2019-03-31 01:00:00
1,1,1,0,0.004913632372292291,2019-03-31 01:00:00,2019-03-31 01:15:00
10,1,1,0,0.004741388000009269,2019-03-31 01:00:00,2019-03-31 01:15:00
16,1,0,1,0.004052410510877178,2019-03-31 01:00:00,2019-03-31 01:15:00
18,4,0,4,0.004052410510877178,2019-03-31 01:00:00,2019-03-31 01:15:00
23,2,0,2,0.004052410510877178,2019-03-31 01:00:00,2019-03-31 01:15:00
26,6,5,1,0.013525850986443426,2019-03-31 01:00:00,2019-03-31 01:15:00
28,1,1,0,0.004913632372292291,2019-03-31 01:00:00,2019-03-31 01:15:00
37,1,0,1,0.004052410510877178,2019-03-31 01:00:00,2019-03-31 01:15:00
41,4,1,3,0.004741388000009269,2019-03-31 01:00:00,2019-03-31 01:15:00
46,5,0,5,0.004052410510877178,2019-03-31 01:00:00,2019-03-31 01:15:00
57,1,1,0,0.007497297956537632,2019-03-31 01:00:00,2019-03-31 01:15:00
58,1,1,0,0.004741388000009269,2019-03-31 01:00:00,2019-03-31 01:15:00
61,2,2,0,0.007129934310681957,2019-03-31 01:00:00,2019-03-31 01:15:00
67,1,1,0,0.013973597789529217,2019-03-31 01:00:00,2019-03-31 01:15:00
68,5,2,3,0.005774854233707404,2019-03-31 01:00:00,2019-03-31 01:15:00
69,1,1,0,0.005289987286340297,2019-03-31 01:00:00,2019-03-31 01:15:00
75,1,1,0,0.004741388000009269,2019-03-31 01:00:00,2019-03-31 01:15:00
88,1,1,0,0.004913632372292291,2019-03-31 01:00:00,2019-03-31 01:15:00
90,2,2,0,0.006601763743188074,2019-03-31 01:00:00,2019-03-31 01:15:00
108,2,1,1,0.026742738011029315,2019-03-31 01:00:00,2019-03-31 01:15:00
109,11,6,5,0.014544698626742425,2019-03-31 01:00:00,2019-03-31 01:15:00
110,2,2,0,0.008998225055445855,2019-03-31 01:00:00,2019-03-31 01:15:00
111,3,3,0,0.007765140837266538,2019-03-31 01:00:00,2019-03-31 01:15:00
112,4,3,1,0.008961545774096025,2019-03-31 01:00:00,2019-03-31 01:15:00
113,5,0,5,0.004052410510877178,2019-03-31 01:00:00,2019-03-31 01:15:00
114,1,0,1,0.004052410510877178,2019-03-31 01:00:00,2019-03-31 01:15:00
116,1,1,0,0.007497297956537632,2019-03-31 01:00:00,2019-03-31 01:15:00
118,2,1,1,0.011670576298714945,2019-03-31 01:00:00,2019-03-31 01:15:00
119,4,4,0,0.006808320467405541,2019-03-31 01:00:00,2019-03-31 01:15:00
120,2,0,2,0.004052410510877178,2019-03-31 01:00:00,2019-03-31 01:15:00
122,7,2,5,0.007497297956537632,2019-03-31 01:00:00,2019-03-31 01:15:00
126,5,2,3,0.005430365489141359,2019-03-31 01:00:00,2019-03-31 01:15:00
127,4,0,4,0.004052410510877178,2019-03-31 01:00:00,2019-03-31 01:15:00
129,4,0,4,0.004052410510877178,2019-03-31 01:00:00,2019-03-31 01:15:00
137,3,3,0,0.010457318454830979,2019-03-31 01:00:00,2019-03-31 01:15:00
138,11,5,6,0.008734874732000752,2019-03-31 01:00:00,2019-03-31 01:15:00
140,2,0,2,0.004052410510877178,2019-03-31 01:00:00,2019-03-31 01:15:00
141,2,2,0,0.006636076095122519,2019-03-31 01:00:00,2019-03-31 01:15:00
147,1,1,0,0.015550660953108798,2019-03-31 01:00:00,2019-03-31 01:15:00
151,1,1,0,0.005591172410779567,2019-03-31 01:00:00,2019-03-31 01:15:00
153,1,0,1,0.004052410510877178,2019-03-31 01:00:00,2019-03-31 01:15:00
157,1,0,1,0.004052410510877178,2019-03-31 01:00:00,2019-03-31 01:15:00
159,2,2,0,0.005774854233707404,2019-03-31 01:00:00,2019-03-31 01:15:00
162,2,0,2,0.004052410510877178,2019-03-31 01:00:00,2019-03-31 01:15:00
164,2,0,2,0.004052410510877178,2019-03-31 01:00:00,2019-03-31 01:15:00
168,1,1,0,0.005774854233707404,2019-03-31 01:00:00,2019-03-31 01:15:00
170,2,1,1,0.026742738011029315,2019-03-31 01:00:00,2019-03-31 01:15:00
172,2,2,0,0.007497297956537632,2019-03-31 01:00:00,2019-03-31 01:15:00
173,4,0,4,0.004052410510877178,2019-03-31 01:00:00,2019-03-31 01:15:00
177,2,2,0,0.008247761505991743,2019-03-31 01:00:00,2019-03-31 01:15:00
197,4,4,0,0.008944218944976103,2019-03-31 01:00:00,2019-03-31 01:15:00
203,1,1,0,0.005774854233707404,2019-03-31 01:00:00,2019-03-31 01:15:00
1,3,3,0,0.008221339882037583,2019-03-31 01:15:00,2019-03-31 01:30:00
16,1,0,1,0.004069765255582679,2019-03-31 01:15:00,2019-03-31 01:30:00
18,3,0,3,0.004069765255582679,2019-03-31 01:15:00,2019-03-31 01:30:00
23,1,0,1,0.004069765255582679,2019-03-31 01:15:00,2019-03-31 01:30:00
26,6,4,2,0.01329548664770469,2019-03-31 01:15:00,2019-03-31 01:30:00
28,2,2,0,0.00591490953400708,2019-03-31 01:15:00,2019-03-31 01:30:00
37,1,0,1,0.004069765255582679,2019-03-31 01:15:00,2019-03-31 01:30:00
41,1,1,0,0.005799588016605555,2019-03-31 01:15:00,2019-03-31 01:30:00
46,2,1,1,0.007529410777628432,2019-03-31 01:15:00,2019-03-31 01:30:00
57,1,0,1,0.004069765255582679,2019-03-31 01:15:00,2019-03-31 01:30:00
58,1,1,0,0.005799588016605555,2019-03-31 01:15:00,2019-03-31 01:30:00
64,1,0,1,0.004069765255582679,2019-03-31 01:15:00,2019-03-31 01:30:00
67,1,1,0,0.010470457405337006,2019-03-31 01:15:00,2019-03-31 01:30:00
68,2,2,0,0.007529410777628432,2019-03-31 01:15:00,2019-03-31 01:30:00
75,2,2,0,0.012205382057248693,2019-03-31 01:15:00,2019-03-31 01:30:00
86,1,1,0,0.009720983520216987,2019-03-31 01:15:00,2019-03-31 01:30:00
88,1,1,0,0.004934676636094117,2019-03-31 01:15:00,2019-03-31 01:30:00
90,2,2,0,0.005453623464400981,2019-03-31 01:15:00,2019-03-31 01:30:00
104,1,0,1,0.004069765255582679,2019-03-31 01:15:00,2019-03-31 01:30:00
106,1,1,0,0.007529410777628432,2019-03-31 01:15:00,2019-03-31 01:30:00
108,2,1,1,0.026856080475151856,2019-03-31 01:15:00,2019-03-31 01:30:00
109,9,4,5,0.007404447363888272,2019-03-31 01:15:00,2019-03-31 01:30:00
110,3,3,0,0.007846449640817103,2019-03-31 01:15:00,2019-03-31 01:30:00
111,3,3,0,0.00927453921131774,2019-03-31 01:15:00,2019-03-31 01:30:00
112,1,0,1,0.004069765255582679,2019-03-31 01:15:00,2019-03-31 01:30:00
113,2,0,2,0.004069765255582679,2019-03-31 01:15:00,2019-03-31 01:30:00
114,1,0,1,0.004069765255582679,2019-03-31 01:15:00,2019-03-31 01:30:00
116,1,1,0,0.007529410777628432,2019-03-31 01:15:00,2019-03-31 01:30:00
118,2,1,1,0.007529410777628432,2019-03-31 01:15:00,2019-03-31 01:30:00
120,1,0,1,0.004069765255582679,2019-03-31 01:15:00,2019-03-31 01:30:00
122,5,0,5,0.004069765255582679,2019-03-31 01:15:00,2019-03-31 01:30:00
126,1,0,1,0.004069765255582679,2019-03-31 01:15:00,2019-03-31 01:30:00
127,2,0,2,0.004069765255582679,2019-03-31 01:15:00,2019-03-31 01:30:00
129,4,0,4,0.004069765255582679,2019-03-31 01:15:00,2019-03-31 01:30:00
137,5,5,0,0.014280937414496356,2019-03-31 01:15:00,2019-03-31 01:30:00
138,14,7,7,0.014285923327395271,2019-03-31 01:15:00,2019-03-31 01:30:00
140,1,1,0,0.0057131548675493585,2019-03-31 01:15:00,2019-03-31 01:30:00
147,1,1,0,0.009720983520216987,2019-03-31 01:15:00,2019-03-31 01:30:00
151,1,1,0,0.007529410777628432,2019-03-31 01:15:00,2019-03-31 01:30:00
153,1,0,1,0.004069765255582679,2019-03-31 01:15:00,2019-03-31 01:30:00
158,1,0,1,0.004069765255582679,2019-03-31 01:15:00,2019-03-31 01:30:00
159,2,2,0,0.005453623464400981,2019-03-31 01:15:00,2019-03-31 01:30:00
162,2,0,2,0.004069765255582679,2019-03-31 01:15:00,2019-03-31 01:30:00
164,2,0,2,0.004069765255582679,2019-03-31 01:15:00,2019-03-31 01:30:00
168,4,1,3,0.005799588016605555,2019-03-31 01:15:00,2019-03-31 01:30:00
170,2,1,1,0.026856080475151856,2019-03-31 01:15:00,2019-03-31 01:30:00
172,2,2,0,0.00925923353865131,2019-03-31 01:15:00,2019-03-31 01:30:00
173,5,0,5,0.004069765255582679,2019-03-31 01:15:00,2019-03-31 01:30:00
175,1,1,0,0.007529410777628432,2019-03-31 01:15:00,2019-03-31 01:30:00
177,2,2,0,0.007058482811683697,2019-03-31 01:15:00,2019-03-31 01:30:00
190,2,0,2,0.004069765255582679,2019-03-31 01:15:00,2019-03-31 01:30:00
203,1,1,0,0.007529410777628432,2019-03-31 01:15:00,2019-03-31 01:30:00
1,2,2,0,0.008222179861038957,2019-03-31 01:30:00,2019-03-31 01:45:00
15,2,2,0,0.009330558086913533,2019-03-31 01:30:00,2019-03-31 01:45:00
16,3,0,3,0.004048843381540608,2019-03-31 01:30:00,2019-03-31 01:45:00
18,4,2,2,0.008294028231614905,2019-03-31 01:30:00,2019-03-31 01:45:00
19,1,0,1,0.004048843381540608,2019-03-31 01:30:00,2019-03-31 01:45:00
23,1,0,1,0.004048843381540608,2019-03-31 01:30:00,2019-03-31 01:45:00
26,4,2,2,0.011099567507465314,2019-03-31 01:30:00,2019-03-31 01:45:00
28,1,1,0,0.0049093074351141035,2019-03-31 01:30:00,2019-03-31 01:45:00
37,1,0,1,0.004048843381540608,2019-03-31 01:30:00,2019-03-31 01:45:00
46,4,1,3,0.007490699595834591,2019-03-31 01:30:00,2019-03-31 01:45:00
58,1,0,1,0.004048843381540608,2019-03-31 01:30:00,2019-03-31 01:45:00
64,1,0,1,0.004048843381540608,2019-03-31 01:30:00,2019-03-31 01:45:00
67,1,1,0,0.007490699595834591,2019-03-31 01:30:00,2019-03-31 01:45:00
68,2,2,0,0.007490699595834591,2019-03-31 01:30:00,2019-03-31 01:45:00
75,2,2,0,0.008812293159264219,2019-03-31 01:30:00,2019-03-31 01:45:00
86,1,1,0,0.008766734647878385,2019-03-31 01:30:00,2019-03-31 01:45:00
88,1,1,0,0.015391382269909298,2019-03-31 01:30:00,2019-03-31 01:45:00
104,1,0,1,0.004048843381540608,2019-03-31 01:30:00,2019-03-31 01:45:00
106,1,1,0,0.007490699595834591,2019-03-31 01:30:00,2019-03-31 01:45:00
109,9,2,7,0.005347709165492784,2019-03-31 01:30:00,2019-03-31 01:45:00
110,2,2,0,0.006419204380663688,2019-03-31 01:30:00,2019-03-31 01:45:00
111,1,1,0,0.004698276273516697,2019-03-31 01:30:00,2019-03-31 01:45:00
114,1,1,0,0.007490699595834591,2019-03-31 01:30:00,2019-03-31 01:45:00
116,3,3,0,0.006494994570257445,2019-03-31 01:30:00,2019-03-31 01:45:00
118,1,0,1,0.004048843381540608,2019-03-31 01:30:00,2019-03-31 01:45:00
119,1,0,1,0.004048843381540608,2019-03-31 01:30:00,2019-03-31 01:45:00
120,1,0,1,0.004048843381540608,2019-03-31 01:30:00,2019-03-31 01:45:00
127,2,0,2,0.004048843381540608,2019-03-31 01:30:00,2019-03-31 01:45:00
129,2,1,1,0.013342541717469514,2019-03-31 01:30:00,2019-03-31 01:45:00
137,3,3,0,0.0107605774256364,2019-03-31 01:30:00,2019-03-31 01:45:00
138,8,4,4,0.012426127758050375,2019-03-31 01:30:00,2019-03-31 01:45:00
140,1,1,0,0.005683782296441512,2019-03-31 01:30:00,2019-03-31 01:45:00
147,1,1,0,0.008766734647878385,2019-03-31 01:30:00,2019-03-31 01:45:00
158,1,0,1,0.004048843381540608,2019-03-31 01:30:00,2019-03-31 01:45:00
159,2,2,0,0.005769771488687599,2019-03-31 01:30:00,2019-03-31 01:45:00
162,3,1,2,0.01397888605227493,2019-03-31 01:30:00,2019-03-31 01:45:00
164,2,0,2,0.004048843381540608,2019-03-31 01:30:00,2019-03-31 01:45:00
168,4,1,3,0.005769771488687599,2019-03-31 01:30:00,2019-03-31 01:45:00
170,2,1,1,0.02642847667423023,2019-03-31 01:30:00,2019-03-31 01:45:00
172,5,3,2,0.023362375823123265,2019-03-31 01:30:00,2019-03-31 01:45:00
173,4,0,4,0.004048843381540608,2019-03-31 01:30:00,2019-03-31 01:45:00
175,1,1,0,0.007490699595834591,2019-03-31 01:30:00,2019-03-31 01:45:00
177,2,2,0,0.010639909830071048,2019-03-31 01:30:00,2019-03-31 01:45:00
190,3,1,2,0.0049093074351141035,2019-03-31 01:30:00,2019-03-31 01:45:00
203,3,2,1,0.010932555810128574,2019-03-31 01:30:00,2019-03-31 01:45:00
1,2,2,0,0.008269791547990565,2019-03-31 01:45:00,2019-03-31 02:00:00
15,4,2,2,0.012620463100854101,2019-03-31 01:45:00,2019-03-31 02:00:00
16,4,1,3,0.01025708172949763,2019-03-31 01:45:00,2019-03-31 02:00:00
18,6,2,4,0.006196401681866057,2019-03-31 01:45:00,2019-03-31 02:00:00
19,1,0,1,0.003955014402183804,2019-03-31 01:45:00,2019-03-31 02:00:00
23,2,1,1,0.005636054861945495,2019-03-31 01:45:00,2019-03-31 02:00:00
26,3,2,1,0.006588751088228874,2019-03-31 01:45:00,2019-03-31 02:00:00
37,1,0,1,0.003955014402183804,2019-03-31 01:45:00,2019-03-31 02:00:00
46,3,0,3,0.003955014402183804,2019-03-31 01:45:00,2019-03-31 02:00:00
58,1,0,1,0.003955014402183804,2019-03-31 01:45:00,2019-03-31 02:00:00
67,1,1,0,0.007317095321707184,2019-03-31 01:45:00,2019-03-31 02:00:00
68,3,3,0,0.013537264920080705,2019-03-31 01:45:00,2019-03-31 02:00:00
75,2,2,0,0.009408432391360081,2019-03-31 01:45:00,2019-03-31 02:00:00
88,1,1,0,0.015034576998817266,2019-03-31 01:45:00,2019-03-31 02:00:00
90,2,2,0,0.006588751088228874,2019-03-31 01:45:00,2019-03-31 02:00:00
104,1,0,1,0.003955014402183804,2019-03-31 01:45:00,2019-03-31 02:00:00
106,1,1,0,0.007317095321707184,2019-03-31 01:45:00,2019-03-31 02:00:00
109,6,1,5,0.0047651736721820576,2019-03-31 01:45:00,2019-03-31 02:00:00
110,1,1,0,0.005636054861945495,2019-03-31 01:45:00,2019-03-31 02:00:00
111,1,1,0,0.0047651736721820576,2019-03-31 01:45:00,2019-03-31 02:00:00
112,2,1,1,0.007413349154093454,2019-03-31 01:45:00,2019-03-31 02:00:00
114,2,1,1,0.007317095321707184,2019-03-31 01:45:00,2019-03-31 02:00:00
115,2,0,2,0.003955014402183804,2019-03-31 01:45:00,2019-03-31 02:00:00
116,3,3,0,0.008481853427199867,2019-03-31 01:45:00,2019-03-31 02:00:00
118,1,0,1,0.003955014402183804,2019-03-31 01:45:00,2019-03-31 02:00:00
119,1,0,1,0.003955014402183804,2019-03-31 01:45:00,2019-03-31 02:00:00
120,1,0,1,0.003955014402183804,2019-03-31 01:45:00,2019-03-31 02:00:00
126,1,1,0,0.005636054861945495,2019-03-31 01:45:00,2019-03-31 02:00:00
127,2,0,2,0.003955014402183804,2019-03-31 01:45:00,2019-03-31 02:00:00
129,2,1,1,0.013033272679407463,2019-03-31 01:45:00,2019-03-31 02:00:00
137,5,2,3,0.008998135781468875,2019-03-31 01:45:00,2019-03-31 02:00:00
138,9,5,4,0.020386688502267526,2019-03-31 01:45:00,2019-03-31 02:00:00
140,1,1,0,0.005636054861945495,2019-03-31 01:45:00,2019-03-31 02:00:00
147,1,1,0,0.009556038494175578,2019-03-31 01:45:00,2019-03-31 02:00:00
153,3,1,2,0.006878842263369881,2019-03-31 01:45:00,2019-03-31 02:00:00
154,1,1,0,0.00650475238145,2019-03-31 01:45:00,2019-03-31 02:00:00
159,2,2,0,0.006196401681866057,2019-03-31 01:45:00,2019-03-31 02:00:00
161,2,2,0,0.01468383702721519,2019-03-31 01:45:00,2019-03-31 02:00:00
162,2,1,1,0.007413349154093454,2019-03-31 01:45:00,2019-03-31 02:00:00
164,2,0,2,0.003955014402183804,2019-03-31 01:45:00,2019-03-31 02:00:00
168,3,3,0,0.010735530820477887,2019-03-31 01:45:00,2019-03-31 02:00:00
170,2,1,1,0.025811533261679297,2019-03-31 01:45:00,2019-03-31 02:00:00
172,5,2,3,0.012204474413041903,2019-03-31 01:45:00,2019-03-31 02:00:00
173,3,0,3,0.003955014402183804,2019-03-31 01:45:00,2019-03-31 02:00:00
177,2,2,0,0.011067240999495884,2019-03-31 01:45:00,2019-03-31 02:00:00
190,3,1,2,0.005075708042024931,2019-03-31 01:45:00,2019-03-31 02:00:00
191,2,0,2,0.003955014402183804,2019-03-31 01:45:00,2019-03-31 02:00:00
203,3,2,1,0.010679176241230565,2019-03-31 01:45:00,2019-03-31 02:00:00
1,2,2,0,0.007920984298593794,2019-03-31 02:00:00,2019-03-31 02:15:00
15,2,0,2,0.00428143099937297,2019-03-31 02:00:00,2019-03-31 02:15:00
16,2,1,1,0.007920984298593794,2019-03-31 02:00:00,2019-03-31 02:15:00
18,4,0,4,0.00428143099937297,2019-03-31 02:00:00,2019-03-31 02:15:00
23,1,0,1,0.00428143099937297,2019-03-31 02:00:00,2019-03-31 02:15:00
26,3,2,1,0.006101207648983383,2019-03-31 02:00:00,2019-03-31 02:15:00
37,1,0,1,0.00428143099937297,2019-03-31 02:00:00,2019-03-31 02:15:00
46,1,0,1,0.00428143099937297,2019-03-31 02:00:00,2019-03-31 02:15:00
67,1,1,0,0.007920984298593794,2019-03-31 02:00:00,2019-03-31 02:15:00
68,3,3,0,0.01156053759781462,2019-03-31 02:00:00,2019-03-31 02:15:00
75,2,2,0,0.013776804442115527,2019-03-31 02:00:00,2019-03-31 02:15:00
88,1,1,0,0.007920984298593794,2019-03-31 02:00:00,2019-03-31 02:15:00
90,2,2,0,0.006101207648983383,2019-03-31 02:00:00,2019-03-31 02:15:00
109,3,1,2,0.007446555480287156,2019-03-31 02:00:00,2019-03-31 02:15:00
112,1,0,1,0.00428143099937297,2019-03-31 02:00:00,2019-03-31 02:15:00
114,1,0,1,0.00428143099937297,2019-03-31 02:00:00,2019-03-31 02:15:00
116,1,1,0,0.01101494300104359,2019-03-31 02:00:00,2019-03-31 02:15:00
118,1,0,1,0.00428143099937297,2019-03-31 02:00:00,2019-03-31 02:15:00
120,1,0,1,0.00428143099937297,2019-03-31 02:00:00,2019-03-31 02:15:00
126,1,1,0,0.007920984298593794,2019-03-31 02:00:00,2019-03-31 02:15:00
127,2,0,2,0.00428143099937297,2019-03-31 02:00:00,2019-03-31 02:15:00
129,1,0,1,0.00428143099937297,2019-03-31 02:00:00,2019-03-31 02:15:00
137,2,1,1,0.007920984298593794,2019-03-31 02:00:00,2019-03-31 02:15:00
138,4,2,2,0.013776804442115528,2019-03-31 02:00:00,2019-03-31 02:15:00
147,1,1,0,0.009467963649818693,2019-03-31 02:00:00,2019-03-31 02:15:00
153,1,0,1,0.00428143099937297,2019-03-31 02:00:00,2019-03-31 02:15:00
154,1,1,0,0.01101494300104359,2019-03-31 02:00:00,2019-03-31 02:15:00
159,2,2,0,0.007920984298593794,2019-03-31 02:00:00,2019-03-31 02:15:00
161,2,2,0,0.007920984298593794,2019-03-31 02:00:00,2019-03-31 02:15:00
162,1,0,1,0.00428143099937297,2019-03-31 02:00:00,2019-03-31 02:15:00
164,1,0,1,0.00428143099937297,2019-03-31 02:00:00,2019-03-31 02:15:00
168,1,1,0,0.007920984298593794,2019-03-31 02:00:00,2019-03-31 02:15:00
170,2,1,1,0.028020224138500013,2019-03-31 02:00:00,2019-03-31 02:15:00
172,1,1,0,0.007920984298593794,2019-03-31 02:00:00,2019-03-31 02:15:00
173,2,0,2,0.00428143099937297,2019-03-31 02:00:00,2019-03-31 02:15:00
177,2,2,0,0.01108610877950798,2019-03-31 02:00:00,2019-03-31 02:15:00
190,2,0,2,0.00428143099937297,2019-03-31 02:00:00,2019-03-31 02:15:00
191,1,0,1,0.00428143099937297,2019-03-31 02:00:00,2019-03-31 02:15:00
203,1,1,0,0.007920984298593794,2019-03-31 02:00:00,2019-03-31 02:15:00
1,2,2,0,0.007920984298593794,2019-03-31 02:15:00,2019-03-31 02:30:00
15,2,0,2,0.00428143099937297,2019-03-31 02:15:00,2019-03-31 02:30:00
16,2,1,1,0.007920984298593794,2019-03-31 02:15:00,2019-03-31 02:30:00
18,4,0,4,0.00428143099937297,2019-03-31 02:15:00,2019-03-31 02:30:00
23,1,0,1,0.00428143099937297,2019-03-31 02:15:00,2019-03-31 02:30:00
26,3,2,1,0.006101207648983383,2019-03-31 02:15:00,2019-03-31 02:30:00
37,1,0,1,0.00428143099937297,2019-03-31 02:15:00,2019-03-31 02:30:00
46,1,0,1,0.00428143099937297,2019-03-31 02:15:00,2019-03-31 02:30:00
67,1,1,0,0.007920984298593794,2019-03-31 02:15:00,2019-03-31 02:30:00
68,3,3,0,0.01156053759781462,2019-03-31 02:15:00,2019-03-31 02:30:00
75,2,2,0,0.013776804442115527,2019-03-31 02:15:00,2019-03-31 02:30:00
88,1,1,0,0.007920984298593794,2019-03-31 02:15:00,2019-03-31 02:30:00
90,2,2,0,0.006101207648983383,2019-03-31 02:15:00,2019-03-31 02:30:00
109,3,1,2,0.007446555480287156,2019-03-31 02:15:00,2019-03-31 02:30:00
112,1,0,1,0.00428143099937297,2019-03-31 02:15:00,2019-03-31 02:30:00
114,1,0,1,0.00428143099937297,2019-03-31 02:15:00,2019-03-31 02:30:00
116,1,1,0,0.01101494300104359,2019-03-31 02:15:00,2019-03-31 02:30:00
118,1,0,1,0.00428143099937297,2019-03-31 02:15:00,2019-03-31 02:30:00
120,1,0,1,0.00428143099937297,2019-03-31 02:15:00,2019-03-31 02:30:00
126,1,1,0,0.007920984298593794,2019-03-31 02:15:00,2019-03-31 02:30:00
127,2,0,2,0.00428143099937297,2019-03-31 02:15:00,2019-03-31 02:30:00
129,1,0,1,0.00428143099937297,2019-03-31 02:15:00,2019-03-31 02:30:00
137,2,1,1,0.007920984298593794,2019-03-31 02:15:00,2019-03-31 02:30:00
138,4,2,2,0.013776804442115528,2019-03-31 02:15:00,2019-03-31 02:30:00
147,1,1,0,0.009467963649818693,2019-03-31 02:15:00,2019-03-31 02:30:00
153,1,0,1,0.00428143099937297,2019-03-31 02:15:00,2019-03-31 02:30:00
154,1,1,0,0.01101494300104359,2019-03-31 02:15:00,2019-03-31 02:30:00
159,2,2,0,0.007920984298593794,2019-03-31 02:15:00,2019-03-31 02:30:00
161,2,2,0,0.007920984298593794,2019-03-31 02:15:00,2019-03-31 02:30:00
162,1,0,1,0.00428143099937297,2019-03-31 02:15:00,2019-03-31 02:30:00
164,1,0,1,0.00428143099937297,2019-03-31 02:15:00,2019-03-31 02:30:00
168,1,1,0,0.007920984298593794,2019-03-31 02:15:00,2019-03-31 02:30:00
170,2,1,1,0.028020224138500013,2019-03-31 02:15:00,2019-03-31 02:30:00
172,1,1,0,0.007920984298593794,2019-03-31 02:15:00,2019-03-31 02:30:00
173,2,0,2,0.00428143099937297,2019-03-31 02:15:00,2019-03-31 02:30:00
177,2,2,0,0.01108610877950798,2019-03-31 02:15:00,2019-03-31 02:30:00
190,2,0,2,0.00428143099937297,2019-03-31 02:15:00,2019-03-31 02:30:00
191,1,0,1,0.00428143099937297,2019-03-31 02:15:00,2019-03-31 02:30:00
203,1,1,0,0.007920984298593794,2019-03-31 02:15:00,2019-03-31 02:30:00
1,2,2,0,0.007920984298593794,2019-03-31 02:30:00,2019-03-31 02:45:00
15,2,0,2,0.00428143099937297,2019-03-31 02:30:00,2019-03-31 02:45:00
16,2,1,1,0.007920984298593794,2019-03-31 02:30:00,2019-03-31 02:45:00
18,4,0,4,0.00428143099937297,2019-03-31 02:30:00,2019-03-31 02:45:00
23,1,0,1,0.00428143099937297,2019-03-31 02:30:00,2019-03-31 02:45:00
26,3,2,1,0.006101207648983383,2019-03-31 02:30:00,2019-03-31 02:45:00
37,1,0,1,0.00428143099937297,2019-03-31 02:30:00,2019-03-31 02:45:00
46,1,0,1,0.00428143099937297,2019-03-31 02:30:00,2019-03-31 02:45:00
67,1,1,0,0.007920984298593794,2019-03-31 02:30:00,2019-03-31 02:45:00
68,3,3,0,0.01156053759781462,2019-03-31 02:30:00,2019-03-31 02:45:00
75,2,2,0,0.013776804442115527,2019-03-31 02:30:00,2019-03-31 02:45:00
88,1,1,0,0.007920984298593794,2019-03-31 02:30:00,2019-03-31 02:45:00
90,2,2,0,0.006101207648983383,2019-03-31 02:30:00,2019-03-31 02:45:00
109,3,1,2,0.007446555480287156,2019-03-31 02:30:00,2019-03-31 02:45:00
112,1,0,1,0.00428143099937297,2019-03-31 02:30:00,2019-03-31 02:45:00
114,1,0,1,0.00428143099937297,2019-03-31 02:30:00,2019-03-31 02:45:00
116,1,1,0,0.01101494300104359,2019-03-31 02:30:00,2019-03-31 02:45:00
118,1,0,1,0.00428143099937297,2019-03-31 02:30:00,2019-03-31 02:45:00
120,1,0,1,0.00428143099937297,2019-03-31 02:30:00,2019-03-31 02:45:00
126,1,1,0,0.007920984298593794,2019-03-31 02:30:00,2019-03-31 02:45:00
127,2,0,2,0.00428143099937297,2019-03-31 02:30:00,2019-03-31 02:45:00
129,1,0,1,0.00428143099937297,2019-03-31 02:30:00,2019-03-31 02:45:00
137,2,1,1,0.007920984298593794,2019-03-31 02:30:00,2019-03-31 02:45:00
138,4,2,2,0.013776804442115528,2019-03-31 02:30:00,2019-03-31 02:45:00
147,1,1,0,0.009467963649818693,2019-03-31 02:30:00,2019-03-31 02:45:00
153,1,0,1,0.00428143099937297,2019-03-31 02:30:00,2019-03-31 02:45:00
154,1,1,0,0.01101494300104359,2019-03-31 02:30:00,2019-03-31 02:45:00
159,2,2,0,0.007920984298593794,2019-03-31 02:30:00,2019-03-31 02:45:00
161,2,2,0,0.007920984298593794,2019-03-31 02:30:00,2019-03-31 02:45:00
162,1,0,1,0.00428143099937297,2019-03-31 02:30:00,2019-03-31 02:45:00
164,1,0,1,0.00428143099937297,2019-03-31 02:30:00,2019-03-31 02:45:00
168,1,1,0,0.007920984298593794,2019-03-31 02:30:00,2019-03-31 02:45:00
170,2,1,1,0.028020224138500013,2019-03-31 02:30:00,2019-03-31 02:45:00
172,1,1,0,0.007920984298593794,2019-03-31 02:30:00,2019-03-31 02:45:00
173,2,0,2,0.00428143099937297,2019-03-31 02:30:00,2019-03-31 02:45:00
177,2,2,0,0.01108610877950798,2019-03-31 02:30:00,2019-03-31 02:45:00
190,2,0,2,0.00428143099937297,2019-03-31 02:30:00,2019-03-31 02:45:00
191,1,0,1,0.00428143099937297,2019-03-31 02:30:00,2019-03-31 02:45:00
203,1,1,0,0.007920984298593794,2019-03-31 02:30:00,2019-03-31 02:45:00
1,2,2,0,0.007920984298593794,2019-03-31 02:45:00,2019-03-31 03:00:00
15,2,0,2,0.00428143099937297,2019-03-31 02:45:00,2019-03-31 03:00:00
16,2,1,1,0.007920984298593794,2019-03-31 02:45:00,2019-03-31 03:00:00
18,4,0,4,0.00428143099937297,2019-03-31 02:45:00,2019-03-31 03:00:00
23,1,0,1,0.00428143099937297,2019-03-31 02:45:00,2019-03-31 03:00:00
26,3,2,1,0.006101207648983383,2019-03-31 02:45:00,2019-03-31 03:00:00
37,1,0,1,0.00428143099937297,2019-03-31 02:45:00,2019-03-31 03:00:00
46,1,0,1,0.00428143099937297,2019-03-31 02:45:00,2019-03-31 03:00:00
67,1,1,0,0.007920984298593794,2019-03-31 02:45:00,2019-03-31 03:00:00
68,3,3,0,0.01156053759781462,2019-03-31 02:45:00,2019-03-31 03:00:00
75,2,2,0,0.013776804442115527,2019-03-31 02:45:00,2019-03-31 03:00:00
88,1,1,0,0.007920984298593794,2019-03-31 02:45:00,2019-03-31 03:00:00
90,2,2,0,0.006101207648983383,2019-03-31 02:45:00,2019-03-31 03:00:00
109,3,1,2,0.007446555480287156,2019-03-31 02:45:00,2019-03-31 03:00:00
112,1,0,1,0.00428143099937297,2019-03-31 02:45:00,2019-03-31 03:00:00
114,1,0,1,0.00428143099937297,2019-03-31 02:45:00,2019-03-31 03:00:00
116,1,1,0,0.01101494300104359,2019-03-31 02:45:00,2019-03-31 03:00:00
118,1,0,1,0.00428143099937297,2019-03-31 02:45:00,2019-03-31 03:00:00
120,1,0,1,0.00428143099937297,2019-03-31 02:45:00,2019-03-31 03:00:00
126,1,1,0,0.007920984298593794,2019-03-31 02:45:00,2019-03-31 03:00:00
127,2,0,2,0.00428143099937297,2019-03-31 02:45:00,2019-03-31 03:00:00
129,1,0,1,0.00428143099937297,2019-03-31 02:45:00,2019-03-31 03:00:00
137,2,1,1,0.007920984298593794,2019-03-31 02:45:00,2019-03-31 03:00:00
138,4,2,2,0.013776804442115528,2019-03-31 02:45:00,2019-03-31 03:00:00
147,1,1,0,0.009467963649818693,2019-03-31 02:45:00,2019-03-31 03:00:00
153,1,0,1,0.00428143099937297,2019-03-31 02:45:00,2019-03-31 03:00:00
154,1,1,0,0.01101494300104359,2019-03-31 02:45:00,2019-03-31 03:00:00
159,2,2,0,0.007920984298593794,2019-03-31 02:45:00,2019-03-31 03:00:00
161,2,2,0,0.007920984298593794,2019-03-31 02:45:00,2019-03-31 03:00:00
162,1,0,1,0.00428143099937297,2019-03-31 02:45:00,2019-03-31 03:00:00
164,1,0,1,0.00428143099937297,2019-03-31 02:45:00,2019-03-31 03:00:00
168,1,1,0,0.007920984298593794,2019-03-31 02:45:00,2019-03-31 03:00:00
170,2,1,1,0.028020224138500013,2019-03-31 02:45:00,2019-03-31 03:00:00
172,1,1,0,0.007920984298593794,2019-03-31 02:45:00,2019-03-31 03:00:00
173,2,0,2,0.00428143099937297,2019-03-31 02:45:00,2019-03-31 03:00:00
177,2,2,0,0.01108610877950798,2019-03-31 02:45:00,2019-03-31 03:00:00
190,2,0,2,0.00428143099937297,2019-03-31 02:45:00,2019-03-31 03:00:00
191,1,0,1,0.00428143099937297,2019-03-31 02:45:00,2019-03-31 03:00:00
203,1,1,0,0.007920984298593794,2019-03-31 02:45:00,2019-03-31 03:00:00
1,2,2,0,0.007523798750679232,2019-03-31 03:00:00,2019-03-31 03:15:00
2,1,1,0,0.007523798750679232,2019-03-31 03:00:00,2019-03-31 03:15:00
15,2,0,2,0.004066730972512669,2019-03-31 03:00:00,2019-03-31 03:15:00
16,2,1,1,0.0047581445281459816,2019-03-31 03:00:00,2019-03-31 03:15:00
18,4,0,4,0.004066730972512669,2019-03-31 03:00:00,2019-03-31 03:15:00
23,1,0,1,0.004066730972512669,2019-03-31 03:00:00,2019-03-31 03:15:00
26,3,2,1,0.0057952648615959505,2019-03-31 03:00:00,2019-03-31 03:15:00
37,1,0,1,0.004066730972512669,2019-03-31 03:00:00,2019-03-31 03:15:00
41,1,1,0,0.007073182386958993,2019-03-31 03:00:00,2019-03-31 03:15:00
46,1,0,1,0.004066730972512669,2019-03-31 03:00:00,2019-03-31 03:15:00
58,1,0,1,0.004066730972512669,2019-03-31 03:00:00,2019-03-31 03:15:00
67,1,1,0,0.007523798750679232,2019-03-31 03:00:00,2019-03-31 03:15:00
68,4,3,1,0.010980866528845796,2019-03-31 03:00:00,2019-03-31 03:15:00
75,2,2,0,0.012005397043206013,2019-03-31 03:00:00,2019-03-31 03:15:00
88,2,2,0,0.010980866528845796,2019-03-31 03:00:00,2019-03-31 03:15:00
90,2,2,0,0.0057952648615959505,2019-03-31 03:00:00,2019-03-31 03:15:00
109,3,1,2,0.007073182386958993,2019-03-31 03:00:00,2019-03-31 03:15:00
110,1,1,0,0.0047581445281459816,2019-03-31 03:00:00,2019-03-31 03:15:00
112,5,0,5,0.004066730972512669,2019-03-31 03:00:00,2019-03-31 03:15:00
114,1,0,1,0.004066730972512669,2019-03-31 03:00:00,2019-03-31 03:15:00
115,1,0,1,0.004066730972512669,2019-03-31 03:00:00,2019-03-31 03:15:00
116,1,1,0,0.008111569984964168,2019-03-31 03:00:00,2019-03-31 03:15:00
118,1,0,1,0.004066730972512669,2019-03-31 03:00:00,2019-03-31 03:15:00
119,1,0,1,0.004066730972512669,2019-03-31 03:00:00,2019-03-31 03:15:00
120,1,0,1,0.004066730972512669,2019-03-31 03:00:00,2019-03-31 03:15:00
126,3,2,1,0.010980866528845796,2019-03-31 03:00:00,2019-03-31 03:15:00
127,2,0,2,0.004066730972512669,2019-03-31 03:00:00,2019-03-31 03:15:00
129,1,0,1,0.004066730972512669,2019-03-31 03:00:00,2019-03-31 03:15:00
135,1,1,0,0.013401511093528587,2019-03-31 03:00:00,2019-03-31 03:15:00
137,2,1,1,0.007523798750679232,2019-03-31 03:00:00,2019-03-31 03:15:00
138,5,2,3,0.015815316669481716,2019-03-31 03:00:00,2019-03-31 03:15:00
140,2,2,0,0.0054495580837792944,2019-03-31 03:00:00,2019-03-31 03:15:00
147,2,2,0,0.009684640392024883,2019-03-31 03:00:00,2019-03-31 03:15:00
153,2,1,1,0.008548329265039449,2019-03-31 03:00:00,2019-03-31 03:15:00
154,1,1,0,0.010462654922103909,2019-03-31 03:00:00,2019-03-31 03:15:00
159,2,2,0,0.007523798750679232,2019-03-31 03:00:00,2019-03-31 03:15:00
161,2,2,0,0.007523798750679232,2019-03-31 03:00:00,2019-03-31 03:15:00
162,2,1,1,0.013401511093528587,2019-03-31 03:00:00,2019-03-31 03:15:00
164,1,0,1,0.004066730972512669,2019-03-31 03:00:00,2019-03-31 03:15:00
168,1,1,0,0.007523798750679232,2019-03-31 03:00:00,2019-03-31 03:15:00
169,1,0,1,0.004066730972512669,2019-03-31 03:00:00,2019-03-31 03:15:00
170,2,1,1,0.026535505557819052,2019-03-31 03:00:00,2019-03-31 03:15:00
172,1,1,0,0.007523798750679232,2019-03-31 03:00:00,2019-03-31 03:15:00
173,2,0,2,0.004066730972512669,2019-03-31 03:00:00,2019-03-31 03:15:00
177,2,2,0,0.0184658636436281,2019-03-31 03:00:00,2019-03-31 03:15:00
190,2,0,2,0.004066730972512669,2019-03-31 03:00:00,2019-03-31 03:15:00
191,1,0,1,0.004066730972512669,2019-03-31 03:00:00,2019-03-31 03:15:00
197,3,1,2,0.007073182386958993,2019-03-31 03:00:00,2019-03-31 03:15:00
203,2,2,0,0.010980866528845796,2019-03-31 03:00:00,2019-03-31 03:15:00
1,2,2,0,0.007819649313111514,2019-03-31 03:15:00,2019-03-31 03:30:00
2,1,1,0,0.007819649313111514,2019-03-31 03:15:00,2019-03-31 03:30:00
15,2,0,2,0.004226733835662393,2019-03-31 03:15:00,2019-03-31 03:30:00
16,1,0,1,0.004226733835662393,2019-03-31 03:15:00,2019-03-31 03:30:00
18,2,0,2,0.004226733835662393,2019-03-31 03:15:00,2019-03-31 03:30:00
20,2,0,2,0.004226733835662393,2019-03-31 03:15:00,2019-03-31 03:30:00
23,1,0,1,0.004226733835662393,2019-03-31 03:15:00,2019-03-31 03:30:00
26,3,2,1,0.007819649313111514,2019-03-31 03:15:00,2019-03-31 03:30:00
37,1,0,1,0.004226733835662393,2019-03-31 03:15:00,2019-03-31 03:30:00
41,1,1,0,0.010873938337609468,2019-03-31 03:15:00,2019-03-31 03:30:00
57,1,0,1,0.004226733835662393,2019-03-31 03:15:00,2019-03-31 03:30:00
58,1,0,1,0.004226733835662393,2019-03-31 03:15:00,2019-03-31 03:30:00
62,1,1,0,0.010873938337609468,2019-03-31 03:15:00,2019-03-31 03:30:00
67,1,1,0,0.007819649313111514,2019-03-31 03:15:00,2019-03-31 03:30:00
68,4,3,1,0.010911510240293704,2019-03-31 03:15:00,2019-03-31 03:30:00
88,2,2,0,0.011412564790560634,2019-03-31 03:15:00,2019-03-31 03:30:00
109,5,2,3,0.009705789004388534,2019-03-31 03:15:00,2019-03-31 03:30:00
110,1,1,0,0.005424372328145433,2019-03-31 03:15:00,2019-03-31 03:30:00
112,3,0,3,0.004226733835662393,2019-03-31 03:15:00,2019-03-31 03:30:00
115,1,0,1,0.004226733835662393,2019-03-31 03:15:00,2019-03-31 03:30:00
116,2,1,1,0.007819649313111514,2019-03-31 03:15:00,2019-03-31 03:30:00
118,1,0,1,0.004226733835662393,2019-03-31 03:15:00,2019-03-31 03:30:00
119,1,0,1,0.004226733835662393,2019-03-31 03:15:00,2019-03-31 03:30:00
120,1,0,1,0.004226733835662393,2019-03-31 03:15:00,2019-03-31 03:30:00
126,2,1,1,0.007819649313111514,2019-03-31 03:15:00,2019-03-31 03:30:00
127,2,0,2,0.004226733835662393,2019-03-31 03:15:00,2019-03-31 03:30:00
129,1,0,1,0.004226733835662393,2019-03-31 03:15:00,2019-03-31 03:30:00
135,1,1,0,0.013502316617208967,2019-03-31 03:15:00,2019-03-31 03:30:00
137,1,1,0,0.007819649313111514,2019-03-31 03:15:00,2019-03-31 03:30:00
138,5,2,3,0.010911510240293704,2019-03-31 03:15:00,2019-03-31 03:30:00
140,2,2,0,0.006622010820628473,2019-03-31 03:15:00,2019-03-31 03:30:00
147,1,1,0,0.010873938337609468,2019-03-31 03:15:00,2019-03-31 03:30:00
153,1,1,0,0.007318594762844584,2019-03-31 03:15:00,2019-03-31 03:30:00
159,2,2,0,0.007819649313111514,2019-03-31 03:15:00,2019-03-31 03:30:00
161,2,2,0,0.007819649313111514,2019-03-31 03:15:00,2019-03-31 03:30:00
162,2,1,1,0.010873938337609468,2019-03-31 03:15:00,2019-03-31 03:30:00
169,1,0,1,0.004226733835662393,2019-03-31 03:15:00,2019-03-31 03:30:00
170,6,2,4,0.007349049019594873,2019-03-31 03:15:00,2019-03-31 03:30:00
172,1,1,0,0.007819649313111514,2019-03-31 03:15:00,2019-03-31 03:30:00
173,2,0,2,0.004226733835662393,2019-03-31 03:15:00,2019-03-31 03:30:00
177,2,2,0,0.01621014982331096,2019-03-31 03:15:00,2019-03-31 03:30:00
190,2,0,2,0.004226733835662393,2019-03-31 03:15:00,2019-03-31 03:30:00
197,3,2,1,0.007819649313111514,2019-03-31 03:15:00,2019-03-31 03:30:00
201,2,2,0,0.007349049019594873,2019-03-31 03:15:00,2019-03-31 03:30:00
203,2,2,0,0.011412564790560634,2019-03-31 03:15:00,2019-03-31 03:30:00
1,2,2,0,0.007216809031881105,2019-03-31 03:30:00,2019-03-31 03:45:00
2,1,1,0,0.007216809031881105,2019-03-31 03:30:00,2019-03-31 03:45:00
16,1,0,1,0.003900788338774673,2019-03-31 03:30:00,2019-03-31 03:45:00
18,2,0,2,0.003900788338774673,2019-03-31 03:30:00,2019-03-31 03:45:00
20,2,0,2,0.003900788338774673,2019-03-31 03:30:00,2019-03-31 03:45:00
23,1,0,1,0.003900788338774673,2019-03-31 03:30:00,2019-03-31 03:45:00
26,3,2,1,0.007216809031881105,2019-03-31 03:30:00,2019-03-31 03:45:00
37,1,0,1,0.003900788338774673,2019-03-31 03:30:00,2019-03-31 03:45:00
57,1,1,0,0.011687812154907083,2019-03-31 03:30:00,2019-03-31 03:45:00
62,1,1,0,0.010035783943527533,2019-03-31 03:30:00,2019-03-31 03:45:00
67,1,1,0,0.007216809031881105,2019-03-31 03:30:00,2019-03-31 03:45:00
68,2,2,0,0.007216809031881105,2019-03-31 03:30:00,2019-03-31 03:45:00
88,1,1,0,0.007216809031881105,2019-03-31 03:30:00,2019-03-31 03:45:00
104,2,0,2,0.003900788338774673,2019-03-31 03:30:00,2019-03-31 03:45:00
109,5,2,3,0.009003501586854173,2019-03-31 03:30:00,2019-03-31 03:45:00
110,1,0,1,0.003900788338774673,2019-03-31 03:30:00,2019-03-31 03:45:00
112,3,1,2,0.005475957721751221,2019-03-31 03:30:00,2019-03-31 03:45:00
116,2,1,1,0.007216809031881105,2019-03-31 03:30:00,2019-03-31 03:45:00
118,1,0,1,0.003900788338774673,2019-03-31 03:30:00,2019-03-31 03:45:00
119,2,0,2,0.003900788338774673,2019-03-31 03:30:00,2019-03-31 03:45:00
120,1,0,1,0.003900788338774673,2019-03-31 03:30:00,2019-03-31 03:45:00
122,2,0,2,0.003900788338774673,2019-03-31 03:30:00,2019-03-31 03:45:00
127,2,0,2,0.003900788338774673,2019-03-31 03:30:00,2019-03-31 03:45:00
129,1,0,1,0.003900788338774673,2019-03-31 03:30:00,2019-03-31 03:45:00
137,3,2,1,0.010532829724987536,2019-03-31 03:30:00,2019-03-31 03:45:00
138,7,5,2,0.018319853541119948,2019-03-31 03:30:00,2019-03-31 03:45:00
140,8,5,3,0.05672910158992312,2019-03-31 03:30:00,2019-03-31 03:45:00
147,1,1,0,0.010035783943527533,2019-03-31 03:30:00,2019-03-31 03:45:00
158,1,1,0,0.005558798685327888,2019-03-31 03:30:00,2019-03-31 03:45:00
159,2,2,0,0.007051127104727771,2019-03-31 03:30:00,2019-03-31 03:45:00
162,1,0,1,0.003900788338774673,2019-03-31 03:30:00,2019-03-31 03:45:00
169,1,0,1,0.003900788338774673,2019-03-31 03:30:00,2019-03-31 03:45:00
170,4,1,3,0.00544320744694657,2019-03-31 03:30:00,2019-03-31 03:45:00
172,1,1,0,0.007216809031881105,2019-03-31 03:30:00,2019-03-31 03:45:00
173,4,1,3,0.005558798685327888,2019-03-31 03:30:00,2019-03-31 03:45:00
177,2,2,0,0.009768165655920855,2019-03-31 03:30:00,2019-03-31 03:45:00
190,2,0,2,0.003900788338774673,2019-03-31 03:30:00,2019-03-31 03:45:00
197,4,3,1,0.04786571053848886,2019-03-31 03:30:00,2019-03-31 03:45:00
201,3,3,0,0.015939597071517757,2019-03-31 03:30:00,2019-03-31 03:45:00
203,1,1,0,0.007216809031881105,2019-03-31 03:30:00,2019-03-31 03:45:00
1,2,2,0,0.007265399998949211,2019-03-31 03:45:00,2019-03-31 04:00:00
2,2,2,0,0.010353525156674894,2019-03-31 03:45:00,2019-03-31 04:00:00
10,1,0,1,0.003927066272348577,2019-03-31 03:45:00,2019-03-31 04:00:00
15,1,0,1,0.003927066272348577,2019-03-31 03:45:00,2019-03-31 04:00:00
16,3,1,2,0.007265399998949211,2019-03-31 03:45:00,2019-03-31 04:00:00
18,2,0,2,0.003927066272348577,2019-03-31 03:45:00,2019-03-31 04:00:00
20,2,0,2,0.003927066272348577,2019-03-31 03:45:00,2019-03-31 04:00:00
23,1,0,1,0.003927066272348577,2019-03-31 03:45:00,2019-03-31 04:00:00
26,3,2,1,0.007265399998949211,2019-03-31 03:45:00,2019-03-31 04:00:00
37,1,0,1,0.003927066272348577,2019-03-31 03:45:00,2019-03-31 04:00:00
57,1,1,0,0.009298312631772266,2019-03-31 03:45:00,2019-03-31 04:00:00
61,1,1,0,0.007265399998949211,2019-03-31 03:45:00,2019-03-31 04:00:00
66,1,1,0,0.007265399998949211,2019-03-31 03:45:00,2019-03-31 04:00:00
67,1,1,0,0.007265399998949211,2019-03-31 03:45:00,2019-03-31 04:00:00
68,2,2,0,0.007265399998949211,2019-03-31 03:45:00,2019-03-31 04:00:00
88,1,1,0,0.007265399998949211,2019-03-31 03:45:00,2019-03-31 04:00:00
104,1,0,1,0.003927066272348577,2019-03-31 03:45:00,2019-03-31 04:00:00
109,7,4,3,0.016769461133619053,2019-03-31 03:45:00,2019-03-31 04:00:00
110,1,0,1,0.003927066272348577,2019-03-31 03:45:00,2019-03-31 04:00:00
112,1,1,0,0.007265399998949211,2019-03-31 03:45:00,2019-03-31 04:00:00
116,1,1,0,0.0070151914300742605,2019-03-31 03:45:00,2019-03-31 04:00:00
118,1,0,1,0.003927066272348577,2019-03-31 03:45:00,2019-03-31 04:00:00
119,2,0,2,0.003927066272348577,2019-03-31 03:45:00,2019-03-31 04:00:00
120,1,0,1,0.003927066272348577,2019-03-31 03:45:00,2019-03-31 04:00:00
122,2,0,2,0.003927066272348577,2019-03-31 03:45:00,2019-03-31 04:00:00
127,2,0,2,0.003927066272348577,2019-03-31 03:45:00,2019-03-31 04:00:00
129,1,0,1,0.003927066272348577,2019-03-31 03:45:00,2019-03-31 04:00:00
135,1,0,1,0.003927066272348577,2019-03-31 03:45:00,2019-03-31 04:00:00
137,3,2,1,0.010603733725549847,2019-03-31 03:45:00,2019-03-31 04:00:00
138,5,3,2,0.012636646358372902,2019-03-31 03:45:00,2019-03-31 04:00:00
140,8,4,4,0.02605110505576738,2019-03-31 03:45:00,2019-03-31 04:00:00
147,1,1,0,0.010103316587799945,2019-03-31 03:45:00,2019-03-31 04:00:00
158,1,1,0,0.007265399998949211,2019-03-31 03:45:00,2019-03-31 04:00:00
162,1,0,1,0.003927066272348577,2019-03-31 03:45:00,2019-03-31 04:00:00
169,1,0,1,0.003927066272348577,2019-03-31 03:45:00,2019-03-31 04:00:00
170,2,1,1,0.02605110505576738,2019-03-31 03:45:00,2019-03-31 04:00:00
172,1,1,0,0.007265399998949211,2019-03-31 03:45:00,2019-03-31 04:00:00
173,1,0,1,0.003927066272348577,2019-03-31 03:45:00,2019-03-31 04:00:00
177,2,2,0,0.012017430566284133,2019-03-31 03:45:00,2019-03-31 04:00:00
190,2,0,2,0.003927066272348577,2019-03-31 03:45:00,2019-03-31 04:00:00
197,4,3,1,0.04817514383918618,2019-03-31 03:45:00,2019-03-31 04:00:00
201,1,1,0,0.012941233176650677,2019-03-31 03:45:00,2019-03-31 04:00:00
203,1,1,0,0.007265399998949211,2019-03-31 03:45:00,2019-03-31 04:00:00
1,2,2,0,0.0077627965766364024,2019-03-31 04:00:00,2019-03-31 04:15:00
2,6,3,3,0.0147619757523673,2019-03-31 04:00:00,2019-03-31 04:15:00
10,1,0,1,0.004195908833687573,2019-03-31 04:00:00,2019-03-31 04:15:00
15,1,0,1,0.004195908833687573,2019-03-31 04:00:00,2019-03-31 04:15:00
16,4,1,3,0.0077627965766364024,2019-03-31 04:00:00,2019-03-31 04:15:00
18,2,0,2,0.004195908833687573,2019-03-31 04:00:00,2019-03-31 04:15:00
20,2,0,2,0.004195908833687573,2019-03-31 04:00:00,2019-03-31 04:15:00
23,1,0,1,0.004195908833687573,2019-03-31 04:00:00,2019-03-31 04:15:00
26,3,2,1,0.0077627965766364024,2019-03-31 04:00:00,2019-03-31 04:15:00
37,1,0,1,0.004195908833687573,2019-03-31 04:00:00,2019-03-31 04:15:00
58,1,1,0,0.0077627965766364024,2019-03-31 04:00:00,2019-03-31 04:15:00
61,1,1,0,0.0077627965766364024,2019-03-31 04:00:00,2019-03-31 04:15:00
67,1,1,0,0.0077627965766364024,2019-03-31 04:00:00,2019-03-31 04:15:00
68,2,2,0,0.0077627965766364024,2019-03-31 04:00:00,2019-03-31 04:15:00
88,1,1,0,0.007297873489611648,2019-03-31 04:00:00,2019-03-31 04:15:00
89,1,1,0,0.005328293244532075,2019-03-31 04:00:00,2019-03-31 04:15:00
90,1,1,0,0.006395612404602001,2019-03-31 04:00:00,2019-03-31 04:15:00
109,9,4,5,0.011762558327132884,2019-03-31 04:00:00,2019-03-31 04:15:00
110,1,1,0,0.008379090507570224,2019-03-31 04:00:00,2019-03-31 04:15:00
116,1,1,0,0.006395612404602001,2019-03-31 04:00:00,2019-03-31 04:15:00
118,1,0,1,0.004195908833687573,2019-03-31 04:00:00,2019-03-31 04:15:00
119,2,0,2,0.004195908833687573,2019-03-31 04:00:00,2019-03-31 04:15:00
120,1,0,1,0.004195908833687573,2019-03-31 04:00:00,2019-03-31 04:15:00
127,2,0,2,0.004195908833687573,2019-03-31 04:00:00,2019-03-31 04:15:00
129,3,1,2,0.007297873489611648,2019-03-31 04:00:00,2019-03-31 04:15:00
137,1,1,0,0.0077627965766364024,2019-03-31 04:00:00,2019-03-31 04:15:00
138,5,1,4,0.005328293244532075,2019-03-31 04:00:00,2019-03-31 04:15:00
140,6,3,3,0.02769016416224382,2019-03-31 04:00:00,2019-03-31 04:15:00
147,1,1,0,0.010795019546430858,2019-03-31 04:00:00,2019-03-31 04:15:00
153,2,2,0,0.008195670584184054,2019-03-31 04:00:00,2019-03-31 04:15:00
154,1,0,1,0.004195908833687573,2019-03-31 04:00:00,2019-03-31 04:15:00
158,2,2,0,0.006460677655376576,2019-03-31 04:00:00,2019-03-31 04:15:00
162,1,0,1,0.004195908833687573,2019-03-31 04:00:00,2019-03-31 04:15:00
170,2,1,1,0.02769016416224382,2019-03-31 04:00:00,2019-03-31 04:15:00
172,1,1,0,0.0077627965766364024,2019-03-31 04:00:00,2019-03-31 04:15:00
177,2,2,0,0.009762677451884642,2019-03-31 04:00:00,2019-03-31 04:15:00
190,2,0,2,0.004195908833687573,2019-03-31 04:00:00,2019-03-31 04:15:00
197,2,2,0,0.0077627965766364024,2019-03-31 04:00:00,2019-03-31 04:15:00
203,1,1,0,0.0077627965766364024,2019-03-31 04:00:00,2019-03-31 04:15:00
1,3,3,0,0.01123076426685872,2019-03-31 04:15:00,2019-03-31 04:30:00
2,2,1,1,0.00618081178391177,2019-03-31 04:15:00,2019-03-31 04:30:00
10,1,0,1,0.004337289729805597,2019-03-31 04:15:00,2019-03-31 04:30:00
16,2,0,2,0.004337289729805597,2019-03-31 04:15:00,2019-03-31 04:30:00
18,2,0,2,0.004337289729805597,2019-03-31 04:15:00,2019-03-31 04:30:00
20,4,2,2,0.008024333838017945,2019-03-31 04:15:00,2019-03-31 04:30:00
23,1,0,1,0.004337289729805597,2019-03-31 04:15:00,2019-03-31 04:30:00
26,3,2,1,0.008024333838017945,2019-03-31 04:15:00,2019-03-31 04:30:00
28,1,0,1,0.004337289729805597,2019-03-31 04:15:00,2019-03-31 04:30:00
37,1,0,1,0.004337289729805597,2019-03-31 04:15:00,2019-03-31 04:30:00
62,1,1,0,0.008024333838017945,2019-03-31 04:15:00,2019-03-31 04:30:00
67,1,1,0,0.008024333838017945,2019-03-31 04:15:00,2019-03-31 04:30:00
68,2,2,0,0.008024333838017945,2019-03-31 04:15:00,2019-03-31 04:30:00
88,1,1,0,0.00618081178391177,2019-03-31 04:15:00,2019-03-31 04:30:00
89,1,1,0,0.007543720158646372,2019-03-31 04:15:00,2019-03-31 04:30:00
109,7,2,5,0.006572003484051894,2019-03-31 04:15:00,2019-03-31 04:30:00
110,1,1,0,0.009591502263100952,2019-03-31 04:15:00,2019-03-31 04:30:00
114,2,0,2,0.004337289729805597,2019-03-31 04:15:00,2019-03-31 04:30:00
116,1,1,0,0.00618081178391177,2019-03-31 04:15:00,2019-03-31 04:30:00
118,1,0,1,0.004337289729805597,2019-03-31 04:15:00,2019-03-31 04:30:00
120,2,1,1,0.00618081178391177,2019-03-31 04:15:00,2019-03-31 04:30:00
126,3,1,2,0.007543720158646372,2019-03-31 04:15:00,2019-03-31 04:30:00
127,2,0,2,0.004337289729805597,2019-03-31 04:15:00,2019-03-31 04:30:00
129,2,0,2,0.004337289729805597,2019-03-31 04:15:00,2019-03-31 04:30:00
137,1,1,0,0.008024333838017945,2019-03-31 04:15:00,2019-03-31 04:30:00
138,3,1,2,0.007543720158646372,2019-03-31 04:15:00,2019-03-31 04:30:00
147,1,1,0,0.011158670688183958,2019-03-31 04:15:00,2019-03-31 04:30:00
153,3,3,0,0.01025904759226424,2019-03-31 04:15:00,2019-03-31 04:30:00
162,1,0,1,0.004337289729805597,2019-03-31 04:15:00,2019-03-31 04:30:00
170,2,1,1,0.028384672736783544,2019-03-31 04:15:00,2019-03-31 04:30:00
172,1,1,0,0.008024333838017945,2019-03-31 04:15:00,2019-03-31 04:30:00
177,2,2,0,0.009141690715141093,2019-03-31 04:15:00,2019-03-31 04:30:00
190,2,0,2,0.004337289729805597,2019-03-31 04:15:00,2019-03-31 04:30:00
197,2,2,0,0.011158670688183958,2019-03-31 04:15:00,2019-03-31 04:30:00
203,1,1,0,0.009591502263100952,2019-03-31 04:15:00,2019-03-31 04:30:00
1,2,2,0,0.007826949847312657,2019-03-31 04:30:00,2019-03-31 04:45:00
2,1,0,1,0.004230580341200693,2019-03-31 04:30:00,2019-03-31 04:45:00
10,1,0,1,0.004230580341200693,2019-03-31 04:30:00,2019-03-31 04:45:00
16,1,0,1,0.004230580341200693,2019-03-31 04:30:00,2019-03-31 04:45:00
18,2,0,2,0.004230580341200693,2019-03-31 04:30:00,2019-03-31 04:45:00
19,1,1,0,0.007358191112084483,2019-03-31 04:30:00,2019-03-31 04:45:00
20,4,2,2,0.006628160011942002,2019-03-31 04:30:00,2019-03-31 04:45:00
23,1,0,1,0.004230580341200693,2019-03-31 04:30:00,2019-03-31 04:45:00
26,3,2,1,0.007826949847312657,2019-03-31 04:30:00,2019-03-31 04:45:00
28,1,1,0,0.0060287650942566755,2019-03-31 04:30:00,2019-03-31 04:45:00
37,1,0,1,0.004230580341200693,2019-03-31 04:30:00,2019-03-31 04:45:00
41,2,2,0,0.006514070107876468,2019-03-31 04:30:00,2019-03-31 04:45:00
57,3,1,2,0.007358191112084483,2019-03-31 04:30:00,2019-03-31 04:45:00
62,1,1,0,0.007826949847312657,2019-03-31 04:30:00,2019-03-31 04:45:00
67,1,1,0,0.007826949847312657,2019-03-31 04:30:00,2019-03-31 04:45:00
68,2,2,0,0.007826949847312657,2019-03-31 04:30:00,2019-03-31 04:45:00
74,1,1,0,0.007826949847312657,2019-03-31 04:30:00,2019-03-31 04:45:00
86,1,0,1,0.004230580341200693,2019-03-31 04:30:00,2019-03-31 04:45:00
88,1,1,0,0.007826949847312657,2019-03-31 04:30:00,2019-03-31 04:45:00
109,5,2,3,0.009764643220271409,2019-03-31 04:30:00,2019-03-31 04:45:00
110,1,1,0,0.007826949847312657,2019-03-31 04:30:00,2019-03-31 04:45:00
114,3,0,3,0.004230580341200693,2019-03-31 04:30:00,2019-03-31 04:45:00
116,2,2,0,0.009625134600368639,2019-03-31 04:30:00,2019-03-31 04:45:00
118,1,0,1,0.004230580341200693,2019-03-31 04:30:00,2019-03-31 04:45:00
120,1,0,1,0.004230580341200693,2019-03-31 04:30:00,2019-03-31 04:45:00
126,2,1,1,0.027917562206237943,2019-03-31 04:30:00,2019-03-31 04:45:00
127,2,0,2,0.004230580341200693,2019-03-31 04:30:00,2019-03-31 04:45:00
129,1,0,1,0.004230580341200693,2019-03-31 04:30:00,2019-03-31 04:45:00
137,1,1,0,0.007826949847312657,2019-03-31 04:30:00,2019-03-31 04:45:00
138,5,1,4,0.00537232522453858,2019-03-31 04:30:00,2019-03-31 04:45:00
147,1,1,0,0.010884243443004902,2019-03-31 04:30:00,2019-03-31 04:45:00
153,2,0,2,0.004230580341200693,2019-03-31 04:30:00,2019-03-31 04:45:00
158,1,1,0,0.00537232522453858,2019-03-31 04:30:00,2019-03-31 04:45:00
162,1,0,1,0.004230580341200693,2019-03-31 04:30:00,2019-03-31 04:45:00
170,2,1,1,0.027917562206237943,2019-03-31 04:30:00,2019-03-31 04:45:00
172,1,1,0,0.007826949847312657,2019-03-31 04:30:00,2019-03-31 04:45:00
173,1,1,0,0.005429370176571347,2019-03-31 04:30:00,2019-03-31 04:45:00
177,2,2,0,0.010593981286848015,2019-03-31 04:30:00,2019-03-31 04:45:00
190,2,0,2,0.004230580341200693,2019-03-31 04:30:00,2019-03-31 04:45:00
197,2,2,0,0.009865145577774154,2019-03-31 04:30:00,2019-03-31 04:45:00
203,1,1,0,0.007826949847312657,2019-03-31 04:30:00,2019-03-31 04:45:00
1,2,2,0,0.007956811886856284,2019-03-31 04:45:00,2019-03-31 05:00:00
2,1,1,0,0.011064762572482607,2019-03-31 04:45:00,2019-03-31 05:00:00
16,2,0,2,0.004300797331276897,2019-03-31 04:45:00,2019-03-31 05:00:00
18,2,0,2,0.004300797331276897,2019-03-31 04:45:00,2019-03-31 05:00:00
20,3,0,3,0.004300797331276897,2019-03-31 04:45:00,2019-03-31 05:00:00
22,1,1,0,0.007480235988891545,2019-03-31 04:45:00,2019-03-31 05:00:00
23,1,0,1,0.004300797331276897,2019-03-31 04:45:00,2019-03-31 05:00:00
26,3,2,1,0.007956811886856284,2019-03-31 04:45:00,2019-03-31 05:00:00
28,1,1,0,0.007956811886856284,2019-03-31 04:45:00,2019-03-31 05:00:00
37,1,0,1,0.004300797331276897,2019-03-31 04:45:00,2019-03-31 05:00:00
41,3,3,0,0.008920570336587543,2019-03-31 04:45:00,2019-03-31 05:00:00
57,1,1,0,0.00612880460906659,2019-03-31 04:45:00,2019-03-31 05:00:00
67,1,1,0,0.007956811886856284,2019-03-31 04:45:00,2019-03-31 05:00:00
68,2,2,0,0.007956811886856284,2019-03-31 04:45:00,2019-03-31 05:00:00
88,1,1,0,0.007956811886856284,2019-03-31 04:45:00,2019-03-31 05:00:00
109,6,3,3,0.01836499565501229,2019-03-31 04:45:00,2019-03-31 05:00:00
116,1,1,0,0.00612880460906659,2019-03-31 04:45:00,2019-03-31 05:00:00
118,1,0,1,0.004300797331276897,2019-03-31 04:45:00,2019-03-31 05:00:00
120,1,0,1,0.004300797331276897,2019-03-31 04:45:00,2019-03-31 05:00:00
127,2,0,2,0.004300797331276897,2019-03-31 04:45:00,2019-03-31 05:00:00
129,1,0,1,0.004300797331276897,2019-03-31 04:45:00,2019-03-31 05:00:00
137,1,1,0,0.007956811886856284,2019-03-31 04:45:00,2019-03-31 05:00:00
138,4,1,3,0.006001348074668989,2019-03-31 04:45:00,2019-03-31 05:00:00
147,1,1,0,0.011064762572482607,2019-03-31 04:45:00,2019-03-31 05:00:00
153,1,0,1,0.004300797331276897,2019-03-31 04:45:00,2019-03-31 05:00:00
159,3,1,2,0.007480235988891545,2019-03-31 04:45:00,2019-03-31 05:00:00
162,1,0,1,0.004300797331276897,2019-03-31 04:45:00,2019-03-31 05:00:00
170,2,1,1,0.028149542201704642,2019-03-31 04:45:00,2019-03-31 05:00:00
172,2,2,0,0.011136250544470932,2019-03-31 04:45:00,2019-03-31 05:00:00
173,3,1,2,0.007480235988891545,2019-03-31 04:45:00,2019-03-31 05:00:00
177,2,2,0,0.013160903770934287,2019-03-31 04:45:00,2019-03-31 05:00:00
190,2,0,2,0.004300797331276897,2019-03-31 04:45:00,2019-03-31 05:00:00
197,2,2,0,0.006738140368329822,2019-03-31 04:45:00,2019-03-31 05:00:00
202,1,0,1,0.004300797331276897,2019-03-31 04:45:00,2019-03-31 05:00:00
203,2,1,1,0.007956811886856284,2019-03-31 04:45:00,2019-03-31 05:00:00
1,2,2,0,0.008114010764613213,2019-03-31 05:00:00,2019-03-31 05:15:00
16,3,0,3,0.0043857595291800985,2019-03-31 05:00:00,2019-03-31 05:15:00
18,2,0,2,0.0043857595291800985,2019-03-31 05:00:00,2019-03-31 05:15:00
20,2,0,2,0.0043857595291800985,2019-03-31 05:00:00,2019-03-31 05:15:00
22,1,1,0,0.008114010764613213,2019-03-31 05:00:00,2019-03-31 05:15:00
23,1,0,1,0.0043857595291800985,2019-03-31 05:00:00,2019-03-31 05:15:00
26,3,2,1,0.008114010764613213,2019-03-31 05:00:00,2019-03-31 05:15:00
37,2,1,1,0.010870298705048841,2019-03-31 05:00:00,2019-03-31 05:15:00
46,1,1,0,0.005628509940991136,2019-03-31 05:00:00,2019-03-31 05:15:00
57,1,1,0,0.005628509940991136,2019-03-31 05:00:00,2019-03-31 05:15:00
67,1,1,0,0.008114010764613213,2019-03-31 05:00:00,2019-03-31 05:15:00
68,2,2,0,0.008114010764613213,2019-03-31 05:00:00,2019-03-31 05:15:00
88,1,1,0,0.008114010764613213,2019-03-31 05:00:00,2019-03-31 05:15:00
90,2,1,1,0.00762802911711447,2019-03-31 05:00:00,2019-03-31 05:15:00
109,6,2,4,0.00762802911711447,2019-03-31 05:00:00,2019-03-31 05:15:00
111,1,1,0,0.006006894323147284,2019-03-31 05:00:00,2019-03-31 05:15:00
116,1,1,0,0.005628509940991136,2019-03-31 05:00:00,2019-03-31 05:15:00
118,1,0,1,0.0043857595291800985,2019-03-31 05:00:00,2019-03-31 05:15:00
120,1,0,1,0.0043857595291800985,2019-03-31 05:00:00,2019-03-31 05:15:00
127,2,0,2,0.0043857595291800985,2019-03-31 05:00:00,2019-03-31 05:15:00
129,1,0,1,0.0043857595291800985,2019-03-31 05:00:00,2019-03-31 05:15:00
137,1,1,0,0.01362658664548447,2019-03-31 05:00:00,2019-03-31 05:15:00
138,3,1,2,0.00762802911711447,2019-03-31 05:00:00,2019-03-31 05:15:00
147,1,1,0,0.011283381523136791,2019-03-31 05:00:00,2019-03-31 05:15:00
159,1,0,1,0.0043857595291800985,2019-03-31 05:00:00,2019-03-31 05:15:00
162,1,0,1,0.0043857595291800985,2019-03-31 05:00:00,2019-03-31 05:15:00
170,2,1,1,0.028702225819628904,2019-03-31 05:00:00,2019-03-31 05:15:00
172,1,1,0,0.008114010764613213,2019-03-31 05:00:00,2019-03-31 05:15:00
177,2,2,0,0.009735145558580398,2019-03-31 05:00:00,2019-03-31 05:15:00
190,2,0,2,0.0043857595291800985,2019-03-31 05:00:00,2019-03-31 05:15:00
197,2,2,0,0.008114010764613213,2019-03-31 05:00:00,2019-03-31 05:15:00
203,1,1,0,0.008114010764613213,2019-03-31 05:00:00,2019-03-31 05:15:00
1,2,2,0,0.009743170909649698,2019-03-31 05:15:00,2019-03-31 05:30:00
16,2,0,2,0.004405868456695934,2019-03-31 05:15:00,2019-03-31 05:30:00
18,2,0,2,0.004405868456695934,2019-03-31 05:15:00,2019-03-31 05:30:00
20,2,0,2,0.004405868456695934,2019-03-31 05:15:00,2019-03-31 05:30:00
23,2,0,2,0.004405868456695934,2019-03-31 05:15:00,2019-03-31 05:30:00
26,3,2,1,0.008151216890068182,2019-03-31 05:15:00,2019-03-31 05:30:00
37,1,0,1,0.004405868456695934,2019-03-31 05:15:00,2019-03-31 05:30:00
46,1,1,0,0.006278542673382057,2019-03-31 05:15:00,2019-03-31 05:30:00
67,1,1,0,0.008151216890068182,2019-03-31 05:15:00,2019-03-31 05:30:00
68,3,3,0,0.011896565323440429,2019-03-31 05:15:00,2019-03-31 05:30:00
88,1,1,0,0.008151216890068182,2019-03-31 05:15:00,2019-03-31 05:30:00
90,1,1,0,0.00766300930985311,2019-03-31 05:15:00,2019-03-31 05:30:00
106,1,1,0,0.008151216890068182,2019-03-31 05:15:00,2019-03-31 05:30:00
108,1,0,1,0.004405868456695934,2019-03-31 05:15:00,2019-03-31 05:30:00
109,5,2,3,0.01016905589758732,2019-03-31 05:15:00,2019-03-31 05:30:00
112,1,0,1,0.004405868456695934,2019-03-31 05:15:00,2019-03-31 05:30:00
116,1,1,0,0.006278542673382057,2019-03-31 05:15:00,2019-03-31 05:30:00
118,1,0,1,0.004405868456695934,2019-03-31 05:15:00,2019-03-31 05:30:00
120,1,0,1,0.004405868456695934,2019-03-31 05:15:00,2019-03-31 05:30:00
127,2,0,2,0.004405868456695934,2019-03-31 05:15:00,2019-03-31 05:30:00
129,1,0,1,0.004405868456695934,2019-03-31 05:15:00,2019-03-31 05:30:00
137,1,1,0,0.008151216890068182,2019-03-31 05:15:00,2019-03-31 05:30:00
138,3,1,2,0.00766300930985311,2019-03-31 05:15:00,2019-03-31 05:30:00
147,1,1,0,0.011335124929231215,2019-03-31 05:15:00,2019-03-31 05:30:00
162,1,0,1,0.004405868456695934,2019-03-31 05:15:00,2019-03-31 05:30:00
170,2,1,1,0.02883303184042881,2019-03-31 05:15:00,2019-03-31 05:30:00
172,1,1,0,0.006278542673382057,2019-03-31 05:15:00,2019-03-31 05:30:00
177,2,2,0,0.011032810610513873,2019-03-31 05:15:00,2019-03-31 05:30:00
190,3,1,2,0.006278542673382057,2019-03-31 05:15:00,2019-03-31 05:30:00
197,2,2,0,0.008151216890068182,2019-03-31 05:15:00,2019-03-31 05:30:00
203,1,1,0,0.008151216890068182,2019-03-31 05:15:00,2019-03-31 05:30:00
1,3,3,0,0.013236950582667559,2019-03-31 05:30:00,2019-03-31 05:45:00
16,2,1,1,0.00715153917166426,2019-03-31 05:30:00,2019-03-31 05:45:00
18,2,0,2,0.004323706988967513,2019-03-31 05:30:00,2019-03-31 05:45:00
19,1,1,0,0.007999200424556926,2019-03-31 05:30:00,2019-03-31 05:45:00
20,2,0,2,0.004323706988967513,2019-03-31 05:30:00,2019-03-31 05:45:00
23,2,0,2,0.004323706988967513,2019-03-31 05:30:00,2019-03-31 05:45:00
26,3,2,1,0.007999200424556926,2019-03-31 05:30:00,2019-03-31 05:45:00
37,1,0,1,0.004323706988967513,2019-03-31 05:30:00,2019-03-31 05:45:00
57,1,0,1,0.004323706988967513,2019-03-31 05:30:00,2019-03-31 05:45:00
67,1,1,0,0.007999200424556926,2019-03-31 05:30:00,2019-03-31 05:45:00
68,2,2,0,0.007999200424556926,2019-03-31 05:30:00,2019-03-31 05:45:00
86,1,0,1,0.004323706988967513,2019-03-31 05:30:00,2019-03-31 05:45:00
88,2,1,1,0.007999200424556926,2019-03-31 05:30:00,2019-03-31 05:45:00
90,1,1,0,0.011123713869599369,2019-03-31 05:30:00,2019-03-31 05:45:00
106,1,1,0,0.007999200424556926,2019-03-31 05:30:00,2019-03-31 05:45:00
108,1,0,1,0.004323706988967513,2019-03-31 05:30:00,2019-03-31 05:45:00
109,5,2,3,0.009979371354361007,2019-03-31 05:30:00,2019-03-31 05:45:00
116,1,1,0,0.01040320198080734,2019-03-31 05:30:00,2019-03-31 05:45:00
118,1,0,1,0.004323706988967513,2019-03-31 05:30:00,2019-03-31 05:45:00
120,1,0,1,0.004323706988967513,2019-03-31 05:30:00,2019-03-31 05:45:00
126,1,0,1,0.004323706988967513,2019-03-31 05:30:00,2019-03-31 05:45:00
127,2,0,2,0.004323706988967513,2019-03-31 05:30:00,2019-03-31 05:45:00
129,1,0,1,0.004323706988967513,2019-03-31 05:30:00,2019-03-31 05:45:00
135,1,1,0,0.007999200424556926,2019-03-31 05:30:00,2019-03-31 05:45:00
137,1,1,0,0.007999200424556926,2019-03-31 05:30:00,2019-03-31 05:45:00
138,5,2,3,0.009979371354361007,2019-03-31 05:30:00,2019-03-31 05:45:00
147,1,1,0,0.011123713869599369,2019-03-31 05:30:00,2019-03-31 05:45:00
162,1,0,1,0.004323706988967513,2019-03-31 05:30:00,2019-03-31 05:45:00
170,2,1,1,0.028298107580565203,2019-03-31 05:30:00,2019-03-31 05:45:00
172,1,1,0,0.00616145370676222,2019-03-31 05:30:00,2019-03-31 05:45:00
177,2,2,0,0.010827032607253675,2019-03-31 05:30:00,2019-03-31 05:45:00
190,3,1,2,0.00616145370676222,2019-03-31 05:30:00,2019-03-31 05:45:00
197,2,2,0,0.007999200424556926,2019-03-31 05:30:00,2019-03-31 05:45:00
203,1,1,0,0.007999200424556926,2019-03-31 05:30:00,2019-03-31 05:45:00
16,2,1,1,0.007265730834868433,2019-03-31 05:45:00,2019-03-31 06:00:00
18,2,0,2,0.004392734606671962,2019-03-31 05:45:00,2019-03-31 06:00:00
19,1,1,0,0.008126914646316522,2019-03-31 05:45:00,2019-03-31 06:00:00
20,2,0,2,0.004392734606671962,2019-03-31 05:45:00,2019-03-31 06:00:00
23,1,0,1,0.004392734606671962,2019-03-31 05:45:00,2019-03-31 06:00:00
26,3,2,1,0.008126914646316522,2019-03-31 05:45:00,2019-03-31 06:00:00
37,1,0,1,0.004392734606671962,2019-03-31 05:45:00,2019-03-31 06:00:00
57,1,0,1,0.004392734606671962,2019-03-31 05:45:00,2019-03-31 06:00:00
67,1,1,0,0.008126914646316522,2019-03-31 05:45:00,2019-03-31 06:00:00
68,2,2,0,0.008126914646316522,2019-03-31 05:45:00,2019-03-31 06:00:00
88,1,1,0,0.008126914646316522,2019-03-31 05:45:00,2019-03-31 06:00:00
104,1,0,1,0.004392734606671962,2019-03-31 05:45:00,2019-03-31 06:00:00
109,5,2,3,0.010138727063064902,2019-03-31 05:45:00,2019-03-31 06:00:00
116,1,1,0,0.010569318968788948,2019-03-31 05:45:00,2019-03-31 06:00:00
118,1,0,1,0.004392734606671962,2019-03-31 05:45:00,2019-03-31 06:00:00
120,1,0,1,0.004392734606671962,2019-03-31 05:45:00,2019-03-31 06:00:00
127,2,0,2,0.004392734606671962,2019-03-31 05:45:00,2019-03-31 06:00:00
129,1,0,1,0.004392734606671962,2019-03-31 05:45:00,2019-03-31 06:00:00
137,1,1,0,0.008126914646316522,2019-03-31 05:45:00,2019-03-31 06:00:00
138,5,2,3,0.010138727063064902,2019-03-31 05:45:00,2019-03-31 06:00:00
147,1,1,0,0.011301324924323144,2019-03-31 05:45:00,2019-03-31 06:00:00
153,1,1,0,0.008126914646316522,2019-03-31 05:45:00,2019-03-31 06:00:00
157,1,0,1,0.004392734606671962,2019-03-31 05:45:00,2019-03-31 06:00:00
162,1,0,1,0.004392734606671962,2019-03-31 05:45:00,2019-03-31 06:00:00
170,2,1,1,0.028748827714240473,2019-03-31 05:45:00,2019-03-31 06:00:00
172,1,1,0,0.008126914646316522,2019-03-31 05:45:00,2019-03-31 06:00:00
177,2,2,0,0.010999910874512991,2019-03-31 05:45:00,2019-03-31 06:00:00
197,3,3,0,0.01186109468596108,2019-03-31 05:45:00,2019-03-31 06:00:00
203,1,1,0,0.008126914646316522,2019-03-31 05:45:00,2019-03-31 06:00:00
16,1,0,1,0.004234435385536777,2019-03-31 06:00:00,2019-03-31 06:15:00
18,4,2,2,0.013625781347992997,2019-03-31 06:00:00,2019-03-31 06:15:00
20,2,0,2,0.004234435385536777,2019-03-31 06:00:00,2019-03-31 06:15:00
23,1,0,1,0.004234435385536777,2019-03-31 06:00:00,2019-03-31 06:15:00
26,3,2,1,0.015817847764495945,2019-03-31 06:00:00,2019-03-31 06:15:00
37,1,0,1,0.004234435385536777,2019-03-31 06:00:00,2019-03-31 06:15:00
67,1,1,0,0.007834075158513414,2019-03-31 06:00:00,2019-03-31 06:15:00
88,1,1,0,0.007834075158513414,2019-03-31 06:00:00,2019-03-31 06:15:00
90,1,1,0,0.007834075158513414,2019-03-31 06:00:00,2019-03-31 06:15:00
109,5,2,3,0.00977350875950126,2019-03-31 06:00:00,2019-03-31 06:15:00
116,1,1,0,0.007834075158513414,2019-03-31 06:00:00,2019-03-31 06:15:00
118,1,0,1,0.004234435385536777,2019-03-31 06:00:00,2019-03-31 06:15:00
120,1,0,1,0.004234435385536777,2019-03-31 06:00:00,2019-03-31 06:15:00
129,1,0,1,0.004234435385536777,2019-03-31 06:00:00,2019-03-31 06:15:00
137,4,2,2,0.013625781347992999,2019-03-31 06:00:00,2019-03-31 06:15:00
138,2,1,1,0.027945546427957692,2019-03-31 06:00:00,2019-03-31 06:15:00
140,1,0,1,0.004234435385536777,2019-03-31 06:00:00,2019-03-31 06:15:00
147,1,1,0,0.017681486944047493,2019-03-31 06:00:00,2019-03-31 06:15:00
154,1,0,1,0.004234435385536777,2019-03-31 06:00:00,2019-03-31 06:15:00
157,1,0,1,0.004234435385536777,2019-03-31 06:00:00,2019-03-31 06:15:00
162,1,0,1,0.004234435385536777,2019-03-31 06:00:00,2019-03-31 06:15:00
170,2,1,1,0.027945546427957692,2019-03-31 06:00:00,2019-03-31 06:15:00
172,1,1,0,0.007834075158513414,2019-03-31 06:00:00,2019-03-31 06:15:00
177,2,2,0,0.010603611845495655,2019-03-31 06:00:00,2019-03-31 06:15:00
197,3,3,0,0.01143371493149005,2019-03-31 06:00:00,2019-03-31 06:15:00
203,1,1,0,0.007834075158513414,2019-03-31 06:00:00,2019-03-31 06:15:00
16,1,0,1,0.004154056691766654,2019-03-31 06:15:00,2019-03-31 06:30:00
18,5,2,3,0.014218511638511093,2019-03-31 06:15:00,2019-03-31 06:30:00
20,2,0,2,0.004154056691766654,2019-03-31 06:15:00,2019-03-31 06:30:00
23,1,0,1,0.004154056691766654,2019-03-31 06:15:00,2019-03-31 06:30:00
26,3,2,1,0.012212090456253105,2019-03-31 06:15:00,2019-03-31 06:30:00
37,1,0,1,0.004154056691766654,2019-03-31 06:15:00,2019-03-31 06:30:00
67,1,1,0,0.007685328981675387,2019-03-31 06:15:00,2019-03-31 06:30:00
88,2,1,1,0.007685328981675387,2019-03-31 06:15:00,2019-03-31 06:30:00
109,5,2,3,0.009587826031496278,2019-03-31 06:15:00,2019-03-31 06:30:00
116,1,1,0,0.007685328981675387,2019-03-31 06:15:00,2019-03-31 06:30:00
118,1,0,1,0.004154056691766654,2019-03-31 06:15:00,2019-03-31 06:30:00
120,1,0,1,0.004154056691766654,2019-03-31 06:15:00,2019-03-31 06:30:00
129,1,0,1,0.004154056691766654,2019-03-31 06:15:00,2019-03-31 06:30:00
137,2,1,1,0.007685328981675387,2019-03-31 06:15:00,2019-03-31 06:30:00
138,3,2,1,0.054208861667803934,2019-03-31 06:15:00,2019-03-31 06:30:00
147,1,1,0,0.014535547893182114,2019-03-31 06:15:00,2019-03-31 06:30:00
154,1,0,1,0.004154056691766654,2019-03-31 06:15:00,2019-03-31 06:30:00
157,1,0,1,0.004154056691766654,2019-03-31 06:15:00,2019-03-31 06:30:00
162,1,0,1,0.004154056691766654,2019-03-31 06:15:00,2019-03-31 06:30:00
169,1,1,0,0.01068723934860236,2019-03-31 06:15:00,2019-03-31 06:30:00
170,2,1,1,0.027548362715304513,2019-03-31 06:15:00,2019-03-31 06:30:00
172,1,1,0,0.007685328981675387,2019-03-31 06:15:00,2019-03-31 06:30:00
177,2,2,0,0.010402213651540199,2019-03-31 06:15:00,2019-03-31 06:30:00
197,3,3,0,0.01121660127158412,2019-03-31 06:15:00,2019-03-31 06:30:00
203,1,1,0,0.007685328981675387,2019-03-31 06:15:00,2019-03-31 06:30:00
16,1,0,1,0.004312193067819733,2019-03-31 06:30:00,2019-03-31 06:45:00
18,3,0,3,0.004312193067819733,2019-03-31 06:30:00,2019-03-31 06:45:00
20,2,0,2,0.004312193067819733,2019-03-31 06:30:00,2019-03-31 06:45:00
23,1,0,1,0.004312193067819733,2019-03-31 06:30:00,2019-03-31 06:45:00
26,3,2,1,0.006756020904541601,2019-03-31 06:30:00,2019-03-31 06:45:00
37,1,0,1,0.004312193067819733,2019-03-31 06:30:00,2019-03-31 06:45:00
67,1,1,0,0.007977934822902537,2019-03-31 06:30:00,2019-03-31 06:45:00
88,2,1,1,0.007977934822902537,2019-03-31 06:30:00,2019-03-31 06:45:00
109,5,2,3,0.009952994390614443,2019-03-31 06:30:00,2019-03-31 06:45:00
116,1,1,0,0.007977934822902537,2019-03-31 06:30:00,2019-03-31 06:45:00
118,1,0,1,0.004312193067819733,2019-03-31 06:30:00,2019-03-31 06:45:00
120,1,0,1,0.004312193067819733,2019-03-31 06:30:00,2019-03-31 06:45:00
129,1,0,1,0.004312193067819733,2019-03-31 06:30:00,2019-03-31 06:45:00
137,1,1,0,0.007977934822902537,2019-03-31 06:30:00,2019-03-31 06:45:00
138,3,2,1,0.0365763071201928,2019-03-31 06:30:00,2019-03-31 06:45:00
147,1,1,0,0.010055442917521218,2019-03-31 06:30:00,2019-03-31 06:45:00
162,1,0,1,0.004312193067819733,2019-03-31 06:30:00,2019-03-31 06:45:00
169,1,1,0,0.01109419696483056,2019-03-31 06:30:00,2019-03-31 06:45:00
170,2,1,1,0.028510278607099537,2019-03-31 06:30:00,2019-03-31 06:45:00
172,1,1,0,0.007977934822902537,2019-03-31 06:30:00,2019-03-31 06:45:00
177,2,2,0,0.010798335484299891,2019-03-31 06:30:00,2019-03-31 06:45:00
189,1,1,0,0.01109419696483056,2019-03-31 06:30:00,2019-03-31 06:45:00
197,2,2,0,0.007977934822902537,2019-03-31 06:30:00,2019-03-31 06:45:00
203,2,1,1,0.007977934822902537,2019-03-31 06:30:00,2019-03-31 06:45:00
16,1,0,1,0.004332942867910575,2019-03-31 06:45:00,2019-03-31 07:00:00
18,2,0,2,0.004332942867910575,2019-03-31 06:45:00,2019-03-31 07:00:00
19,2,1,1,0.008016288180497586,2019-03-31 06:45:00,2019-03-31 07:00:00
20,2,0,2,0.004332942867910575,2019-03-31 06:45:00,2019-03-31 07:00:00
23,1,0,1,0.004332942867910575,2019-03-31 06:45:00,2019-03-31 07:00:00
26,3,2,1,0.008016288180497586,2019-03-31 06:45:00,2019-03-31 07:00:00
37,1,0,1,0.004332942867910575,2019-03-31 06:45:00,2019-03-31 07:00:00
57,1,0,1,0.004332942867910575,2019-03-31 06:45:00,2019-03-31 07:00:00
58,3,1,2,0.007536153529177875,2019-03-31 06:45:00,2019-03-31 07:00:00
67,1,1,0,0.008016288180497586,2019-03-31 06:45:00,2019-03-31 07:00:00
74,1,1,0,0.00729608620351802,2019-03-31 06:45:00,2019-03-31 07:00:00
88,1,1,0,0.008016288180497586,2019-03-31 06:45:00,2019-03-31 07:00:00
90,1,1,0,0.00729608620351802,2019-03-31 06:45:00,2019-03-31 07:00:00
104,1,1,0,0.011147477083966243,2019-03-31 06:45:00,2019-03-31 07:00:00
109,5,2,3,0.010000690198926625,2019-03-31 06:45:00,2019-03-31 07:00:00
111,1,1,0,0.007536153529177875,2019-03-31 06:45:00,2019-03-31 07:00:00
116,1,1,0,0.008016288180497586,2019-03-31 06:45:00,2019-03-31 07:00:00
118,1,0,1,0.004332942867910575,2019-03-31 06:45:00,2019-03-31 07:00:00
120,1,0,1,0.004332942867910575,2019-03-31 06:45:00,2019-03-31 07:00:00
129,1,0,1,0.004332942867910575,2019-03-31 06:45:00,2019-03-31 07:00:00
137,1,1,0,0.008016288180497586,2019-03-31 06:45:00,2019-03-31 07:00:00
138,7,3,4,0.013942574851712478,2019-03-31 06:45:00,2019-03-31 07:00:00
147,1,1,0,0.011147477083966243,2019-03-31 06:45:00,2019-03-31 07:00:00
162,1,0,1,0.004332942867910575,2019-03-31 06:45:00,2019-03-31 07:00:00
170,2,1,1,0.02835863819813172,2019-03-31 06:45:00,2019-03-31 07:00:00
172,1,1,0,0.008016288180497586,2019-03-31 06:45:00,2019-03-31 07:00:00
177,2,2,0,0.01085016184600561,2019-03-31 06:45:00,2019-03-31 07:00:00
189,1,1,0,0.011147477083966243,2019-03-31 06:45:00,2019-03-31 07:00:00
196,1,0,1,0.004332942867910575,2019-03-31 06:45:00,2019-03-31 07:00:00
197,2,2,0,0.008016288180497586,2019-03-31 06:45:00,2019-03-31 07:00:00
203,2,1,1,0.008016288180497586,2019-03-31 06:45:00,2019-03-31 07:00:00
16,1,0,1,0.004469866343345242,2019-03-31 07:00:00,2019-03-31 07:15:00
18,3,0,3,0.004469866343345242,2019-03-31 07:00:00,2019-03-31 07:15:00
19,2,1,1,0.008269502427438128,2019-03-31 07:00:00,2019-03-31 07:15:00
20,2,0,2,0.004469866343345242,2019-03-31 07:00:00,2019-03-31 07:15:00
23,1,0,1,0.004469866343345242,2019-03-31 07:00:00,2019-03-31 07:15:00
26,3,2,1,0.007002957066073833,2019-03-31 07:00:00,2019-03-31 07:15:00
37,1,0,1,0.004469866343345242,2019-03-31 07:00:00,2019-03-31 07:15:00
57,1,0,1,0.004469866343345242,2019-03-31 07:00:00,2019-03-31 07:15:00
58,1,0,1,0.004469866343345242,2019-03-31 07:00:00,2019-03-31 07:15:00
67,1,1,0,0.008269502427438128,2019-03-31 07:00:00,2019-03-31 07:15:00
74,1,1,0,0.007739649231440908,2019-03-31 07:00:00,2019-03-31 07:15:00
88,1,1,0,0.008269502427438128,2019-03-31 07:00:00,2019-03-31 07:15:00
90,1,1,0,0.007739649231440908,2019-03-31 07:00:00,2019-03-31 07:15:00
104,1,1,0,0.011499591309101194,2019-03-31 07:00:00,2019-03-31 07:15:00
109,5,2,3,0.010260749003351693,2019-03-31 07:00:00,2019-03-31 07:15:00
111,1,1,0,0.008269502427438128,2019-03-31 07:00:00,2019-03-31 07:15:00
116,1,1,0,0.008269502427438128,2019-03-31 07:00:00,2019-03-31 07:15:00
118,1,0,1,0.004469866343345242,2019-03-31 07:00:00,2019-03-31 07:15:00
120,1,0,1,0.004469866343345242,2019-03-31 07:00:00,2019-03-31 07:15:00
129,1,0,1,0.004469866343345242,2019-03-31 07:00:00,2019-03-31 07:15:00
137,1,1,0,0.008269502427438128,2019-03-31 07:00:00,2019-03-31 07:15:00
138,5,2,3,0.011539285315533793,2019-03-31 07:00:00,2019-03-31 07:15:00
141,1,1,0,0.0057364117047095375,2019-03-31 07:00:00,2019-03-31 07:15:00
147,1,1,0,0.010422895015213506,2019-03-31 07:00:00,2019-03-31 07:15:00
154,1,1,0,0.007771536499936522,2019-03-31 07:00:00,2019-03-31 07:15:00
162,1,0,1,0.004469866343345242,2019-03-31 07:00:00,2019-03-31 07:15:00
170,3,1,2,0.007771536499936522,2019-03-31 07:00:00,2019-03-31 07:15:00
172,1,1,0,0.008269502427438128,2019-03-31 07:00:00,2019-03-31 07:15:00
177,2,2,0,0.011164943757441355,2019-03-31 07:00:00,2019-03-31 07:15:00
191,1,0,1,0.004469866343345242,2019-03-31 07:00:00,2019-03-31 07:15:00
197,2,2,0,0.008269502427438128,2019-03-31 07:00:00,2019-03-31 07:15:00
203,1,1,0,0.008269502427438128,2019-03-31 07:00:00,2019-03-31 07:15:00
10,1,0,1,0.004329543722575454,2019-03-31 07:15:00,2019-03-31 07:30:00
16,3,1,2,0.00753022600771775,2019-03-31 07:15:00,2019-03-31 07:30:00
18,3,0,3,0.004329543722575454,2019-03-31 07:15:00,2019-03-31 07:30:00
19,1,1,0,0.008009989084160521,2019-03-31 07:15:00,2019-03-31 07:30:00
20,2,0,2,0.004329543722575454,2019-03-31 07:15:00,2019-03-31 07:30:00
23,1,0,1,0.004329543722575454,2019-03-31 07:15:00,2019-03-31 07:30:00
26,3,2,1,0.006783173963632165,2019-03-31 07:15:00,2019-03-31 07:30:00
37,1,0,1,0.004329543722575454,2019-03-31 07:15:00,2019-03-31 07:30:00
64,2,1,1,0.02861713616516485,2019-03-31 07:15:00,2019-03-31 07:30:00
67,1,1,0,0.008009989084160521,2019-03-31 07:15:00,2019-03-31 07:30:00
74,1,1,0,0.00753022600771775,2019-03-31 07:15:00,2019-03-31 07:30:00
88,1,1,0,0.008009989084160521,2019-03-31 07:15:00,2019-03-31 07:30:00
109,5,2,3,0.009992819741954822,2019-03-31 07:15:00,2019-03-31 07:30:00
112,1,1,0,0.008009989084160521,2019-03-31 07:15:00,2019-03-31 07:30:00
116,1,1,0,0.00753022600771775,2019-03-31 07:15:00,2019-03-31 07:30:00
118,1,0,1,0.004329543722575454,2019-03-31 07:15:00,2019-03-31 07:30:00
120,1,0,1,0.004329543722575454,2019-03-31 07:15:00,2019-03-31 07:30:00
129,1,0,1,0.004329543722575454,2019-03-31 07:15:00,2019-03-31 07:30:00
137,1,1,0,0.008009989084160521,2019-03-31 07:15:00,2019-03-31 07:30:00
138,3,1,2,0.00753022600771775,2019-03-31 07:15:00,2019-03-31 07:30:00
141,1,1,0,0.00555635884310381,2019-03-31 07:15:00,2019-03-31 07:30:00
147,1,1,0,0.01009579892393339,2019-03-31 07:15:00,2019-03-31 07:30:00
162,1,0,1,0.004329543722575454,2019-03-31 07:15:00,2019-03-31 07:30:00
170,2,1,1,0.02861713616516485,2019-03-31 07:15:00,2019-03-31 07:30:00
172,1,1,0,0.008009989084160521,2019-03-31 07:15:00,2019-03-31 07:30:00
177,2,2,0,0.010841627093850205,2019-03-31 07:15:00,2019-03-31 07:30:00
191,1,0,1,0.004329543722575454,2019-03-31 07:15:00,2019-03-31 07:30:00
197,2,2,0,0.008009989084160521,2019-03-31 07:15:00,2019-03-31 07:30:00
203,1,1,0,0.008009989084160521,2019-03-31 07:15:00,2019-03-31 07:30:00
10,1,0,1,0.0041699651521301725,2019-03-31 07:30:00,2019-03-31 07:45:00
16,4,1,3,0.005818810089537977,2019-03-31 07:30:00,2019-03-31 07:45:00
18,2,0,2,0.0041699651521301725,2019-03-31 07:30:00,2019-03-31 07:45:00
20,2,0,2,0.0041699651521301725,2019-03-31 07:30:00,2019-03-31 07:45:00
23,1,0,1,0.0041699651521301725,2019-03-31 07:30:00,2019-03-31 07:45:00
26,4,3,1,0.011259629367337603,2019-03-31 07:30:00,2019-03-31 07:45:00
37,2,1,1,0.007714797259733888,2019-03-31 07:30:00,2019-03-31 07:45:00
50,1,1,0,0.007714797259733888,2019-03-31 07:30:00,2019-03-31 07:45:00
64,2,1,1,0.02761894684661584,2019-03-31 07:30:00,2019-03-31 07:45:00
67,1,1,0,0.007714797259733888,2019-03-31 07:30:00,2019-03-31 07:45:00
68,1,0,1,0.0041699651521301725,2019-03-31 07:30:00,2019-03-31 07:45:00
88,1,1,0,0.007714797259733888,2019-03-31 07:30:00,2019-03-31 07:45:00
104,1,0,1,0.0041699651521301725,2019-03-31 07:30:00,2019-03-31 07:45:00
109,5,2,3,0.009624711172466126,2019-03-31 07:30:00,2019-03-31 07:45:00
112,1,1,0,0.007714797259733888,2019-03-31 07:30:00,2019-03-31 07:45:00
116,1,1,0,0.005818810089537977,2019-03-31 07:30:00,2019-03-31 07:45:00
118,1,0,1,0.0041699651521301725,2019-03-31 07:30:00,2019-03-31 07:45:00
120,2,1,1,0.007714797259733888,2019-03-31 07:30:00,2019-03-31 07:45:00
129,1,0,1,0.0041699651521301725,2019-03-31 07:30:00,2019-03-31 07:45:00
137,1,1,0,0.010728271104903203,2019-03-31 07:30:00,2019-03-31 07:45:00
138,4,2,2,0.02761894684661584,2019-03-31 07:30:00,2019-03-31 07:45:00
147,2,2,0,0.015390589887480322,2019-03-31 07:30:00,2019-03-31 07:45:00
157,1,0,1,0.0041699651521301725,2019-03-31 07:30:00,2019-03-31 07:45:00
162,1,0,1,0.0041699651521301725,2019-03-31 07:30:00,2019-03-31 07:45:00
170,2,1,1,0.02761894684661584,2019-03-31 07:30:00,2019-03-31 07:45:00
172,1,1,0,0.007714797259733888,2019-03-31 07:30:00,2019-03-31 07:45:00
177,2,2,0,0.010442170269901865,2019-03-31 07:30:00,2019-03-31 07:45:00
190,1,0,1,0.0041699651521301725,2019-03-31 07:30:00,2019-03-31 07:45:00
197,2,2,0,0.007714797259733888,2019-03-31 07:30:00,2019-03-31 07:45:00
203,1,1,0,0.010728271104903203,2019-03-31 07:30:00,2019-03-31 07:45:00
10,1,0,1,0.00393533361562458,2019-03-31 07:45:00,2019-03-31 08:00:00
16,2,0,2,0.00393533361562458,2019-03-31 07:45:00,2019-03-31 08:00:00
18,2,0,2,0.00393533361562458,2019-03-31 07:45:00,2019-03-31 08:00:00
19,1,1,0,0.007280667016175964,2019-03-31 07:45:00,2019-03-31 08:00:00
20,2,0,2,0.00393533361562458,2019-03-31 07:45:00,2019-03-31 08:00:00
22,2,2,0,0.006059419290999689,2019-03-31 07:45:00,2019-03-31 08:00:00
23,1,0,1,0.00393533361562458,2019-03-31 07:45:00,2019-03-31 08:00:00
26,3,2,1,0.007280667016175964,2019-03-31 07:45:00,2019-03-31 08:00:00
28,1,1,0,0.007280667016175964,2019-03-31 07:45:00,2019-03-31 08:00:00
37,2,1,1,0.007280667016175964,2019-03-31 07:45:00,2019-03-31 08:00:00
50,1,1,0,0.008702585413050447,2019-03-31 07:45:00,2019-03-31 08:00:00
61,1,0,1,0.00393533361562458,2019-03-31 07:45:00,2019-03-31 08:00:00
64,2,1,1,0.0260679817227112,2019-03-31 07:45:00,2019-03-31 08:00:00
67,1,1,0,0.004997376453312134,2019-03-31 07:45:00,2019-03-31 08:00:00
68,1,0,1,0.00393533361562458,2019-03-31 07:45:00,2019-03-31 08:00:00
88,1,1,0,0.007280667016175964,2019-03-31 07:45:00,2019-03-31 08:00:00
104,1,0,1,0.00393533361562458,2019-03-31 07:45:00,2019-03-31 08:00:00
109,6,3,3,0.03206907135989789,2019-03-31 07:45:00,2019-03-31 08:00:00
112,1,1,0,0.007280667016175964,2019-03-31 07:45:00,2019-03-31 08:00:00
116,1,1,0,0.005608000315900272,2019-03-31 07:45:00,2019-03-31 08:00:00
118,5,1,4,0.004997376453312134,2019-03-31 07:45:00,2019-03-31 08:00:00
120,2,1,1,0.010124503809924931,2019-03-31 07:45:00,2019-03-31 08:00:00
129,1,0,1,0.00393533361562458,2019-03-31 07:45:00,2019-03-31 08:00:00
137,5,3,2,0.02342794007037244,2019-03-31 07:45:00,2019-03-31 08:00:00
138,2,1,1,0.0260679817227112,2019-03-31 07:45:00,2019-03-31 08:00:00
141,1,0,1,0.00393533361562458,2019-03-31 07:45:00,2019-03-31 08:00:00
147,2,2,0,0.011797170510200622,2019-03-31 07:45:00,2019-03-31 08:00:00
153,1,1,0,0.005608000315900272,2019-03-31 07:45:00,2019-03-31 08:00:00
157,2,1,1,0.007280667016175964,2019-03-31 07:45:00,2019-03-31 08:00:00
158,1,0,1,0.00393533361562458,2019-03-31 07:45:00,2019-03-31 08:00:00
162,1,0,1,0.00393533361562458,2019-03-31 07:45:00,2019-03-31 08:00:00
170,2,1,1,0.0260679817227112,2019-03-31 07:45:00,2019-03-31 08:00:00
172,1,1,0,0.007280667016175964,2019-03-31 07:45:00,2019-03-31 08:00:00
177,2,2,0,0.016368484458364557,2019-03-31 07:45:00,2019-03-31 08:00:00
190,2,1,1,0.005608000315900272,2019-03-31 07:45:00,2019-03-31 08:00:00
197,2,2,0,0.007280667016175964,2019-03-31 07:45:00,2019-03-31 08:00:00
199,2,0,2,0.00393533361562458,2019-03-31 07:45:00,2019-03-31 08:00:00
203,1,1,0,0.012542072106724846,2019-03-31 07:45:00,2019-03-31 08:00:00
10,4,1,3,0.01877129591518454,2019-03-31 08:00:00,2019-03-31 08:15:00
15,1,0,1,0.0037805726165362624,2019-03-31 08:00:00,2019-03-31 08:15:00
16,2,1,1,0.006994367255917334,2019-03-31 08:00:00,2019-03-31 08:15:00
18,4,2,2,0.016091527701513605,2019-03-31 08:00:00,2019-03-31 08:15:00
19,1,1,0,0.006994367255917334,2019-03-31 08:00:00,2019-03-31 08:15:00
20,2,0,2,0.0037805726165362624,2019-03-31 08:00:00,2019-03-31 08:15:00
22,2,2,0,0.005923102376123644,2019-03-31 08:00:00,2019-03-31 08:15:00
23,1,0,1,0.0037805726165362624,2019-03-31 08:00:00,2019-03-31 08:15:00
26,3,2,1,0.017460634843341587,2019-03-31 08:00:00,2019-03-31 08:15:00
37,1,0,1,0.0037805726165362624,2019-03-31 08:00:00,2019-03-31 08:15:00
61,1,0,1,0.0037805726165362624,2019-03-31 08:00:00,2019-03-31 08:15:00
64,2,1,1,0.025016859137875967,2019-03-31 08:00:00,2019-03-31 08:15:00
67,1,1,0,0.004851837496329953,2019-03-31 08:00:00,2019-03-31 08:15:00
70,1,0,1,0.0037805726165362624,2019-03-31 08:00:00,2019-03-31 08:15:00
88,1,1,0,0.006994367255917334,2019-03-31 08:00:00,2019-03-31 08:15:00
109,5,2,3,0.008725862572484902,2019-03-31 08:00:00,2019-03-31 08:15:00
111,6,3,3,0.016143797506407858,2019-03-31 08:00:00,2019-03-31 08:15:00
116,1,1,0,0.009726405274482522,2019-03-31 08:00:00,2019-03-31 08:15:00
118,3,0,3,0.0037805726165362624,2019-03-31 08:00:00,2019-03-31 08:15:00
120,4,2,2,0.016917139116307434,2019-03-31 08:00:00,2019-03-31 08:15:00
122,6,3,3,0.025016859137875967,2019-03-31 08:00:00,2019-03-31 08:15:00
129,1,0,1,0.0037805726165362624,2019-03-31 08:00:00,2019-03-31 08:15:00
137,2,2,0,0.010208161895298405,2019-03-31 08:00:00,2019-03-31 08:15:00
138,7,2,5,0.005728454283507559,2019-03-31 08:00:00,2019-03-31 08:15:00
141,1,0,1,0.0037805726165362624,2019-03-31 08:00:00,2019-03-31 08:15:00
147,1,1,0,0.018624526265912406,2019-03-31 08:00:00,2019-03-31 08:15:00
151,1,0,1,0.0037805726165362624,2019-03-31 08:00:00,2019-03-31 08:15:00
157,2,1,1,0.006994367255917334,2019-03-31 08:00:00,2019-03-31 08:15:00
158,1,0,1,0.0037805726165362624,2019-03-31 08:00:00,2019-03-31 08:15:00
162,1,0,1,0.0037805726165362624,2019-03-31 08:00:00,2019-03-31 08:15:00
164,1,1,0,0.0047545134500219105,2019-03-31 08:00:00,2019-03-31 08:15:00
170,2,1,1,0.025016859137875967,2019-03-31 08:00:00,2019-03-31 08:15:00
171,3,3,0,0.00894224892288863,2019-03-31 08:00:00,2019-03-31 08:15:00
172,1,1,0,0.006994367255917334,2019-03-31 08:00:00,2019-03-31 08:15:00
177,2,2,0,0.009467012233891655,2019-03-31 08:00:00,2019-03-31 08:15:00
190,4,3,1,0.01763338533785236,2019-03-31 08:00:00,2019-03-31 08:15:00
191,2,1,1,0.009100081657503773,2019-03-31 08:00:00,2019-03-31 08:15:00
197,2,2,0,0.006994367255917334,2019-03-31 08:00:00,2019-03-31 08:15:00
199,1,0,1,0.0037805726165362624,2019-03-31 08:00:00,2019-03-31 08:15:00
203,1,1,0,0.010971306458361172,2019-03-31 08:00:00,2019-03-31 08:15:00
2,1,0,1,0.004003841184925341,2019-03-31 08:15:00,2019-03-31 08:30:00
5,1,1,0,0.012760541263806095,2019-03-31 08:15:00,2019-03-31 08:30:00
10,2,0,2,0.004003841184925341,2019-03-31 08:15:00,2019-03-31 08:30:00
15,2,2,0,0.010300823679972745,2019-03-31 08:15:00,2019-03-31 08:30:00
16,2,1,1,0.007407435344779319,2019-03-31 08:15:00,2019-03-31 08:30:00
18,2,0,2,0.004003841184925341,2019-03-31 08:15:00,2019-03-31 08:30:00
20,2,0,2,0.004003841184925341,2019-03-31 08:15:00,2019-03-31 08:30:00
23,1,0,1,0.004003841184925341,2019-03-31 08:15:00,2019-03-31 08:30:00
26,3,2,1,0.007407435344779319,2019-03-31 08:15:00,2019-03-31 08:30:00
28,2,0,2,0.004003841184925341,2019-03-31 08:15:00,2019-03-31 08:30:00
37,1,0,1,0.004003841184925341,2019-03-31 08:15:00,2019-03-31 08:30:00
62,1,0,1,0.004003841184925341,2019-03-31 08:15:00,2019-03-31 08:30:00
64,2,1,1,0.026518033199652763,2019-03-31 08:15:00,2019-03-31 08:30:00
67,1,1,0,0.007407435344779319,2019-03-31 08:15:00,2019-03-31 08:30:00
70,2,2,0,0.007407435344779319,2019-03-31 08:15:00,2019-03-31 08:30:00
88,3,1,2,0.007407435344779319,2019-03-31 08:15:00,2019-03-31 08:30:00
90,2,1,1,0.026518033199652763,2019-03-31 08:15:00,2019-03-31 08:30:00
109,5,2,3,0.009241191416742591,2019-03-31 08:15:00,2019-03-31 08:30:00
111,3,1,2,0.006963781806266027,2019-03-31 08:15:00,2019-03-31 08:30:00
115,1,1,0,0.006963781806266027,2019-03-31 08:15:00,2019-03-31 08:30:00
116,2,1,1,0.010300823679972745,2019-03-31 08:15:00,2019-03-31 08:30:00
118,1,0,1,0.004003841184925341,2019-03-31 08:15:00,2019-03-31 08:30:00
120,3,1,2,0.006963781806266027,2019-03-31 08:15:00,2019-03-31 08:30:00
122,1,1,0,0.007407435344779319,2019-03-31 08:15:00,2019-03-31 08:30:00
126,1,1,0,0.007407435344779319,2019-03-31 08:15:00,2019-03-31 08:30:00
129,1,0,1,0.004003841184925341,2019-03-31 08:15:00,2019-03-31 08:30:00
137,2,2,0,0.010811029504633297,2019-03-31 08:15:00,2019-03-31 08:30:00
138,4,1,3,0.0055869862389966345,2019-03-31 08:15:00,2019-03-31 08:30:00
141,1,0,1,0.004003841184925341,2019-03-31 08:15:00,2019-03-31 08:30:00
147,1,1,0,0.010300823679972745,2019-03-31 08:15:00,2019-03-31 08:30:00
151,1,0,1,0.004003841184925341,2019-03-31 08:15:00,2019-03-31 08:30:00
157,1,1,0,0.007407435344779319,2019-03-31 08:15:00,2019-03-31 08:30:00
162,1,0,1,0.004003841184925341,2019-03-31 08:15:00,2019-03-31 08:30:00
168,1,0,1,0.004003841184925341,2019-03-31 08:15:00,2019-03-31 08:30:00
170,2,1,1,0.026518033199652763,2019-03-31 08:15:00,2019-03-31 08:30:00
171,2,2,0,0.007170131293067929,2019-03-31 08:15:00,2019-03-31 08:30:00
172,1,1,0,0.007407435344779319,2019-03-31 08:15:00,2019-03-31 08:30:00
177,3,2,1,0.010026110460687944,2019-03-31 08:15:00,2019-03-31 08:30:00
190,2,2,0,0.007407435344779319,2019-03-31 08:15:00,2019-03-31 08:30:00
191,1,1,0,0.012527039273908695,2019-03-31 08:15:00,2019-03-31 08:30:00
197,2,2,0,0.007407435344779319,2019-03-31 08:15:00,2019-03-31 08:30:00
202,1,0,1,0.004003841184925341,2019-03-31 08:15:00,2019-03-31 08:30:00
203,2,2,0,0.010367375966120005,2019-03-31 08:15:00,2019-03-31 08:30:00
2,1,0,1,0.003613533069898897,2019-03-31 08:30:00,2019-03-31 08:45:00
5,1,1,0,0.011516723548790336,2019-03-31 08:30:00,2019-03-31 08:45:00
10,2,0,2,0.003613533069898897,2019-03-31 08:30:00,2019-03-31 08:45:00
15,3,2,1,0.011516723548790336,2019-03-31 08:30:00,2019-03-31 08:45:00
16,2,1,1,0.006685354291019609,2019-03-31 08:30:00,2019-03-31 08:45:00
18,3,0,3,0.003613533069898897,2019-03-31 08:30:00,2019-03-31 08:45:00
20,2,0,2,0.003613533069898897,2019-03-31 08:30:00,2019-03-31 08:45:00
23,1,0,1,0.003613533069898897,2019-03-31 08:30:00,2019-03-31 08:45:00
26,4,3,1,0.008733235105100084,2019-03-31 08:30:00,2019-03-31 08:45:00
28,2,0,2,0.003613533069898897,2019-03-31 08:30:00,2019-03-31 08:45:00
37,1,0,1,0.003613533069898897,2019-03-31 08:30:00,2019-03-31 08:45:00
40,1,0,1,0.003613533069898897,2019-03-31 08:30:00,2019-03-31 08:45:00
46,2,1,1,0.02398038285115177,2019-03-31 08:30:00,2019-03-31 08:45:00
62,1,1,0,0.00929672658357737,2019-03-31 08:30:00,2019-03-31 08:45:00
67,1,1,0,0.006685354291019609,2019-03-31 08:30:00,2019-03-31 08:45:00
68,1,1,0,0.013404057869249357,2019-03-31 08:30:00,2019-03-31 08:45:00
70,3,2,1,0.006685354291019609,2019-03-31 08:30:00,2019-03-31 08:45:00
75,2,1,1,0.02398038285115177,2019-03-31 08:30:00,2019-03-31 08:45:00
88,3,1,2,0.00929672658357737,2019-03-31 08:30:00,2019-03-31 08:45:00
90,1,0,1,0.003613533069898897,2019-03-31 08:30:00,2019-03-31 08:45:00
109,5,2,3,0.008340449421240298,2019-03-31 08:30:00,2019-03-31 08:45:00
111,1,0,1,0.003613533069898897,2019-03-31 08:30:00,2019-03-31 08:45:00
115,1,1,0,0.006685354291019609,2019-03-31 08:30:00,2019-03-31 08:45:00
116,2,1,1,0.00929672658357737,2019-03-31 08:30:00,2019-03-31 08:45:00
118,1,0,1,0.003613533069898897,2019-03-31 08:30:00,2019-03-31 08:45:00
120,3,1,2,0.00628496947188468,2019-03-31 08:30:00,2019-03-31 08:45:00
122,3,2,1,0.009757175512140321,2019-03-31 08:30:00,2019-03-31 08:45:00
129,2,1,1,0.006685354291019609,2019-03-31 08:30:00,2019-03-31 08:45:00
135,1,0,1,0.003613533069898897,2019-03-31 08:30:00,2019-03-31 08:45:00
137,2,1,1,0.006685354291019609,2019-03-31 08:30:00,2019-03-31 08:45:00
138,9,5,4,0.041675796230418845,2019-03-31 08:30:00,2019-03-31 08:45:00
147,1,1,0,0.011037641445282544,2019-03-31 08:30:00,2019-03-31 08:45:00
151,1,0,1,0.003613533069898897,2019-03-31 08:30:00,2019-03-31 08:45:00
154,1,1,0,0.00929672658357737,2019-03-31 08:30:00,2019-03-31 08:45:00
157,1,1,0,0.011516723548790336,2019-03-31 08:30:00,2019-03-31 08:45:00
162,1,0,1,0.003613533069898897,2019-03-31 08:30:00,2019-03-31 08:45:00
168,2,1,1,0.00929672658357737,2019-03-31 08:30:00,2019-03-31 08:45:00
170,2,1,1,0.02398038285115177,2019-03-31 08:30:00,2019-03-31 08:45:00
171,3,1,2,0.00628496947188468,2019-03-31 08:30:00,2019-03-31 08:45:00
172,1,1,0,0.006685354291019609,2019-03-31 08:30:00,2019-03-31 08:45:00
177,3,2,1,0.00904881246669031,2019-03-31 08:30:00,2019-03-31 08:45:00
189,1,1,0,0.006685354291019609,2019-03-31 08:30:00,2019-03-31 08:45:00
190,2,2,0,0.006685354291019609,2019-03-31 08:30:00,2019-03-31 08:45:00
191,3,2,1,0.012329943643563303,2019-03-31 08:30:00,2019-03-31 08:45:00
196,1,1,0,0.014095409812782584,2019-03-31 08:30:00,2019-03-31 08:45:00
197,3,2,1,0.006685354291019609,2019-03-31 08:30:00,2019-03-31 08:45:00
201,1,0,1,0.003613533069898897,2019-03-31 08:30:00,2019-03-31 08:45:00
202,1,0,1,0.003613533069898897,2019-03-31 08:30:00,2019-03-31 08:45:00
203,3,3,0,0.017651356499241627,2019-03-31 08:30:00,2019-03-31 08:45:00
2,2,1,1,0.005830246018651589,2019-03-31 08:45:00,2019-03-31 09:00:00
10,2,0,2,0.003948380516838349,2019-03-31 08:45:00,2019-03-31 09:00:00
15,5,2,3,0.010193215289103191,2019-03-31 08:45:00,2019-03-31 09:00:00
16,2,1,1,0.007304820144097423,2019-03-31 08:45:00,2019-03-31 09:00:00
18,3,0,3,0.003948380516838349,2019-03-31 08:45:00,2019-03-31 09:00:00
20,3,0,3,0.003948380516838349,2019-03-31 08:45:00,2019-03-31 09:00:00
23,1,0,1,0.003948380516838349,2019-03-31 08:45:00,2019-03-31 09:00:00
26,4,3,1,0.00954244656227014,2019-03-31 08:45:00,2019-03-31 09:00:00
28,4,2,2,0.025769507566991565,2019-03-31 08:45:00,2019-03-31 09:00:00
37,1,0,1,0.003948380516838349,2019-03-31 08:45:00,2019-03-31 09:00:00
62,1,1,0,0.008521568436637773,2019-03-31 08:45:00,2019-03-31 09:00:00
67,1,1,0,0.007304820144097423,2019-03-31 08:45:00,2019-03-31 09:00:00
68,2,2,0,0.009725170806849884,2019-03-31 08:45:00,2019-03-31 09:00:00
69,1,1,0,0.007304820144097423,2019-03-31 08:45:00,2019-03-31 09:00:00
88,1,1,0,0.007304820144097423,2019-03-31 08:45:00,2019-03-31 09:00:00
89,1,0,1,0.003948380516838349,2019-03-31 08:45:00,2019-03-31 09:00:00
109,6,3,3,0.015850527673240893,2019-03-31 08:45:00,2019-03-31 09:00:00
112,1,0,1,0.003948380516838349,2019-03-31 08:45:00,2019-03-31 09:00:00
114,3,2,1,0.012583727508273156,2019-03-31 08:45:00,2019-03-31 09:00:00
115,1,1,0,0.007304820144097423,2019-03-31 08:45:00,2019-03-31 09:00:00
116,3,1,2,0.010158111281935745,2019-03-31 08:45:00,2019-03-31 09:00:00
118,1,0,1,0.003948380516838349,2019-03-31 08:45:00,2019-03-31 09:00:00
119,2,2,0,0.007712111520464829,2019-03-31 08:45:00,2019-03-31 09:00:00
120,4,2,2,0.015487773448061987,2019-03-31 08:45:00,2019-03-31 09:00:00
129,1,0,1,0.003948380516838349,2019-03-31 08:45:00,2019-03-31 09:00:00
135,1,0,1,0.003948380516838349,2019-03-31 08:45:00,2019-03-31 09:00:00
137,2,1,1,0.007304820144097423,2019-03-31 08:45:00,2019-03-31 09:00:00
138,8,3,5,0.011068551147723904,2019-03-31 08:45:00,2019-03-31 09:00:00
147,1,1,0,0.012060305373827959,2019-03-31 08:45:00,2019-03-31 09:00:00
151,1,0,1,0.003948380516838349,2019-03-31 08:45:00,2019-03-31 09:00:00
153,1,0,1,0.003948380516838349,2019-03-31 08:45:00,2019-03-31 09:00:00
162,1,0,1,0.003948380516838349,2019-03-31 08:45:00,2019-03-31 09:00:00
164,1,1,0,0.014645821419959643,2019-03-31 08:45:00,2019-03-31 09:00:00
168,3,1,2,0.010158111281935745,2019-03-31 08:45:00,2019-03-31 09:00:00
169,2,2,0,0.012583727508273156,2019-03-31 08:45:00,2019-03-31 09:00:00
170,3,1,2,0.006867300947397838,2019-03-31 08:45:00,2019-03-31 09:00:00
171,1,0,1,0.003948380516838349,2019-03-31 08:45:00,2019-03-31 09:00:00
172,1,1,0,0.007304820144097423,2019-03-31 08:45:00,2019-03-31 09:00:00
177,2,2,0,0.01179643350701895,2019-03-31 08:45:00,2019-03-31 09:00:00
189,1,1,0,0.007304820144097423,2019-03-31 08:45:00,2019-03-31 09:00:00
190,2,2,0,0.007304820144097423,2019-03-31 08:45:00,2019-03-31 09:00:00
191,3,2,1,0.006186006935011065,2019-03-31 08:45:00,2019-03-31 09:00:00
196,1,1,0,0.009207014235989637,2019-03-31 08:45:00,2019-03-31 09:00:00
197,5,3,2,0.01075919485481049,2019-03-31 08:45:00,2019-03-31 09:00:00
201,1,0,1,0.003948380516838349,2019-03-31 08:45:00,2019-03-31 09:00:00
203,1,1,0,0.010531535448818508,2019-03-31 08:45:00,2019-03-31 09:00:00
2,3,2,1,0.0067797712023690395,2019-03-31 09:00:00,2019-03-31 09:15:00
10,2,0,2,0.003835267865128354,2019-03-31 09:00:00,2019-03-31 09:15:00
16,2,0,2,0.003835267865128354,2019-03-31 09:00:00,2019-03-31 09:15:00
18,5,1,4,0.004870302988370764,2019-03-31 09:00:00,2019-03-31 09:15:00
20,3,0,3,0.003835267865128354,2019-03-31 09:00:00,2019-03-31 09:15:00
21,2,2,0,0.007095532041800369,2019-03-31 09:00:00,2019-03-31 09:15:00
22,1,1,0,0.009867045246471987,2019-03-31 09:00:00,2019-03-31 09:15:00
23,2,1,1,0.00950579837224163,2019-03-31 09:00:00,2019-03-31 09:15:00
26,3,2,1,0.005905338111613173,2019-03-31 09:00:00,2019-03-31 09:15:00
28,4,2,2,0.02531478191190837,2019-03-31 09:00:00,2019-03-31 09:15:00
37,1,0,1,0.003835267865128354,2019-03-31 09:00:00,2019-03-31 09:15:00
62,1,1,0,0.009867045246471987,2019-03-31 09:00:00,2019-03-31 09:15:00
67,1,1,0,0.007095532041800369,2019-03-31 09:00:00,2019-03-31 09:15:00
69,1,1,0,0.010160066810705325,2019-03-31 09:00:00,2019-03-31 09:15:00
88,1,1,0,0.007095532041800369,2019-03-31 09:00:00,2019-03-31 09:15:00
90,1,0,1,0.003835267865128354,2019-03-31 09:00:00,2019-03-31 09:15:00
99,1,0,1,0.003835267865128354,2019-03-31 09:00:00,2019-03-31 09:15:00
104,2,0,2,0.003835267865128354,2019-03-31 09:00:00,2019-03-31 09:15:00
109,7,4,3,0.024697714725276005,2019-03-31 09:00:00,2019-03-31 09:15:00
112,2,1,1,0.007440175821118451,2019-03-31 09:00:00,2019-03-31 09:15:00
114,4,2,2,0.008481288644136178,2019-03-31 09:00:00,2019-03-31 09:15:00
115,2,1,1,0.006670533118684992,2019-03-31 09:00:00,2019-03-31 09:15:00
116,3,1,2,0.005465399953464361,2019-03-31 09:00:00,2019-03-31 09:15:00
118,1,0,1,0.003835267865128354,2019-03-31 09:00:00,2019-03-31 09:15:00
119,2,2,0,0.00646401036293771,2019-03-31 09:00:00,2019-03-31 09:15:00
120,4,2,2,0.016694765481877722,2019-03-31 09:00:00,2019-03-31 09:15:00
122,1,0,1,0.003835267865128354,2019-03-31 09:00:00,2019-03-31 09:15:00
129,1,0,1,0.003835267865128354,2019-03-31 09:00:00,2019-03-31 09:15:00
137,6,4,2,0.02368212464002481,2019-03-31 09:00:00,2019-03-31 09:15:00
138,6,2,4,0.006184674237275442,2019-03-31 09:00:00,2019-03-31 09:15:00
147,2,2,0,0.01211554885106763,2019-03-31 09:00:00,2019-03-31 09:15:00
151,1,0,1,0.003835267865128354,2019-03-31 09:00:00,2019-03-31 09:15:00
153,3,1,2,0.006670533118684992,2019-03-31 09:00:00,2019-03-31 09:15:00
160,2,1,1,0.007095532041800369,2019-03-31 09:00:00,2019-03-31 09:15:00
162,1,0,1,0.003835267865128354,2019-03-31 09:00:00,2019-03-31 09:15:00
168,1,1,0,0.013901332110008768,2019-03-31 09:00:00,2019-03-31 09:15:00
170,2,1,1,0.02531478191190837,2019-03-31 09:00:00,2019-03-31 09:15:00
172,1,1,0,0.011916064702682888,2019-03-31 09:00:00,2019-03-31 09:15:00
177,2,2,0,0.01409416940554314,2019-03-31 09:00:00,2019-03-31 09:15:00
189,1,1,0,0.007095532041800369,2019-03-31 09:00:00,2019-03-31 09:15:00
190,3,2,1,0.007095532041800369,2019-03-31 09:00:00,2019-03-31 09:15:00
191,1,1,0,0.004922022590685692,2019-03-31 09:00:00,2019-03-31 09:15:00
196,1,0,1,0.003835267865128354,2019-03-31 09:00:00,2019-03-31 09:15:00
197,2,2,0,0.00600877731624303,2019-03-31 09:00:00,2019-03-31 09:15:00
201,1,0,1,0.003835267865128354,2019-03-31 09:00:00,2019-03-31 09:15:00
203,1,1,0,0.010931400200220823,2019-03-31 09:00:00,2019-03-31 09:15:00
2,1,1,0,0.005052783480787146,2019-03-31 09:15:00,2019-03-31 09:30:00
5,1,1,0,0.00912214624780609,2019-03-31 09:15:00,2019-03-31 09:30:00
10,2,0,2,0.003545716386161159,2019-03-31 09:15:00,2019-03-31 09:30:00
16,2,0,2,0.003545716386161159,2019-03-31 09:15:00,2019-03-31 09:30:00
18,3,0,3,0.003545716386161159,2019-03-31 09:15:00,2019-03-31 09:30:00
20,2,0,2,0.003545716386161159,2019-03-31 09:15:00,2019-03-31 09:30:00
21,2,2,0,0.006559850575413133,2019-03-31 09:15:00,2019-03-31 09:30:00
22,1,1,0,0.00912214624780609,2019-03-31 09:15:00,2019-03-31 09:30:00
23,3,2,1,0.007961839713258539,2019-03-31 09:15:00,2019-03-31 09:30:00
26,3,2,1,0.005555139178995808,2019-03-31 09:15:00,2019-03-31 09:30:00
28,4,2,2,0.023557631971808893,2019-03-31 09:15:00,2019-03-31 09:30:00
37,1,0,1,0.003545716386161159,2019-03-31 09:15:00,2019-03-31 09:30:00
58,3,2,1,0.04356954755745662,2019-03-31 09:15:00,2019-03-31 09:30:00
62,1,1,0,0.010947853946158782,2019-03-31 09:15:00,2019-03-31 09:30:00
67,1,1,0,0.006559850575413133,2019-03-31 09:15:00,2019-03-31 09:30:00
71,4,2,2,0.023557631971808893,2019-03-31 09:15:00,2019-03-31 09:30:00
79,1,1,0,0.004947705524006565,2019-03-31 09:15:00,2019-03-31 09:30:00
87,2,2,0,0.00634969466185197,2019-03-31 09:15:00,2019-03-31 09:30:00
88,1,1,0,0.00980991202070551,2019-03-31 09:15:00,2019-03-31 09:30:00
90,1,0,1,0.003545716386161159,2019-03-31 09:15:00,2019-03-31 09:30:00
99,2,0,2,0.003545716386161159,2019-03-31 09:15:00,2019-03-31 09:30:00
104,2,0,2,0.003545716386161159,2019-03-31 09:15:00,2019-03-31 09:30:00
109,5,2,3,0.00818375491566423,2019-03-31 09:15:00,2019-03-31 09:30:00
112,1,1,0,0.006559850575413133,2019-03-31 09:15:00,2019-03-31 09:30:00
114,1,0,1,0.003545716386161159,2019-03-31 09:15:00,2019-03-31 09:30:00
115,1,0,1,0.003545716386161159,2019-03-31 09:15:00,2019-03-31 09:30:00
116,2,2,0,0.007200424493511372,2019-03-31 09:15:00,2019-03-31 09:30:00
118,1,0,1,0.003545716386161159,2019-03-31 09:15:00,2019-03-31 09:30:00
120,4,2,2,0.012816526718303006,2019-03-31 09:15:00,2019-03-31 09:30:00
126,3,1,2,0.005052783480787146,2019-03-31 09:15:00,2019-03-31 09:30:00
129,2,1,1,0.007368606190908988,2019-03-31 09:15:00,2019-03-31 09:30:00
137,7,5,2,0.027745527791938233,2019-03-31 09:15:00,2019-03-31 09:30:00
138,4,2,2,0.007914444651693043,2019-03-31 09:15:00,2019-03-31 09:30:00
140,1,0,1,0.003545716386161159,2019-03-31 09:15:00,2019-03-31 09:30:00
141,1,0,1,0.003545716386161159,2019-03-31 09:15:00,2019-03-31 09:30:00
147,2,2,0,0.009775114784967757,2019-03-31 09:15:00,2019-03-31 09:30:00
151,1,0,1,0.003545716386161159,2019-03-31 09:15:00,2019-03-31 09:30:00
153,3,2,1,0.04356954755745662,2019-03-31 09:15:00,2019-03-31 09:30:00
157,1,0,1,0.003545716386161159,2019-03-31 09:15:00,2019-03-31 09:30:00
159,4,1,3,0.004947705524006565,2019-03-31 09:15:00,2019-03-31 09:30:00
160,2,1,1,0.006559850575413133,2019-03-31 09:15:00,2019-03-31 09:30:00
162,1,0,1,0.003545716386161159,2019-03-31 09:15:00,2019-03-31 09:30:00
168,2,2,0,0.018353242544319723,2019-03-31 09:15:00,2019-03-31 09:30:00
170,4,1,3,0.004947705524006565,2019-03-31 09:15:00,2019-03-31 09:30:00
172,1,1,0,0.010313979472090335,2019-03-31 09:15:00,2019-03-31 09:30:00
173,1,0,1,0.003545716386161159,2019-03-31 09:15:00,2019-03-31 09:30:00
177,2,2,0,0.008878869840164668,2019-03-31 09:15:00,2019-03-31 09:30:00
190,4,3,1,0.008707491588137358,2019-03-31 09:15:00,2019-03-31 09:30:00
191,2,1,1,0.006559850575413133,2019-03-31 09:15:00,2019-03-31 09:30:00
196,1,0,1,0.003545716386161159,2019-03-31 09:15:00,2019-03-31 09:30:00
197,2,2,0,0.006559850575413133,2019-03-31 09:15:00,2019-03-31 09:30:00
203,3,1,2,0.008993636913555177,2019-03-31 09:15:00,2019-03-31 09:30:00
1,4,3,1,0.015371105669165039,2019-03-31 09:30:00,2019-03-31 09:45:00
5,1,1,0,0.005553772846486938,2019-03-31 09:30:00,2019-03-31 09:45:00
10,2,0,2,0.0031089600591357575,2019-03-31 09:30:00,2019-03-31 09:45:00
11,1,1,0,0.005751847857879127,2019-03-31 09:30:00,2019-03-31 09:45:00
16,1,0,1,0.0031089600591357575,2019-03-31 09:30:00,2019-03-31 09:45:00
18,4,2,2,0.006214494796172781,2019-03-31 09:30:00,2019-03-31 09:45:00
19,2,2,0,0.015959342883737702,2019-03-31 09:30:00,2019-03-31 09:45:00
20,3,0,3,0.0031089600591357575,2019-03-31 09:30:00,2019-03-31 09:45:00
21,2,2,0,0.005751847857879127,2019-03-31 09:30:00,2019-03-31 09:45:00
23,3,2,1,0.008394735656622496,2019-03-31 09:30:00,2019-03-31 09:45:00
26,3,2,1,0.00839191225664426,2019-03-31 09:30:00,2019-03-31 09:45:00
28,4,2,2,0.020683207123885,2019-03-31 09:30:00,2019-03-31 09:45:00
37,2,1,1,0.004430403958507442,2019-03-31 09:30:00,2019-03-31 09:45:00
41,1,1,0,0.00540738035834964,2019-03-31 09:30:00,2019-03-31 09:45:00
46,1,1,0,0.005475468353081832,2019-03-31 09:30:00,2019-03-31 09:45:00
58,3,1,2,0.00540738035834964,2019-03-31 09:30:00,2019-03-31 09:45:00
62,1,0,1,0.0031089600591357575,2019-03-31 09:30:00,2019-03-31 09:45:00
66,3,3,0,0.005091125908193285,2019-03-31 09:30:00,2019-03-31 09:45:00
67,1,1,0,0.005475468353081832,2019-03-31 09:30:00,2019-03-31 09:45:00
71,4,2,2,0.020683207123885,2019-03-31 09:30:00,2019-03-31 09:45:00
80,1,0,1,0.0031089600591357575,2019-03-31 09:30:00,2019-03-31 09:45:00
87,4,3,1,0.05091443166229315,2019-03-31 09:30:00,2019-03-31 09:45:00
88,1,1,0,0.006808869139289982,2019-03-31 09:30:00,2019-03-31 09:45:00
90,1,0,1,0.0031089600591357575,2019-03-31 09:30:00,2019-03-31 09:45:00
99,2,0,2,0.0031089600591357575,2019-03-31 09:30:00,2019-03-31 09:45:00
104,2,0,2,0.0031089600591357575,2019-03-31 09:30:00,2019-03-31 09:45:00
109,5,2,3,0.007175892231545217,2019-03-31 09:30:00,2019-03-31 09:45:00
112,7,4,3,0.021218947647806078,2019-03-31 09:30:00,2019-03-31 09:45:00
114,3,2,1,0.0055675948546809306,2019-03-31 09:30:00,2019-03-31 09:45:00
115,1,0,1,0.0031089600591357575,2019-03-31 09:30:00,2019-03-31 09:45:00
116,4,3,1,0.028843560605551568,2019-03-31 09:30:00,2019-03-31 09:45:00
118,4,2,2,0.0055675948546809306,2019-03-31 09:30:00,2019-03-31 09:45:00
119,2,2,0,0.011765012215247152,2019-03-31 09:30:00,2019-03-31 09:45:00
120,6,2,4,0.006355158371521401,2019-03-31 09:30:00,2019-03-31 09:45:00
122,1,0,1,0.0031089600591357575,2019-03-31 09:30:00,2019-03-31 09:45:00
126,10,5,5,0.059030348505665534,2019-03-31 09:30:00,2019-03-31 09:45:00
129,4,2,2,0.008704425165633503,2019-03-31 09:30:00,2019-03-31 09:45:00
135,4,2,2,0.020683207123885,2019-03-31 09:30:00,2019-03-31 09:45:00
137,5,4,1,0.015091921542871957,2019-03-31 09:30:00,2019-03-31 09:45:00
138,4,2,2,0.010004220956777407,2019-03-31 09:30:00,2019-03-31 09:45:00
140,1,0,1,0.0031089600591357575,2019-03-31 09:30:00,2019-03-31 09:45:00
147,2,2,0,0.011564459240054526,2019-03-31 09:30:00,2019-03-31 09:45:00
153,4,1,3,0.004338277456908344,2019-03-31 09:30:00,2019-03-31 09:45:00
154,1,1,0,0.005751847857879127,2019-03-31 09:30:00,2019-03-31 09:45:00
157,1,0,1,0.0031089600591357575,2019-03-31 09:30:00,2019-03-31 09:45:00
158,2,0,2,0.0031089600591357575,2019-03-31 09:30:00,2019-03-31 09:45:00
159,1,0,1,0.0031089600591357575,2019-03-31 09:30:00,2019-03-31 09:45:00
162,1,0,1,0.0031089600591357575,2019-03-31 09:30:00,2019-03-31 09:45:00
168,2,2,0,0.01858171178641006,2019-03-31 09:30:00,2019-03-31 09:45:00
170,5,2,3,0.008026229650226103,2019-03-31 09:30:00,2019-03-31 09:45:00
171,4,1,3,0.004338277456908344,2019-03-31 09:30:00,2019-03-31 09:45:00
172,2,1,1,0.010245323409797112,2019-03-31 09:30:00,2019-03-31 09:45:00
173,1,0,1,0.0031089600591357575,2019-03-31 09:30:00,2019-03-31 09:45:00
177,2,2,0,0.0077853139440838565,2019-03-31 09:30:00,2019-03-31 09:45:00
190,2,2,0,0.005751847857879127,2019-03-31 09:30:00,2019-03-31 09:45:00
191,3,1,2,0.005751847857879127,2019-03-31 09:30:00,2019-03-31 09:45:00
197,3,2,1,0.004870885258298004,2019-03-31 09:30:00,2019-03-31 09:45:00
201,1,0,1,0.0031089600591357575,2019-03-31 09:30:00,2019-03-31 09:45:00
202,4,0,4,0.0031089600591357575,2019-03-31 09:30:00,2019-03-31 09:45:00
203,3,1,2,0.004459602345177879,2019-03-31 09:30:00,2019-03-31 09:45:00
1,4,3,1,0.009729868302265177,2019-03-31 09:45:00,2019-03-31 10:00:00
5,2,0,2,0.002997053938986058,2019-03-31 09:45:00,2019-03-31 10:00:00
10,2,0,2,0.002997053938986058,2019-03-31 09:45:00,2019-03-31 10:00:00
11,2,1,1,0.019952165957713864,2019-03-31 09:45:00,2019-03-31 10:00:00
16,1,0,1,0.002997053938986058,2019-03-31 09:45:00,2019-03-31 10:00:00
18,4,2,2,0.0050937528953200065,2019-03-31 09:45:00,2019-03-31 10:00:00
19,3,2,1,0.010396306052246215,2019-03-31 09:45:00,2019-03-31 10:00:00
20,4,1,3,0.004270946405859564,2019-03-31 09:45:00,2019-03-31 10:00:00
22,1,1,0,0.004270946405859564,2019-03-31 09:45:00,2019-03-31 10:00:00
23,3,3,0,0.018564557430015238,2019-03-31 09:45:00,2019-03-31 10:00:00
26,5,4,1,0.009875115567172825,2019-03-31 09:45:00,2019-03-31 10:00:00
27,4,2,2,0.019952165957713864,2019-03-31 09:45:00,2019-03-31 10:00:00
28,2,0,2,0.002997053938986058,2019-03-31 09:45:00,2019-03-31 10:00:00
37,2,1,1,0.0036340001724228113,2019-03-31 09:45:00,2019-03-31 10:00:00
41,2,2,0,0.00554483887273307,2019-03-31 09:45:00,2019-03-31 10:00:00
46,1,1,0,0.004270946405859564,2019-03-31 09:45:00,2019-03-31 10:00:00
58,2,0,2,0.002997053938986058,2019-03-31 09:45:00,2019-03-31 10:00:00
62,1,0,1,0.002997053938986058,2019-03-31 09:45:00,2019-03-31 10:00:00
66,3,3,0,0.006970786555185713,2019-03-31 09:45:00,2019-03-31 10:00:00
68,1,1,0,0.004754945770671092,2019-03-31 09:45:00,2019-03-31 10:00:00
69,1,1,0,0.004270946405859564,2019-03-31 09:45:00,2019-03-31 10:00:00
71,4,2,2,0.019952165957713864,2019-03-31 09:45:00,2019-03-31 10:00:00
80,2,1,1,0.019952165957713864,2019-03-31 09:45:00,2019-03-31 10:00:00
87,2,1,1,0.019952165957713864,2019-03-31 09:45:00,2019-03-31 10:00:00
88,1,1,0,0.00554483887273307,2019-03-31 09:45:00,2019-03-31 10:00:00
89,1,1,0,0.0037691753565867884,2019-03-31 09:45:00,2019-03-31 10:00:00
90,1,0,1,0.002997053938986058,2019-03-31 09:45:00,2019-03-31 10:00:00
99,1,0,1,0.002997053938986058,2019-03-31 09:45:00,2019-03-31 10:00:00
109,7,2,5,0.004541296774187518,2019-03-31 09:45:00,2019-03-31 10:00:00
110,2,1,1,0.019952165957713864,2019-03-31 09:45:00,2019-03-31 10:00:00
112,1,1,0,0.0038059079987469275,2019-03-31 09:45:00,2019-03-31 10:00:00
114,1,0,1,0.002997053938986058,2019-03-31 09:45:00,2019-03-31 10:00:00
116,3,2,1,0.013816418158384726,2019-03-31 09:45:00,2019-03-31 10:00:00
118,2,0,2,0.002997053938986058,2019-03-31 09:45:00,2019-03-31 10:00:00
119,1,1,0,0.00554483887273307,2019-03-31 09:45:00,2019-03-31 10:00:00
120,5,1,4,0.0038059079987469275,2019-03-31 09:45:00,2019-03-31 10:00:00
122,2,0,2,0.002997053938986058,2019-03-31 09:45:00,2019-03-31 10:00:00
126,2,1,1,0.00554483887273307,2019-03-31 09:45:00,2019-03-31 10:00:00
129,1,0,1,0.002997053938986058,2019-03-31 09:45:00,2019-03-31 10:00:00
135,7,3,4,0.00827072943404116,2019-03-31 09:45:00,2019-03-31 10:00:00
137,4,3,1,0.009271051552457315,2019-03-31 09:45:00,2019-03-31 10:00:00
138,4,3,1,0.05386238999516947,2019-03-31 09:45:00,2019-03-31 10:00:00
140,1,0,1,0.002997053938986058,2019-03-31 09:45:00,2019-03-31 10:00:00
147,1,1,0,0.01139212698078319,2019-03-31 09:45:00,2019-03-31 10:00:00
158,4,0,4,0.002997053938986058,2019-03-31 09:45:00,2019-03-31 10:00:00
159,1,0,1,0.002997053938986058,2019-03-31 09:45:00,2019-03-31 10:00:00
162,2,0,2,0.002997053938986058,2019-03-31 09:45:00,2019-03-31 10:00:00
168,1,1,0,0.010878514266967157,2019-03-31 09:45:00,2019-03-31 10:00:00
170,6,5,1,0.09567492232162444,2019-03-31 09:45:00,2019-03-31 10:00:00
171,2,1,1,0.019952165957713864,2019-03-31 09:45:00,2019-03-31 10:00:00
172,6,3,3,0.009858401281017228,2019-03-31 09:45:00,2019-03-31 10:00:00
177,2,2,0,0.005043067823460295,2019-03-31 09:45:00,2019-03-31 10:00:00
190,2,2,0,0.00554483887273307,2019-03-31 09:45:00,2019-03-31 10:00:00
191,1,1,0,0.00554483887273307,2019-03-31 09:45:00,2019-03-31 10:00:00
197,3,2,1,0.0054175525782047046,2019-03-31 09:45:00,2019-03-31 10:00:00
201,1,0,1,0.002997053938986058,2019-03-31 09:45:00,2019-03-31 10:00:00
202,5,1,4,0.006232470178029535,2019-03-31 09:45:00,2019-03-31 10:00:00
203,2,1,1,0.0038059079987469275,2019-03-31 09:45:00,2019-03-31 10:00:00
1,1,1,0,0.008904232309482906,2019-03-31 10:00:00,2019-03-31 10:15:00
2,3,1,2,0.004278735435731731,2019-03-31 10:00:00,2019-03-31 10:15:00
5,2,0,2,0.0033693991520855537,2019-03-31 10:00:00,2019-03-31 10:15:00
10,5,1,4,0.007390370064973641,2019-03-31 10:00:00,2019-03-31 10:15:00
11,1,0,1,0.0033693991520855537,2019-03-31 10:00:00,2019-03-31 10:15:00
13,1,1,0,0.004801549065824572,2019-03-31 10:00:00,2019-03-31 10:15:00
16,2,0,2,0.0033693991520855537,2019-03-31 10:00:00,2019-03-31 10:15:00
18,5,3,2,0.011889584178928722,2019-03-31 10:00:00,2019-03-31 10:15:00
19,3,2,1,0.006510709148168102,2019-03-31 10:00:00,2019-03-31 10:15:00
20,4,1,3,0.004801549065824572,2019-03-31 10:00:00,2019-03-31 10:15:00
21,3,0,3,0.0033693991520855537,2019-03-31 10:00:00,2019-03-31 10:15:00
22,3,3,0,0.006711082284143262,2019-03-31 10:00:00,2019-03-31 10:15:00
23,2,2,0,0.008052371546855943,2019-03-31 10:00:00,2019-03-31 10:15:00
26,5,4,1,0.0177733507792425,2019-03-31 10:00:00,2019-03-31 10:15:00
27,4,2,2,0.022413945420982108,2019-03-31 10:00:00,2019-03-31 10:15:00
28,1,0,1,0.0033693991520855537,2019-03-31 10:00:00,2019-03-31 10:15:00
37,1,0,1,0.0033693991520855537,2019-03-31 10:00:00,2019-03-31 10:15:00
40,1,1,0,0.005188071719377907,2019-03-31 10:00:00,2019-03-31 10:15:00
41,2,1,1,0.004729995527791287,2019-03-31 10:00:00,2019-03-31 10:15:00
46,1,1,0,0.006233698979563589,2019-03-31 10:00:00,2019-03-31 10:15:00
62,1,0,1,0.0033693991520855537,2019-03-31 10:00:00,2019-03-31 10:15:00
67,3,3,0,0.007566008381779406,2019-03-31 10:00:00,2019-03-31 10:15:00
68,1,1,0,0.006233698979563589,2019-03-31 10:00:00,2019-03-31 10:15:00
69,1,1,0,0.004701708554301369,2019-03-31 10:00:00,2019-03-31 10:15:00
71,4,2,2,0.022413945420982108,2019-03-31 10:00:00,2019-03-31 10:15:00
80,1,1,0,0.006233698979563589,2019-03-31 10:00:00,2019-03-31 10:15:00
85,1,1,0,0.005188071719377907,2019-03-31 10:00:00,2019-03-31 10:15:00
88,1,1,0,0.004278735435731731,2019-03-31 10:00:00,2019-03-31 10:15:00
89,1,0,1,0.0033693991520855537,2019-03-31 10:00:00,2019-03-31 10:15:00
109,6,2,4,0.0058603886674330665,2019-03-31 10:00:00,2019-03-31 10:15:00
110,2,1,1,0.022413945420982108,2019-03-31 10:00:00,2019-03-31 10:15:00
111,1,1,0,0.006233698979563589,2019-03-31 10:00:00,2019-03-31 10:15:00
114,3,2,1,0.0058603886674330665,2019-03-31 10:00:00,2019-03-31 10:15:00
116,1,1,0,0.004801549065824572,2019-03-31 10:00:00,2019-03-31 10:15:00
118,4,1,3,0.004701708554301369,2019-03-31 10:00:00,2019-03-31 10:15:00
120,1,0,1,0.0033693991520855537,2019-03-31 10:00:00,2019-03-31 10:15:00
122,3,1,2,0.004278735435731731,2019-03-31 10:00:00,2019-03-31 10:15:00
129,5,1,4,0.004278735435731731,2019-03-31 10:00:00,2019-03-31 10:15:00
135,1,0,1,0.0033693991520855537,2019-03-31 10:00:00,2019-03-31 10:15:00
137,2,1,1,0.006233698979563589,2019-03-31 10:00:00,2019-03-31 10:15:00
138,4,3,1,0.07456560519697675,2019-03-31 10:00:00,2019-03-31 10:15:00
147,2,2,0,0.019433723023683416,2019-03-31 10:00:00,2019-03-31 10:15:00
154,1,0,1,0.0033693991520855537,2019-03-31 10:00:00,2019-03-31 10:15:00
157,2,1,1,0.005188071719377907,2019-03-31 10:00:00,2019-03-31 10:15:00
159,1,0,1,0.0033693991520855537,2019-03-31 10:00:00,2019-03-31 10:15:00
162,2,0,2,0.0033693991520855537,2019-03-31 10:00:00,2019-03-31 10:15:00
168,1,1,0,0.008668677578841918,2019-03-31 10:00:00,2019-03-31 10:15:00
170,3,2,1,0.05919338923333007,2019-03-31 10:00:00,2019-03-31 10:15:00
171,2,0,2,0.0033693991520855537,2019-03-31 10:00:00,2019-03-31 10:15:00
172,6,2,4,0.0058603886674330665,2019-03-31 10:00:00,2019-03-31 10:15:00
177,2,2,0,0.006047043823498328,2019-03-31 10:00:00,2019-03-31 10:15:00
190,3,2,1,0.006510709148168102,2019-03-31 10:00:00,2019-03-31 10:15:00
191,1,0,1,0.0033693991520855537,2019-03-31 10:00:00,2019-03-31 10:15:00
197,2,2,0,0.0060905919034970205,2019-03-31 10:00:00,2019-03-31 10:15:00
202,1,1,0,0.008668677578841918,2019-03-31 10:00:00,2019-03-31 10:15:00
203,2,1,1,0.006233698979563589,2019-03-31 10:00:00,2019-03-31 10:15:00
1,3,3,0,0.011411941274812279,2019-03-31 10:15:00,2019-03-31 10:30:00
2,3,1,2,0.006526524463425656,2019-03-31 10:15:00,2019-03-31 10:30:00
5,3,2,1,0.008884763856910031,2019-03-31 10:15:00,2019-03-31 10:30:00
10,6,1,5,0.006526524463425656,2019-03-31 10:15:00,2019-03-31 10:30:00
13,1,1,0,0.005027111815126094,2019-03-31 10:15:00,2019-03-31 10:30:00
16,2,0,2,0.0035276991668265318,2019-03-31 10:15:00,2019-03-31 10:30:00
18,2,0,2,0.0035276991668265318,2019-03-31 10:15:00,2019-03-31 10:30:00
19,5,2,3,0.0057469448848113305,2019-03-31 10:15:00,2019-03-31 10:30:00
20,2,0,2,0.0035276991668265318,2019-03-31 10:15:00,2019-03-31 10:30:00
21,1,0,1,0.0035276991668265318,2019-03-31 10:15:00,2019-03-31 10:30:00
22,1,1,0,0.005027111815126094,2019-03-31 10:15:00,2019-03-31 10:30:00
26,4,3,1,0.014079439783046323,2019-03-31 10:15:00,2019-03-31 10:30:00
27,4,2,2,0.02343681433978076,2019-03-31 10:15:00,2019-03-31 10:30:00
30,1,0,1,0.0035276991668265318,2019-03-31 10:15:00,2019-03-31 10:30:00
37,1,0,1,0.0035276991668265318,2019-03-31 10:15:00,2019-03-31 10:30:00
40,1,1,0,0.006526524463425656,2019-03-31 10:15:00,2019-03-31 10:30:00
41,1,0,1,0.0035276991668265318,2019-03-31 10:15:00,2019-03-31 10:30:00
46,1,1,0,0.006526524463425656,2019-03-31 10:15:00,2019-03-31 10:30:00
50,1,0,1,0.0035276991668265318,2019-03-31 10:15:00,2019-03-31 10:30:00
57,2,1,1,0.02343681433978076,2019-03-31 10:15:00,2019-03-31 10:30:00
61,1,0,1,0.0035276991668265318,2019-03-31 10:15:00,2019-03-31 10:30:00
67,3,3,0,0.00952534976002478,2019-03-31 10:15:00,2019-03-31 10:30:00
71,4,2,2,0.02343681433978076,2019-03-31 10:15:00,2019-03-31 10:30:00
75,1,0,1,0.0035276991668265318,2019-03-31 10:15:00,2019-03-31 10:30:00
85,1,1,0,0.00630175631430753,2019-03-31 10:15:00,2019-03-31 10:30:00
86,3,1,2,0.006135629252677151,2019-03-31 10:15:00,2019-03-31 10:30:00
89,1,0,1,0.0035276991668265318,2019-03-31 10:15:00,2019-03-31 10:30:00
90,1,0,1,0.0035276991668265318,2019-03-31 10:15:00,2019-03-31 10:30:00
99,2,2,0,0.006526524463425656,2019-03-31 10:15:00,2019-03-31 10:30:00
106,1,0,1,0.0035276991668265318,2019-03-31 10:15:00,2019-03-31 10:30:00
109,3,1,2,0.006135629252677151,2019-03-31 10:15:00,2019-03-31 10:30:00
110,3,1,2,0.006135629252677151,2019-03-31 10:15:00,2019-03-31 10:30:00
111,1,1,0,0.006526524463425656,2019-03-31 10:15:00,2019-03-31 10:30:00
112,3,2,1,0.008204421206368013,2019-03-31 10:15:00,2019-03-31 10:30:00
114,2,0,2,0.0035276991668265318,2019-03-31 10:15:00,2019-03-31 10:30:00
116,2,2,0,0.012001752826215439,2019-03-31 10:15:00,2019-03-31 10:30:00
118,2,1,1,0.02343681433978076,2019-03-31 10:15:00,2019-03-31 10:30:00
120,1,0,1,0.0035276991668265318,2019-03-31 10:15:00,2019-03-31 10:30:00
122,1,0,1,0.0035276991668265318,2019-03-31 10:15:00,2019-03-31 10:30:00
126,2,0,2,0.0035276991668265318,2019-03-31 10:15:00,2019-03-31 10:30:00
129,1,0,1,0.0035276991668265318,2019-03-31 10:15:00,2019-03-31 10:30:00
133,1,1,0,0.006526524463425656,2019-03-31 10:15:00,2019-03-31 10:30:00
137,4,3,1,0.0121332798458754,2019-03-31 10:15:00,2019-03-31 10:30:00
138,2,1,1,0.02343681433978076,2019-03-31 10:15:00,2019-03-31 10:30:00
147,2,2,0,0.018495502837620713,2019-03-31 10:15:00,2019-03-31 10:30:00
153,1,1,0,0.006526524463425656,2019-03-31 10:15:00,2019-03-31 10:30:00
154,1,0,1,0.0035276991668265318,2019-03-31 10:15:00,2019-03-31 10:30:00
157,3,1,2,0.00630175631430753,2019-03-31 10:15:00,2019-03-31 10:30:00
162,2,0,2,0.0035276991668265318,2019-03-31 10:15:00,2019-03-31 10:30:00
164,1,1,0,0.005156171437288739,2019-03-31 10:15:00,2019-03-31 10:30:00
168,2,2,0,0.016840962631852634,2019-03-31 10:15:00,2019-03-31 10:30:00
169,2,2,0,0.006784643707750948,2019-03-31 10:15:00,2019-03-31 10:30:00
170,2,1,1,0.02343681433978076,2019-03-31 10:15:00,2019-03-31 10:30:00
171,2,0,2,0.0035276991668265318,2019-03-31 10:15:00,2019-03-31 10:30:00
172,7,3,4,0.009734075027899115,2019-03-31 10:15:00,2019-03-31 10:30:00
177,5,3,2,0.008744664759969113,2019-03-31 10:15:00,2019-03-31 10:30:00
190,3,2,1,0.0057469448848113305,2019-03-31 10:15:00,2019-03-31 10:30:00
197,4,4,0,0.01396032489170208,2019-03-31 10:15:00,2019-03-31 10:30:00
199,1,1,0,0.006526524463425656,2019-03-31 10:15:00,2019-03-31 10:30:00
203,1,1,0,0.006526524463425656,2019-03-31 10:15:00,2019-03-31 10:30:00
1,2,2,0,0.01337268338780476,2019-03-31 10:30:00,2019-03-31 10:45:00
2,2,0,2,0.003256951344853495,2019-03-31 10:30:00,2019-03-31 10:45:00
5,3,2,1,0.0072024947214309396,2019-03-31 10:30:00,2019-03-31 10:45:00
10,5,0,5,0.003256951344853495,2019-03-31 10:30:00,2019-03-31 10:45:00
13,2,2,0,0.006319860310151363,2019-03-31 10:30:00,2019-03-31 10:45:00
16,3,1,2,0.00394912571857133,2019-03-31 10:30:00,2019-03-31 10:45:00
18,2,0,2,0.003256951344853495,2019-03-31 10:30:00,2019-03-31 10:45:00
19,7,3,4,0.00948681960108558,2019-03-31 10:30:00,2019-03-31 10:45:00
20,3,0,3,0.003256951344853495,2019-03-31 10:30:00,2019-03-31 10:45:00
23,1,0,1,0.003256951344853495,2019-03-31 10:30:00,2019-03-31 10:45:00
26,7,4,3,0.01390825851850274,2019-03-31 10:30:00,2019-03-31 10:45:00
27,4,2,2,0.021657610392327765,2019-03-31 10:30:00,2019-03-31 10:45:00
30,1,0,1,0.003256951344853495,2019-03-31 10:30:00,2019-03-31 10:45:00
37,2,0,2,0.003256951344853495,2019-03-31 10:30:00,2019-03-31 10:45:00
46,1,1,0,0.006700780385274845,2019-03-31 10:30:00,2019-03-31 10:45:00
50,2,0,2,0.003256951344853495,2019-03-31 10:30:00,2019-03-31 10:45:00
57,2,1,1,0.006025648839724838,2019-03-31 10:30:00,2019-03-31 10:45:00
61,1,0,1,0.003256951344853495,2019-03-31 10:30:00,2019-03-31 10:45:00
67,3,3,0,0.006025648839724838,2019-03-31 10:30:00,2019-03-31 10:45:00
68,1,0,1,0.003256951344853495,2019-03-31 10:30:00,2019-03-31 10:45:00
69,1,1,0,0.0073516438018084015,2019-03-31 10:30:00,2019-03-31 10:45:00
70,1,0,1,0.003256951344853495,2019-03-31 10:30:00,2019-03-31 10:45:00
71,4,2,2,0.021657610392327765,2019-03-31 10:30:00,2019-03-31 10:45:00
75,1,0,1,0.003256951344853495,2019-03-31 10:30:00,2019-03-31 10:45:00
85,1,1,0,0.004641300092289167,2019-03-31 10:30:00,2019-03-31 10:45:00
86,1,0,1,0.003256951344853495,2019-03-31 10:30:00,2019-03-31 10:45:00
90,4,0,4,0.003256951344853495,2019-03-31 10:30:00,2019-03-31 10:45:00
99,2,2,0,0.01626270674198459,2019-03-31 10:30:00,2019-03-31 10:45:00
104,1,0,1,0.003256951344853495,2019-03-31 10:30:00,2019-03-31 10:45:00
106,3,0,3,0.003256951344853495,2019-03-31 10:30:00,2019-03-31 10:45:00
109,3,2,1,0.02625777515419633,2019-03-31 10:30:00,2019-03-31 10:45:00
110,3,1,2,0.00773968463539422,2019-03-31 10:30:00,2019-03-31 10:45:00
111,2,2,0,0.009836543152655086,2019-03-31 10:30:00,2019-03-31 10:45:00
112,5,3,2,0.009633407390456074,2019-03-31 10:30:00,2019-03-31 10:45:00
114,3,1,2,0.015298578056438465,2019-03-31 10:30:00,2019-03-31 10:45:00
116,2,2,0,0.009030204019670598,2019-03-31 10:30:00,2019-03-31 10:45:00
118,2,1,1,0.021657610392327765,2019-03-31 10:30:00,2019-03-31 10:45:00
119,4,2,2,0.021657610392327765,2019-03-31 10:30:00,2019-03-31 10:45:00
120,1,0,1,0.003256951344853495,2019-03-31 10:30:00,2019-03-31 10:45:00
126,2,1,1,0.021657610392327765,2019-03-31 10:30:00,2019-03-31 10:45:00
127,1,1,0,0.004641300092289167,2019-03-31 10:30:00,2019-03-31 10:45:00
133,1,1,0,0.004641300092289167,2019-03-31 10:30:00,2019-03-31 10:45:00
137,5,3,2,0.008102171960878346,2019-03-31 10:30:00,2019-03-31 10:45:00
138,3,2,1,0.04005826943980203,2019-03-31 10:30:00,2019-03-31 10:45:00
147,1,1,0,0.007198256184242446,2019-03-31 10:30:00,2019-03-31 10:45:00
153,4,3,1,0.009717245499553296,2019-03-31 10:30:00,2019-03-31 10:45:00
157,3,1,2,0.004641300092289167,2019-03-31 10:30:00,2019-03-31 10:45:00
158,2,1,1,0.005273154656254914,2019-03-31 10:30:00,2019-03-31 10:45:00
162,2,0,2,0.003256951344853495,2019-03-31 10:30:00,2019-03-31 10:45:00
164,4,3,1,0.014164715050388424,2019-03-31 10:30:00,2019-03-31 10:45:00
168,2,2,0,0.0073929547589926805,2019-03-31 10:30:00,2019-03-31 10:45:00
169,2,2,0,0.007289357967656332,2019-03-31 10:30:00,2019-03-31 10:45:00
170,2,1,1,0.021657610392327765,2019-03-31 10:30:00,2019-03-31 10:45:00
171,1,1,0,0.004641300092289167,2019-03-31 10:30:00,2019-03-31 10:45:00
172,7,2,5,0.004935073456573282,2019-03-31 10:30:00,2019-03-31 10:45:00
173,1,0,1,0.003256951344853495,2019-03-31 10:30:00,2019-03-31 10:45:00
177,4,2,2,0.005195039591263435,2019-03-31 10:30:00,2019-03-31 10:45:00
190,4,2,2,0.004364430342802032,2019-03-31 10:30:00,2019-03-31 10:45:00
191,2,2,0,0.004935073456573282,2019-03-31 10:30:00,2019-03-31 10:45:00
195,1,0,1,0.003256951344853495,2019-03-31 10:30:00,2019-03-31 10:45:00
197,4,4,0,0.00951903140402761,2019-03-31 10:30:00,2019-03-31 10:45:00
199,3,3,0,0.010649433434714294,2019-03-31 10:30:00,2019-03-31 10:45:00
203,1,1,0,0.006025648839724838,2019-03-31 10:30:00,2019-03-31 10:45:00
1,3,2,1,0.007493074827953291,2019-03-31 10:45:00,2019-03-31 11:00:00
5,11,5,6,0.011013531431948963,2019-03-31 10:45:00,2019-03-31 11:00:00
13,2,2,0,0.0071786717065912015,2019-03-31 10:45:00,2019-03-31 11:00:00
16,3,1,2,0.004212497929110959,2019-03-31 10:45:00,2019-03-31 11:00:00
18,3,1,2,0.005388149605030176,2019-03-31 10:45:00,2019-03-31 11:00:00
19,9,3,6,0.006801473614485191,2019-03-31 10:45:00,2019-03-31 11:00:00
20,4,0,4,0.002912384734823806,2019-03-31 10:45:00,2019-03-31 11:00:00
21,1,1,0,0.005980636928990568,2019-03-31 10:45:00,2019-03-31 11:00:00
23,2,0,2,0.002912384734823806,2019-03-31 10:45:00,2019-03-31 11:00:00
26,9,5,4,0.02067705531228136,2019-03-31 10:45:00,2019-03-31 11:00:00
27,2,1,1,0.019383676202402587,2019-03-31 10:45:00,2019-03-31 11:00:00
28,1,0,1,0.002912384734823806,2019-03-31 10:45:00,2019-03-31 11:00:00
30,1,0,1,0.002912384734823806,2019-03-31 10:45:00,2019-03-31 11:00:00
37,2,0,2,0.002912384734823806,2019-03-31 10:45:00,2019-03-31 11:00:00
40,1,0,1,0.002912384734823806,2019-03-31 10:45:00,2019-03-31 11:00:00
46,1,1,0,0.004789964547739283,2019-03-31 10:45:00,2019-03-31 11:00:00
50,1,0,1,0.002912384734823806,2019-03-31 10:45:00,2019-03-31 11:00:00
57,3,1,2,0.006440474461210197,2019-03-31 10:45:00,2019-03-31 11:00:00
58,5,2,3,0.006722106080330132,2019-03-31 10:45:00,2019-03-31 11:00:00
61,3,1,2,0.009282302594022398,2019-03-31 10:45:00,2019-03-31 11:00:00
67,6,3,3,0.005388149605030176,2019-03-31 10:45:00,2019-03-31 11:00:00
68,2,0,2,0.002912384734823806,2019-03-31 10:45:00,2019-03-31 11:00:00
69,1,1,0,0.009702943400885658,2019-03-31 10:45:00,2019-03-31 11:00:00
70,1,0,1,0.002912384734823806,2019-03-31 10:45:00,2019-03-31 11:00:00
75,1,0,1,0.002912384734823806,2019-03-31 10:45:00,2019-03-31 11:00:00
87,1,0,1,0.002912384734823806,2019-03-31 10:45:00,2019-03-31 11:00:00
90,6,2,4,0.006117358601864122,2019-03-31 10:45:00,2019-03-31 11:00:00
99,6,4,2,0.025972192789434096,2019-03-31 10:45:00,2019-03-31 11:00:00
106,3,0,3,0.002912384734823806,2019-03-31 10:45:00,2019-03-31 11:00:00
109,10,4,6,0.0073268535587961425,2019-03-31 10:45:00,2019-03-31 11:00:00
110,2,2,0,0.010321602304269168,2019-03-31 10:45:00,2019-03-31 11:00:00
111,1,0,1,0.002912384734823806,2019-03-31 10:45:00,2019-03-31 11:00:00
112,5,4,1,0.00798795229143149,2019-03-31 10:45:00,2019-03-31 11:00:00
113,1,1,0,0.00564989556136287,2019-03-31 10:45:00,2019-03-31 11:00:00
114,5,0,5,0.002912384734823806,2019-03-31 10:45:00,2019-03-31 11:00:00
116,1,1,0,0.004702906836384831,2019-03-31 10:45:00,2019-03-31 11:00:00
118,4,2,2,0.007218519364093753,2019-03-31 10:45:00,2019-03-31 11:00:00
119,11,7,4,0.0553453203529244,2019-03-31 10:45:00,2019-03-31 11:00:00
120,2,1,1,0.006122297663490761,2019-03-31 10:45:00,2019-03-31 11:00:00
122,1,0,1,0.002912384734823806,2019-03-31 10:45:00,2019-03-31 11:00:00
126,1,0,1,0.002912384734823806,2019-03-31 10:45:00,2019-03-31 11:00:00
127,4,4,0,0.007264622799612175,2019-03-31 10:45:00,2019-03-31 11:00:00
129,1,1,0,0.005388149605030176,2019-03-31 10:45:00,2019-03-31 11:00:00
137,5,2,3,0.006626032040133361,2019-03-31 10:45:00,2019-03-31 11:00:00
138,6,5,1,0.0852688420727177,2019-03-31 10:45:00,2019-03-31 11:00:00
141,1,0,1,0.002912384734823806,2019-03-31 10:45:00,2019-03-31 11:00:00
147,1,1,0,0.0073071367331208545,2019-03-31 10:45:00,2019-03-31 11:00:00
153,6,4,2,0.007864439558484246,2019-03-31 10:45:00,2019-03-31 11:00:00
157,5,2,3,0.006033464791043492,2019-03-31 10:45:00,2019-03-31 11:00:00
158,4,3,1,0.005803356132326425,2019-03-31 10:45:00,2019-03-31 11:00:00
162,2,0,2,0.002912384734823806,2019-03-31 10:45:00,2019-03-31 11:00:00
164,2,2,0,0.0057108071980368335,2019-03-31 10:45:00,2019-03-31 11:00:00
168,5,3,2,0.031871869990281715,2019-03-31 10:45:00,2019-03-31 11:00:00
169,3,3,0,0.007315463870031923,2019-03-31 10:45:00,2019-03-31 11:00:00
170,2,1,1,0.019383676202402587,2019-03-31 10:45:00,2019-03-31 11:00:00
171,1,1,0,0.004150267169926991,2019-03-31 10:45:00,2019-03-31 11:00:00
172,8,2,6,0.004063962787946127,2019-03-31 10:45:00,2019-03-31 11:00:00
173,2,1,1,0.004150267169926991,2019-03-31 10:45:00,2019-03-31 11:00:00
177,3,1,2,0.004150267169926991,2019-03-31 10:45:00,2019-03-31 11:00:00
189,3,3,0,0.007799841048424249,2019-03-31 10:45:00,2019-03-31 11:00:00
190,2,0,2,0.002912384734823806,2019-03-31 10:45:00,2019-03-31 11:00:00
191,4,4,0,0.010359570861611617,2019-03-31 10:45:00,2019-03-31 11:00:00
196,2,2,0,0.010803423749501067,2019-03-31 10:45:00,2019-03-31 11:00:00
197,7,5,2,0.013355023752427279,2019-03-31 10:45:00,2019-03-31 11:00:00
199,2,2,0,0.006626032040133361,2019-03-31 10:45:00,2019-03-31 11:00:00
203,5,2,3,0.011327087582727702,2019-03-31 10:45:00,2019-03-31 11:00:00
1,5,2,3,0.005337177518216382,2019-03-31 11:00:00,2019-03-31 11:15:00
2,1,1,0,0.0028038041440281588,2019-03-31 11:00:00,2019-03-31 11:15:00
5,7,3,4,0.010347173564915504,2019-03-31 11:00:00,2019-03-31 11:15:00
13,2,2,0,0.005260900776826286,2019-03-31 11:00:00,2019-03-31 11:15:00
15,2,0,2,0.002312384817468533,2019-03-31 11:00:00,2019-03-31 11:15:00
16,2,0,2,0.002312384817468533,2019-03-31 11:00:00,2019-03-31 11:15:00
18,3,1,2,0.006286542647529933,2019-03-31 11:00:00,2019-03-31 11:15:00
19,7,3,4,0.013106867448247994,2019-03-31 11:00:00,2019-03-31 11:15:00
20,3,0,3,0.002312384817468533,2019-03-31 11:00:00,2019-03-31 11:15:00
26,8,4,4,0.013320523655514864,2019-03-31 11:00:00,2019-03-31 11:15:00
28,2,1,1,0.005143964856110839,2019-03-31 11:00:00,2019-03-31 11:15:00
30,1,0,1,0.002312384817468533,2019-03-31 11:00:00,2019-03-31 11:15:00
35,3,1,2,0.004021833868886244,2019-03-31 11:00:00,2019-03-31 11:15:00
37,2,1,1,0.009997774745462321,2019-03-31 11:00:00,2019-03-31 11:15:00
40,1,0,1,0.002312384817468533,2019-03-31 11:00:00,2019-03-31 11:15:00
41,1,0,1,0.002312384817468533,2019-03-31 11:00:00,2019-03-31 11:15:00
50,1,0,1,0.002312384817468533,2019-03-31 11:00:00,2019-03-31 11:15:00
57,2,1,1,0.01068562761617567,2019-03-31 11:00:00,2019-03-31 11:15:00
58,3,1,2,0.004021833868886244,2019-03-31 11:00:00,2019-03-31 11:15:00
61,3,1,2,0.003824781167842458,2019-03-31 11:00:00,2019-03-31 11:15:00
66,2,0,2,0.002312384817468533,2019-03-31 11:00:00,2019-03-31 11:15:00
67,3,0,3,0.002312384817468533,2019-03-31 11:00:00,2019-03-31 11:15:00
68,3,0,3,0.002312384817468533,2019-03-31 11:00:00,2019-03-31 11:15:00
74,2,2,0,0.003622836354960868,2019-03-31 11:00:00,2019-03-31 11:15:00
75,1,0,1,0.002312384817468533,2019-03-31 11:00:00,2019-03-31 11:15:00
87,1,0,1,0.002312384817468533,2019-03-31 11:00:00,2019-03-31 11:15:00
88,1,1,0,0.004278062123707035,2019-03-31 11:00:00,2019-03-31 11:15:00
90,4,2,2,0.006995161141228577,2019-03-31 11:00:00,2019-03-31 11:15:00
99,4,2,2,0.01540701693536094,2019-03-31 11:00:00,2019-03-31 11:15:00
106,1,1,0,0.0059490551307389075,2019-03-31 11:00:00,2019-03-31 11:15:00
109,6,2,4,0.005084525398575708,2019-03-31 11:00:00,2019-03-31 11:15:00
111,1,0,1,0.002312384817468533,2019-03-31 11:00:00,2019-03-31 11:15:00
112,4,3,1,0.004278062123707035,2019-03-31 11:00:00,2019-03-31 11:15:00
114,6,4,2,0.00791473243697741,2019-03-31 11:00:00,2019-03-31 11:15:00
115,1,1,0,0.004021833868886244,2019-03-31 11:00:00,2019-03-31 11:15:00
116,1,1,0,0.003295223470587784,2019-03-31 11:00:00,2019-03-31 11:15:00
118,3,2,1,0.01977189430799175,2019-03-31 11:00:00,2019-03-31 11:15:00
119,9,5,4,0.019796869855213978,2019-03-31 11:00:00,2019-03-31 11:15:00
120,4,0,4,0.002312384817468533,2019-03-31 11:00:00,2019-03-31 11:15:00
122,1,0,1,0.002312384817468533,2019-03-31 11:00:00,2019-03-31 11:15:00
126,5,2,3,0.005969623962466952,2019-03-31 11:00:00,2019-03-31 11:15:00
127,5,5,0,0.00751979835074881,2019-03-31 11:00:00,2019-03-31 11:15:00
129,2,1,1,0.004278062123707035,2019-03-31 11:00:00,2019-03-31 11:15:00
137,6,3,3,0.024825790795261645,2019-03-31 11:00:00,2019-03-31 11:15:00
138,5,5,0,0.01230889647946396,2019-03-31 11:00:00,2019-03-31 11:15:00
140,1,0,1,0.002312384817468533,2019-03-31 11:00:00,2019-03-31 11:15:00
141,3,1,2,0.00934827615119886,2019-03-31 11:00:00,2019-03-31 11:15:00
147,1,1,0,0.005143964856110839,2019-03-31 11:00:00,2019-03-31 11:15:00
153,3,2,1,0.009040578597239292,2019-03-31 11:00:00,2019-03-31 11:15:00
157,4,3,1,0.008676180557883632,2019-03-31 11:00:00,2019-03-31 11:15:00
158,8,7,1,0.12310316997506882,2019-03-31 11:00:00,2019-03-31 11:15:00
162,2,0,2,0.002312384817468533,2019-03-31 11:00:00,2019-03-31 11:15:00
164,3,1,2,0.004021833868886244,2019-03-31 11:00:00,2019-03-31 11:15:00
168,7,5,2,0.12690991649740274,2019-03-31 11:00:00,2019-03-31 11:15:00
169,5,4,1,0.014170272401885406,2019-03-31 11:00:00,2019-03-31 11:15:00
170,2,1,1,0.01540701693536094,2019-03-31 11:00:00,2019-03-31 11:15:00
172,6,2,4,0.004021833868886244,2019-03-31 11:00:00,2019-03-31 11:15:00
173,7,3,4,0.006380911640265675,2019-03-31 11:00:00,2019-03-31 11:15:00
177,4,2,2,0.007571127530227659,2019-03-31 11:00:00,2019-03-31 11:15:00
189,5,3,2,0.019697309832425878,2019-03-31 11:00:00,2019-03-31 11:15:00
190,1,0,1,0.002312384817468533,2019-03-31 11:00:00,2019-03-31 11:15:00
191,6,3,3,0.009209191952093077,2019-03-31 11:00:00,2019-03-31 11:15:00
196,2,2,0,0.005563817996148671,2019-03-31 11:00:00,2019-03-31 11:15:00
197,6,4,2,0.010059309739827455,2019-03-31 11:00:00,2019-03-31 11:15:00
199,2,1,1,0.004278062123707035,2019-03-31 11:00:00,2019-03-31 11:15:00
203,4,2,2,0.004876558394595099,2019-03-31 11:00:00,2019-03-31 11:15:00
2,1,1,0,0.0033328407520088633,2019-03-31 11:15:00,2019-03-31 11:30:00
5,5,3,2,0.035077334810615056,2019-03-31 11:15:00,2019-03-31 11:30:00
13,3,3,0,0.005596831054685098,2019-03-31 11:15:00,2019-03-31 11:30:00
15,1,0,1,0.0028485366611587268,2019-03-31 11:15:00,2019-03-31 11:30:00
16,1,0,1,0.0028485366611587268,2019-03-31 11:15:00,2019-03-31 11:30:00
18,2,0,2,0.0028485366611587268,2019-03-31 11:15:00,2019-03-31 11:30:00
19,1,0,1,0.0028485366611587268,2019-03-31 11:15:00,2019-03-31 11:30:00
23,3,3,0,0.01295695961810769,2019-03-31 11:15:00,2019-03-31 11:30:00
26,7,4,3,0.01216456360800059,2019-03-31 11:15:00,2019-03-31 11:30:00
28,1,1,0,0.0039748928674845346,2019-03-31 11:15:00,2019-03-31 11:30:00
30,4,1,3,0.0039748928674845346,2019-03-31 11:15:00,2019-03-31 11:30:00
35,3,1,2,0.004954468228127983,2019-03-31 11:15:00,2019-03-31 11:30:00
37,1,1,0,0.004059296888284068,2019-03-31 11:15:00,2019-03-31 11:30:00
41,3,1,2,0.004059296888284068,2019-03-31 11:15:00,2019-03-31 11:30:00
50,2,0,2,0.0028485366611587268,2019-03-31 11:15:00,2019-03-31 11:30:00
57,1,1,0,0.004059296888284068,2019-03-31 11:15:00,2019-03-31 11:30:00
58,1,0,1,0.0028485366611587268,2019-03-31 11:15:00,2019-03-31 11:30:00
61,2,0,2,0.0028485366611587268,2019-03-31 11:15:00,2019-03-31 11:30:00
67,9,3,6,0.004954468228127983,2019-03-31 11:15:00,2019-03-31 11:30:00
68,4,2,2,0.007016345403263827,2019-03-31 11:15:00,2019-03-31 11:30:00
69,1,0,1,0.0028485366611587268,2019-03-31 11:15:00,2019-03-31 11:30:00
74,6,6,0,0.013340746935499744,2019-03-31 11:15:00,2019-03-31 11:30:00
75,2,1,1,0.007431260115786783,2019-03-31 11:15:00,2019-03-31 11:30:00
87,4,4,0,0.009942693223331498,2019-03-31 11:15:00,2019-03-31 11:30:00
88,1,1,0,0.005270057115409409,2019-03-31 11:15:00,2019-03-31 11:30:00
90,7,2,5,0.004316243626364152,2019-03-31 11:15:00,2019-03-31 11:30:00
99,4,2,2,0.018962935735886893,2019-03-31 11:15:00,2019-03-31 11:30:00
106,1,1,0,0.005270057115409409,2019-03-31 11:15:00,2019-03-31 11:30:00
109,3,2,1,0.04634607446334928,2019-03-31 11:15:00,2019-03-31 11:30:00
111,1,0,1,0.0028485366611587268,2019-03-31 11:15:00,2019-03-31 11:30:00
112,1,0,1,0.0028485366611587268,2019-03-31 11:15:00,2019-03-31 11:30:00
113,1,1,0,0.0035823901437614394,2019-03-31 11:15:00,2019-03-31 11:30:00
114,9,5,4,0.010851076615641901,2019-03-31 11:15:00,2019-03-31 11:30:00
115,2,2,0,0.00543877231897812,2019-03-31 11:15:00,2019-03-31 11:30:00
116,4,3,1,0.009882468433941628,2019-03-31 11:15:00,2019-03-31 11:30:00
118,5,2,3,0.00735396148646196,2019-03-31 11:15:00,2019-03-31 11:30:00
119,6,3,3,0.009527442815782714,2019-03-31 11:15:00,2019-03-31 11:30:00
120,5,0,5,0.0028485366611587268,2019-03-31 11:15:00,2019-03-31 11:30:00
122,1,0,1,0.0028485366611587268,2019-03-31 11:15:00,2019-03-31 11:30:00
126,7,4,3,0.014540635393391415,2019-03-31 11:15:00,2019-03-31 11:30:00
129,1,0,1,0.0028485366611587268,2019-03-31 11:15:00,2019-03-31 11:30:00
137,6,3,3,0.016170704282563383,2019-03-31 11:15:00,2019-03-31 11:30:00
138,5,2,3,0.015698761159346264,2019-03-31 11:15:00,2019-03-31 11:30:00
140,1,0,1,0.0028485366611587268,2019-03-31 11:15:00,2019-03-31 11:30:00
141,1,0,1,0.0028485366611587268,2019-03-31 11:15:00,2019-03-31 11:30:00
147,1,1,0,0.006295789907454316,2019-03-31 11:15:00,2019-03-31 11:30:00
153,2,0,2,0.0028485366611587268,2019-03-31 11:15:00,2019-03-31 11:30:00
157,2,1,1,0.018962935735886893,2019-03-31 11:15:00,2019-03-31 11:30:00
158,7,3,4,0.007328630874881179,2019-03-31 11:15:00,2019-03-31 11:30:00
162,5,1,4,0.0036173037443592414,2019-03-31 11:15:00,2019-03-31 11:30:00
164,3,1,2,0.004954468228127983,2019-03-31 11:15:00,2019-03-31 11:30:00
168,3,3,0,0.011063540797162808,2019-03-31 11:15:00,2019-03-31 11:30:00
169,10,8,2,0.09476055135860764,2019-03-31 11:15:00,2019-03-31 11:30:00
170,2,1,1,0.018962935735886893,2019-03-31 11:15:00,2019-03-31 11:30:00
171,1,0,1,0.0028485366611587268,2019-03-31 11:15:00,2019-03-31 11:30:00
172,6,3,3,0.018962935735886893,2019-03-31 11:15:00,2019-03-31 11:30:00
173,1,0,1,0.0028485366611587268,2019-03-31 11:15:00,2019-03-31 11:30:00
177,2,2,0,0.0060388241986099244,2019-03-31 11:15:00,2019-03-31 11:30:00
189,2,0,2,0.0028485366611587268,2019-03-31 11:15:00,2019-03-31 11:30:00
191,4,1,3,0.005270057115409409,2019-03-31 11:15:00,2019-03-31 11:30:00
196,2,2,0,0.005270057115409409,2019-03-31 11:15:00,2019-03-31 11:30:00
197,1,0,1,0.0028485366611587268,2019-03-31 11:15:00,2019-03-31 11:30:00
199,5,3,2,0.026456957170088072,2019-03-31 11:15:00,2019-03-31 11:30:00
203,1,1,0,0.0033328407520088633,2019-03-31 11:15:00,2019-03-31 11:30:00
1,2,2,0,0.0072628157850072724,2019-03-31 11:30:00,2019-03-31 11:45:00
5,1,1,0,0.009165352831408537,2019-03-31 11:30:00,2019-03-31 11:45:00
10,3,2,1,0.1346138359687812,2019-03-31 11:30:00,2019-03-31 11:45:00
13,3,3,0,0.0049072255316694536,2019-03-31 11:30:00,2019-03-31 11:45:00
16,6,2,4,0.004116834021835973,2019-03-31 11:30:00,2019-03-31 11:45:00
18,5,0,5,0.0026736999325950635,2019-03-31 11:30:00,2019-03-31 11:45:00
19,1,0,1,0.0026736999325950635,2019-03-31 11:30:00,2019-03-31 11:45:00
20,4,4,0,0.005140401668870805,2019-03-31 11:30:00,2019-03-31 11:45:00
23,8,6,2,0.00669299692729705,2019-03-31 11:30:00,2019-03-31 11:45:00
26,8,4,4,0.00623160818609177,2019-03-31 11:30:00,2019-03-31 11:45:00
28,1,1,0,0.00442247548570832,2019-03-31 11:30:00,2019-03-31 11:45:00
30,1,0,1,0.0026736999325950635,2019-03-31 11:30:00,2019-03-31 11:45:00
35,3,1,2,0.004650315628982123,2019-03-31 11:30:00,2019-03-31 11:45:00
37,1,1,0,0.0031190979816242397,2019-03-31 11:30:00,2019-03-31 11:45:00
41,2,0,2,0.0026736999325950635,2019-03-31 11:30:00,2019-03-31 11:45:00
46,1,1,0,0.004082101288574578,2019-03-31 11:30:00,2019-03-31 11:45:00
50,1,0,1,0.0026736999325950635,2019-03-31 11:30:00,2019-03-31 11:45:00
57,2,2,0,0.006566025657521625,2019-03-31 11:30:00,2019-03-31 11:45:00
58,2,0,2,0.0026736999325950635,2019-03-31 11:30:00,2019-03-31 11:45:00
61,2,0,2,0.0026736999325950635,2019-03-31 11:30:00,2019-03-31 11:45:00
62,2,1,1,0.0055186275457930695,2019-03-31 11:30:00,2019-03-31 11:45:00
66,1,1,0,0.003548619681428428,2019-03-31 11:30:00,2019-03-31 11:45:00
69,5,2,3,0.008459258003698518,2019-03-31 11:30:00,2019-03-31 11:45:00
74,3,1,2,0.0034313190531384576,2019-03-31 11:30:00,2019-03-31 11:45:00
75,1,1,0,0.004867557815430031,2019-03-31 11:30:00,2019-03-31 11:45:00
85,2,2,0,0.0052971853354884385,2019-03-31 11:30:00,2019-03-31 11:45:00
86,1,0,1,0.0026736999325950635,2019-03-31 11:30:00,2019-03-31 11:45:00
87,4,4,0,0.006651200315447882,2019-03-31 11:30:00,2019-03-31 11:45:00
88,3,1,2,0.003662007780788593,2019-03-31 11:30:00,2019-03-31 11:45:00
89,5,0,5,0.0026736999325950635,2019-03-31 11:30:00,2019-03-31 11:45:00
90,6,2,4,0.003972520612911882,2019-03-31 11:30:00,2019-03-31 11:45:00
99,5,2,3,0.006171251038821577,2019-03-31 11:30:00,2019-03-31 11:45:00
106,1,1,0,0.004946557294225246,2019-03-31 11:30:00,2019-03-31 11:45:00
109,7,3,4,0.006626931325369182,2019-03-31 11:30:00,2019-03-31 11:45:00
110,4,0,4,0.0026736999325950635,2019-03-31 11:30:00,2019-03-31 11:45:00
111,1,0,1,0.0026736999325950635,2019-03-31 11:30:00,2019-03-31 11:45:00
112,3,2,1,0.0076363351446937944,2019-03-31 11:30:00,2019-03-31 11:45:00
113,3,3,0,0.004427092085237918,2019-03-31 11:30:00,2019-03-31 11:45:00
114,7,3,4,0.005319445762870065,2019-03-31 11:30:00,2019-03-31 11:45:00
115,1,1,0,0.005070770292885023,2019-03-31 11:30:00,2019-03-31 11:45:00
116,4,3,1,0.005809634859804853,2019-03-31 11:30:00,2019-03-31 11:45:00
118,8,5,3,0.04971945235120232,2019-03-31 11:30:00,2019-03-31 11:45:00
119,7,5,2,0.0076635738257738294,2019-03-31 11:30:00,2019-03-31 11:45:00
120,3,0,3,0.0026736999325950635,2019-03-31 11:30:00,2019-03-31 11:45:00
122,6,2,4,0.004650315628982123,2019-03-31 11:30:00,2019-03-31 11:45:00
126,3,2,1,0.004946557294225246,2019-03-31 11:30:00,2019-03-31 11:45:00
127,2,1,1,0.0055186275457930695,2019-03-31 11:30:00,2019-03-31 11:45:00
129,1,0,1,0.0026736999325950635,2019-03-31 11:30:00,2019-03-31 11:45:00
137,12,8,4,0.01032258090808871,2019-03-31 11:30:00,2019-03-31 11:45:00
138,33,14,19,0.017662725526729376,2019-03-31 11:30:00,2019-03-31 11:45:00
141,1,0,1,0.0026736999325950635,2019-03-31 11:30:00,2019-03-31 11:45:00
147,1,1,0,0.003998082587017381,2019-03-31 11:30:00,2019-03-31 11:45:00
151,2,1,1,0.00413215506839768,2019-03-31 11:30:00,2019-03-31 11:45:00
153,15,4,11,0.005763191311999677,2019-03-31 11:30:00,2019-03-31 11:45:00
157,1,0,1,0.0026736999325950635,2019-03-31 11:30:00,2019-03-31 11:45:00
158,4,0,4,0.0026736999325950635,2019-03-31 11:30:00,2019-03-31 11:45:00
162,5,0,5,0.0026736999325950635,2019-03-31 11:30:00,2019-03-31 11:45:00
164,2,1,1,0.01780752923487029,2019-03-31 11:30:00,2019-03-31 11:45:00
168,6,6,0,0.012269624240452338,2019-03-31 11:30:00,2019-03-31 11:45:00
169,16,13,3,0.027725044319729268,2019-03-31 11:30:00,2019-03-31 11:45:00
170,7,3,4,0.006172105084321802,2019-03-31 11:30:00,2019-03-31 11:45:00
171,3,0,3,0.0026736999325950635,2019-03-31 11:30:00,2019-03-31 11:45:00
172,2,1,1,0.01780752923487029,2019-03-31 11:30:00,2019-03-31 11:45:00
173,3,1,2,0.007365183064083292,2019-03-31 11:30:00,2019-03-31 11:45:00
177,2,2,0,0.0054011287665512815,2019-03-31 11:30:00,2019-03-31 11:45:00
189,4,2,2,0.0038101286134101546,2019-03-31 11:30:00,2019-03-31 11:45:00
190,2,2,0,0.011570199155638628,2019-03-31 11:30:00,2019-03-31 11:45:00
191,7,5,2,0.04609857214303368,2019-03-31 11:30:00,2019-03-31 11:45:00
196,5,4,1,0.020660068851533923,2019-03-31 11:30:00,2019-03-31 11:45:00
197,1,0,1,0.0026736999325950635,2019-03-31 11:30:00,2019-03-31 11:45:00
199,2,1,1,0.004946557294225246,2019-03-31 11:30:00,2019-03-31 11:45:00
203,8,3,5,0.005199277283216015,2019-03-31 11:30:00,2019-03-31 11:45:00
1,8,6,2,0.15364516678472892,2019-03-31 11:45:00,2019-03-31 12:00:00
2,1,1,0,0.004143068923649468,2019-03-31 11:45:00,2019-03-31 12:00:00
5,1,0,1,0.002239409509897513,2019-03-31 11:45:00,2019-03-31 12:00:00
10,1,1,0,0.015328244117389948,2019-03-31 11:45:00,2019-03-31 12:00:00
13,1,1,0,0.004263520613714111,2019-03-31 11:45:00,2019-03-31 12:00:00
15,2,1,1,0.01190252713664174,2019-03-31 11:45:00,2019-03-31 12:00:00
16,12,6,6,0.010165685156517923,2019-03-31 11:45:00,2019-03-31 12:00:00
18,8,1,7,0.002548952328231589,2019-03-31 11:45:00,2019-03-31 12:00:00
19,3,1,2,0.0036798325791697183,2019-03-31 11:45:00,2019-03-31 12:00:00
20,5,4,1,0.01805655911561233,2019-03-31 11:45:00,2019-03-31 12:00:00
23,8,7,1,0.010064941518245751,2019-03-31 11:45:00,2019-03-31 12:00:00
26,6,4,2,0.0047621545603176215,2019-03-31 11:45:00,2019-03-31 12:00:00
28,2,0,2,0.002239409509897513,2019-03-31 11:45:00,2019-03-31 12:00:00
30,1,0,1,0.002239409509897513,2019-03-31 11:45:00,2019-03-31 12:00:00
35,2,1,1,0.014912593970758366,2019-03-31 11:45:00,2019-03-31 12:00:00
37,1,1,0,0.0033074700551292188,2019-03-31 11:45:00,2019-03-31 12:00:00
41,1,1,0,0.00576135108835755,2019-03-31 11:45:00,2019-03-31 12:00:00
46,1,1,0,0.00636264556073317,2019-03-31 11:45:00,2019-03-31 12:00:00
50,1,0,1,0.002239409509897513,2019-03-31 11:45:00,2019-03-31 12:00:00
57,7,5,2,0.022731808399133253,2019-03-31 11:45:00,2019-03-31 12:00:00
58,4,2,2,0.006615662713910805,2019-03-31 11:45:00,2019-03-31 12:00:00
61,3,0,3,0.002239409509897513,2019-03-31 11:45:00,2019-03-31 12:00:00
62,3,2,1,0.013778283455918123,2019-03-31 11:45:00,2019-03-31 12:00:00
67,2,0,2,0.002239409509897513,2019-03-31 11:45:00,2019-03-31 12:00:00
68,1,1,0,0.003191239216773491,2019-03-31 11:45:00,2019-03-31 12:00:00
69,4,2,2,0.004547639464826489,2019-03-31 11:45:00,2019-03-31 12:00:00
74,2,0,2,0.002239409509897513,2019-03-31 11:45:00,2019-03-31 12:00:00
85,2,2,0,0.004135570100833491,2019-03-31 11:45:00,2019-03-31 12:00:00
86,2,0,2,0.002239409509897513,2019-03-31 11:45:00,2019-03-31 12:00:00
87,1,1,0,0.0048495339132859396,2019-03-31 11:45:00,2019-03-31 12:00:00
88,4,1,3,0.0031248737348368505,2019-03-31 11:45:00,2019-03-31 12:00:00
89,5,0,5,0.002239409509897513,2019-03-31 11:45:00,2019-03-31 12:00:00
90,4,2,2,0.004557131205674176,2019-03-31 11:45:00,2019-03-31 12:00:00
99,6,3,3,0.014912593970758366,2019-03-31 11:45:00,2019-03-31 12:00:00
104,4,2,2,0.006254126293971529,2019-03-31 11:45:00,2019-03-31 12:00:00
106,1,1,0,0.012747229368194687,2019-03-31 11:45:00,2019-03-31 12:00:00
108,2,2,0,0.004143068923649468,2019-03-31 11:45:00,2019-03-31 12:00:00
109,9,6,3,0.014550295445358349,2019-03-31 11:45:00,2019-03-31 12:00:00
110,4,1,3,0.0030877777160281676,2019-03-31 11:45:00,2019-03-31 12:00:00
111,3,2,1,0.003070390511847157,2019-03-31 11:45:00,2019-03-31 12:00:00
112,3,2,1,0.004365219742926836,2019-03-31 11:45:00,2019-03-31 12:00:00
113,2,2,0,0.0035085157857321497,2019-03-31 11:45:00,2019-03-31 12:00:00
114,7,5,2,0.010186128439122671,2019-03-31 11:45:00,2019-03-31 12:00:00
115,4,3,1,0.005003326612143455,2019-03-31 11:45:00,2019-03-31 12:00:00
116,1,1,0,0.0036798325791697183,2019-03-31 11:45:00,2019-03-31 12:00:00
118,8,4,4,0.011513631853210997,2019-03-31 11:45:00,2019-03-31 12:00:00
119,16,7,9,0.008981417102976709,2019-03-31 11:45:00,2019-03-31 12:00:00
120,3,0,3,0.002239409509897513,2019-03-31 11:45:00,2019-03-31 12:00:00
122,4,1,3,0.0031248737348368505,2019-03-31 11:45:00,2019-03-31 12:00:00
126,1,0,1,0.002239409509897513,2019-03-31 11:45:00,2019-03-31 12:00:00
127,2,2,0,0.003759426872754169,2019-03-31 11:45:00,2019-03-31 12:00:00
129,2,1,1,0.012358952968847049,2019-03-31 11:45:00,2019-03-31 12:00:00
137,9,7,2,0.008622241417601864,2019-03-31 11:45:00,2019-03-31 12:00:00
138,26,8,18,0.008797317197962382,2019-03-31 11:45:00,2019-03-31 12:00:00
141,1,0,1,0.002239409509897513,2019-03-31 11:45:00,2019-03-31 12:00:00
147,3,2,1,0.028385012846830298,2019-03-31 11:45:00,2019-03-31 12:00:00
151,3,1,2,0.003191239216773491,2019-03-31 11:45:00,2019-03-31 12:00:00
153,11,4,7,0.008794276902407687,2019-03-31 11:45:00,2019-03-31 12:00:00
157,4,2,2,0.01623217873772557,2019-03-31 11:45:00,2019-03-31 12:00:00
158,3,1,2,0.004176399322923786,2019-03-31 11:45:00,2019-03-31 12:00:00
159,1,0,1,0.002239409509897513,2019-03-31 11:45:00,2019-03-31 12:00:00
160,2,1,1,0.004143068923649468,2019-03-31 11:45:00,2019-03-31 12:00:00
162,3,0,3,0.002239409509897513,2019-03-31 11:45:00,2019-03-31 12:00:00
164,2,1,1,0.014912593970758366,2019-03-31 11:45:00,2019-03-31 12:00:00
168,12,6,6,0.011648150977493867,2019-03-31 11:45:00,2019-03-31 12:00:00
169,13,11,2,0.013983167798698482,2019-03-31 11:45:00,2019-03-31 12:00:00
170,8,3,5,0.0055759931701056965,2019-03-31 11:45:00,2019-03-31 12:00:00
171,2,0,2,0.002239409509897513,2019-03-31 11:45:00,2019-03-31 12:00:00
172,4,3,1,0.03760257021766204,2019-03-31 11:45:00,2019-03-31 12:00:00
173,1,0,1,0.002239409509897513,2019-03-31 11:45:00,2019-03-31 12:00:00
177,3,2,1,0.0035085157857321497,2019-03-31 11:45:00,2019-03-31 12:00:00
189,3,2,1,0.003989345190609384,2019-03-31 11:45:00,2019-03-31 12:00:00
190,3,2,1,0.015856298209399027,2019-03-31 11:45:00,2019-03-31 12:00:00
191,4,2,2,0.004010337959776188,2019-03-31 11:45:00,2019-03-31 12:00:00
196,5,4,1,0.015396027521266073,2019-03-31 11:45:00,2019-03-31 12:00:00
197,3,0,3,0.002239409509897513,2019-03-31 11:45:00,2019-03-31 12:00:00
199,4,1,3,0.004143068923649468,2019-03-31 11:45:00,2019-03-31 12:00:00
203,4,1,3,0.002873962647814831,2019-03-31 11:45:00,2019-03-31 12:00:00
1,5,5,0,0.008224249423260607,2019-03-31 12:00:00,2019-03-31 12:15:00
2,2,2,0,0.008821263255043807,2019-03-31 12:00:00,2019-03-31 12:15:00
5,3,2,1,0.004305050859471213,2019-03-31 12:00:00,2019-03-31 12:15:00
10,1,1,0,0.0066083091569769875,2019-03-31 12:00:00,2019-03-31 12:15:00
15,3,2,1,0.01922252193986918,2019-03-31 12:00:00,2019-03-31 12:15:00
16,17,9,8,0.02795774183808443,2019-03-31 12:00:00,2019-03-31 12:15:00
18,7,2,5,0.0037604615495931025,2019-03-31 12:00:00,2019-03-31 12:15:00
19,7,2,5,0.00621884567142218,2019-03-31 12:00:00,2019-03-31 12:15:00
20,9,4,5,0.008843045847881212,2019-03-31 12:00:00,2019-03-31 12:15:00
23,10,6,4,0.01846130197999263,2019-03-31 12:00:00,2019-03-31 12:15:00
26,14,8,6,0.009136446626837933,2019-03-31 12:00:00,2019-03-31 12:15:00
28,8,0,8,0.0021902317081435975,2019-03-31 12:00:00,2019-03-31 12:15:00
30,2,0,2,0.0021902317081435975,2019-03-31 12:00:00,2019-03-31 12:15:00
35,2,1,1,0.014567017675235907,2019-03-31 12:00:00,2019-03-31 12:15:00
37,1,1,0,0.004687779798636676,2019-03-31 12:00:00,2019-03-31 12:15:00
40,2,1,1,0.004111300336816335,2019-03-31 12:00:00,2019-03-31 12:15:00
41,4,1,3,0.0063074001704701635,2019-03-31 12:00:00,2019-03-31 12:15:00
46,8,4,4,0.007789663360012007,2019-03-31 12:00:00,2019-03-31 12:15:00
50,3,2,1,0.0051972002713112555,2019-03-31 12:00:00,2019-03-31 12:15:00
57,5,4,1,0.01989926640977929,2019-03-31 12:00:00,2019-03-31 12:15:00
58,6,4,2,0.01186565134792169,2019-03-31 12:00:00,2019-03-31 12:15:00
61,5,0,5,0.0021902317081435975,2019-03-31 12:00:00,2019-03-31 12:15:00
62,3,2,1,0.012141240907289784,2019-03-31 12:00:00,2019-03-31 12:15:00
66,2,0,2,0.0021902317081435975,2019-03-31 12:00:00,2019-03-31 12:15:00
67,8,5,3,0.0055074598975621974,2019-03-31 12:00:00,2019-03-31 12:15:00
68,3,1,2,0.003750823390488441,2019-03-31 12:00:00,2019-03-31 12:15:00
69,2,1,1,0.003750823390488441,2019-03-31 12:00:00,2019-03-31 12:15:00
74,3,0,3,0.0021902317081435975,2019-03-31 12:00:00,2019-03-31 12:15:00
75,6,2,4,0.0070090039253625095,2019-03-31 12:00:00,2019-03-31 12:15:00
79,4,0,4,0.0021902317081435975,2019-03-31 12:00:00,2019-03-31 12:15:00
85,5,2,3,0.006032368965489073,2019-03-31 12:00:00,2019-03-31 12:15:00
86,2,0,2,0.0021902317081435975,2019-03-31 12:00:00,2019-03-31 12:15:00
87,1,1,0,0.0045996178167530535,2019-03-31 12:00:00,2019-03-31 12:15:00
88,2,0,2,0.0021902317081435975,2019-03-31 12:00:00,2019-03-31 12:15:00
89,5,0,5,0.0021902317081435975,2019-03-31 12:00:00,2019-03-31 12:15:00
90,8,3,5,0.004725624398894639,2019-03-31 12:00:00,2019-03-31 12:15:00
99,12,5,7,0.005575949551155178,2019-03-31 12:00:00,2019-03-31 12:15:00
104,2,1,1,0.004052045422282812,2019-03-31 12:00:00,2019-03-31 12:15:00
106,2,2,0,0.0077547723005171945,2019-03-31 12:00:00,2019-03-31 12:15:00
108,9,5,4,0.011180271250234533,2019-03-31 12:00:00,2019-03-31 12:15:00
109,6,3,3,0.005819996028380065,2019-03-31 12:00:00,2019-03-31 12:15:00
110,1,1,0,0.003180532867525545,2019-03-31 12:00:00,2019-03-31 12:15:00
111,11,6,5,0.014170149411116061,2019-03-31 12:00:00,2019-03-31 12:15:00
112,3,3,0,0.007697042782030898,2019-03-31 12:00:00,2019-03-31 12:15:00
114,10,8,2,0.06412948078809177,2019-03-31 12:00:00,2019-03-31 12:15:00
115,5,2,3,0.0024207978049745607,2019-03-31 12:00:00,2019-03-31 12:15:00
116,4,3,1,0.00847238276177431,2019-03-31 12:00:00,2019-03-31 12:15:00
118,9,5,4,0.014841435374215239,2019-03-31 12:00:00,2019-03-31 12:15:00
119,12,5,7,0.008154595154081477,2019-03-31 12:00:00,2019-03-31 12:15:00
120,6,2,4,0.004052045422282812,2019-03-31 12:00:00,2019-03-31 12:15:00
122,6,1,5,0.002638868805700599,2019-03-31 12:00:00,2019-03-31 12:15:00
126,6,3,3,0.005874889337011982,2019-03-31 12:00:00,2019-03-31 12:15:00
127,5,4,1,0.0037559570341841276,2019-03-31 12:00:00,2019-03-31 12:15:00
129,2,2,0,0.019393321198560663,2019-03-31 12:00:00,2019-03-31 12:15:00
135,3,2,1,0.0034314408509030733,2019-03-31 12:00:00,2019-03-31 12:15:00
137,13,12,1,0.0187744029579982,2019-03-31 12:00:00,2019-03-31 12:15:00
138,18,1,17,0.002305514756559079,2019-03-31 12:00:00,2019-03-31 12:15:00
141,4,1,3,0.003056219924339407,2019-03-31 12:00:00,2019-03-31 12:15:00
147,3,2,1,0.02316509612047814,2019-03-31 12:00:00,2019-03-31 12:15:00
151,1,0,1,0.0021902317081435975,2019-03-31 12:00:00,2019-03-31 12:15:00
153,5,3,2,0.005875745386704388,2019-03-31 12:00:00,2019-03-31 12:15:00
154,1,1,0,0.003484667202139826,2019-03-31 12:00:00,2019-03-31 12:15:00
157,5,0,5,0.0021902317081435975,2019-03-31 12:00:00,2019-03-31 12:15:00
158,2,1,1,0.0029936479665030203,2019-03-31 12:00:00,2019-03-31 12:15:00
159,3,2,1,0.0031211385652132042,2019-03-31 12:00:00,2019-03-31 12:15:00
160,2,1,1,0.004843376282022523,2019-03-31 12:00:00,2019-03-31 12:15:00
162,1,0,1,0.0021902317081435975,2019-03-31 12:00:00,2019-03-31 12:15:00
164,11,9,2,0.02263906806782004,2019-03-31 12:00:00,2019-03-31 12:15:00
168,8,5,3,0.028947171325454615,2019-03-31 12:00:00,2019-03-31 12:15:00
169,11,9,2,0.005548468961396101,2019-03-31 12:00:00,2019-03-31 12:15:00
170,10,4,6,0.013557537367499838,2019-03-31 12:00:00,2019-03-31 12:15:00
171,2,1,1,0.005383014227616259,2019-03-31 12:00:00,2019-03-31 12:15:00
172,5,3,2,0.012023285969895003,2019-03-31 12:00:00,2019-03-31 12:15:00
173,1,1,0,0.002422958422410999,2019-03-31 12:00:00,2019-03-31 12:15:00
177,13,9,4,0.028357401558735614,2019-03-31 12:00:00,2019-03-31 12:15:00
189,2,0,2,0.0021902317081435975,2019-03-31 12:00:00,2019-03-31 12:15:00
190,2,1,1,0.0038549245356450873,2019-03-31 12:00:00,2019-03-31 12:15:00
191,5,3,2,0.00555552970386664,2019-03-31 12:00:00,2019-03-31 12:15:00
196,4,4,0,0.007651568183315505,2019-03-31 12:00:00,2019-03-31 12:15:00
197,10,2,8,0.004132875116495865,2019-03-31 12:00:00,2019-03-31 12:15:00
199,6,4,2,0.032945209765983814,2019-03-31 12:00:00,2019-03-31 12:15:00
202,4,3,1,0.020531092110003552,2019-03-31 12:00:00,2019-03-31 12:15:00
203,4,1,3,0.0030513505665482575,2019-03-31 12:00:00,2019-03-31 12:15:00
1,7,5,2,0.009391478630620342,2019-03-31 12:15:00,2019-03-31 12:30:00
2,5,4,1,0.008388137843028783,2019-03-31 12:15:00,2019-03-31 12:30:00
5,7,3,4,0.0038222700367761303,2019-03-31 12:15:00,2019-03-31 12:30:00
10,1,1,0,0.003907733756822112,2019-03-31 12:15:00,2019-03-31 12:30:00
15,1,1,0,0.0025226247894335942,2019-03-31 12:15:00,2019-03-31 12:30:00
16,10,5,5,0.02535484231636408,2019-03-31 12:15:00,2019-03-31 12:30:00
18,8,4,4,0.013741299344750721,2019-03-31 12:15:00,2019-03-31 12:30:00
19,4,0,4,0.0021122299559894094,2019-03-31 12:15:00,2019-03-31 12:30:00
20,6,4,2,0.00428259138383615,2019-03-31 12:15:00,2019-03-31 12:30:00
21,2,1,1,0.00420745755578692,2019-03-31 12:15:00,2019-03-31 12:30:00
22,2,1,1,0.014065149741076791,2019-03-31 12:15:00,2019-03-31 12:30:00
23,11,7,4,0.012936371448170059,2019-03-31 12:15:00,2019-03-31 12:30:00
26,19,8,11,0.014693178713349703,2019-03-31 12:15:00,2019-03-31 12:30:00
27,2,2,0,0.002498365267134466,2019-03-31 12:15:00,2019-03-31 12:30:00
28,13,2,11,0.002498365267134466,2019-03-31 12:15:00,2019-03-31 12:30:00
30,3,0,3,0.0021122299559894094,2019-03-31 12:15:00,2019-03-31 12:30:00
35,2,1,1,0.014065149741076791,2019-03-31 12:15:00,2019-03-31 12:30:00
37,2,2,0,0.0032866753225313256,2019-03-31 12:15:00,2019-03-31 12:30:00
40,1,0,1,0.0021122299559894094,2019-03-31 12:15:00,2019-03-31 12:30:00
41,6,2,4,0.00935916726961816,2019-03-31 12:15:00,2019-03-31 12:30:00
46,3,1,2,0.003180191682153247,2019-03-31 12:15:00,2019-03-31 12:30:00
50,1,0,1,0.0021122299559894094,2019-03-31 12:15:00,2019-03-31 12:30:00
57,5,4,1,0.009266651967036967,2019-03-31 12:15:00,2019-03-31 12:30:00
58,6,4,2,0.01137375065605117,2019-03-31 12:15:00,2019-03-31 12:30:00
61,7,1,6,0.0024608759044439134,2019-03-31 12:15:00,2019-03-31 12:30:00
62,6,5,1,0.009191854083392173,2019-03-31 12:15:00,2019-03-31 12:30:00
66,3,0,3,0.0021122299559894094,2019-03-31 12:15:00,2019-03-31 12:30:00
67,9,6,3,0.0073942460201412916,2019-03-31 12:15:00,2019-03-31 12:30:00
68,3,0,3,0.0021122299559894094,2019-03-31 12:15:00,2019-03-31 12:30:00
69,1,0,1,0.0021122299559894094,2019-03-31 12:15:00,2019-03-31 12:30:00
74,9,4,5,0.010385156934886182,2019-03-31 12:15:00,2019-03-31 12:30:00
75,12,6,6,0.008007945035475217,2019-03-31 12:15:00,2019-03-31 12:30:00
79,2,0,2,0.0021122299559894094,2019-03-31 12:15:00,2019-03-31 12:30:00
85,9,2,7,0.00914376978789438,2019-03-31 12:15:00,2019-03-31 12:30:00
87,6,6,0,0.013331974904764494,2019-03-31 12:15:00,2019-03-31 12:30:00
88,4,1,3,0.0029899024684908572,2019-03-31 12:15:00,2019-03-31 12:30:00
89,5,0,5,0.0021122299559894094,2019-03-31 12:15:00,2019-03-31 12:30:00
90,7,3,4,0.004129929189015338,2019-03-31 12:15:00,2019-03-31 12:30:00
99,4,2,2,0.014065149741076791,2019-03-31 12:15:00,2019-03-31 12:30:00
104,1,1,0,0.0027107312229336434,2019-03-31 12:15:00,2019-03-31 12:30:00
106,5,3,2,0.005578023672001137,2019-03-31 12:15:00,2019-03-31 12:30:00
108,4,1,3,0.0029473749135789217,2019-03-31 12:15:00,2019-03-31 12:30:00
109,11,5,6,0.007537171990247114,2019-03-31 12:15:00,2019-03-31 12:30:00
110,5,1,4,0.0024114805894615266,2019-03-31 12:15:00,2019-03-31 12:30:00
111,10,4,6,0.010685357772672752,2019-03-31 12:15:00,2019-03-31 12:30:00
112,4,4,0,0.009747913845931823,2019-03-31 12:15:00,2019-03-31 12:30:00
114,8,7,1,0.05714748053533691,2019-03-31 12:15:00,2019-03-31 12:30:00
116,10,4,6,0.009537833477632492,2019-03-31 12:15:00,2019-03-31 12:30:00
118,9,6,3,0.06928106115991972,2019-03-31 12:15:00,2019-03-31 12:30:00
119,5,2,3,0.004356609707030288,2019-03-31 12:15:00,2019-03-31 12:30:00
120,8,4,4,0.005530289345644069,2019-03-31 12:15:00,2019-03-31 12:30:00
122,2,0,2,0.0021122299559894094,2019-03-31 12:15:00,2019-03-31 12:30:00
126,8,3,5,0.005174043362042274,2019-03-31 12:15:00,2019-03-31 12:30:00
127,4,3,1,0.005558904528119791,2019-03-31 12:15:00,2019-03-31 12:30:00
135,5,2,3,0.005643499602935276,2019-03-31 12:15:00,2019-03-31 12:30:00
137,14,13,1,0.015447827314102597,2019-03-31 12:15:00,2019-03-31 12:30:00
138,13,2,11,0.005310505434120121,2019-03-31 12:15:00,2019-03-31 12:30:00
141,5,1,4,0.00268224331625165,2019-03-31 12:15:00,2019-03-31 12:30:00
147,2,2,0,0.00534303178898384,2019-03-31 12:15:00,2019-03-31 12:30:00
151,1,1,0,0.005688877163071575,2019-03-31 12:15:00,2019-03-31 12:30:00
153,11,4,7,0.004742474714792796,2019-03-31 12:15:00,2019-03-31 12:30:00
154,2,2,0,0.004599318636277401,2019-03-31 12:15:00,2019-03-31 12:30:00
157,4,0,4,0.0021122299559894094,2019-03-31 12:15:00,2019-03-31 12:30:00
158,1,0,1,0.0021122299559894094,2019-03-31 12:15:00,2019-03-31 12:30:00
159,1,0,1,0.0021122299559894094,2019-03-31 12:15:00,2019-03-31 12:30:00
160,3,2,1,0.007899638063638137,2019-03-31 12:15:00,2019-03-31 12:30:00
162,5,2,3,0.0031751748414887817,2019-03-31 12:15:00,2019-03-31 12:30:00
164,16,14,2,0.036751604758199885,2019-03-31 12:15:00,2019-03-31 12:30:00
168,13,6,7,0.0238263348277245,2019-03-31 12:15:00,2019-03-31 12:30:00
169,16,14,2,0.013298574781526734,2019-03-31 12:15:00,2019-03-31 12:30:00
170,8,4,4,0.016541688255267636,2019-03-31 12:15:00,2019-03-31 12:30:00
171,7,4,3,0.018496578657576847,2019-03-31 12:15:00,2019-03-31 12:30:00
172,1,0,1,0.0021122299559894094,2019-03-31 12:15:00,2019-03-31 12:30:00
173,2,2,0,0.002498365267134466,2019-03-31 12:15:00,2019-03-31 12:30:00
177,12,9,3,0.030675172472682657,2019-03-31 12:15:00,2019-03-31 12:30:00
189,6,0,6,0.0021122299559894094,2019-03-31 12:15:00,2019-03-31 12:30:00
190,4,2,2,0.0038715935535787284,2019-03-31 12:15:00,2019-03-31 12:30:00
191,12,3,9,0.0056268866481465705,2019-03-31 12:15:00,2019-03-31 12:30:00
196,4,4,0,0.014115016474162374,2019-03-31 12:15:00,2019-03-31 12:30:00
197,6,1,5,0.003932492801764388,2019-03-31 12:15:00,2019-03-31 12:30:00
199,3,3,0,0.004981879689327483,2019-03-31 12:15:00,2019-03-31 12:30:00
202,3,2,1,0.020041609633620477,2019-03-31 12:15:00,2019-03-31 12:30:00
203,4,1,3,0.0032875744081901706,2019-03-31 12:15:00,2019-03-31 12:30:00
1,13,6,7,0.008151244782954063,2019-03-31 12:30:00,2019-03-31 12:45:00
2,4,3,1,0.005345832584291564,2019-03-31 12:30:00,2019-03-31 12:45:00
5,10,5,5,0.00764693495607987,2019-03-31 12:30:00,2019-03-31 12:45:00
11,2,1,1,0.014237444818593865,2019-03-31 12:30:00,2019-03-31 12:45:00
16,6,4,2,0.010415732588348391,2019-03-31 12:30:00,2019-03-31 12:45:00
18,9,4,5,0.007739954806377883,2019-03-31 12:30:00,2019-03-31 12:45:00
19,6,2,4,0.003783167484027734,2019-03-31 12:30:00,2019-03-31 12:45:00
20,3,3,0,0.003530282300935309,2019-03-31 12:30:00,2019-03-31 12:45:00
23,19,9,10,0.009673378454691316,2019-03-31 12:30:00,2019-03-31 12:45:00
26,11,5,6,0.007502383484204269,2019-03-31 12:30:00,2019-03-31 12:45:00
27,2,2,0,0.00507419479397519,2019-03-31 12:30:00,2019-03-31 12:45:00
28,10,2,8,0.002715602497886579,2019-03-31 12:30:00,2019-03-31 12:45:00
35,2,1,1,0.014237444818593865,2019-03-31 12:30:00,2019-03-31 12:45:00
37,2,2,0,0.0033867335430774565,2019-03-31 12:30:00,2019-03-31 12:45:00
41,5,2,3,0.005204148496621878,2019-03-31 12:30:00,2019-03-31 12:45:00
46,6,4,2,0.011441316385376571,2019-03-31 12:30:00,2019-03-31 12:45:00
50,2,1,1,0.014237444818593865,2019-03-31 12:30:00,2019-03-31 12:45:00
57,6,4,2,0.007639094732911639,2019-03-31 12:30:00,2019-03-31 12:45:00
58,7,3,4,0.0058919818923036296,2019-03-31 12:30:00,2019-03-31 12:45:00
61,3,0,3,0.002138493500399572,2019-03-31 12:30:00,2019-03-31 12:45:00
62,8,7,1,0.04804241462390218,2019-03-31 12:30:00,2019-03-31 12:45:00
66,5,1,4,0.002715602497886579,2019-03-31 12:30:00,2019-03-31 12:45:00
67,12,9,3,0.01640239745403787,2019-03-31 12:30:00,2019-03-31 12:45:00
68,2,2,0,0.009433596730391139,2019-03-31 12:30:00,2019-03-31 12:45:00
71,4,2,2,0.014237444818593865,2019-03-31 12:30:00,2019-03-31 12:45:00
74,8,4,4,0.0068810721873806425,2019-03-31 12:30:00,2019-03-31 12:45:00
75,12,6,6,0.0057118052796475485,2019-03-31 12:30:00,2019-03-31 12:45:00
79,2,0,2,0.002138493500399572,2019-03-31 12:30:00,2019-03-31 12:45:00
85,2,0,2,0.002138493500399572,2019-03-31 12:30:00,2019-03-31 12:45:00
87,10,6,4,0.012455216586429166,2019-03-31 12:30:00,2019-03-31 12:45:00
88,5,2,3,0.010118467957561458,2019-03-31 12:30:00,2019-03-31 12:45:00
89,4,0,4,0.002138493500399572,2019-03-31 12:30:00,2019-03-31 12:45:00
90,2,1,1,0.014237444818593865,2019-03-31 12:30:00,2019-03-31 12:45:00
104,1,0,1,0.002138493500399572,2019-03-31 12:30:00,2019-03-31 12:45:00
106,2,0,2,0.002138493500399572,2019-03-31 12:30:00,2019-03-31 12:45:00
108,6,3,3,0.014237444818593865,2019-03-31 12:30:00,2019-03-31 12:45:00
109,17,9,8,0.01702185264030286,2019-03-31 12:30:00,2019-03-31 12:45:00
110,7,2,5,0.006100396924773108,2019-03-31 12:30:00,2019-03-31 12:45:00
111,10,3,7,0.004306108719879282,2019-03-31 12:30:00,2019-03-31 12:45:00
112,6,4,2,0.008781176821658583,2019-03-31 12:30:00,2019-03-31 12:45:00
113,1,0,1,0.002138493500399572,2019-03-31 12:30:00,2019-03-31 12:45:00
114,8,5,3,0.008342258920611804,2019-03-31 12:30:00,2019-03-31 12:45:00
115,2,2,0,0.008683747236715849,2019-03-31 12:30:00,2019-03-31 12:45:00
116,12,5,7,0.019544989172074763,2019-03-31 12:30:00,2019-03-31 12:45:00
118,3,2,1,0.04444178372443878,2019-03-31 12:30:00,2019-03-31 12:45:00
119,9,3,6,0.0104701892559322,2019-03-31 12:30:00,2019-03-31 12:45:00
120,7,4,3,0.005110559413314505,2019-03-31 12:30:00,2019-03-31 12:45:00
122,1,0,1,0.002138493500399572,2019-03-31 12:30:00,2019-03-31 12:45:00
126,2,1,1,0.0024270479991430755,2019-03-31 12:30:00,2019-03-31 12:45:00
127,4,4,0,0.007411287993795533,2019-03-31 12:30:00,2019-03-31 12:45:00
135,3,0,3,0.002138493500399572,2019-03-31 12:30:00,2019-03-31 12:45:00
137,12,9,3,0.014080588220289698,2019-03-31 12:30:00,2019-03-31 12:45:00
138,8,3,5,0.005168240030301103,2019-03-31 12:30:00,2019-03-31 12:45:00
141,5,2,3,0.004935636938959962,2019-03-31 12:30:00,2019-03-31 12:45:00
147,2,1,1,0.003201478573305403,2019-03-31 12:30:00,2019-03-31 12:45:00
153,6,1,5,0.003947340397641653,2019-03-31 12:30:00,2019-03-31 12:45:00
154,3,2,1,0.00499264847420841,2019-03-31 12:30:00,2019-03-31 12:45:00
157,7,1,6,0.004785640295231687,2019-03-31 12:30:00,2019-03-31 12:45:00
158,4,3,1,0.005035390387726284,2019-03-31 12:30:00,2019-03-31 12:45:00
159,3,2,1,0.007549145737499324,2019-03-31 12:30:00,2019-03-31 12:45:00
160,5,2,3,0.009546396101532025,2019-03-31 12:30:00,2019-03-31 12:45:00
162,6,2,4,0.002859151255744431,2019-03-31 12:30:00,2019-03-31 12:45:00
164,18,12,6,0.023096802696039066,2019-03-31 12:30:00,2019-03-31 12:45:00
168,18,9,9,0.01974492470465135,2019-03-31 12:30:00,2019-03-31 12:45:00
169,16,14,2,0.023307962324659585,2019-03-31 12:30:00,2019-03-31 12:45:00
170,4,3,1,0.049362268022525545,2019-03-31 12:30:00,2019-03-31 12:45:00
171,8,4,4,0.009896491580088778,2019-03-31 12:30:00,2019-03-31 12:45:00
172,1,0,1,0.002138493500399572,2019-03-31 12:30:00,2019-03-31 12:45:00
173,2,2,0,0.002715602497886579,2019-03-31 12:30:00,2019-03-31 12:45:00
177,13,9,4,0.016388767528677937,2019-03-31 12:30:00,2019-03-31 12:45:00
189,4,0,4,0.002138493500399572,2019-03-31 12:30:00,2019-03-31 12:45:00
190,5,1,4,0.0042016354543440455,2019-03-31 12:30:00,2019-03-31 12:45:00
191,11,2,9,0.0038148076440783665,2019-03-31 12:30:00,2019-03-31 12:45:00
196,4,4,0,0.0231654978345203,2019-03-31 12:30:00,2019-03-31 12:45:00
197,7,1,6,0.003390716404098122,2019-03-31 12:30:00,2019-03-31 12:45:00
199,2,2,0,0.004264463646211233,2019-03-31 12:30:00,2019-03-31 12:45:00
202,4,2,2,0.0068810721873806425,2019-03-31 12:30:00,2019-03-31 12:45:00
203,5,1,4,0.003586603171754286,2019-03-31 12:30:00,2019-03-31 12:45:00
1,21,10,11,0.009864400536771133,2019-03-31 12:45:00,2019-03-31 13:00:00
2,9,7,2,0.018288953161420405,2019-03-31 12:45:00,2019-03-31 13:00:00
5,9,3,6,0.003441908234439098,2019-03-31 12:45:00,2019-03-31 13:00:00
10,5,1,4,0.0025130410698076967,2019-03-31 12:45:00,2019-03-31 13:00:00
11,2,1,1,0.013183943422602687,2019-03-31 12:45:00,2019-03-31 13:00:00
13,2,2,0,0.0037973782294104842,2019-03-31 12:45:00,2019-03-31 13:00:00
15,2,0,2,0.0019789841184742955,2019-03-31 12:45:00,2019-03-31 13:00:00
16,12,5,7,0.011309139511282465,2019-03-31 12:45:00,2019-03-31 13:00:00
18,9,4,5,0.0059733214228157175,2019-03-31 12:45:00,2019-03-31 13:00:00
19,4,2,2,0.0054005422114081734,2019-03-31 12:45:00,2019-03-31 13:00:00
20,4,2,2,0.003402882235540178,2019-03-31 12:45:00,2019-03-31 13:00:00
23,15,8,7,0.01408669921135511,2019-03-31 12:45:00,2019-03-31 13:00:00
26,13,5,8,0.005804552858286247,2019-03-31 12:45:00,2019-03-31 13:00:00
27,1,1,0,0.00401397447138963,2019-03-31 12:45:00,2019-03-31 13:00:00
28,7,2,5,0.002998571955485661,2019-03-31 12:45:00,2019-03-31 13:00:00
35,4,1,3,0.002761448952290188,2019-03-31 12:45:00,2019-03-31 13:00:00
37,2,1,1,0.002799364134375641,2019-03-31 12:45:00,2019-03-31 13:00:00
41,7,2,5,0.0037693359431879743,2019-03-31 12:45:00,2019-03-31 13:00:00
46,6,6,0,0.016129719528369255,2019-03-31 12:45:00,2019-03-31 13:00:00
50,5,1,4,0.0025130410698076967,2019-03-31 12:45:00,2019-03-31 13:00:00
57,4,4,0,0.00933813436400539,2019-03-31 12:45:00,2019-03-31 13:00:00
58,10,2,8,0.005678828676533768,2019-03-31 12:45:00,2019-03-31 13:00:00
61,2,0,2,0.0019789841184742955,2019-03-31 12:45:00,2019-03-31 13:00:00
62,7,5,2,0.01115252282399179,2019-03-31 12:45:00,2019-03-31 13:00:00
66,4,2,2,0.0055407808203971134,2019-03-31 12:45:00,2019-03-31 13:00:00
67,13,10,3,0.015442244074560511,2019-03-31 12:45:00,2019-03-31 13:00:00
68,5,2,3,0.008389998706003652,2019-03-31 12:45:00,2019-03-31 13:00:00
70,2,1,1,0.0022398057297462596,2019-03-31 12:45:00,2019-03-31 13:00:00
71,4,2,2,0.013183943422602687,2019-03-31 12:45:00,2019-03-31 13:00:00
74,12,3,9,0.002761448952290188,2019-03-31 12:45:00,2019-03-31 13:00:00
75,14,4,10,0.004318468707289917,2019-03-31 12:45:00,2019-03-31 13:00:00
79,2,0,2,0.0019789841184742955,2019-03-31 12:45:00,2019-03-31 13:00:00
85,2,0,2,0.0019789841184742955,2019-03-31 12:45:00,2019-03-31 13:00:00
86,1,1,0,0.003882942913984234,2019-03-31 12:45:00,2019-03-31 13:00:00
87,4,2,2,0.004787567873347662,2019-03-31 12:45:00,2019-03-31 13:00:00
88,10,5,5,0.011544453013688068,2019-03-31 12:45:00,2019-03-31 13:00:00
89,4,0,4,0.0019789841184742955,2019-03-31 12:45:00,2019-03-31 13:00:00
90,2,1,1,0.013183943422602687,2019-03-31 12:45:00,2019-03-31 13:00:00
104,4,2,2,0.0030122509533471375,2019-03-31 12:45:00,2019-03-31 13:00:00
108,2,1,1,0.013183943422602687,2019-03-31 12:45:00,2019-03-31 13:00:00
109,19,9,10,0.007099205340980616,2019-03-31 12:45:00,2019-03-31 13:00:00
110,7,4,3,0.013454038114631792,2019-03-31 12:45:00,2019-03-31 13:00:00
111,7,2,5,0.00472081338484042,2019-03-31 12:45:00,2019-03-31 13:00:00
112,9,5,4,0.00837963353283556,2019-03-31 12:45:00,2019-03-31 13:00:00
113,1,0,1,0.0019789841184742955,2019-03-31 12:45:00,2019-03-31 13:00:00
114,10,2,8,0.004861897742243094,2019-03-31 12:45:00,2019-03-31 13:00:00
115,2,2,0,0.004029670818446161,2019-03-31 12:45:00,2019-03-31 13:00:00
116,6,2,4,0.005428178969027425,2019-03-31 12:45:00,2019-03-31 13:00:00
118,7,6,1,0.07695000827852276,2019-03-31 12:45:00,2019-03-31 13:00:00
119,6,0,6,0.0019789841184742955,2019-03-31 12:45:00,2019-03-31 13:00:00
120,10,6,4,0.012256672748080786,2019-03-31 12:45:00,2019-03-31 13:00:00
122,3,1,2,0.0033524528125986938,2019-03-31 12:45:00,2019-03-31 13:00:00
126,10,6,4,0.00825779680192979,2019-03-31 12:45:00,2019-03-31 13:00:00
127,8,8,0,0.006192651250367847,2019-03-31 12:45:00,2019-03-31 13:00:00
129,3,1,2,0.003441908234439098,2019-03-31 12:45:00,2019-03-31 13:00:00
135,3,0,3,0.0019789841184742955,2019-03-31 12:45:00,2019-03-31 13:00:00
137,19,12,7,0.015136965269981949,2019-03-31 12:45:00,2019-03-31 13:00:00
138,10,5,5,0.006064454482458461,2019-03-31 12:45:00,2019-03-31 13:00:00
140,2,2,0,0.004227994669107813,2019-03-31 12:45:00,2019-03-31 13:00:00
141,2,1,1,0.00370831905295099,2019-03-31 12:45:00,2019-03-31 13:00:00
147,2,1,1,0.0025957926978586905,2019-03-31 12:45:00,2019-03-31 13:00:00
151,4,2,2,0.013183943422602687,2019-03-31 12:45:00,2019-03-31 13:00:00
153,8,3,5,0.0048251727197246444,2019-03-31 12:45:00,2019-03-31 13:00:00
154,4,3,1,0.0036900793330344266,2019-03-31 12:45:00,2019-03-31 13:00:00
157,10,2,8,0.002889544737239919,2019-03-31 12:45:00,2019-03-31 13:00:00
158,8,4,4,0.0066074614535116954,2019-03-31 12:45:00,2019-03-31 13:00:00
159,2,2,0,0.004309388258936431,2019-03-31 12:45:00,2019-03-31 13:00:00
160,3,1,2,0.002741363962796781,2019-03-31 12:45:00,2019-03-31 13:00:00
161,4,2,2,0.013183943422602687,2019-03-31 12:45:00,2019-03-31 13:00:00
162,6,2,4,0.004277952308152604,2019-03-31 12:45:00,2019-03-31 13:00:00
164,22,12,10,0.012061198488493892,2019-03-31 12:45:00,2019-03-31 13:00:00
168,18,12,6,0.018948665665800044,2019-03-31 12:45:00,2019-03-31 13:00:00
169,21,19,2,0.13826166724173874,2019-03-31 12:45:00,2019-03-31 13:00:00
170,7,3,4,0.0081361485453748,2019-03-31 12:45:00,2019-03-31 13:00:00
171,10,4,6,0.0045674567802530715,2019-03-31 12:45:00,2019-03-31 13:00:00
173,4,3,1,0.0035152053729220816,2019-03-31 12:45:00,2019-03-31 13:00:00
177,11,8,3,0.013494308961341978,2019-03-31 12:45:00,2019-03-31 13:00:00
189,1,0,1,0.0019789841184742955,2019-03-31 12:45:00,2019-03-31 13:00:00
190,9,5,4,0.0067825614961460855,2019-03-31 12:45:00,2019-03-31 13:00:00
191,9,3,6,0.008112608006545388,2019-03-31 12:45:00,2019-03-31 13:00:00
196,2,2,0,0.0036612250610153644,2019-03-31 12:45:00,2019-03-31 13:00:00
197,7,2,5,0.0039867356169627395,2019-03-31 12:45:00,2019-03-31 13:00:00
199,3,3,0,0.003729234694679506,2019-03-31 12:45:00,2019-03-31 13:00:00
202,4,2,2,0.0059204399758463234,2019-03-31 12:45:00,2019-03-31 13:00:00
203,4,2,2,0.007972792952752487,2019-03-31 12:45:00,2019-03-31 13:00:00
1,14,6,8,0.007666811240569293,2019-03-31 13:00:00,2019-03-31 13:15:00
2,11,7,4,0.008445170481781741,2019-03-31 13:00:00,2019-03-31 13:15:00
5,12,3,9,0.002463654351525551,2019-03-31 13:00:00,2019-03-31 13:15:00
10,3,0,3,0.0017655934549798513,2019-03-31 13:00:00,2019-03-31 13:15:00
11,2,1,1,0.01176798111080793,2019-03-31 13:00:00,2019-03-31 13:15:00
13,3,2,1,0.0027661283473003253,2019-03-31 13:00:00,2019-03-31 13:15:00
15,3,1,2,0.0020409764082816007,2019-03-31 13:00:00,2019-03-31 13:15:00
16,11,4,7,0.003433246661554995,2019-03-31 13:00:00,2019-03-31 13:15:00
18,9,4,5,0.0035358943299166504,2019-03-31 13:00:00,2019-03-31 13:15:00
19,4,2,2,0.009016089002564827,2019-03-31 13:00:00,2019-03-31 13:15:00
20,10,6,4,0.007948903345953266,2019-03-31 13:00:00,2019-03-31 13:15:00
23,10,6,4,0.0170573179305005,2019-03-31 13:00:00,2019-03-31 13:15:00
26,17,9,8,0.012584510069186426,2019-03-31 13:00:00,2019-03-31 13:15:00
27,4,2,2,0.008891130876358809,2019-03-31 13:00:00,2019-03-31 13:15:00
28,7,2,5,0.0026751942418877218,2019-03-31 13:00:00,2019-03-31 13:15:00
30,1,1,0,0.002580292697299472,2019-03-31 13:00:00,2019-03-31 13:15:00
35,3,1,2,0.003070692139011646,2019-03-31 13:00:00,2019-03-31 13:15:00
37,1,0,1,0.0017655934549798513,2019-03-31 13:00:00,2019-03-31 13:15:00
41,7,3,4,0.0064418801907737385,2019-03-31 13:00:00,2019-03-31 13:15:00
46,4,4,0,0.003313112747801385,2019-03-31 13:00:00,2019-03-31 13:15:00
50,3,0,3,0.0017655934549798513,2019-03-31 13:00:00,2019-03-31 13:15:00
57,5,5,0,0.00972075312792101,2019-03-31 13:00:00,2019-03-31 13:15:00
58,7,2,5,0.005807994930917571,2019-03-31 13:00:00,2019-03-31 13:15:00
61,2,0,2,0.0017655934549798513,2019-03-31 13:00:00,2019-03-31 13:15:00
62,7,5,2,0.013469108602398984,2019-03-31 13:00:00,2019-03-31 13:15:00
64,6,3,3,0.01176798111080793,2019-03-31 13:00:00,2019-03-31 13:15:00
66,8,2,6,0.00385977614461695,2019-03-31 13:00:00,2019-03-31 13:15:00
67,16,14,2,0.021466855364577094,2019-03-31 13:00:00,2019-03-31 13:15:00
68,11,3,8,0.002591742314885099,2019-03-31 13:00:00,2019-03-31 13:15:00
70,2,1,1,0.0022325360722490234,2019-03-31 13:00:00,2019-03-31 13:15:00
71,4,2,2,0.01176798111080793,2019-03-31 13:00:00,2019-03-31 13:15:00
74,21,7,14,0.007689885850313929,2019-03-31 13:00:00,2019-03-31 13:15:00
75,17,5,12,0.0038076965059231794,2019-03-31 13:00:00,2019-03-31 13:15:00
86,3,3,0,0.004968459240384398,2019-03-31 13:00:00,2019-03-31 13:15:00
87,6,5,1,0.003936331546698549,2019-03-31 13:00:00,2019-03-31 13:15:00
88,5,3,2,0.01427296210212476,2019-03-31 13:00:00,2019-03-31 13:15:00
89,4,0,4,0.0017655934549798513,2019-03-31 13:00:00,2019-03-31 13:15:00
90,2,1,1,0.01176798111080793,2019-03-31 13:00:00,2019-03-31 13:15:00
104,1,0,1,0.0017655934549798513,2019-03-31 13:00:00,2019-03-31 13:15:00
106,6,2,4,0.003070692139011646,2019-03-31 13:00:00,2019-03-31 13:15:00
108,3,2,1,0.07249170720298409,2019-03-31 13:00:00,2019-03-31 13:15:00
109,18,7,11,0.0064490195546711435,2019-03-31 13:00:00,2019-03-31 13:15:00
110,15,8,7,0.016303024920203503,2019-03-31 13:00:00,2019-03-31 13:15:00
111,14,4,10,0.004424491107854438,2019-03-31 13:00:00,2019-03-31 13:15:00
112,3,1,2,0.002463654351525551,2019-03-31 13:00:00,2019-03-31 13:15:00
113,1,0,1,0.0017655934549798513,2019-03-31 13:00:00,2019-03-31 13:15:00
114,4,1,3,0.0022658609011400885,2019-03-31 13:00:00,2019-03-31 13:15:00
115,2,2,0,0.0028592412522964756,2019-03-31 13:00:00,2019-03-31 13:15:00
116,16,5,11,0.008103200143401445,2019-03-31 13:00:00,2019-03-31 13:15:00
118,12,7,5,0.011631896450158398,2019-03-31 13:00:00,2019-03-31 13:15:00
119,3,0,3,0.0017655934549798513,2019-03-31 13:00:00,2019-03-31 13:15:00
120,5,4,1,0.010286935677854627,2019-03-31 13:00:00,2019-03-31 13:15:00
122,1,0,1,0.0017655934549798513,2019-03-31 13:00:00,2019-03-31 13:15:00
126,21,13,8,0.014178521097446748,2019-03-31 13:00:00,2019-03-31 13:15:00
127,7,6,1,0.006971807754692333,2019-03-31 13:00:00,2019-03-31 13:15:00
129,2,0,2,0.0017655934549798513,2019-03-31 13:00:00,2019-03-31 13:15:00
133,1,1,0,0.0037455945948213533,2019-03-31 13:00:00,2019-03-31 13:15:00
137,19,12,7,0.011576535089360396,2019-03-31 13:00:00,2019-03-31 13:15:00
138,12,7,5,0.009001967557932979,2019-03-31 13:00:00,2019-03-31 13:15:00
140,1,1,0,0.0034549646717954435,2019-03-31 13:00:00,2019-03-31 13:15:00
141,2,1,1,0.0029069134878618144,2019-03-31 13:00:00,2019-03-31 13:15:00
147,9,3,6,0.00432986670782862,2019-03-31 13:00:00,2019-03-31 13:15:00
151,4,2,2,0.01176798111080793,2019-03-31 13:00:00,2019-03-31 13:15:00
153,6,3,3,0.004003353720863878,2019-03-31 13:00:00,2019-03-31 13:15:00
154,7,4,3,0.0036352423385958925,2019-03-31 13:00:00,2019-03-31 13:15:00
157,10,3,7,0.003054724271384157,2019-03-31 13:00:00,2019-03-31 13:15:00
158,9,1,8,0.0019754969719269484,2019-03-31 13:00:00,2019-03-31 13:15:00
159,2,2,0,0.003266395793460563,2019-03-31 13:00:00,2019-03-31 13:15:00
160,2,0,2,0.0017655934549798513,2019-03-31 13:00:00,2019-03-31 13:15:00
161,4,2,2,0.01176798111080793,2019-03-31 13:00:00,2019-03-31 13:15:00
162,3,0,3,0.0017655934549798513,2019-03-31 13:00:00,2019-03-31 13:15:00
164,15,8,7,0.009398183735569722,2019-03-31 13:00:00,2019-03-31 13:15:00
168,27,16,11,0.013350208259241683,2019-03-31 13:00:00,2019-03-31 13:15:00
169,23,21,2,0.14236957591974755,2019-03-31 13:00:00,2019-03-31 13:15:00
170,4,1,3,0.002463654351525551,2019-03-31 13:00:00,2019-03-31 13:15:00
171,3,1,2,0.003743310957351277,2019-03-31 13:00:00,2019-03-31 13:15:00
172,2,0,2,0.0017655934549798513,2019-03-31 13:00:00,2019-03-31 13:15:00
173,4,3,1,0.004181890849147498,2019-03-31 13:00:00,2019-03-31 13:15:00
177,6,6,0,0.004447740402169036,2019-03-31 13:00:00,2019-03-31 13:15:00
189,3,2,1,0.00515148220884268,2019-03-31 13:00:00,2019-03-31 13:15:00
190,8,5,3,0.006462463617535932,2019-03-31 13:00:00,2019-03-31 13:15:00
191,13,9,4,0.014265265020958836,2019-03-31 13:00:00,2019-03-31 13:15:00
196,3,3,0,0.004407715826342525,2019-03-31 13:00:00,2019-03-31 13:15:00
197,8,2,6,0.0029630151839145427,2019-03-31 13:00:00,2019-03-31 13:15:00
199,8,1,7,0.002009627841048551,2019-03-31 13:00:00,2019-03-31 13:15:00
201,3,2,1,0.014687363097300149,2019-03-31 13:00:00,2019-03-31 13:15:00
202,3,2,1,0.021770368766636013,2019-03-31 13:00:00,2019-03-31 13:15:00
203,11,6,5,0.037986883526089886,2019-03-31 13:00:00,2019-03-31 13:15:00
1,14,5,9,0.004050682007413017,2019-03-31 13:15:00,2019-03-31 13:30:00
2,7,3,4,0.005673812808206045,2019-03-31 13:15:00,2019-03-31 13:30:00
5,13,5,8,0.0057739197016281035,2019-03-31 13:15:00,2019-03-31 13:30:00
10,3,3,0,0.002871664886253105,2019-03-31 13:15:00,2019-03-31 13:30:00
11,4,2,2,0.011961703488626985,2019-03-31 13:15:00,2019-03-31 13:30:00
13,1,0,1,0.001795058656353236,2019-03-31 13:15:00,2019-03-31 13:30:00
15,4,2,2,0.003774318748796925,2019-03-31 13:15:00,2019-03-31 13:30:00
16,5,2,3,0.00414290786055278,2019-03-31 13:15:00,2019-03-31 13:30:00
18,10,2,8,0.003321970328628625,2019-03-31 13:15:00,2019-03-31 13:30:00
19,3,2,1,0.008429265489585593,2019-03-31 13:15:00,2019-03-31 13:30:00
20,6,5,1,0.0062542254423440646,2019-03-31 13:15:00,2019-03-31 13:30:00
23,11,7,4,0.015606049897882786,2019-03-31 13:15:00,2019-03-31 13:30:00
26,14,8,6,0.006946365914672182,2019-03-31 13:15:00,2019-03-31 13:30:00
27,2,1,1,0.011961703488626985,2019-03-31 13:15:00,2019-03-31 13:30:00
28,8,4,4,0.004453008378501154,2019-03-31 13:15:00,2019-03-31 13:30:00
30,4,1,3,0.002177668856879589,2019-03-31 13:15:00,2019-03-31 13:30:00
41,2,1,1,0.002100234713943135,2019-03-31 13:15:00,2019-03-31 13:30:00
46,4,4,0,0.0032068359457828495,2019-03-31 13:15:00,2019-03-31 13:30:00
50,4,1,3,0.003959218592108986,2019-03-31 13:15:00,2019-03-31 13:30:00
57,5,5,0,0.011042490166570072,2019-03-31 13:15:00,2019-03-31 13:30:00
58,5,1,4,0.008961817820742457,2019-03-31 13:15:00,2019-03-31 13:30:00
61,2,0,2,0.001795058656353236,2019-03-31 13:15:00,2019-03-31 13:30:00
62,19,11,8,0.022922204473062056,2019-03-31 13:15:00,2019-03-31 13:30:00
64,6,3,3,0.011961703488626985,2019-03-31 13:15:00,2019-03-31 13:30:00
66,9,0,9,0.001795058656353236,2019-03-31 13:15:00,2019-03-31 13:30:00
67,13,12,1,0.027543831753497866,2019-03-31 13:15:00,2019-03-31 13:30:00
68,5,0,5,0.001795058656353236,2019-03-31 13:15:00,2019-03-31 13:30:00
69,2,0,2,0.001795058656353236,2019-03-31 13:15:00,2019-03-31 13:30:00
70,3,1,2,0.003121996224977124,2019-03-31 13:15:00,2019-03-31 13:30:00
71,4,2,2,0.011961703488626985,2019-03-31 13:15:00,2019-03-31 13:30:00
74,11,4,7,0.005556793380718852,2019-03-31 13:15:00,2019-03-31 13:30:00
75,16,4,12,0.0032765133312709655,2019-03-31 13:15:00,2019-03-31 13:30:00
80,6,3,3,0.011961703488626985,2019-03-31 13:15:00,2019-03-31 13:30:00
85,12,7,5,0.03093571692976368,2019-03-31 13:15:00,2019-03-31 13:30:00
86,2,2,0,0.003040802170229848,2019-03-31 13:15:00,2019-03-31 13:30:00
87,3,3,0,0.0026801873506496167,2019-03-31 13:15:00,2019-03-31 13:30:00
88,5,3,2,0.01904394215851443,2019-03-31 13:15:00,2019-03-31 13:30:00
89,8,3,5,0.005307684255381666,2019-03-31 13:15:00,2019-03-31 13:30:00
90,3,2,1,0.02063107804991001,2019-03-31 13:15:00,2019-03-31 13:30:00
106,8,3,5,0.003663673927168153,2019-03-31 13:15:00,2019-03-31 13:30:00
108,7,4,3,0.0371683201348868,2019-03-31 13:15:00,2019-03-31 13:30:00
109,21,8,13,0.006127180245868566,2019-03-31 13:15:00,2019-03-31 13:30:00
110,14,9,5,0.009956364395623191,2019-03-31 13:15:00,2019-03-31 13:30:00
111,4,1,3,0.003756197430495948,2019-03-31 13:15:00,2019-03-31 13:30:00
112,5,3,2,0.013091330692212957,2019-03-31 13:15:00,2019-03-31 13:30:00
113,3,1,2,0.00400463255866953,2019-03-31 13:15:00,2019-03-31 13:30:00
114,4,2,2,0.004426705346550608,2019-03-31 13:15:00,2019-03-31 13:30:00
115,6,2,4,0.002134143164786457,2019-03-31 13:15:00,2019-03-31 13:30:00
116,10,2,8,0.002279474763524709,2019-03-31 13:15:00,2019-03-31 13:30:00
118,10,4,6,0.005069093186341581,2019-03-31 13:15:00,2019-03-31 13:30:00
119,6,3,3,0.0058908280978071945,2019-03-31 13:15:00,2019-03-31 13:30:00
120,8,6,2,0.01524311647859809,2019-03-31 13:15:00,2019-03-31 13:30:00
126,22,12,10,0.00853016354527512,2019-03-31 13:15:00,2019-03-31 13:30:00
127,13,7,6,0.015593482371805158,2019-03-31 13:15:00,2019-03-31 13:30:00
129,3,0,3,0.001795058656353236,2019-03-31 13:15:00,2019-03-31 13:30:00
133,1,1,0,0.0034881027750225547,2019-03-31 13:15:00,2019-03-31 13:30:00
137,22,12,10,0.01534831426004166,2019-03-31 13:15:00,2019-03-31 13:30:00
138,16,10,6,0.013840139635071556,2019-03-31 13:15:00,2019-03-31 13:30:00
140,2,0,2,0.001795058656353236,2019-03-31 13:15:00,2019-03-31 13:30:00
141,2,1,1,0.0034691426912070262,2019-03-31 13:15:00,2019-03-31 13:30:00
147,5,1,4,0.0027792352451827063,2019-03-31 13:15:00,2019-03-31 13:30:00
151,5,3,2,0.016072174345195357,2019-03-31 13:15:00,2019-03-31 13:30:00
153,5,3,2,0.003429870752108049,2019-03-31 13:15:00,2019-03-31 13:30:00
154,4,1,3,0.00245852744066518,2019-03-31 13:15:00,2019-03-31 13:30:00
157,14,7,7,0.006505115916424984,2019-03-31 13:15:00,2019-03-31 13:30:00
158,9,4,5,0.008398358272801639,2019-03-31 13:15:00,2019-03-31 13:30:00
160,1,1,0,0.0027792352451827063,2019-03-31 13:15:00,2019-03-31 13:30:00
161,4,2,2,0.011961703488626985,2019-03-31 13:15:00,2019-03-31 13:30:00
162,1,0,1,0.001795058656353236,2019-03-31 13:15:00,2019-03-31 13:30:00
164,13,8,5,0.009845702826678078,2019-03-31 13:15:00,2019-03-31 13:30:00
168,34,23,11,0.027998463753825892,2019-03-31 13:15:00,2019-03-31 13:30:00
169,27,23,4,0.1268704125470539,2019-03-31 13:15:00,2019-03-31 13:30:00
170,6,2,4,0.003121996224977124,2019-03-31 13:15:00,2019-03-31 13:30:00
171,1,1,0,0.0025133259154231924,2019-03-31 13:15:00,2019-03-31 13:30:00
172,6,2,4,0.003121996224977124,2019-03-31 13:15:00,2019-03-31 13:30:00
173,3,3,0,0.004412970526402817,2019-03-31 13:15:00,2019-03-31 13:30:00
177,5,3,2,0.006929824490709715,2019-03-31 13:15:00,2019-03-31 13:30:00
189,5,3,2,0.0057758713622249,2019-03-31 13:15:00,2019-03-31 13:30:00
190,4,1,3,0.002520241205307606,2019-03-31 13:15:00,2019-03-31 13:30:00
191,10,7,3,0.008577250997618295,2019-03-31 13:15:00,2019-03-31 13:30:00
196,3,3,0,0.004995022979156521,2019-03-31 13:15:00,2019-03-31 13:30:00
197,16,3,13,0.005487044903319395,2019-03-31 13:15:00,2019-03-31 13:30:00
199,6,0,6,0.001795058656353236,2019-03-31 13:15:00,2019-03-31 13:30:00
201,6,2,4,0.004525571617322542,2019-03-31 13:15:00,2019-03-31 13:30:00
203,18,7,11,0.017661386266688874,2019-03-31 13:15:00,2019-03-31 13:30:00
1,9,3,6,0.003078280527680169,2019-03-31 13:30:00,2019-03-31 13:45:00
2,8,4,4,0.009497561528465778,2019-03-31 13:30:00,2019-03-31 13:45:00
5,14,6,8,0.011343823520150863,2019-03-31 13:30:00,2019-03-31 13:45:00
10,4,2,2,0.002053849024443966,2019-03-31 13:30:00,2019-03-31 13:45:00
11,4,2,2,0.011777298966337215,2019-03-31 13:30:00,2019-03-31 13:45:00
13,1,0,1,0.001769975604440532,2019-03-31 13:30:00,2019-03-31 13:45:00
15,7,2,5,0.00793164306517114,2019-03-31 13:30:00,2019-03-31 13:45:00
16,5,3,2,0.016928789397720148,2019-03-31 13:30:00,2019-03-31 13:45:00
18,9,2,7,0.02636743663788695,2019-03-31 13:30:00,2019-03-31 13:45:00
19,5,4,1,0.008388149523906912,2019-03-31 13:30:00,2019-03-31 13:45:00
20,8,4,4,0.005884286243749455,2019-03-31 13:30:00,2019-03-31 13:45:00
23,13,8,5,0.011764191237214602,2019-03-31 13:30:00,2019-03-31 13:45:00
26,19,11,8,0.02487125131437199,2019-03-31 13:30:00,2019-03-31 13:45:00
27,1,0,1,0.001769975604440532,2019-03-31 13:30:00,2019-03-31 13:45:00
28,6,4,2,0.017576644592108573,2019-03-31 13:30:00,2019-03-31 13:45:00
30,3,0,3,0.001769975604440532,2019-03-31 13:30:00,2019-03-31 13:45:00
41,1,0,1,0.001769975604440532,2019-03-31 13:30:00,2019-03-31 13:45:00
46,8,5,3,0.006940593269507154,2019-03-31 13:30:00,2019-03-31 13:45:00
50,8,2,6,0.005513426644840372,2019-03-31 13:30:00,2019-03-31 13:45:00
57,6,5,1,0.010462024618452515,2019-03-31 13:30:00,2019-03-31 13:45:00
58,2,1,1,0.008900485536036217,2019-03-31 13:30:00,2019-03-31 13:45:00
61,2,0,2,0.001769975604440532,2019-03-31 13:30:00,2019-03-31 13:45:00
62,21,9,12,0.008858631878845792,2019-03-31 13:30:00,2019-03-31 13:45:00
64,6,3,3,0.011777298966337215,2019-03-31 13:30:00,2019-03-31 13:45:00
66,7,0,7,0.001769975604440532,2019-03-31 13:30:00,2019-03-31 13:45:00
67,15,14,1,0.009126432551102933,2019-03-31 13:30:00,2019-03-31 13:45:00
68,4,0,4,0.001769975604440532,2019-03-31 13:30:00,2019-03-31 13:45:00
69,8,3,5,0.0036123050977780367,2019-03-31 13:30:00,2019-03-31 13:45:00
70,6,2,4,0.01209936328417388,2019-03-31 13:30:00,2019-03-31 13:45:00
74,9,3,6,0.006765643640369004,2019-03-31 13:30:00,2019-03-31 13:45:00
75,16,4,12,0.002763252244231061,2019-03-31 13:30:00,2019-03-31 13:45:00
85,6,3,3,0.007424235175812614,2019-03-31 13:30:00,2019-03-31 13:45:00
86,2,2,0,0.0024461741076785056,2019-03-31 13:30:00,2019-03-31 13:45:00
87,2,2,0,0.002772985484463023,2019-03-31 13:30:00,2019-03-31 13:45:00
88,4,2,2,0.011777298966337215,2019-03-31 13:30:00,2019-03-31 13:45:00
89,6,2,4,0.0058194524860986675,2019-03-31 13:30:00,2019-03-31 13:45:00
90,3,2,1,0.025102336284317954,2019-03-31 13:30:00,2019-03-31 13:45:00
101,1,1,0,0.002146104309448966,2019-03-31 13:30:00,2019-03-31 13:45:00
106,10,3,7,0.0027842733592974922,2019-03-31 13:30:00,2019-03-31 13:45:00
108,6,3,3,0.004664338150039936,2019-03-31 13:30:00,2019-03-31 13:45:00
109,20,9,11,0.019055848068936468,2019-03-31 13:30:00,2019-03-31 13:45:00
110,14,10,4,0.014641774973442425,2019-03-31 13:30:00,2019-03-31 13:45:00
112,7,4,3,0.010515632184186215,2019-03-31 13:30:00,2019-03-31 13:45:00
113,5,3,2,0.004186099647422293,2019-03-31 13:30:00,2019-03-31 13:45:00
114,3,1,2,0.002146104309448966,2019-03-31 13:30:00,2019-03-31 13:45:00
115,11,4,7,0.009168563350001463,2019-03-31 13:30:00,2019-03-31 13:45:00
116,3,0,3,0.001769975604440532,2019-03-31 13:30:00,2019-03-31 13:45:00
118,9,3,6,0.005705704765562803,2019-03-31 13:30:00,2019-03-31 13:45:00
119,9,7,2,0.020577760621447935,2019-03-31 13:30:00,2019-03-31 13:45:00
120,12,10,2,0.015719557060831783,2019-03-31 13:30:00,2019-03-31 13:45:00
126,22,12,10,0.01453649217382734,2019-03-31 13:30:00,2019-03-31 13:45:00
127,11,5,6,0.005684383763524583,2019-03-31 13:30:00,2019-03-31 13:45:00
129,5,0,5,0.001769975604440532,2019-03-31 13:30:00,2019-03-31 13:45:00
133,1,1,0,0.004881779572936352,2019-03-31 13:30:00,2019-03-31 13:45:00
135,2,2,0,0.0070560416237196045,2019-03-31 13:30:00,2019-03-31 13:45:00
137,28,14,14,0.03334422506503495,2019-03-31 13:30:00,2019-03-31 13:45:00
138,16,9,7,0.021292601417590148,2019-03-31 13:30:00,2019-03-31 13:45:00
140,1,1,0,0.0020708785684472792,2019-03-31 13:30:00,2019-03-31 13:45:00
141,1,0,1,0.001769975604440532,2019-03-31 13:30:00,2019-03-31 13:45:00
147,5,1,4,0.0044130086140800676,2019-03-31 13:30:00,2019-03-31 13:45:00
151,7,5,2,0.006567093656319202,2019-03-31 13:30:00,2019-03-31 13:45:00
153,7,6,1,0.00817052652424379,2019-03-31 13:30:00,2019-03-31 13:45:00
157,11,5,6,0.007484766049701568,2019-03-31 13:30:00,2019-03-31 13:45:00
158,10,5,5,0.010440833560824543,2019-03-31 13:30:00,2019-03-31 13:45:00
160,3,0,3,0.001769975604440532,2019-03-31 13:30:00,2019-03-31 13:45:00
161,4,2,2,0.011777298966337215,2019-03-31 13:30:00,2019-03-31 13:45:00
162,1,0,1,0.001769975604440532,2019-03-31 13:30:00,2019-03-31 13:45:00
164,16,11,5,0.02467202776376355,2019-03-31 13:30:00,2019-03-31 13:45:00
168,36,26,10,0.03484577286523914,2019-03-31 13:30:00,2019-03-31 13:45:00
169,19,17,2,0.05323856049370684,2019-03-31 13:30:00,2019-03-31 13:45:00
170,5,2,3,0.004084729281646686,2019-03-31 13:30:00,2019-03-31 13:45:00
171,4,4,0,0.007386995502996799,2019-03-31 13:30:00,2019-03-31 13:45:00
172,6,2,4,0.003078280527680169,2019-03-31 13:30:00,2019-03-31 13:45:00
173,1,0,1,0.001769975604440532,2019-03-31 13:30:00,2019-03-31 13:45:00
175,8,4,4,0.011777298966337215,2019-03-31 13:30:00,2019-03-31 13:45:00
177,4,3,1,0.029477192012924428,2019-03-31 13:30:00,2019-03-31 13:45:00
189,3,0,3,0.001769975604440532,2019-03-31 13:30:00,2019-03-31 13:45:00
190,4,1,3,0.003005747487614431,2019-03-31 13:30:00,2019-03-31 13:45:00
191,8,4,4,0.004866249467185212,2019-03-31 13:30:00,2019-03-31 13:45:00
196,3,3,0,0.007469348513703121,2019-03-31 13:30:00,2019-03-31 13:45:00
197,18,4,14,0.0023377224444474,2019-03-31 13:30:00,2019-03-31 13:45:00
199,5,0,5,0.001769975604440532,2019-03-31 13:30:00,2019-03-31 13:45:00
201,4,0,4,0.001769975604440532,2019-03-31 13:30:00,2019-03-31 13:45:00
203,23,9,14,0.02261658069215846,2019-03-31 13:30:00,2019-03-31 13:45:00
1,6,3,3,0.004610156123768564,2019-03-31 13:45:00,2019-03-31 14:00:00
2,9,3,6,0.0050877786909960965,2019-03-31 13:45:00,2019-03-31 14:00:00
5,10,5,5,0.005687221080164757,2019-03-31 13:45:00,2019-03-31 14:00:00
10,3,1,2,0.0018552218699391609,2019-03-31 13:45:00,2019-03-31 14:00:00
11,6,3,3,0.011356161316273932,2019-03-31 13:45:00,2019-03-31 14:00:00
15,6,0,6,0.001704310641225885,2019-03-31 13:45:00,2019-03-31 14:00:00
16,7,5,2,0.03722031093632897,2019-03-31 13:45:00,2019-03-31 14:00:00
18,11,4,7,0.01660054113371336,2019-03-31 13:45:00,2019-03-31 14:00:00
19,6,4,2,0.010160072434743091,2019-03-31 13:45:00,2019-03-31 14:00:00
20,10,5,5,0.005741179842120671,2019-03-31 13:45:00,2019-03-31 14:00:00
23,18,11,7,0.013731980140158901,2019-03-31 13:45:00,2019-03-31 14:00:00
26,22,13,9,0.021036892140865977,2019-03-31 13:45:00,2019-03-31 14:00:00
27,5,1,4,0.002164228351028171,2019-03-31 13:45:00,2019-03-31 14:00:00
28,8,3,5,0.003478375992655992,2019-03-31 13:45:00,2019-03-31 14:00:00
30,3,0,3,0.001704310641225885,2019-03-31 13:45:00,2019-03-31 14:00:00
41,5,2,3,0.003254316562742025,2019-03-31 13:45:00,2019-03-31 14:00:00
46,10,8,2,0.018840276221425506,2019-03-31 13:45:00,2019-03-31 14:00:00
50,6,1,5,0.0033561953617112167,2019-03-31 13:45:00,2019-03-31 14:00:00
57,7,5,2,0.008239719993809281,2019-03-31 13:45:00,2019-03-31 14:00:00
58,5,4,1,0.009355593564761828,2019-03-31 13:45:00,2019-03-31 14:00:00
61,3,1,2,0.0019975340805128933,2019-03-31 13:45:00,2019-03-31 14:00:00
62,17,8,9,0.006238014928021529,2019-03-31 13:45:00,2019-03-31 14:00:00
64,6,3,3,0.011356161316273932,2019-03-31 13:45:00,2019-03-31 14:00:00
66,6,0,6,0.001704310641225885,2019-03-31 13:45:00,2019-03-31 14:00:00
67,7,5,2,0.005774418293312341,2019-03-31 13:45:00,2019-03-31 14:00:00
68,8,2,6,0.0036134723275043678,2019-03-31 13:45:00,2019-03-31 14:00:00
69,12,7,5,0.011864583052874076,2019-03-31 13:45:00,2019-03-31 14:00:00
70,6,1,5,0.0022162752010448884,2019-03-31 13:45:00,2019-03-31 14:00:00
71,8,4,4,0.011356161316273932,2019-03-31 13:45:00,2019-03-31 14:00:00
74,4,2,2,0.003146111639421718,2019-03-31 13:45:00,2019-03-31 14:00:00
75,15,4,11,0.0025870517142783604,2019-03-31 13:45:00,2019-03-31 14:00:00
79,2,1,1,0.00317797744817974,2019-03-31 13:45:00,2019-03-31 14:00:00
85,2,0,2,0.001704310641225885,2019-03-31 13:45:00,2019-03-31 14:00:00
86,1,1,0,0.00317797744817974,2019-03-31 13:45:00,2019-03-31 14:00:00
87,4,2,2,0.0026701242164473156,2019-03-31 13:45:00,2019-03-31 14:00:00
88,7,2,5,0.0025823482974430055,2019-03-31 13:45:00,2019-03-31 14:00:00
89,5,0,5,0.001704310641225885,2019-03-31 13:45:00,2019-03-31 14:00:00
90,6,4,2,0.02285614999157575,2019-03-31 13:45:00,2019-03-31 14:00:00
101,1,1,0,0.0022162752010448884,2019-03-31 13:45:00,2019-03-31 14:00:00
104,1,1,0,0.003691516066101214,2019-03-31 13:45:00,2019-03-31 14:00:00
106,8,3,5,0.003478375992655992,2019-03-31 13:45:00,2019-03-31 14:00:00
108,2,1,1,0.0030415763250555864,2019-03-31 13:45:00,2019-03-31 14:00:00
109,29,12,17,0.01321433725166116,2019-03-31 13:45:00,2019-03-31 14:00:00
110,14,10,4,0.025435348609429413,2019-03-31 13:45:00,2019-03-31 14:00:00
111,7,2,5,0.0025823482974430055,2019-03-31 13:45:00,2019-03-31 14:00:00
112,18,7,11,0.0038802144259033546,2019-03-31 13:45:00,2019-03-31 14:00:00
113,9,4,5,0.003093121116368016,2019-03-31 13:45:00,2019-03-31 14:00:00
114,2,1,1,0.003153031004058031,2019-03-31 13:45:00,2019-03-31 14:00:00
115,8,4,4,0.012432491883592411,2019-03-31 13:45:00,2019-03-31 14:00:00
116,3,0,3,0.001704310641225885,2019-03-31 13:45:00,2019-03-31 14:00:00
118,1,1,0,0.0024252111403238012,2019-03-31 13:45:00,2019-03-31 14:00:00
119,9,8,1,0.06997225178988499,2019-03-31 13:45:00,2019-03-31 14:00:00
120,12,10,2,0.012657016701980509,2019-03-31 13:45:00,2019-03-31 14:00:00
126,28,12,16,0.005518973342526431,2019-03-31 13:45:00,2019-03-31 14:00:00
127,13,4,9,0.003045495842488245,2019-03-31 13:45:00,2019-03-31 14:00:00
129,6,0,6,0.001704310641225885,2019-03-31 13:45:00,2019-03-31 14:00:00
135,2,2,0,0.0056787214909765436,2019-03-31 13:45:00,2019-03-31 14:00:00
137,30,18,12,0.025866273185933993,2019-03-31 13:45:00,2019-03-31 14:00:00
138,18,13,5,0.01457246492789157,2019-03-31 13:45:00,2019-03-31 14:00:00
140,1,1,0,0.0019457640350312427,2019-03-31 13:45:00,2019-03-31 14:00:00
141,1,0,1,0.001704310641225885,2019-03-31 13:45:00,2019-03-31 14:00:00
147,5,1,4,0.003691516066101214,2019-03-31 13:45:00,2019-03-31 14:00:00
151,13,8,5,0.008667859003502636,2019-03-31 13:45:00,2019-03-31 14:00:00
153,8,6,2,0.007802717582064513,2019-03-31 13:45:00,2019-03-31 14:00:00
154,4,2,2,0.00302605129085851,2019-03-31 13:45:00,2019-03-31 14:00:00
157,11,5,6,0.005459264615144845,2019-03-31 13:45:00,2019-03-31 14:00:00
158,15,9,6,0.04009974315264569,2019-03-31 13:45:00,2019-03-31 14:00:00
159,1,0,1,0.001704310641225885,2019-03-31 13:45:00,2019-03-31 14:00:00
160,10,3,7,0.005819111587761947,2019-03-31 13:45:00,2019-03-31 14:00:00
162,1,0,1,0.001704310641225885,2019-03-31 13:45:00,2019-03-31 14:00:00
164,13,9,4,0.028859757743112925,2019-03-31 13:45:00,2019-03-31 14:00:00
168,50,31,19,0.03691774439430012,2019-03-31 13:45:00,2019-03-31 14:00:00
169,26,19,7,0.02376394767143347,2019-03-31 13:45:00,2019-03-31 14:00:00
170,8,3,5,0.0030366897048536303,2019-03-31 13:45:00,2019-03-31 14:00:00
171,8,5,3,0.03353545741217818,2019-03-31 13:45:00,2019-03-31 14:00:00
172,4,2,2,0.0044589754109225456,2019-03-31 13:45:00,2019-03-31 14:00:00
173,5,2,3,0.003933323998682537,2019-03-31 13:45:00,2019-03-31 14:00:00
175,8,4,4,0.011356161316273932,2019-03-31 13:45:00,2019-03-31 14:00:00
177,8,5,3,0.024446855200058504,2019-03-31 13:45:00,2019-03-31 14:00:00
189,5,2,3,0.005262418251818142,2019-03-31 13:45:00,2019-03-31 14:00:00
190,5,5,0,0.004775478279714649,2019-03-31 13:45:00,2019-03-31 14:00:00
191,11,4,7,0.005170335009065923,2019-03-31 13:45:00,2019-03-31 14:00:00
196,3,3,0,0.00953667495968069,2019-03-31 13:45:00,2019-03-31 14:00:00
197,17,4,13,0.002307955556078988,2019-03-31 13:45:00,2019-03-31 14:00:00
199,2,0,2,0.001704310641225885,2019-03-31 13:45:00,2019-03-31 14:00:00
201,1,0,1,0.001704310641225885,2019-03-31 13:45:00,2019-03-31 14:00:00
203,21,9,12,0.012220186775480616,2019-03-31 13:45:00,2019-03-31 14:00:00
1,13,7,6,0.006810287736355483,2019-03-31 14:00:00,2019-03-31 14:15:00
2,14,4,10,0.006926082355587289,2019-03-31 14:00:00,2019-03-31 14:15:00
5,13,7,6,0.006078901775970013,2019-03-31 14:00:00,2019-03-31 14:15:00
10,5,2,3,0.0020203502793542743,2019-03-31 14:00:00,2019-03-31 14:15:00
11,6,3,3,0.010045218843167404,2019-03-31 14:00:00,2019-03-31 14:15:00
15,7,1,6,0.0037878930419314363,2019-03-31 14:00:00,2019-03-31 14:15:00
16,9,5,4,0.010043044808619108,2019-03-31 14:00:00,2019-03-31 14:15:00
18,7,2,5,0.004602737873295267,2019-03-31 14:00:00,2019-03-31 14:15:00
19,5,2,3,0.0067444990088800175,2019-03-31 14:00:00,2019-03-31 14:15:00
20,11,2,9,0.0018580075278489948,2019-03-31 14:00:00,2019-03-31 14:15:00
23,15,10,5,0.01631700770818592,2019-03-31 14:00:00,2019-03-31 14:15:00
26,33,16,17,0.014548213787350127,2019-03-31 14:00:00,2019-03-31 14:15:00
27,4,0,4,0.0015070469687813019,2019-03-31 14:00:00,2019-03-31 14:15:00
28,8,5,3,0.017662368197836176,2019-03-31 14:00:00,2019-03-31 14:15:00
30,2,0,2,0.0015070469687813019,2019-03-31 14:00:00,2019-03-31 14:15:00
37,1,1,0,0.002831651549983178,2019-03-31 14:00:00,2019-03-31 14:15:00
41,7,2,5,0.0025054115767635266,2019-03-31 14:00:00,2019-03-31 14:15:00
46,8,7,1,0.02423926060934531,2019-03-31 14:00:00,2019-03-31 14:15:00
50,4,0,4,0.0015070469687813019,2019-03-31 14:00:00,2019-03-31 14:15:00
57,10,8,2,0.02343030653007628,2019-03-31 14:00:00,2019-03-31 14:15:00
58,9,7,2,0.008640322022550374,2019-03-31 14:00:00,2019-03-31 14:15:00
61,8,5,3,0.006315665744436352,2019-03-31 14:00:00,2019-03-31 14:15:00
62,21,9,12,0.005131120773950861,2019-03-31 14:00:00,2019-03-31 14:15:00
64,6,3,3,0.010045218843167404,2019-03-31 14:00:00,2019-03-31 14:15:00
66,6,0,6,0.0015070469687813019,2019-03-31 14:00:00,2019-03-31 14:15:00
67,18,9,9,0.014553509325625337,2019-03-31 14:00:00,2019-03-31 14:15:00
68,17,7,10,0.0093843238386094,2019-03-31 14:00:00,2019-03-31 14:15:00
69,25,14,11,0.02333035752493066,2019-03-31 14:00:00,2019-03-31 14:15:00
70,4,0,4,0.0015070469687813019,2019-03-31 14:00:00,2019-03-31 14:15:00
71,8,4,4,0.010045218843167404,2019-03-31 14:00:00,2019-03-31 14:15:00
74,6,4,2,0.004280288366869978,2019-03-31 14:00:00,2019-03-31 14:15:00
75,5,2,3,0.001873047613898807,2019-03-31 14:00:00,2019-03-31 14:15:00
79,2,1,1,0.00198675376746356,2019-03-31 14:00:00,2019-03-31 14:15:00
80,4,2,2,0.010045218843167404,2019-03-31 14:00:00,2019-03-31 14:15:00
85,2,1,1,0.001870506671253989,2019-03-31 14:00:00,2019-03-31 14:15:00
86,8,4,4,0.004289545969388028,2019-03-31 14:00:00,2019-03-31 14:15:00
87,2,0,2,0.0015070469687813019,2019-03-31 14:00:00,2019-03-31 14:15:00
88,10,5,5,0.008297834151482613,2019-03-31 14:00:00,2019-03-31 14:15:00
89,2,1,1,0.0034206705521613997,2019-03-31 14:00:00,2019-03-31 14:15:00
90,7,5,2,0.03454323382143016,2019-03-31 14:00:00,2019-03-31 14:15:00
99,5,3,2,0.014882208558511871,2019-03-31 14:00:00,2019-03-31 14:15:00
101,3,2,1,0.015338614320491514,2019-03-31 14:00:00,2019-03-31 14:15:00
104,4,3,1,0.0036895347478465234,2019-03-31 14:00:00,2019-03-31 14:15:00
106,8,3,5,0.0030756479563912465,2019-03-31 14:00:00,2019-03-31 14:15:00
108,1,0,1,0.0015070469687813019,2019-03-31 14:00:00,2019-03-31 14:15:00
109,24,11,13,0.017122550272980687,2019-03-31 14:00:00,2019-03-31 14:15:00
110,13,9,4,0.02961309811624988,2019-03-31 14:00:00,2019-03-31 14:15:00
111,12,6,6,0.011718616196050963,2019-03-31 14:00:00,2019-03-31 14:15:00
112,10,3,7,0.004514814855467416,2019-03-31 14:00:00,2019-03-31 14:15:00
113,8,1,7,0.0017153403749997327,2019-03-31 14:00:00,2019-03-31 14:15:00
114,5,3,2,0.003891424193081694,2019-03-31 14:00:00,2019-03-31 14:15:00
115,3,2,1,0.004602737873295267,2019-03-31 14:00:00,2019-03-31 14:15:00
116,3,3,0,0.004311807519701554,2019-03-31 14:00:00,2019-03-31 14:15:00
118,6,4,2,0.007742455310443973,2019-03-31 14:00:00,2019-03-31 14:15:00
119,10,9,1,0.0635690925502852,2019-03-31 14:00:00,2019-03-31 14:15:00
120,12,6,6,0.013504512750269301,2019-03-31 14:00:00,2019-03-31 14:15:00
126,21,6,15,0.0022834174589127574,2019-03-31 14:00:00,2019-03-31 14:15:00
127,8,3,5,0.002330183071832763,2019-03-31 14:00:00,2019-03-31 14:15:00
129,7,0,7,0.0015070469687813019,2019-03-31 14:00:00,2019-03-31 14:15:00
135,2,2,0,0.0029620388214914493,2019-03-31 14:00:00,2019-03-31 14:15:00
137,19,12,7,0.011778923925202689,2019-03-31 14:00:00,2019-03-31 14:15:00
138,29,19,10,0.015581198595675973,2019-03-31 14:00:00,2019-03-31 14:15:00
140,3,0,3,0.0015070469687813019,2019-03-31 14:00:00,2019-03-31 14:15:00
141,3,2,1,0.005334294135541497,2019-03-31 14:00:00,2019-03-31 14:15:00
147,5,1,4,0.0022345428951363756,2019-03-31 14:00:00,2019-03-31 14:15:00
151,11,4,7,0.003950472545971443,2019-03-31 14:00:00,2019-03-31 14:15:00
153,9,7,2,0.014356209500281996,2019-03-31 14:00:00,2019-03-31 14:15:00
154,2,0,2,0.0015070469687813019,2019-03-31 14:00:00,2019-03-31 14:15:00
157,10,5,5,0.00821371759327951,2019-03-31 14:00:00,2019-03-31 14:15:00
158,9,4,5,0.013414199421621064,2019-03-31 14:00:00,2019-03-31 14:15:00
159,1,0,1,0.0015070469687813019,2019-03-31 14:00:00,2019-03-31 14:15:00
160,7,2,5,0.003850379920186825,2019-03-31 14:00:00,2019-03-31 14:15:00
162,3,2,1,0.002233966373726676,2019-03-31 14:00:00,2019-03-31 14:15:00
164,15,8,7,0.018457630007974117,2019-03-31 14:00:00,2019-03-31 14:15:00
168,37,20,17,0.020769484497208997,2019-03-31 14:00:00,2019-03-31 14:15:00
169,26,17,9,0.01638638558507364,2019-03-31 14:00:00,2019-03-31 14:15:00
170,4,2,2,0.003574624285642423,2019-03-31 14:00:00,2019-03-31 14:15:00
171,9,7,2,0.054319406546596026,2019-03-31 14:00:00,2019-03-31 14:15:00
172,4,3,1,0.009658142004817325,2019-03-31 14:00:00,2019-03-31 14:15:00
173,5,3,2,0.021068213887741733,2019-03-31 14:00:00,2019-03-31 14:15:00
175,8,4,4,0.010045218843167404,2019-03-31 14:00:00,2019-03-31 14:15:00
177,14,5,9,0.005305254731138463,2019-03-31 14:00:00,2019-03-31 14:15:00
189,3,2,1,0.007792896875812911,2019-03-31 14:00:00,2019-03-31 14:15:00
190,10,10,0,0.005082006467180607,2019-03-31 14:00:00,2019-03-31 14:15:00
191,9,4,5,0.003408944144921497,2019-03-31 14:00:00,2019-03-31 14:15:00
196,5,3,2,0.007328296871450632,2019-03-31 14:00:00,2019-03-31 14:15:00
197,15,5,10,0.0035882827191611195,2019-03-31 14:00:00,2019-03-31 14:15:00
199,2,0,2,0.0015070469687813019,2019-03-31 14:00:00,2019-03-31 14:15:00
201,3,2,1,0.001873047613898807,2019-03-31 14:00:00,2019-03-31 14:15:00
202,1,0,1,0.0015070469687813019,2019-03-31 14:00:00,2019-03-31 14:15:00
203,18,9,9,0.013627120143956764,2019-03-31 14:00:00,2019-03-31 14:15:00
1,13,7,6,0.00649342079498018,2019-03-31 14:15:00,2019-03-31 14:30:00
2,23,12,11,0.022713330843396756,2019-03-31 14:15:00,2019-03-31 14:30:00
5,11,6,5,0.006040740814737906,2019-03-31 14:15:00,2019-03-31 14:30:00
10,7,4,3,0.005163840348587652,2019-03-31 14:15:00,2019-03-31 14:30:00
11,7,3,4,0.004462884027368656,2019-03-31 14:15:00,2019-03-31 14:30:00
13,2,2,0,0.006584759088362662,2019-03-31 14:15:00,2019-03-31 14:30:00
15,8,2,6,0.0034292782351132353,2019-03-31 14:15:00,2019-03-31 14:30:00
16,7,4,3,0.011479241519483721,2019-03-31 14:15:00,2019-03-31 14:30:00
18,8,5,3,0.014330527175397331,2019-03-31 14:15:00,2019-03-31 14:30:00
19,8,1,7,0.002185316349094997,2019-03-31 14:15:00,2019-03-31 14:30:00
20,11,3,8,0.002456060655227621,2019-03-31 14:15:00,2019-03-31 14:30:00
22,1,0,1,0.001617682001063153,2019-03-31 14:15:00,2019-03-31 14:30:00
23,12,9,3,0.010761214230541688,2019-03-31 14:15:00,2019-03-31 14:30:00
26,22,8,14,0.014720401796145248,2019-03-31 14:15:00,2019-03-31 14:30:00
27,2,0,2,0.001617682001063153,2019-03-31 14:15:00,2019-03-31 14:30:00
28,5,3,2,0.005843023970257544,2019-03-31 14:15:00,2019-03-31 14:30:00
30,2,0,2,0.001617682001063153,2019-03-31 14:15:00,2019-03-31 14:30:00
37,1,1,0,0.002681568971174762,2019-03-31 14:15:00,2019-03-31 14:30:00
40,2,2,0,0.006228161794171577,2019-03-31 14:15:00,2019-03-31 14:30:00
41,10,4,6,0.004207733688694967,2019-03-31 14:15:00,2019-03-31 14:30:00
46,9,7,2,0.008703358300361914,2019-03-31 14:15:00,2019-03-31 14:30:00
50,4,0,4,0.001617682001063153,2019-03-31 14:15:00,2019-03-31 14:30:00
57,7,6,1,0.01578302114194846,2019-03-31 14:15:00,2019-03-31 14:30:00
58,9,6,3,0.003712961868193811,2019-03-31 14:15:00,2019-03-31 14:30:00
61,7,4,3,0.004996424983436067,2019-03-31 14:15:00,2019-03-31 14:30:00
62,31,14,17,0.005662193018402243,2019-03-31 14:15:00,2019-03-31 14:30:00
64,6,3,3,0.010771474856157487,2019-03-31 14:15:00,2019-03-31 14:30:00
66,10,2,8,0.005940741371359415,2019-03-31 14:15:00,2019-03-31 14:30:00
67,30,13,17,0.015386345316538416,2019-03-31 14:15:00,2019-03-31 14:30:00
68,6,2,4,0.002606668206321613,2019-03-31 14:15:00,2019-03-31 14:30:00
69,25,14,11,0.03358483955497381,2019-03-31 14:15:00,2019-03-31 14:30:00
70,3,1,2,0.0022489820342440937,2019-03-31 14:15:00,2019-03-31 14:30:00
71,8,4,4,0.010771474856157487,2019-03-31 14:15:00,2019-03-31 14:30:00
74,9,6,3,0.005803143537660529,2019-03-31 14:15:00,2019-03-31 14:30:00
75,4,1,3,0.0022138084547786785,2019-03-31 14:15:00,2019-03-31 14:30:00
79,1,0,1,0.001617682001063153,2019-03-31 14:15:00,2019-03-31 14:30:00
80,8,3,5,0.0033014998629883486,2019-03-31 14:15:00,2019-03-31 14:30:00
85,1,1,0,0.001900801336443018,2019-03-31 14:15:00,2019-03-31 14:30:00
86,10,6,4,0.007513948381864741,2019-03-31 14:15:00,2019-03-31 14:30:00
87,2,2,0,0.003721792832062176,2019-03-31 14:15:00,2019-03-31 14:30:00
88,7,5,2,0.05031418333634598,2019-03-31 14:15:00,2019-03-31 14:30:00
89,1,0,1,0.001617682001063153,2019-03-31 14:15:00,2019-03-31 14:30:00
90,6,2,4,0.0029476143494986343,2019-03-31 14:15:00,2019-03-31 14:30:00
99,2,2,0,0.003405434361618662,2019-03-31 14:15:00,2019-03-31 14:30:00
101,8,4,4,0.010771474856157487,2019-03-31 14:15:00,2019-03-31 14:30:00
104,3,2,1,0.003405434361618662,2019-03-31 14:15:00,2019-03-31 14:30:00
106,8,3,5,0.0033014998629883486,2019-03-31 14:15:00,2019-03-31 14:30:00
108,1,0,1,0.001617682001063153,2019-03-31 14:15:00,2019-03-31 14:30:00
109,21,8,13,0.010758073911802309,2019-03-31 14:15:00,2019-03-31 14:30:00
110,16,8,8,0.01858244157063391,2019-03-31 14:15:00,2019-03-31 14:30:00
111,10,5,5,0.012712750849615968,2019-03-31 14:15:00,2019-03-31 14:30:00
112,7,3,4,0.003421830325836579,2019-03-31 14:15:00,2019-03-31 14:30:00
113,3,0,3,0.001617682001063153,2019-03-31 14:15:00,2019-03-31 14:30:00
114,11,7,4,0.00438996450965644,2019-03-31 14:15:00,2019-03-31 14:30:00
115,6,2,4,0.002671144320920976,2019-03-31 14:15:00,2019-03-31 14:30:00
116,3,3,0,0.005530623834025273,2019-03-31 14:15:00,2019-03-31 14:30:00
118,9,4,5,0.013094327026906556,2019-03-31 14:15:00,2019-03-31 14:30:00
119,16,9,7,0.011060470538051122,2019-03-31 14:15:00,2019-03-31 14:30:00
120,12,7,5,0.02100788829282219,2019-03-31 14:15:00,2019-03-31 14:30:00
126,16,4,12,0.0022572549644109953,2019-03-31 14:15:00,2019-03-31 14:30:00
127,15,3,12,0.003099877669687651,2019-03-31 14:15:00,2019-03-31 14:30:00
129,11,3,8,0.004283379231272769,2019-03-31 14:15:00,2019-03-31 14:30:00
137,29,18,11,0.03150050227526553,2019-03-31 14:15:00,2019-03-31 14:30:00
138,28,16,12,0.015017814708710801,2019-03-31 14:15:00,2019-03-31 14:30:00
140,5,3,2,0.0034969276559094612,2019-03-31 14:15:00,2019-03-31 14:30:00
141,4,2,2,0.008761328212411337,2019-03-31 14:15:00,2019-03-31 14:30:00
147,5,3,2,0.0166774920595847,2019-03-31 14:15:00,2019-03-31 14:30:00
151,10,4,6,0.004107527119208537,2019-03-31 14:15:00,2019-03-31 14:30:00
153,12,11,1,0.010687023890493003,2019-03-31 14:15:00,2019-03-31 14:30:00
154,1,0,1,0.001617682001063153,2019-03-31 14:15:00,2019-03-31 14:30:00
157,11,5,6,0.005357280502804254,2019-03-31 14:15:00,2019-03-31 14:30:00
158,5,1,4,0.002054214047549507,2019-03-31 14:15:00,2019-03-31 14:30:00
159,2,1,1,0.004213280260340763,2019-03-31 14:15:00,2019-03-31 14:30:00
160,5,1,4,0.0029927461886268816,2019-03-31 14:15:00,2019-03-31 14:30:00
161,1,1,0,0.004052230290205294,2019-03-31 14:15:00,2019-03-31 14:30:00
162,3,2,1,0.0021839206718228827,2019-03-31 14:15:00,2019-03-31 14:30:00
164,21,12,9,0.01944784148000406,2019-03-31 14:15:00,2019-03-31 14:30:00
168,32,17,15,0.026633874413157555,2019-03-31 14:15:00,2019-03-31 14:30:00
169,34,23,11,0.02982823983427657,2019-03-31 14:15:00,2019-03-31 14:30:00
170,2,1,1,0.010771474856157487,2019-03-31 14:15:00,2019-03-31 14:30:00
171,8,5,3,0.009488649929733407,2019-03-31 14:15:00,2019-03-31 14:30:00
172,6,3,3,0.008410230166863404,2019-03-31 14:15:00,2019-03-31 14:30:00
173,7,5,2,0.029310638550654362,2019-03-31 14:15:00,2019-03-31 14:30:00
175,8,4,4,0.010771474856157487,2019-03-31 14:15:00,2019-03-31 14:30:00
177,23,8,15,0.0055965739801663375,2019-03-31 14:15:00,2019-03-31 14:30:00
189,3,2,1,0.011157680288289784,2019-03-31 14:15:00,2019-03-31 14:30:00
190,17,12,5,0.005163612018341363,2019-03-31 14:15:00,2019-03-31 14:30:00
191,12,3,9,0.002939517316802695,2019-03-31 14:15:00,2019-03-31 14:30:00
196,9,6,3,0.01054640088326627,2019-03-31 14:15:00,2019-03-31 14:30:00
197,14,5,9,0.004250444269250591,2019-03-31 14:15:00,2019-03-31 14:30:00
200,2,1,1,0.010771474856157487,2019-03-31 14:15:00,2019-03-31 14:30:00
201,3,2,1,0.0025279996653968296,2019-03-31 14:15:00,2019-03-31 14:30:00
202,1,0,1,0.001617682001063153,2019-03-31 14:15:00,2019-03-31 14:30:00
203,17,10,7,0.03412141023325016,2019-03-31 14:15:00,2019-03-31 14:30:00
1,20,7,13,0.011852245816737323,2019-03-31 14:30:00,2019-03-31 14:45:00
2,24,12,12,0.014252879131178835,2019-03-31 14:30:00,2019-03-31 14:45:00
5,17,9,8,0.023560614790708843,2019-03-31 14:30:00,2019-03-31 14:45:00
10,5,4,1,0.009262049447861428,2019-03-31 14:30:00,2019-03-31 14:45:00
11,7,3,4,0.004703198783952251,2019-03-31 14:30:00,2019-03-31 14:45:00
13,2,2,0,0.0030016163010501027,2019-03-31 14:30:00,2019-03-31 14:45:00
15,11,5,6,0.008473580258860273,2019-03-31 14:30:00,2019-03-31 14:45:00
16,8,5,3,0.006237081815999211,2019-03-31 14:30:00,2019-03-31 14:45:00
18,13,9,4,0.02483550795184929,2019-03-31 14:30:00,2019-03-31 14:45:00
19,7,3,4,0.004676513944758098,2019-03-31 14:30:00,2019-03-31 14:45:00
20,13,5,8,0.005819789934997175,2019-03-31 14:30:00,2019-03-31 14:45:00
22,2,0,2,0.001704766683837133,2019-03-31 14:30:00,2019-03-31 14:45:00
23,17,6,11,0.007794444577955544,2019-03-31 14:30:00,2019-03-31 14:45:00
26,13,4,9,0.0036742856792287564,2019-03-31 14:30:00,2019-03-31 14:45:00
27,1,0,1,0.001704766683837133,2019-03-31 14:30:00,2019-03-31 14:45:00
28,6,2,4,0.0030512877594303387,2019-03-31 14:30:00,2019-03-31 14:45:00
30,2,0,2,0.001704766683837133,2019-03-31 14:30:00,2019-03-31 14:45:00
37,1,1,0,0.0027815280969182357,2019-03-31 14:30:00,2019-03-31 14:45:00
40,2,2,0,0.01259755667010339,2019-03-31 14:30:00,2019-03-31 14:45:00
41,13,4,9,0.0035871515800132295,2019-03-31 14:30:00,2019-03-31 14:45:00
46,8,5,3,0.004762501569811265,2019-03-31 14:30:00,2019-03-31 14:45:00
50,4,0,4,0.001704766683837133,2019-03-31 14:30:00,2019-03-31 14:45:00
57,8,8,0,0.011249812497921835,2019-03-31 14:30:00,2019-03-31 14:45:00
58,7,4,3,0.005837391483101544,2019-03-31 14:30:00,2019-03-31 14:45:00
61,7,6,1,0.006512657300805859,2019-03-31 14:30:00,2019-03-31 14:45:00
62,26,13,13,0.016832939623796367,2019-03-31 14:30:00,2019-03-31 14:45:00
64,6,3,3,0.011333021164126982,2019-03-31 14:30:00,2019-03-31 14:45:00
66,10,2,8,0.002833157326892902,2019-03-31 14:30:00,2019-03-31 14:45:00
67,27,14,13,0.013059386642283646,2019-03-31 14:30:00,2019-03-31 14:45:00
68,7,2,5,0.003383466826464726,2019-03-31 14:30:00,2019-03-31 14:45:00
69,20,11,9,0.017744147137213416,2019-03-31 14:30:00,2019-03-31 14:45:00
70,1,1,0,0.0020058068836892396,2019-03-31 14:30:00,2019-03-31 14:45:00
71,8,4,4,0.011333021164126982,2019-03-31 14:30:00,2019-03-31 14:45:00
74,17,10,7,0.012194468061593964,2019-03-31 14:30:00,2019-03-31 14:45:00
75,5,1,4,0.002043582367109057,2019-03-31 14:30:00,2019-03-31 14:45:00
79,1,0,1,0.001704766683837133,2019-03-31 14:30:00,2019-03-31 14:45:00
80,8,3,5,0.003479251775838822,2019-03-31 14:30:00,2019-03-31 14:45:00
85,3,2,1,0.018597811440210773,2019-03-31 14:30:00,2019-03-31 14:45:00
86,10,6,4,0.014659301300424131,2019-03-31 14:30:00,2019-03-31 14:45:00
87,18,6,12,0.00718903496253641,2019-03-31 14:30:00,2019-03-31 14:45:00
88,2,2,0,0.003419638823654857,2019-03-31 14:30:00,2019-03-31 14:45:00
89,2,2,0,0.004969188161786068,2019-03-31 14:30:00,2019-03-31 14:45:00
90,6,3,3,0.0061570413934812,2019-03-31 14:30:00,2019-03-31 14:45:00
101,10,5,5,0.011333021164126982,2019-03-31 14:30:00,2019-03-31 14:45:00
104,1,0,1,0.001704766683837133,2019-03-31 14:30:00,2019-03-31 14:45:00
106,6,2,4,0.002964889398268684,2019-03-31 14:30:00,2019-03-31 14:45:00
108,4,2,2,0.003133934770644158,2019-03-31 14:30:00,2019-03-31 14:45:00
109,26,11,15,0.011610893330275096,2019-03-31 14:30:00,2019-03-31 14:45:00
110,27,18,9,0.03102918103493889,2019-03-31 14:30:00,2019-03-31 14:45:00
111,9,3,6,0.003982228982255047,2019-03-31 14:30:00,2019-03-31 14:45:00
112,13,7,6,0.007283674086391283,2019-03-31 14:30:00,2019-03-31 14:45:00
113,3,0,3,0.001704766683837133,2019-03-31 14:30:00,2019-03-31 14:45:00
114,9,5,4,0.0031681443111792242,2019-03-31 14:30:00,2019-03-31 14:45:00
115,8,3,5,0.003531156819512181,2019-03-31 14:30:00,2019-03-31 14:45:00
116,3,3,0,0.0037091163277222093,2019-03-31 14:30:00,2019-03-31 14:45:00
118,7,2,5,0.0023305332795768045,2019-03-31 14:30:00,2019-03-31 14:45:00
119,18,11,7,0.026107396500759363,2019-03-31 14:30:00,2019-03-31 14:45:00
120,6,5,1,0.005908717703347475,2019-03-31 14:30:00,2019-03-31 14:45:00
126,9,3,6,0.003460212704049978,2019-03-31 14:30:00,2019-03-31 14:45:00
127,9,2,7,0.0023068470835413456,2019-03-31 14:30:00,2019-03-31 14:45:00
129,5,1,4,0.0027144596832915,2019-03-31 14:30:00,2019-03-31 14:45:00
135,1,0,1,0.001704766683837133,2019-03-31 14:30:00,2019-03-31 14:45:00
137,52,24,28,0.04458701978219531,2019-03-31 14:30:00,2019-03-31 14:45:00
138,27,14,13,0.016466230081380418,2019-03-31 14:30:00,2019-03-31 14:45:00
140,9,3,6,0.0060517013130156165,2019-03-31 14:30:00,2019-03-31 14:45:00
141,6,2,4,0.002964889398268684,2019-03-31 14:30:00,2019-03-31 14:45:00
147,7,4,3,0.013634376973695357,2019-03-31 14:30:00,2019-03-31 14:45:00
151,12,8,4,0.011800455924939437,2019-03-31 14:30:00,2019-03-31 14:45:00
153,18,14,4,0.014791079925108171,2019-03-31 14:30:00,2019-03-31 14:45:00
157,9,3,6,0.003297042859727502,2019-03-31 14:30:00,2019-03-31 14:45:00
158,3,0,3,0.001704766683837133,2019-03-31 14:30:00,2019-03-31 14:45:00
159,3,2,1,0.004343389304765479,2019-03-31 14:30:00,2019-03-31 14:45:00
160,7,2,5,0.005661723645572415,2019-03-31 14:30:00,2019-03-31 14:45:00
161,5,3,2,0.02020336537774461,2019-03-31 14:30:00,2019-03-31 14:45:00
162,4,3,1,0.004630756762210961,2019-03-31 14:30:00,2019-03-31 14:45:00
164,18,11,7,0.0134399582430253,2019-03-31 14:30:00,2019-03-31 14:45:00
168,38,22,16,0.015596733403275007,2019-03-31 14:30:00,2019-03-31 14:45:00
169,42,35,7,0.044845891720990905,2019-03-31 14:30:00,2019-03-31 14:45:00
170,2,1,1,0.011333021164126982,2019-03-31 14:30:00,2019-03-31 14:45:00
171,15,5,10,0.003680848261630781,2019-03-31 14:30:00,2019-03-31 14:45:00
172,5,1,4,0.0021648021418176943,2019-03-31 14:30:00,2019-03-31 14:45:00
173,8,4,4,0.005183578650374958,2019-03-31 14:30:00,2019-03-31 14:45:00
175,8,4,4,0.011333021164126982,2019-03-31 14:30:00,2019-03-31 14:45:00
177,25,9,16,0.009974773059747845,2019-03-31 14:30:00,2019-03-31 14:45:00
189,15,9,6,0.013401009259790498,2019-03-31 14:30:00,2019-03-31 14:45:00
190,16,8,8,0.008222687597236518,2019-03-31 14:30:00,2019-03-31 14:45:00
191,13,6,7,0.0051945793675008765,2019-03-31 14:30:00,2019-03-31 14:45:00
196,9,4,5,0.008226003989722381,2019-03-31 14:30:00,2019-03-31 14:45:00
197,15,6,9,0.007758208077866743,2019-03-31 14:30:00,2019-03-31 14:45:00
200,4,1,3,0.002378775572119413,2019-03-31 14:30:00,2019-03-31 14:45:00
201,3,1,2,0.002562202753745995,2019-03-31 14:30:00,2019-03-31 14:45:00
202,2,0,2,0.001704766683837133,2019-03-31 14:30:00,2019-03-31 14:45:00
203,13,8,5,0.02395797116779576,2019-03-31 14:30:00,2019-03-31 14:45:00
1,23,8,15,0.009469011660817598,2019-03-31 14:45:00,2019-03-31 15:00:00
2,14,6,8,0.005899520152525992,2019-03-31 14:45:00,2019-03-31 15:00:00
5,23,11,12,0.024767917889205213,2019-03-31 14:45:00,2019-03-31 15:00:00
10,6,5,1,0.01048902588723456,2019-03-31 14:45:00,2019-03-31 15:00:00
11,9,4,5,0.005292920592235517,2019-03-31 14:45:00,2019-03-31 15:00:00
13,2,2,0,0.0037421024121869883,2019-03-31 14:45:00,2019-03-31 15:00:00
15,16,11,5,0.043121727264749665,2019-03-31 14:45:00,2019-03-31 15:00:00
16,11,5,6,0.006804722302202542,2019-03-31 14:45:00,2019-03-31 15:00:00
18,10,3,7,0.004259042240279325,2019-03-31 14:45:00,2019-03-31 15:00:00
19,8,6,2,0.01396328104799741,2019-03-31 14:45:00,2019-03-31 15:00:00
20,12,9,3,0.012326670928910606,2019-03-31 14:45:00,2019-03-31 15:00:00
22,2,0,2,0.0016934322138397657,2019-03-31 14:45:00,2019-03-31 15:00:00
23,19,6,13,0.0047639443178266756,2019-03-31 14:45:00,2019-03-31 15:00:00
26,15,7,8,0.00572193058528069,2019-03-31 14:45:00,2019-03-31 15:00:00
27,2,2,0,0.0023164574729617003,2019-03-31 14:45:00,2019-03-31 15:00:00
28,7,3,4,0.004819966497748269,2019-03-31 14:45:00,2019-03-31 15:00:00
30,2,0,2,0.0016934322138397657,2019-03-31 14:45:00,2019-03-31 15:00:00
37,1,1,0,0.003150011455524365,2019-03-31 14:45:00,2019-03-31 15:00:00
41,12,2,10,0.0023164574729617003,2019-03-31 14:45:00,2019-03-31 15:00:00
46,8,5,3,0.0053718577569343015,2019-03-31 14:45:00,2019-03-31 15:00:00
50,1,0,1,0.0016934322138397657,2019-03-31 14:45:00,2019-03-31 15:00:00
57,12,7,5,0.010169704465852226,2019-03-31 14:45:00,2019-03-31 15:00:00
58,8,4,4,0.021050225213311773,2019-03-31 14:45:00,2019-03-31 15:00:00
61,9,5,4,0.004376612909449077,2019-03-31 14:45:00,2019-03-31 15:00:00
62,14,7,7,0.010642766590514134,2019-03-31 14:45:00,2019-03-31 15:00:00
64,3,1,2,0.0029452158509424677,2019-03-31 14:45:00,2019-03-31 15:00:00
66,6,2,4,0.002764545775474788,2019-03-31 14:45:00,2019-03-31 15:00:00
67,15,10,5,0.012868961682161811,2019-03-31 14:45:00,2019-03-31 15:00:00
68,14,5,9,0.0035630806593914552,2019-03-31 14:45:00,2019-03-31 15:00:00
69,21,10,11,0.012737475113971615,2019-03-31 14:45:00,2019-03-31 15:00:00
70,2,2,0,0.006069384760976805,2019-03-31 14:45:00,2019-03-31 15:00:00
71,8,4,4,0.011259808243353105,2019-03-31 14:45:00,2019-03-31 15:00:00
74,4,1,3,0.00357197239675942,2019-03-31 14:45:00,2019-03-31 15:00:00
75,13,5,8,0.003287689414961044,2019-03-31 14:45:00,2019-03-31 15:00:00
80,4,1,3,0.0023629748538330038,2019-03-31 14:45:00,2019-03-31 15:00:00
85,6,4,2,0.023239953179453158,2019-03-31 14:45:00,2019-03-31 15:00:00
86,8,4,4,0.00780809027322874,2019-03-31 14:45:00,2019-03-31 15:00:00
87,22,7,15,0.0041179928482343205,2019-03-31 14:45:00,2019-03-31 15:00:00
88,7,3,4,0.0035594889838438575,2019-03-31 14:45:00,2019-03-31 15:00:00
89,8,6,2,0.005853539744669022,2019-03-31 14:45:00,2019-03-31 15:00:00
90,6,5,1,0.020460749970934264,2019-03-31 14:45:00,2019-03-31 15:00:00
99,2,0,2,0.0016934322138397657,2019-03-31 14:45:00,2019-03-31 15:00:00
101,12,5,7,0.0043109984610787706,2019-03-31 14:45:00,2019-03-31 15:00:00
104,2,0,2,0.0016934322138397657,2019-03-31 14:45:00,2019-03-31 15:00:00
106,4,2,2,0.011259808243353105,2019-03-31 14:45:00,2019-03-31 15:00:00
108,10,7,3,0.01383416752270896,2019-03-31 14:45:00,2019-03-31 15:00:00
109,28,13,15,0.010744442958670303,2019-03-31 14:45:00,2019-03-31 15:00:00
110,27,16,11,0.012531597429105153,2019-03-31 14:45:00,2019-03-31 15:00:00
111,6,1,5,0.003150011455524365,2019-03-31 14:45:00,2019-03-31 15:00:00
112,11,5,6,0.0038468039986987368,2019-03-31 14:45:00,2019-03-31 15:00:00
113,2,0,2,0.0016934322138397657,2019-03-31 14:45:00,2019-03-31 15:00:00
114,7,3,4,0.00516754499371789,2019-03-31 14:45:00,2019-03-31 15:00:00
115,4,2,2,0.0023150579122049693,2019-03-31 14:45:00,2019-03-31 15:00:00
116,5,3,2,0.004114232097213379,2019-03-31 14:45:00,2019-03-31 15:00:00
118,3,2,1,0.0023150579122049693,2019-03-31 14:45:00,2019-03-31 15:00:00
119,24,16,8,0.020375949625319856,2019-03-31 14:45:00,2019-03-31 15:00:00
120,5,5,0,0.02486462451985077,2019-03-31 14:45:00,2019-03-31 15:00:00
122,4,2,2,0.007272616132834963,2019-03-31 14:45:00,2019-03-31 15:00:00
126,15,5,10,0.004682975834241554,2019-03-31 14:45:00,2019-03-31 15:00:00
127,9,4,5,0.006105734589866822,2019-03-31 14:45:00,2019-03-31 15:00:00
129,13,5,8,0.00799706447708461,2019-03-31 14:45:00,2019-03-31 15:00:00
135,1,0,1,0.0016934322138397657,2019-03-31 14:45:00,2019-03-31 15:00:00
137,38,11,27,0.011052080821399695,2019-03-31 14:45:00,2019-03-31 15:00:00
138,25,13,12,0.02056056988116067,2019-03-31 14:45:00,2019-03-31 15:00:00
140,3,0,3,0.0016934322138397657,2019-03-31 14:45:00,2019-03-31 15:00:00
141,8,5,3,0.007522602637088252,2019-03-31 14:45:00,2019-03-31 15:00:00
147,4,2,2,0.004489405380445403,2019-03-31 14:45:00,2019-03-31 15:00:00
151,11,7,4,0.0065779900517810895,2019-03-31 14:45:00,2019-03-31 15:00:00
153,16,10,6,0.012175360151255926,2019-03-31 14:45:00,2019-03-31 15:00:00
154,2,0,2,0.0016934322138397657,2019-03-31 14:45:00,2019-03-31 15:00:00
156,2,2,0,0.005509785226819949,2019-03-31 14:45:00,2019-03-31 15:00:00
157,7,2,5,0.0025658734817763395,2019-03-31 14:45:00,2019-03-31 15:00:00
158,3,1,2,0.0020414113095839717,2019-03-31 14:45:00,2019-03-31 15:00:00
159,9,5,4,0.008839002699171922,2019-03-31 14:45:00,2019-03-31 15:00:00
160,6,1,5,0.0030913782904842257,2019-03-31 14:45:00,2019-03-31 15:00:00
161,5,3,2,0.013560043675248398,2019-03-31 14:45:00,2019-03-31 15:00:00
162,2,1,1,0.0024131736699666492,2019-03-31 14:45:00,2019-03-31 15:00:00
164,11,5,6,0.006227455560458783,2019-03-31 14:45:00,2019-03-31 15:00:00
168,60,33,27,0.028787848346632016,2019-03-31 14:45:00,2019-03-31 15:00:00
169,35,32,3,0.038734225032166385,2019-03-31 14:45:00,2019-03-31 15:00:00
170,3,2,1,0.02087573796658277,2019-03-31 14:45:00,2019-03-31 15:00:00
171,15,5,10,0.0036564250666970563,2019-03-31 14:45:00,2019-03-31 15:00:00
172,8,3,5,0.0034561912242290008,2019-03-31 14:45:00,2019-03-31 15:00:00
173,12,5,7,0.004781723354577696,2019-03-31 14:45:00,2019-03-31 15:00:00
175,8,4,4,0.011259808243353105,2019-03-31 14:45:00,2019-03-31 15:00:00
177,18,8,10,0.009862783330146674,2019-03-31 14:45:00,2019-03-31 15:00:00
189,12,8,4,0.00819965647151651,2019-03-31 14:45:00,2019-03-31 15:00:00
190,15,8,7,0.010364021659837751,2019-03-31 14:45:00,2019-03-31 15:00:00
191,12,6,6,0.0047102707467759145,2019-03-31 14:45:00,2019-03-31 15:00:00
196,8,4,4,0.007096707994363816,2019-03-31 14:45:00,2019-03-31 15:00:00
197,9,5,4,0.019154884254732066,2019-03-31 14:45:00,2019-03-31 15:00:00
199,2,1,1,0.011259808243353105,2019-03-31 14:45:00,2019-03-31 15:00:00
200,4,1,3,0.0023629748538330038,2019-03-31 14:45:00,2019-03-31 15:00:00
202,2,0,2,0.0016934322138397657,2019-03-31 14:45:00,2019-03-31 15:00:00
203,22,14,8,0.019403445681211398,2019-03-31 14:45:00,2019-03-31 15:00:00
1,17,5,12,0.003930233652111593,2019-03-31 15:00:00,2019-03-31 15:15:00
2,13,5,8,0.005762670031040097,2019-03-31 15:00:00,2019-03-31 15:15:00
5,31,10,21,0.004259080238090104,2019-03-31 15:00:00,2019-03-31 15:15:00
10,6,6,0,0.006192759289406807,2019-03-31 15:00:00,2019-03-31 15:15:00
11,9,4,5,0.005028621733754053,2019-03-31 15:00:00,2019-03-31 15:15:00
13,2,2,0,0.0030121814258630576,2019-03-31 15:00:00,2019-03-31 15:15:00
15,8,4,4,0.01307470955573913,2019-03-31 15:00:00,2019-03-31 15:15:00
16,14,8,6,0.01151102536340346,2019-03-31 15:00:00,2019-03-31 15:15:00
18,10,4,6,0.005351182916449606,2019-03-31 15:00:00,2019-03-31 15:15:00
19,8,7,1,0.05551854527739695,2019-03-31 15:00:00,2019-03-31 15:15:00
20,15,6,9,0.004705866927997423,2019-03-31 15:00:00,2019-03-31 15:15:00
22,1,0,1,0.0016089385603197627,2019-03-31 15:00:00,2019-03-31 15:15:00
23,12,5,7,0.007241864799876336,2019-03-31 15:00:00,2019-03-31 15:15:00
26,23,11,12,0.016558415643780428,2019-03-31 15:00:00,2019-03-31 15:15:00
27,9,8,1,0.008317479372886051,2019-03-31 15:00:00,2019-03-31 15:15:00
28,6,2,4,0.003301434523126191,2019-03-31 15:00:00,2019-03-31 15:15:00
37,2,1,1,0.0020832636428497683,2019-03-31 15:00:00,2019-03-31 15:15:00
40,4,1,3,0.002245059688875011,2019-03-31 15:00:00,2019-03-31 15:15:00
41,9,1,8,0.0018002175742483947,2019-03-31 15:00:00,2019-03-31 15:15:00
46,7,5,2,0.0043446035522253235,2019-03-31 15:00:00,2019-03-31 15:15:00
50,1,0,1,0.0016089385603197627,2019-03-31 15:00:00,2019-03-31 15:15:00
57,6,1,5,0.0020782764983650723,2019-03-31 15:00:00,2019-03-31 15:15:00
58,4,3,1,0.019996241326202376,2019-03-31 15:00:00,2019-03-31 15:15:00
61,7,3,4,0.0024441882432703374,2019-03-31 15:00:00,2019-03-31 15:15:00
62,28,14,14,0.012888986535857534,2019-03-31 15:00:00,2019-03-31 15:15:00
64,9,3,6,0.0027982279099595326,2019-03-31 15:00:00,2019-03-31 15:15:00
66,6,2,4,0.0020528392877516726,2019-03-31 15:00:00,2019-03-31 15:15:00
67,16,8,8,0.009936319270049883,2019-03-31 15:00:00,2019-03-31 15:15:00
68,13,3,10,0.002611086633302582,2019-03-31 15:00:00,2019-03-31 15:15:00
69,15,9,6,0.04154779301141509,2019-03-31 15:00:00,2019-03-31 15:15:00
70,4,4,0,0.004851785217096092,2019-03-31 15:00:00,2019-03-31 15:15:00
71,8,4,4,0.010717803995236207,2019-03-31 15:00:00,2019-03-31 15:15:00
74,5,1,4,0.0026610391337621516,2019-03-31 15:00:00,2019-03-31 15:15:00
75,19,7,12,0.0031308980218632447,2019-03-31 15:00:00,2019-03-31 15:15:00
80,2,1,1,0.010717803995236207,2019-03-31 15:00:00,2019-03-31 15:15:00
85,3,2,1,0.004676822383039912,2019-03-31 15:00:00,2019-03-31 15:15:00
86,8,4,4,0.007340412761532614,2019-03-31 15:00:00,2019-03-31 15:15:00
87,24,13,11,0.02329055188456277,2019-03-31 15:00:00,2019-03-31 15:15:00
88,8,4,4,0.005566450088748751,2019-03-31 15:00:00,2019-03-31 15:15:00
89,12,6,6,0.012738235740022303,2019-03-31 15:00:00,2019-03-31 15:15:00
90,11,8,3,0.01161751508397065,2019-03-31 15:00:00,2019-03-31 15:15:00
99,7,3,4,0.004159633197048507,2019-03-31 15:00:00,2019-03-31 15:15:00
101,8,3,5,0.003283680596972491,2019-03-31 15:00:00,2019-03-31 15:15:00
104,1,0,1,0.0016089385603197627,2019-03-31 15:00:00,2019-03-31 15:15:00
106,10,3,7,0.0025309642828515552,2019-03-31 15:00:00,2019-03-31 15:15:00
108,13,9,4,0.011022048290594557,2019-03-31 15:00:00,2019-03-31 15:15:00
109,28,15,13,0.02019364470086943,2019-03-31 15:00:00,2019-03-31 15:15:00
110,24,13,11,0.027825607551027528,2019-03-31 15:00:00,2019-03-31 15:15:00
111,6,3,3,0.0035997232720366657,2019-03-31 15:00:00,2019-03-31 15:15:00
112,14,9,5,0.014691977656168467,2019-03-31 15:00:00,2019-03-31 15:15:00
113,2,0,2,0.0016089385603197627,2019-03-31 15:00:00,2019-03-31 15:15:00
114,5,4,1,0.005440232839578591,2019-03-31 15:00:00,2019-03-31 15:15:00
115,6,6,0,0.009433632173409789,2019-03-31 15:00:00,2019-03-31 15:15:00
116,2,0,2,0.0016089385603197627,2019-03-31 15:00:00,2019-03-31 15:15:00
118,2,2,0,0.0022236223753409577,2019-03-31 15:00:00,2019-03-31 15:15:00
119,26,15,11,0.0225252632299225,2019-03-31 15:00:00,2019-03-31 15:15:00
120,13,7,6,0.014155849571338681,2019-03-31 15:00:00,2019-03-31 15:15:00
122,3,1,2,0.003413893371256946,2019-03-31 15:00:00,2019-03-31 15:15:00
126,16,6,10,0.008055414904498943,2019-03-31 15:00:00,2019-03-31 15:15:00
127,7,3,4,0.002834744730593414,2019-03-31 15:00:00,2019-03-31 15:15:00
129,18,11,7,0.018350640504115497,2019-03-31 15:00:00,2019-03-31 15:15:00
137,30,14,16,0.018146426199059686,2019-03-31 15:00:00,2019-03-31 15:15:00
138,20,9,11,0.006137844130308895,2019-03-31 15:00:00,2019-03-31 15:15:00
140,2,0,2,0.0016089385603197627,2019-03-31 15:00:00,2019-03-31 15:15:00
141,6,3,3,0.005439574165471616,2019-03-31 15:00:00,2019-03-31 15:15:00
147,1,1,0,0.002664869315992511,2019-03-31 15:00:00,2019-03-31 15:15:00
151,9,6,3,0.004608531396249031,2019-03-31 15:00:00,2019-03-31 15:15:00
153,15,4,11,0.004434272635658068,2019-03-31 15:00:00,2019-03-31 15:15:00
154,4,2,2,0.003955091220272603,2019-03-31 15:00:00,2019-03-31 15:15:00
157,5,3,2,0.037087826144033116,2019-03-31 15:00:00,2019-03-31 15:15:00
158,3,2,1,0.0029452182226359425,2019-03-31 15:00:00,2019-03-31 15:15:00
159,5,2,3,0.0037131397072045404,2019-03-31 15:00:00,2019-03-31 15:15:00
160,4,0,4,0.0016089385603197627,2019-03-31 15:00:00,2019-03-31 15:15:00
161,5,3,2,0.01710614127338419,2019-03-31 15:00:00,2019-03-31 15:15:00
162,4,2,2,0.0051768066092390715,2019-03-31 15:00:00,2019-03-31 15:15:00
164,13,5,8,0.00488414435163087,2019-03-31 15:00:00,2019-03-31 15:15:00
168,50,31,19,0.03428158371140386,2019-03-31 15:00:00,2019-03-31 15:15:00
169,29,23,6,0.025240815899105252,2019-03-31 15:00:00,2019-03-31 15:15:00
170,3,1,2,0.0027982279099595326,2019-03-31 15:00:00,2019-03-31 15:15:00
171,10,3,7,0.0025309642828515552,2019-03-31 15:00:00,2019-03-31 15:15:00
172,5,3,2,0.012998017589851005,2019-03-31 15:00:00,2019-03-31 15:15:00
173,9,3,6,0.00322411517086634,2019-03-31 15:00:00,2019-03-31 15:15:00
175,10,5,5,0.010717803995236207,2019-03-31 15:00:00,2019-03-31 15:15:00
177,18,10,8,0.01395232726642383,2019-03-31 15:00:00,2019-03-31 15:15:00
189,8,3,5,0.0027606563342367062,2019-03-31 15:00:00,2019-03-31 15:15:00
190,8,5,3,0.004672875416621775,2019-03-31 15:00:00,2019-03-31 15:15:00
191,10,5,5,0.0036335787655501052,2019-03-31 15:00:00,2019-03-31 15:15:00
195,1,1,0,0.0020832636428497683,2019-03-31 15:00:00,2019-03-31 15:15:00
196,6,3,3,0.005350000215777013,2019-03-31 15:00:00,2019-03-31 15:15:00
197,9,4,5,0.003217325364338368,2019-03-31 15:00:00,2019-03-31 15:15:00
199,2,1,1,0.010717803995236207,2019-03-31 15:00:00,2019-03-31 15:15:00
200,4,1,3,0.002245059688875011,2019-03-31 15:00:00,2019-03-31 15:15:00
201,1,0,1,0.0016089385603197627,2019-03-31 15:00:00,2019-03-31 15:15:00
202,1,1,0,0.004112581012290124,2019-03-31 15:00:00,2019-03-31 15:15:00
203,20,11,9,0.017665298771666105,2019-03-31 15:00:00,2019-03-31 15:15:00
1,14,3,11,0.0028275613968307195,2019-03-31 15:15:00,2019-03-31 15:30:00
2,16,6,10,0.005722305810366618,2019-03-31 15:15:00,2019-03-31 15:30:00
5,27,10,17,0.008155067465388278,2019-03-31 15:15:00,2019-03-31 15:30:00
10,6,5,1,0.03628849075698067,2019-03-31 15:15:00,2019-03-31 15:30:00
11,6,3,3,0.01052250018347942,2019-03-31 15:15:00,2019-03-31 15:30:00
13,2,2,0,0.00241503071293833,2019-03-31 15:15:00,2019-03-31 15:30:00
15,7,4,3,0.010125003188807704,2019-03-31 15:15:00,2019-03-31 15:30:00
16,16,12,4,0.01935327344691324,2019-03-31 15:15:00,2019-03-31 15:30:00
18,8,2,6,0.007886373867442825,2019-03-31 15:15:00,2019-03-31 15:30:00
19,12,6,6,0.008043660773251627,2019-03-31 15:15:00,2019-03-31 15:30:00
20,19,6,13,0.004608638549770991,2019-03-31 15:15:00,2019-03-31 15:30:00
22,1,0,1,0.0015799895706377028,2019-03-31 15:15:00,2019-03-31 15:30:00
23,11,4,7,0.007823540165564455,2019-03-31 15:15:00,2019-03-31 15:30:00
26,20,7,13,0.0074019941266720984,2019-03-31 15:15:00,2019-03-31 15:30:00
27,8,6,2,0.005219465503432549,2019-03-31 15:15:00,2019-03-31 15:30:00
28,15,5,10,0.004911803050476853,2019-03-31 15:15:00,2019-03-31 15:30:00
30,1,1,0,0.0033712895961502372,2019-03-31 15:15:00,2019-03-31 15:30:00
37,2,1,1,0.004687018960027822,2019-03-31 15:15:00,2019-03-31 15:30:00
40,4,1,3,0.0022046594422991186,2019-03-31 15:15:00,2019-03-31 15:30:00
41,6,1,5,0.0018189529712994048,2019-03-31 15:15:00,2019-03-31 15:30:00
46,5,5,0,0.008483616911685051,2019-03-31 15:15:00,2019-03-31 15:30:00
57,2,1,1,0.002759044133386429,2019-03-31 15:15:00,2019-03-31 15:30:00
58,8,4,4,0.005384078725247557,2019-03-31 15:15:00,2019-03-31 15:30:00
61,3,2,1,0.0020169897673856362,2019-03-31 15:15:00,2019-03-31 15:30:00
62,21,9,12,0.010871165944903666,2019-03-31 15:15:00,2019-03-31 15:30:00
64,5,0,5,0.0015799895706377028,2019-03-31 15:15:00,2019-03-31 15:30:00
66,6,3,3,0.002871552053724601,2019-03-31 15:15:00,2019-03-31 15:30:00
67,26,16,10,0.0200902588982788,2019-03-31 15:15:00,2019-03-31 15:30:00
68,10,1,9,0.002530068832567422,2019-03-31 15:15:00,2019-03-31 15:30:00
69,15,9,6,0.03045820264488858,2019-03-31 15:15:00,2019-03-31 15:30:00
70,13,8,5,0.008585249764808574,2019-03-31 15:15:00,2019-03-31 15:30:00
71,8,4,4,0.01052250018347942,2019-03-31 15:15:00,2019-03-31 15:30:00
74,8,3,5,0.004557623510836315,2019-03-31 15:15:00,2019-03-31 15:30:00
75,15,5,10,0.002862498097603298,2019-03-31 15:15:00,2019-03-31 15:30:00
80,2,1,1,0.01052250018347942,2019-03-31 15:15:00,2019-03-31 15:30:00
85,2,2,0,0.004224639977594931,2019-03-31 15:15:00,2019-03-31 15:30:00
86,9,5,4,0.005948425809992972,2019-03-31 15:15:00,2019-03-31 15:30:00
87,28,17,11,0.02326649713150889,2019-03-31 15:15:00,2019-03-31 15:30:00
88,6,3,3,0.004630935711705874,2019-03-31 15:15:00,2019-03-31 15:30:00
89,7,3,4,0.009019216391357741,2019-03-31 15:15:00,2019-03-31 15:30:00
90,15,9,6,0.01527967025464467,2019-03-31 15:15:00,2019-03-31 15:30:00
99,11,7,4,0.02205553316208576,2019-03-31 15:15:00,2019-03-31 15:30:00
101,11,5,6,0.005417961354082608,2019-03-31 15:15:00,2019-03-31 15:30:00
104,2,1,1,0.0037984811992805892,2019-03-31 15:15:00,2019-03-31 15:30:00
106,12,5,7,0.011513607720957263,2019-03-31 15:15:00,2019-03-31 15:30:00
108,10,8,2,0.016328593360358103,2019-03-31 15:15:00,2019-03-31 15:30:00
109,19,13,6,0.022254551318322466,2019-03-31 15:15:00,2019-03-31 15:30:00
110,25,12,13,0.015644479332372542,2019-03-31 15:15:00,2019-03-31 15:30:00
111,8,3,5,0.004596242273802581,2019-03-31 15:15:00,2019-03-31 15:30:00
112,12,7,5,0.011531586470663623,2019-03-31 15:15:00,2019-03-31 15:30:00
114,5,2,3,0.0030586604098990283,2019-03-31 15:15:00,2019-03-31 15:30:00
115,11,9,2,0.013372456369020236,2019-03-31 15:15:00,2019-03-31 15:30:00
116,6,2,4,0.0027478655138604,2019-03-31 15:15:00,2019-03-31 15:30:00
118,2,2,0,0.0029965283848611443,2019-03-31 15:15:00,2019-03-31 15:30:00
119,21,12,9,0.016563312192653595,2019-03-31 15:15:00,2019-03-31 15:30:00
120,5,3,2,0.00548514581647392,2019-03-31 15:15:00,2019-03-31 15:30:00
122,3,2,1,0.0036577927656910774,2019-03-31 15:15:00,2019-03-31 15:30:00
126,19,8,11,0.008660458544962973,2019-03-31 15:15:00,2019-03-31 15:30:00
127,13,7,6,0.005218637692843914,2019-03-31 15:15:00,2019-03-31 15:30:00
129,16,6,10,0.004102819400551506,2019-03-31 15:15:00,2019-03-31 15:30:00
137,26,14,12,0.020341646615772695,2019-03-31 15:15:00,2019-03-31 15:30:00
138,24,16,8,0.02923750928571479,2019-03-31 15:15:00,2019-03-31 15:30:00
140,2,0,2,0.0015799895706377028,2019-03-31 15:15:00,2019-03-31 15:30:00
141,7,3,4,0.004888534622530985,2019-03-31 15:15:00,2019-03-31 15:30:00
147,3,0,3,0.0015799895706377028,2019-03-31 15:15:00,2019-03-31 15:30:00
151,8,4,4,0.0032765907215548556,2019-03-31 15:15:00,2019-03-31 15:30:00
153,11,4,7,0.004773139838435782,2019-03-31 15:15:00,2019-03-31 15:30:00
154,5,3,2,0.0036876704268426334,2019-03-31 15:15:00,2019-03-31 15:30:00
157,3,1,2,0.0027478655138604,2019-03-31 15:15:00,2019-03-31 15:30:00
158,4,3,1,0.003994683958406666,2019-03-31 15:15:00,2019-03-31 15:30:00
159,5,2,3,0.00364628720308486,2019-03-31 15:15:00,2019-03-31 15:30:00
160,5,1,4,0.002006349763893316,2019-03-31 15:15:00,2019-03-31 15:30:00
161,1,1,0,0.0030211098526585077,2019-03-31 15:15:00,2019-03-31 15:30:00
162,7,4,3,0.008523465563352574,2019-03-31 15:15:00,2019-03-31 15:30:00
164,13,5,8,0.005322562102904027,2019-03-31 15:15:00,2019-03-31 15:30:00
168,46,26,20,0.031108029324412895,2019-03-31 15:15:00,2019-03-31 15:30:00
169,30,18,12,0.021944840412530173,2019-03-31 15:15:00,2019-03-31 15:30:00
170,4,2,2,0.004107081374840997,2019-03-31 15:15:00,2019-03-31 15:30:00
171,12,4,8,0.0066651221441678885,2019-03-31 15:15:00,2019-03-31 15:30:00
172,7,4,3,0.006321848054013646,2019-03-31 15:15:00,2019-03-31 15:30:00
173,8,3,5,0.0030265818696070665,2019-03-31 15:15:00,2019-03-31 15:30:00
175,10,5,5,0.01052250018347942,2019-03-31 15:15:00,2019-03-31 15:30:00
177,16,8,8,0.010250293546541785,2019-03-31 15:15:00,2019-03-31 15:30:00
189,5,2,3,0.004161080432682154,2019-03-31 15:15:00,2019-03-31 15:30:00
190,4,3,1,0.004809684923170481,2019-03-31 15:15:00,2019-03-31 15:30:00
191,9,6,3,0.00801762778708771,2019-03-31 15:15:00,2019-03-31 15:30:00
195,1,1,0,0.004687018960027822,2019-03-31 15:15:00,2019-03-31 15:30:00
196,6,3,3,0.010808376810198297,2019-03-31 15:15:00,2019-03-31 15:30:00
197,11,4,7,0.002948530522258506,2019-03-31 15:15:00,2019-03-31 15:30:00
199,2,1,1,0.0017984896690116698,2019-03-31 15:15:00,2019-03-31 15:30:00
200,2,1,1,0.01052250018347942,2019-03-31 15:15:00,2019-03-31 15:30:00
201,1,0,1,0.0015799895706377028,2019-03-31 15:15:00,2019-03-31 15:30:00
202,4,3,1,0.047411332471924396,2019-03-31 15:15:00,2019-03-31 15:30:00
203,26,13,13,0.014866777487664259,2019-03-31 15:15:00,2019-03-31 15:30:00
1,10,2,8,0.0021262106494014735,2019-03-31 15:30:00,2019-03-31 15:45:00
2,15,6,9,0.005884178886299985,2019-03-31 15:30:00,2019-03-31 15:45:00
5,22,10,12,0.0075629410843976235,2019-03-31 15:30:00,2019-03-31 15:45:00
10,7,6,1,0.03332157728333291,2019-03-31 15:30:00,2019-03-31 15:45:00
11,8,4,4,0.011793011366117523,2019-03-31 15:30:00,2019-03-31 15:45:00
15,9,6,3,0.008442314206676753,2019-03-31 15:30:00,2019-03-31 15:45:00
16,19,13,6,0.013863626119674094,2019-03-31 15:30:00,2019-03-31 15:45:00
18,10,4,6,0.0056015545984819505,2019-03-31 15:30:00,2019-03-31 15:45:00
19,22,10,12,0.011675051515650368,2019-03-31 15:30:00,2019-03-31 15:45:00
20,12,3,9,0.003589741288927529,2019-03-31 15:30:00,2019-03-31 15:45:00
23,22,5,17,0.0023607596140422685,2019-03-31 15:30:00,2019-03-31 15:45:00
26,19,4,15,0.0022895262383206094,2019-03-31 15:30:00,2019-03-31 15:45:00
27,6,6,0,0.005260447649242732,2019-03-31 15:30:00,2019-03-31 15:45:00
28,9,3,6,0.003134087622440853,2019-03-31 15:30:00,2019-03-31 15:45:00
35,7,7,0,0.005941788829156804,2019-03-31 15:30:00,2019-03-31 15:45:00
37,5,1,4,0.0021933797842484636,2019-03-31 15:30:00,2019-03-31 15:45:00
40,2,1,1,0.011793011366117523,2019-03-31 15:30:00,2019-03-31 15:45:00
41,6,2,4,0.002938543112085564,2019-03-31 15:30:00,2019-03-31 15:45:00
46,12,6,6,0.005266332961412223,2019-03-31 15:30:00,2019-03-31 15:45:00
57,5,3,2,0.0027613185856951994,2019-03-31 15:30:00,2019-03-31 15:45:00
58,9,2,7,0.0023384871527471498,2019-03-31 15:30:00,2019-03-31 15:45:00
61,5,5,0,0.0045713117804059835,2019-03-31 15:30:00,2019-03-31 15:45:00
62,31,14,17,0.008717554710484183,2019-03-31 15:30:00,2019-03-31 15:45:00
64,9,2,7,0.0023384871527471498,2019-03-31 15:30:00,2019-03-31 15:45:00
66,12,5,7,0.004507209092938536,2019-03-31 15:30:00,2019-03-31 15:45:00
67,26,14,12,0.014388929941238499,2019-03-31 15:30:00,2019-03-31 15:45:00
68,6,1,5,0.0018885906038487849,2019-03-31 15:30:00,2019-03-31 15:45:00
69,16,10,6,0.03965554067206275,2019-03-31 15:30:00,2019-03-31 15:45:00
70,14,6,8,0.009756872060555536,2019-03-31 15:30:00,2019-03-31 15:45:00
71,8,4,4,0.011793011366117523,2019-03-31 15:30:00,2019-03-31 15:45:00
74,7,3,4,0.0037704722623050713,2019-03-31 15:30:00,2019-03-31 15:45:00
75,12,4,8,0.0035157020851685167,2019-03-31 15:30:00,2019-03-31 15:45:00
79,3,2,1,0.004842268586892891,2019-03-31 15:30:00,2019-03-31 15:45:00
80,2,1,1,0.011793011366117523,2019-03-31 15:30:00,2019-03-31 15:45:00
85,2,2,0,0.0045708711367685815,2019-03-31 15:30:00,2019-03-31 15:45:00
86,11,5,6,0.008970310194032187,2019-03-31 15:30:00,2019-03-31 15:45:00
87,21,13,8,0.01565862543258019,2019-03-31 15:30:00,2019-03-31 15:45:00
88,4,3,1,0.004294922318175425,2019-03-31 15:30:00,2019-03-31 15:45:00
89,5,3,2,0.0118685757343143,2019-03-31 15:30:00,2019-03-31 15:45:00
90,12,8,4,0.022761884799103994,2019-03-31 15:30:00,2019-03-31 15:45:00
99,14,8,6,0.00845716166568241,2019-03-31 15:30:00,2019-03-31 15:45:00
101,11,5,6,0.006071674193102627,2019-03-31 15:30:00,2019-03-31 15:45:00
104,3,2,1,0.0037215220466115927,2019-03-31 15:30:00,2019-03-31 15:45:00
106,12,6,6,0.01681898510360438,2019-03-31 15:30:00,2019-03-31 15:45:00
108,15,9,6,0.021980194794745396,2019-03-31 15:30:00,2019-03-31 15:45:00
109,33,18,15,0.019065245351553475,2019-03-31 15:30:00,2019-03-31 15:45:00
110,19,11,8,0.08318969627848755,2019-03-31 15:30:00,2019-03-31 15:45:00
111,6,2,4,0.003357833831516786,2019-03-31 15:30:00,2019-03-31 15:45:00
112,12,3,9,0.0066418351357572444,2019-03-31 15:30:00,2019-03-31 15:45:00
114,4,3,1,0.003917555371658014,2019-03-31 15:30:00,2019-03-31 15:45:00
115,5,3,2,0.004909928871288859,2019-03-31 15:30:00,2019-03-31 15:45:00
116,5,2,3,0.003511728975010112,2019-03-31 15:30:00,2019-03-31 15:45:00
118,4,4,0,0.006674148017428053,2019-03-31 15:30:00,2019-03-31 15:45:00
119,25,14,11,0.011339139267790151,2019-03-31 15:30:00,2019-03-31 15:45:00
120,4,1,3,0.002397899583370843,2019-03-31 15:30:00,2019-03-31 15:45:00
122,4,4,0,0.0064105534871906865,2019-03-31 15:30:00,2019-03-31 15:45:00
126,16,6,10,0.006653193302849594,2019-03-31 15:30:00,2019-03-31 15:45:00
127,16,8,8,0.0044645716017605985,2019-03-31 15:30:00,2019-03-31 15:45:00
129,20,9,11,0.007530400071994032,2019-03-31 15:30:00,2019-03-31 15:45:00
137,29,19,10,0.018275999946136268,2019-03-31 15:30:00,2019-03-31 15:45:00
138,34,19,15,0.027098149896952684,2019-03-31 15:30:00,2019-03-31 15:45:00
140,2,0,2,0.001770548351300414,2019-03-31 15:30:00,2019-03-31 15:45:00
141,8,4,4,0.005832388900241023,2019-03-31 15:30:00,2019-03-31 15:45:00
151,11,7,4,0.009073279950164926,2019-03-31 15:30:00,2019-03-31 15:45:00
153,12,7,5,0.004981527176516762,2019-03-31 15:30:00,2019-03-31 15:45:00
154,3,2,1,0.0036169673157380425,2019-03-31 15:30:00,2019-03-31 15:45:00
157,7,3,4,0.00434888096568973,2019-03-31 15:30:00,2019-03-31 15:45:00
158,2,2,0,0.00333675798854419,2019-03-31 15:30:00,2019-03-31 15:45:00
159,6,2,4,0.0030793055815080605,2019-03-31 15:30:00,2019-03-31 15:45:00
160,5,1,4,0.0022483370021131946,2019-03-31 15:30:00,2019-03-31 15:45:00
161,1,1,0,0.0033242325304109472,2019-03-31 15:30:00,2019-03-31 15:45:00
162,10,5,5,0.004664301714662059,2019-03-31 15:30:00,2019-03-31 15:45:00
164,10,5,5,0.0069360990795449586,2019-03-31 15:30:00,2019-03-31 15:45:00
168,47,29,18,0.02964603697831007,2019-03-31 15:30:00,2019-03-31 15:45:00
169,26,13,13,0.013514534833359588,2019-03-31 15:30:00,2019-03-31 15:45:00
170,6,2,4,0.0031545201961095093,2019-03-31 15:30:00,2019-03-31 15:45:00
171,12,6,6,0.008334193586385288,2019-03-31 15:30:00,2019-03-31 15:45:00
172,4,2,2,0.011793011366117523,2019-03-31 15:30:00,2019-03-31 15:45:00
173,6,3,3,0.005110900299492634,2019-03-31 15:30:00,2019-03-31 15:45:00
175,14,7,7,0.011793011366117523,2019-03-31 15:30:00,2019-03-31 15:45:00
177,20,8,12,0.005442333894210616,2019-03-31 15:30:00,2019-03-31 15:45:00
189,8,2,6,0.002984524986738616,2019-03-31 15:30:00,2019-03-31 15:45:00
190,4,4,0,0.003094226378954878,2019-03-31 15:30:00,2019-03-31 15:45:00
191,8,3,5,0.0034673381784830377,2019-03-31 15:30:00,2019-03-31 15:45:00
195,1,1,0,0.003734818450793426,2019-03-31 15:30:00,2019-03-31 15:45:00
196,7,5,2,0.007319234098769124,2019-03-31 15:30:00,2019-03-31 15:45:00
197,9,4,5,0.0042162093949172745,2019-03-31 15:30:00,2019-03-31 15:45:00
199,3,1,2,0.002597609982434407,2019-03-31 15:30:00,2019-03-31 15:45:00
202,2,1,1,0.006608146326333332,2019-03-31 15:30:00,2019-03-31 15:45:00
203,25,11,14,0.008074204721673377,2019-03-31 15:30:00,2019-03-31 15:45:00
1,9,1,8,0.002014373872502063,2019-03-31 15:45:00,2019-03-31 16:00:00
2,18,7,11,0.005583097609627995,2019-03-31 15:45:00,2019-03-31 16:00:00
5,24,9,15,0.007826303851576982,2019-03-31 15:45:00,2019-03-31 16:00:00
10,13,9,4,0.02704435890372569,2019-03-31 15:45:00,2019-03-31 16:00:00
11,11,5,6,0.006176189220062224,2019-03-31 15:45:00,2019-03-31 16:00:00
13,2,2,0,0.003959665870735015,2019-03-31 15:45:00,2019-03-31 16:00:00
15,11,7,4,0.010229720056006215,2019-03-31 15:45:00,2019-03-31 16:00:00
16,18,11,7,0.010063637014122082,2019-03-31 15:45:00,2019-03-31 16:00:00
18,15,7,8,0.01039072403342281,2019-03-31 15:45:00,2019-03-31 16:00:00
19,19,7,12,0.015432668553030358,2019-03-31 15:45:00,2019-03-31 16:00:00
20,7,4,3,0.006035507259418109,2019-03-31 15:45:00,2019-03-31 16:00:00
22,2,0,2,0.0018003370249488637,2019-03-31 15:45:00,2019-03-31 16:00:00
23,25,5,20,0.003286718971883439,2019-03-31 15:45:00,2019-03-31 16:00:00
26,14,3,11,0.002343667716099089,2019-03-31 15:45:00,2019-03-31 16:00:00
27,7,2,5,0.0021625574857156806,2019-03-31 15:45:00,2019-03-31 16:00:00
28,4,2,2,0.0021625574857156806,2019-03-31 15:45:00,2019-03-31 16:00:00
30,2,1,1,0.0022318166319237652,2019-03-31 15:45:00,2019-03-31 16:00:00
35,15,12,3,0.008282640816681942,2019-03-31 15:45:00,2019-03-31 16:00:00
37,4,0,4,0.0018003370249488637,2019-03-31 15:45:00,2019-03-31 16:00:00
40,2,1,1,0.011937350120975486,2019-03-31 15:45:00,2019-03-31 16:00:00
41,5,3,2,0.003654671682624718,2019-03-31 15:45:00,2019-03-31 16:00:00
46,13,7,6,0.006640775167698164,2019-03-31 15:45:00,2019-03-31 16:00:00
50,1,1,0,0.0026166212300907043,2019-03-31 15:45:00,2019-03-31 16:00:00
57,7,6,1,0.004574076329523155,2019-03-31 15:45:00,2019-03-31 16:00:00
58,8,1,7,0.0020491769047071918,2019-03-31 15:45:00,2019-03-31 16:00:00
61,5,5,0,0.005803155084750421,2019-03-31 15:45:00,2019-03-31 16:00:00
62,25,11,14,0.0067807628077794285,2019-03-31 15:45:00,2019-03-31 16:00:00
64,10,2,8,0.002286171356708948,2019-03-31 15:45:00,2019-03-31 16:00:00
66,9,2,7,0.002377840211369563,2019-03-31 15:45:00,2019-03-31 16:00:00
67,24,13,11,0.009717114020139963,2019-03-31 15:45:00,2019-03-31 16:00:00
68,8,2,6,0.0063252129690179555,2019-03-31 15:45:00,2019-03-31 16:00:00
69,19,12,7,0.029344641305507457,2019-03-31 15:45:00,2019-03-31 16:00:00
70,5,0,5,0.0018003370249488637,2019-03-31 15:45:00,2019-03-31 16:00:00
71,12,6,6,0.011937350120975486,2019-03-31 15:45:00,2019-03-31 16:00:00
74,8,3,5,0.0038839000037606333,2019-03-31 15:45:00,2019-03-31 16:00:00
75,13,5,8,0.005833029831604032,2019-03-31 15:45:00,2019-03-31 16:00:00
79,4,3,1,0.004066702505420819,2019-03-31 15:45:00,2019-03-31 16:00:00
80,2,2,0,0.002687436112045624,2019-03-31 15:45:00,2019-03-31 16:00:00
85,2,2,0,0.0033696927101130336,2019-03-31 15:45:00,2019-03-31 16:00:00
86,9,2,7,0.002377840211369563,2019-03-31 15:45:00,2019-03-31 16:00:00
87,28,16,12,0.0186942911885215,2019-03-31 15:45:00,2019-03-31 16:00:00
88,7,4,3,0.008109953221709184,2019-03-31 15:45:00,2019-03-31 16:00:00
89,7,5,2,0.00650625316549358,2019-03-31 15:45:00,2019-03-31 16:00:00
90,17,6,11,0.007931494504611378,2019-03-31 15:45:00,2019-03-31 16:00:00
99,12,8,4,0.00508048121628767,2019-03-31 15:45:00,2019-03-31 16:00:00
101,11,5,6,0.006176189220062224,2019-03-31 15:45:00,2019-03-31 16:00:00
104,4,3,1,0.006046315743274715,2019-03-31 15:45:00,2019-03-31 16:00:00
106,16,8,8,0.026908550034826076,2019-03-31 15:45:00,2019-03-31 16:00:00
108,11,8,3,0.022858497889064393,2019-03-31 15:45:00,2019-03-31 16:00:00
109,29,11,18,0.012035157681116432,2019-03-31 15:45:00,2019-03-31 16:00:00
110,26,13,13,0.03283044031018697,2019-03-31 15:45:00,2019-03-31 16:00:00
111,2,2,0,0.004008702396807335,2019-03-31 15:45:00,2019-03-31 16:00:00
112,16,4,12,0.005399960818414983,2019-03-31 15:45:00,2019-03-31 16:00:00
114,6,5,1,0.0075252331689106685,2019-03-31 15:45:00,2019-03-31 16:00:00
115,2,2,0,0.0033696927101130336,2019-03-31 15:45:00,2019-03-31 16:00:00
116,5,2,3,0.0028808551417743153,2019-03-31 15:45:00,2019-03-31 16:00:00
118,6,6,0,0.008733541366265099,2019-03-31 15:45:00,2019-03-31 16:00:00
119,25,16,9,0.014757284884659416,2019-03-31 15:45:00,2019-03-31 16:00:00
120,6,2,4,0.003762747029980744,2019-03-31 15:45:00,2019-03-31 16:00:00
122,4,4,0,0.004463554162282968,2019-03-31 15:45:00,2019-03-31 16:00:00
126,14,7,7,0.009418283791530181,2019-03-31 15:45:00,2019-03-31 16:00:00
127,15,11,4,0.006564016276830125,2019-03-31 15:45:00,2019-03-31 16:00:00
129,20,10,10,0.01627360378943893,2019-03-31 15:45:00,2019-03-31 16:00:00
133,1,1,0,0.003947447265350384,2019-03-31 15:45:00,2019-03-31 16:00:00
137,46,36,10,0.04738278007060787,2019-03-31 15:45:00,2019-03-31 16:00:00
138,33,16,17,0.018027690844721417,2019-03-31 15:45:00,2019-03-31 16:00:00
140,2,0,2,0.0018003370249488637,2019-03-31 15:45:00,2019-03-31 16:00:00
141,9,3,6,0.005386605912826741,2019-03-31 15:45:00,2019-03-31 16:00:00
151,6,4,2,0.008753822860834364,2019-03-31 15:45:00,2019-03-31 16:00:00
153,15,6,9,0.00866489881605422,2019-03-31 15:45:00,2019-03-31 16:00:00
154,2,2,0,0.0034475058094494246,2019-03-31 15:45:00,2019-03-31 16:00:00
157,5,3,2,0.006934413688354889,2019-03-31 15:45:00,2019-03-31 16:00:00
158,7,2,5,0.002727855553756863,2019-03-31 15:45:00,2019-03-31 16:00:00
159,7,2,5,0.002727855553756863,2019-03-31 15:45:00,2019-03-31 16:00:00
160,2,1,1,0.011937350120975486,2019-03-31 15:45:00,2019-03-31 16:00:00
161,1,1,0,0.00582861785408101,2019-03-31 15:45:00,2019-03-31 16:00:00
162,7,4,3,0.006055781117794172,2019-03-31 15:45:00,2019-03-31 16:00:00
164,6,4,2,0.008764021167355656,2019-03-31 15:45:00,2019-03-31 16:00:00
168,52,23,29,0.026767124045292204,2019-03-31 15:45:00,2019-03-31 16:00:00
169,27,16,11,0.029120278772713545,2019-03-31 15:45:00,2019-03-31 16:00:00
170,4,2,2,0.004119899673151239,2019-03-31 15:45:00,2019-03-31 16:00:00
171,11,5,6,0.005865661365509636,2019-03-31 15:45:00,2019-03-31 16:00:00
172,5,2,3,0.004155051240701552,2019-03-31 15:45:00,2019-03-31 16:00:00
173,6,3,3,0.006276438930841809,2019-03-31 15:45:00,2019-03-31 16:00:00
175,14,7,7,0.011937350120975486,2019-03-31 15:45:00,2019-03-31 16:00:00
177,20,10,10,0.017925110538640633,2019-03-31 15:45:00,2019-03-31 16:00:00
189,7,4,3,0.006399863217757477,2019-03-31 15:45:00,2019-03-31 16:00:00
190,9,6,3,0.007043786056963167,2019-03-31 15:45:00,2019-03-31 16:00:00
191,9,5,4,0.005320395981205836,2019-03-31 15:45:00,2019-03-31 16:00:00
195,2,1,1,0.0030225059541742353,2019-03-31 15:45:00,2019-03-31 16:00:00
196,9,5,4,0.004081487690759585,2019-03-31 15:45:00,2019-03-31 16:00:00
197,7,2,5,0.006301544639200685,2019-03-31 15:45:00,2019-03-31 16:00:00
199,1,0,1,0.0018003370249488637,2019-03-31 15:45:00,2019-03-31 16:00:00
200,2,2,0,0.009241350589413538,2019-03-31 15:45:00,2019-03-31 16:00:00
202,1,0,1,0.0018003370249488637,2019-03-31 15:45:00,2019-03-31 16:00:00
203,25,11,14,0.010971920927068047,2019-03-31 15:45:00,2019-03-31 16:00:00
1,16,7,9,0.004023087034485385,2019-03-31 16:00:00,2019-03-31 16:15:00
2,21,8,13,0.007030912800747738,2019-03-31 16:00:00,2019-03-31 16:15:00
5,22,10,12,0.007809011304823376,2019-03-31 16:00:00,2019-03-31 16:15:00
10,7,4,3,0.0076820847548338175,2019-03-31 16:00:00,2019-03-31 16:15:00
11,9,4,5,0.005221613209123366,2019-03-31 16:00:00,2019-03-31 16:15:00
13,2,2,0,0.003983571190948899,2019-03-31 16:00:00,2019-03-31 16:15:00
15,19,14,5,0.014696542916835127,2019-03-31 16:00:00,2019-03-31 16:15:00
16,12,6,6,0.010588705617762947,2019-03-31 16:00:00,2019-03-31 16:15:00
18,25,13,12,0.0199441872313516,2019-03-31 16:00:00,2019-03-31 16:15:00
19,8,2,6,0.004757974587937026,2019-03-31 16:00:00,2019-03-31 16:15:00
20,6,3,3,0.006612746276949393,2019-03-31 16:00:00,2019-03-31 16:15:00
21,1,0,1,0.001670739435788068,2019-03-31 16:00:00,2019-03-31 16:15:00
22,2,0,2,0.001670739435788068,2019-03-31 16:00:00,2019-03-31 16:15:00
23,17,2,15,0.0024541937989430306,2019-03-31 16:00:00,2019-03-31 16:15:00
26,12,2,10,0.0027435606253639498,2019-03-31 16:00:00,2019-03-31 16:15:00
27,15,6,9,0.0037139767304186482,2019-03-31 16:00:00,2019-03-31 16:15:00
28,8,3,5,0.0030850183019013122,2019-03-31 16:00:00,2019-03-31 16:15:00
30,2,1,1,0.0021304948169500993,2019-03-31 16:00:00,2019-03-31 16:15:00
35,9,7,2,0.004129570445094593,2019-03-31 16:00:00,2019-03-31 16:15:00
37,4,1,3,0.0023198936396309315,2019-03-31 16:00:00,2019-03-31 16:15:00
40,4,3,1,0.041923267119080815,2019-03-31 16:00:00,2019-03-31 16:15:00
41,6,4,2,0.003909243307233413,2019-03-31 16:00:00,2019-03-31 16:15:00
46,4,2,2,0.0037625281876629614,2019-03-31 16:00:00,2019-03-31 16:15:00
50,2,2,0,0.003930361953449411,2019-03-31 16:00:00,2019-03-31 16:15:00
57,8,5,3,0.005439371608695277,2019-03-31 16:00:00,2019-03-31 16:15:00
58,5,1,4,0.002121587446733645,2019-03-31 16:00:00,2019-03-31 16:15:00
61,6,3,3,0.003345142403524803,2019-03-31 16:00:00,2019-03-31 16:15:00
62,19,11,8,0.022354434337402515,2019-03-31 16:00:00,2019-03-31 16:15:00
64,13,5,8,0.0037345682695886836,2019-03-31 16:00:00,2019-03-31 16:15:00
66,6,2,4,0.0029056909430981016,2019-03-31 16:00:00,2019-03-31 16:15:00
67,31,15,16,0.013653584732047057,2019-03-31 16:00:00,2019-03-31 16:15:00
68,9,3,6,0.0073819581220308066,2019-03-31 16:00:00,2019-03-31 16:15:00
69,10,6,4,0.00808778260599768,2019-03-31 16:00:00,2019-03-31 16:15:00
70,5,1,4,0.0023921278343360824,2019-03-31 16:00:00,2019-03-31 16:15:00
71,8,4,4,0.011130461523064367,2019-03-31 16:00:00,2019-03-31 16:15:00
74,6,2,4,0.0029056909430981016,2019-03-31 16:00:00,2019-03-31 16:15:00
75,13,5,8,0.0057956446866304755,2019-03-31 16:00:00,2019-03-31 16:15:00
79,4,4,0,0.005616642942848465,2019-03-31 16:00:00,2019-03-31 16:15:00
80,2,2,0,0.002777120147325318,2019-03-31 16:00:00,2019-03-31 16:15:00
86,3,0,3,0.001670739435788068,2019-03-31 16:00:00,2019-03-31 16:15:00
87,26,12,14,0.010523845196135341,2019-03-31 16:00:00,2019-03-31 16:15:00
88,7,3,4,0.0051166661742583965,2019-03-31 16:00:00,2019-03-31 16:15:00
89,8,3,5,0.003927956185337025,2019-03-31 16:00:00,2019-03-31 16:15:00
90,18,8,10,0.009100130483159878,2019-03-31 16:00:00,2019-03-31 16:15:00
99,12,8,4,0.005441761153182295,2019-03-31 16:00:00,2019-03-31 16:15:00
101,6,3,3,0.011130461523064367,2019-03-31 16:00:00,2019-03-31 16:15:00
104,4,2,2,0.006029737587074141,2019-03-31 16:00:00,2019-03-31 16:15:00
106,16,7,9,0.012636218631251812,2019-03-31 16:00:00,2019-03-31 16:15:00
108,8,7,1,0.0583016320012651,2019-03-31 16:00:00,2019-03-31 16:15:00
109,22,12,10,0.011992770054065292,2019-03-31 16:00:00,2019-03-31 16:15:00
110,19,8,11,0.008399700517262673,2019-03-31 16:00:00,2019-03-31 16:15:00
111,2,2,0,0.004496531309022058,2019-03-31 16:00:00,2019-03-31 16:15:00
112,11,3,8,0.003739054427820945,2019-03-31 16:00:00,2019-03-31 16:15:00
114,7,5,2,0.00837723991350688,2019-03-31 16:00:00,2019-03-31 16:15:00
115,6,3,3,0.00535420329729702,2019-03-31 16:00:00,2019-03-31 16:15:00
116,4,1,3,0.0018098141435501842,2019-03-31 16:00:00,2019-03-31 16:15:00
118,10,4,6,0.007690927546226857,2019-03-31 16:00:00,2019-03-31 16:15:00
119,28,19,9,0.02227123942828233,2019-03-31 16:00:00,2019-03-31 16:15:00
120,4,1,3,0.0026902470688255097,2019-03-31 16:00:00,2019-03-31 16:15:00
122,4,4,0,0.007318432691332796,2019-03-31 16:00:00,2019-03-31 16:15:00
126,9,4,5,0.00493849121790352,2019-03-31 16:00:00,2019-03-31 16:15:00
127,17,13,4,0.008027135954716935,2019-03-31 16:00:00,2019-03-31 16:15:00
129,16,11,5,0.03638303224003304,2019-03-31 16:00:00,2019-03-31 16:15:00
133,1,1,0,0.0023198936396309315,2019-03-31 16:00:00,2019-03-31 16:15:00
135,2,2,0,0.005279392314807386,2019-03-31 16:00:00,2019-03-31 16:15:00
137,49,32,17,0.042944553282079925,2019-03-31 16:00:00,2019-03-31 16:15:00
138,33,16,17,0.014425969115522621,2019-03-31 16:00:00,2019-03-31 16:15:00
141,7,2,5,0.0029449767530374455,2019-03-31 16:00:00,2019-03-31 16:15:00
151,7,1,6,0.0029975016497528185,2019-03-31 16:00:00,2019-03-31 16:15:00
153,9,5,4,0.006115531927423309,2019-03-31 16:00:00,2019-03-31 16:15:00
154,9,5,4,0.011543851458240289,2019-03-31 16:00:00,2019-03-31 16:15:00
157,4,1,3,0.0023312868140792026,2019-03-31 16:00:00,2019-03-31 16:15:00
158,8,2,6,0.0023312868140792026,2019-03-31 16:00:00,2019-03-31 16:15:00
159,5,3,2,0.002944740738761992,2019-03-31 16:00:00,2019-03-31 16:15:00
160,4,2,2,0.011130461523064367,2019-03-31 16:00:00,2019-03-31 16:15:00
162,7,2,5,0.0025314561440552713,2019-03-31 16:00:00,2019-03-31 16:15:00
164,3,2,1,0.0045397461651206835,2019-03-31 16:00:00,2019-03-31 16:15:00
168,55,28,27,0.02904370481254192,2019-03-31 16:00:00,2019-03-31 16:15:00
169,33,16,17,0.02148201521231743,2019-03-31 16:00:00,2019-03-31 16:15:00
170,9,6,3,0.011274728327851596,2019-03-31 16:00:00,2019-03-31 16:15:00
171,5,2,3,0.003121578674165928,2019-03-31 16:00:00,2019-03-31 16:15:00
172,5,3,2,0.022474309335648993,2019-03-31 16:00:00,2019-03-31 16:15:00
173,4,4,0,0.004441697310119909,2019-03-31 16:00:00,2019-03-31 16:15:00
175,17,7,10,0.004125487035866404,2019-03-31 16:00:00,2019-03-31 16:15:00
177,18,11,7,0.02774090530181976,2019-03-31 16:00:00,2019-03-31 16:15:00
189,15,10,5,0.009398347880507339,2019-03-31 16:00:00,2019-03-31 16:15:00
190,11,4,7,0.0032258924243970463,2019-03-31 16:00:00,2019-03-31 16:15:00
191,13,4,9,0.0032991545915067554,2019-03-31 16:00:00,2019-03-31 16:15:00
195,4,2,2,0.003121578674165928,2019-03-31 16:00:00,2019-03-31 16:15:00
196,7,3,4,0.004075777043091271,2019-03-31 16:00:00,2019-03-31 16:15:00
197,9,4,5,0.006645067891353518,2019-03-31 16:00:00,2019-03-31 16:15:00
199,2,1,1,0.0029975016497528185,2019-03-31 16:00:00,2019-03-31 16:15:00
200,2,2,0,0.0025200736377706838,2019-03-31 16:00:00,2019-03-31 16:15:00
202,1,0,1,0.001670739435788068,2019-03-31 16:00:00,2019-03-31 16:15:00
203,25,13,12,0.01437565303510425,2019-03-31 16:00:00,2019-03-31 16:15:00
1,16,7,9,0.0045876787937227615,2019-03-31 16:15:00,2019-03-31 16:30:00
2,24,8,16,0.008303237402339035,2019-03-31 16:15:00,2019-03-31 16:30:00
5,19,9,10,0.01068498694197038,2019-03-31 16:15:00,2019-03-31 16:30:00
10,7,3,4,0.006623881650487118,2019-03-31 16:15:00,2019-03-31 16:30:00
11,9,4,5,0.005168394534609563,2019-03-31 16:15:00,2019-03-31 16:30:00
13,3,2,1,0.003993995367095476,2019-03-31 16:15:00,2019-03-31 16:30:00
15,22,15,7,0.014879000290523324,2019-03-31 16:15:00,2019-03-31 16:30:00
16,12,6,6,0.007526979380471158,2019-03-31 16:15:00,2019-03-31 16:30:00
18,20,9,11,0.011758517103382589,2019-03-31 16:15:00,2019-03-31 16:30:00
19,15,8,7,0.00920167860824304,2019-03-31 16:15:00,2019-03-31 16:30:00
20,7,3,4,0.005038109007992067,2019-03-31 16:15:00,2019-03-31 16:30:00
22,2,0,2,0.0016536601365249345,2019-03-31 16:15:00,2019-03-31 16:30:00
23,24,10,14,0.010908340826536751,2019-03-31 16:15:00,2019-03-31 16:30:00
26,7,1,6,0.002191108064480756,2019-03-31 16:15:00,2019-03-31 16:30:00
27,10,2,8,0.0020999040904378535,2019-03-31 16:15:00,2019-03-31 16:30:00
28,4,1,3,0.002803286195965703,2019-03-31 16:15:00,2019-03-31 16:30:00
30,4,2,2,0.0036434189582185933,2019-03-31 16:15:00,2019-03-31 16:30:00
35,6,6,0,0.005281821630741667,2019-03-31 16:15:00,2019-03-31 16:30:00
37,3,0,3,0.0016536601365249345,2019-03-31 16:15:00,2019-03-31 16:30:00
40,6,3,3,0.00598060107343688,2019-03-31 16:15:00,2019-03-31 16:30:00
41,12,6,6,0.008509724498106951,2019-03-31 16:15:00,2019-03-31 16:30:00
46,5,3,2,0.004098355506775223,2019-03-31 16:15:00,2019-03-31 16:30:00
50,5,5,0,0.007398178185172929,2019-03-31 16:15:00,2019-03-31 16:30:00
57,7,5,2,0.00817421512264206,2019-03-31 16:15:00,2019-03-31 16:30:00
58,8,4,4,0.0038239025965328475,2019-03-31 16:15:00,2019-03-31 16:30:00
61,6,3,3,0.004057028183542105,2019-03-31 16:15:00,2019-03-31 16:30:00
62,19,11,8,0.01357039933714426,2019-03-31 16:15:00,2019-03-31 16:30:00
64,14,8,6,0.005355658431184116,2019-03-31 16:15:00,2019-03-31 16:30:00
66,6,2,4,0.0028760078216500786,2019-03-31 16:15:00,2019-03-31 16:30:00
67,23,11,12,0.007513159745427487,2019-03-31 16:15:00,2019-03-31 16:30:00
68,4,0,4,0.0016536601365249345,2019-03-31 16:15:00,2019-03-31 16:30:00
69,13,6,7,0.010469023195332616,2019-03-31 16:15:00,2019-03-31 16:30:00
70,6,1,5,0.002191108064480756,2019-03-31 16:15:00,2019-03-31 16:30:00
71,8,4,4,0.011017649242421913,2019-03-31 16:15:00,2019-03-31 16:30:00
74,5,2,3,0.0038163545944092567,2019-03-31 16:15:00,2019-03-31 16:30:00
75,14,6,8,0.007646533200653734,2019-03-31 16:15:00,2019-03-31 16:30:00
79,4,4,0,0.004777168420443644,2019-03-31 16:15:00,2019-03-31 16:30:00
80,2,2,0,0.0034704260033087617,2019-03-31 16:15:00,2019-03-31 16:30:00
85,6,4,2,0.016107512838768386,2019-03-31 16:15:00,2019-03-31 16:30:00
86,3,0,3,0.0016536601365249345,2019-03-31 16:15:00,2019-03-31 16:30:00
87,31,13,18,0.008102792060297853,2019-03-31 16:15:00,2019-03-31 16:30:00
88,8,3,5,0.00482329803064186,2019-03-31 16:15:00,2019-03-31 16:30:00
89,10,6,4,0.009974885245377565,2019-03-31 16:15:00,2019-03-31 16:30:00
90,19,11,8,0.015993860999396002,2019-03-31 16:15:00,2019-03-31 16:30:00
99,21,13,8,0.011012623398144,2019-03-31 16:15:00,2019-03-31 16:30:00
101,2,1,1,0.011017649242421913,2019-03-31 16:15:00,2019-03-31 16:30:00
104,4,2,2,0.006572079074113273,2019-03-31 16:15:00,2019-03-31 16:30:00
106,14,7,7,0.03796412208398376,2019-03-31 16:15:00,2019-03-31 16:30:00
108,11,8,3,0.033332922437174256,2019-03-31 16:15:00,2019-03-31 16:30:00
109,16,8,8,0.010068142066426818,2019-03-31 16:15:00,2019-03-31 16:30:00
110,18,9,9,0.012410689668272176,2019-03-31 16:15:00,2019-03-31 16:30:00
111,3,3,0,0.00521308308487581,2019-03-31 16:15:00,2019-03-31 16:30:00
112,13,4,9,0.0041957932216114754,2019-03-31 16:15:00,2019-03-31 16:30:00
114,6,3,3,0.004975317934937008,2019-03-31 16:15:00,2019-03-31 16:30:00
115,9,5,4,0.01551892659035252,2019-03-31 16:15:00,2019-03-31 16:30:00
116,2,0,2,0.0016536601365249345,2019-03-31 16:15:00,2019-03-31 16:30:00
118,2,0,2,0.0016536601365249345,2019-03-31 16:15:00,2019-03-31 16:30:00
119,34,23,11,0.022725797450329245,2019-03-31 16:15:00,2019-03-31 16:30:00
120,3,1,2,0.0025624372954941386,2019-03-31 16:15:00,2019-03-31 16:30:00
122,5,1,4,0.002478696539280152,2019-03-31 16:15:00,2019-03-31 16:30:00
126,13,7,6,0.011172988836059832,2019-03-31 16:15:00,2019-03-31 16:30:00
127,22,14,8,0.013124800662298349,2019-03-31 16:15:00,2019-03-31 16:30:00
129,16,11,5,0.050991938460315564,2019-03-31 16:15:00,2019-03-31 16:30:00
133,1,1,0,0.002825960882205788,2019-03-31 16:15:00,2019-03-31 16:30:00
135,2,2,0,0.004757423277186727,2019-03-31 16:15:00,2019-03-31 16:30:00
137,39,16,23,0.02232070810657354,2019-03-31 16:15:00,2019-03-31 16:30:00
138,38,16,22,0.013908380664173853,2019-03-31 16:15:00,2019-03-31 16:30:00
141,5,2,3,0.004679145892622229,2019-03-31 16:15:00,2019-03-31 16:30:00
151,3,0,3,0.0016536601365249345,2019-03-31 16:15:00,2019-03-31 16:30:00
153,9,4,5,0.004782031795290559,2019-03-31 16:15:00,2019-03-31 16:30:00
154,7,1,6,0.004324072872787454,2019-03-31 16:15:00,2019-03-31 16:30:00
157,11,6,5,0.011833670656379459,2019-03-31 16:15:00,2019-03-31 16:30:00
158,4,1,3,0.002723585181830981,2019-03-31 16:15:00,2019-03-31 16:30:00
159,6,3,3,0.0036150686703122297,2019-03-31 16:15:00,2019-03-31 16:30:00
160,6,3,3,0.011017649242421913,2019-03-31 16:15:00,2019-03-31 16:30:00
162,6,2,4,0.0028760078216500786,2019-03-31 16:15:00,2019-03-31 16:30:00
164,7,7,0,0.005063206239235968,2019-03-31 16:15:00,2019-03-31 16:30:00
168,60,40,20,0.036151996464057326,2019-03-31 16:15:00,2019-03-31 16:30:00
169,28,4,24,0.0037358737654563825,2019-03-31 16:15:00,2019-03-31 16:30:00
170,7,5,2,0.006282626445568526,2019-03-31 16:15:00,2019-03-31 16:30:00
171,1,0,1,0.0016536601365249345,2019-03-31 16:15:00,2019-03-31 16:30:00
172,7,6,1,0.034202891844875405,2019-03-31 16:15:00,2019-03-31 16:30:00
173,8,6,2,0.006581606916545536,2019-03-31 16:15:00,2019-03-31 16:30:00
175,11,3,8,0.003063477218110074,2019-03-31 16:15:00,2019-03-31 16:30:00
177,14,7,7,0.011571640517021904,2019-03-31 16:15:00,2019-03-31 16:30:00
189,19,11,8,0.009208006552701414,2019-03-31 16:15:00,2019-03-31 16:30:00
190,6,1,5,0.002086963025661147,2019-03-31 16:15:00,2019-03-31 16:30:00
191,14,5,9,0.006194708309896961,2019-03-31 16:15:00,2019-03-31 16:30:00
195,3,2,1,0.0027181488304259707,2019-03-31 16:15:00,2019-03-31 16:30:00
196,4,3,1,0.0043936335842825365,2019-03-31 16:15:00,2019-03-31 16:30:00
197,8,5,3,0.00514363874159665,2019-03-31 16:15:00,2019-03-31 16:30:00
199,2,1,1,0.003964258852023352,2019-03-31 16:15:00,2019-03-31 16:30:00
202,1,0,1,0.0016536601365249345,2019-03-31 16:15:00,2019-03-31 16:30:00
203,25,15,10,0.031754211955658605,2019-03-31 16:15:00,2019-03-31 16:30:00
1,13,5,8,0.008868662675344365,2019-03-31 16:30:00,2019-03-31 16:45:00
2,22,8,14,0.008593622586137517,2019-03-31 16:30:00,2019-03-31 16:45:00
5,14,7,7,0.0051839396123487605,2019-03-31 16:30:00,2019-03-31 16:45:00
10,6,3,3,0.012187511379895502,2019-03-31 16:30:00,2019-03-31 16:45:00
11,9,4,5,0.004810190477678941,2019-03-31 16:30:00,2019-03-31 16:45:00
13,1,0,1,0.0015391439305957738,2019-03-31 16:30:00,2019-03-31 16:45:00
15,14,10,4,0.013760916532001493,2019-03-31 16:30:00,2019-03-31 16:45:00
16,8,4,4,0.005759729922267379,2019-03-31 16:30:00,2019-03-31 16:45:00
18,13,4,9,0.004804261744178743,2019-03-31 16:30:00,2019-03-31 16:45:00
19,16,10,6,0.009799154365243937,2019-03-31 16:30:00,2019-03-31 16:45:00
20,5,4,1,0.004349151452087841,2019-03-31 16:30:00,2019-03-31 16:45:00
22,1,0,1,0.0015391439305957738,2019-03-31 16:30:00,2019-03-31 16:45:00
23,22,11,11,0.014092349158040396,2019-03-31 16:30:00,2019-03-31 16:45:00
26,7,3,4,0.0037785355182669437,2019-03-31 16:30:00,2019-03-31 16:45:00
27,7,5,2,0.020937814067736756,2019-03-31 16:30:00,2019-03-31 16:45:00
28,4,0,4,0.0015391439305957738,2019-03-31 16:30:00,2019-03-31 16:45:00
30,3,1,2,0.0026768068862180598,2019-03-31 16:30:00,2019-03-31 16:45:00
35,8,7,1,0.008043771183571604,2019-03-31 16:30:00,2019-03-31 16:45:00
37,3,2,1,0.004805783288227117,2019-03-31 16:30:00,2019-03-31 16:45:00
40,4,1,3,0.0021476563846337597,2019-03-31 16:30:00,2019-03-31 16:45:00
41,10,5,5,0.01188072631730113,2019-03-31 16:30:00,2019-03-31 16:45:00
46,11,6,5,0.004486524709515315,2019-03-31 16:30:00,2019-03-31 16:45:00
50,5,3,2,0.005253418302841492,2019-03-31 16:30:00,2019-03-31 16:45:00
57,2,1,1,0.004545551449201129,2019-03-31 16:30:00,2019-03-31 16:45:00
58,5,4,1,0.002873005769939144,2019-03-31 16:30:00,2019-03-31 16:45:00
61,5,3,2,0.004262064865570132,2019-03-31 16:30:00,2019-03-31 16:45:00
62,26,12,14,0.010577551882079012,2019-03-31 16:30:00,2019-03-31 16:45:00
64,16,7,9,0.004340734810409868,2019-03-31 16:30:00,2019-03-31 16:45:00
66,4,1,3,0.0021476563846337597,2019-03-31 16:30:00,2019-03-31 16:45:00
67,17,9,8,0.0074575905682636445,2019-03-31 16:30:00,2019-03-31 16:45:00
68,4,0,4,0.0015391439305957738,2019-03-31 16:30:00,2019-03-31 16:45:00
69,12,5,7,0.005142992728138474,2019-03-31 16:30:00,2019-03-31 16:45:00
70,5,1,4,0.002599285659903708,2019-03-31 16:30:00,2019-03-31 16:45:00
71,8,4,4,0.010257537109406781,2019-03-31 16:30:00,2019-03-31 16:45:00
74,6,3,3,0.0046499496109503186,2019-03-31 16:30:00,2019-03-31 16:45:00
75,17,9,8,0.012022165601905384,2019-03-31 16:30:00,2019-03-31 16:45:00
79,3,3,0,0.002447019503575512,2019-03-31 16:30:00,2019-03-31 16:45:00
80,8,5,3,0.018630146133607285,2019-03-31 16:30:00,2019-03-31 16:45:00
85,2,1,1,0.010257537109406781,2019-03-31 16:30:00,2019-03-31 16:45:00
86,7,1,6,0.0017931819137628493,2019-03-31 16:30:00,2019-03-31 16:45:00
87,23,9,14,0.01441730196724076,2019-03-31 16:30:00,2019-03-31 16:45:00
88,11,6,5,0.010801172817277414,2019-03-31 16:30:00,2019-03-31 16:45:00
89,9,6,3,0.009759910613718219,2019-03-31 16:30:00,2019-03-31 16:45:00
90,18,10,8,0.014289656276737226,2019-03-31 16:30:00,2019-03-31 16:45:00
99,12,5,7,0.003917961937326993,2019-03-31 16:30:00,2019-03-31 16:45:00
101,2,1,1,0.010257537109406781,2019-03-31 16:30:00,2019-03-31 16:45:00
104,2,2,0,0.004541132386625885,2019-03-31 16:30:00,2019-03-31 16:45:00
106,15,7,8,0.012060680291452686,2019-03-31 16:30:00,2019-03-31 16:45:00
108,10,7,3,0.007259268371211271,2019-03-31 16:30:00,2019-03-31 16:45:00
109,26,12,14,0.010963765611334884,2019-03-31 16:30:00,2019-03-31 16:45:00
110,26,13,13,0.02497506441308825,2019-03-31 16:30:00,2019-03-31 16:45:00
111,5,5,0,0.009512788754973925,2019-03-31 16:30:00,2019-03-31 16:45:00
112,18,7,11,0.004900622924396026,2019-03-31 16:30:00,2019-03-31 16:45:00
114,7,5,2,0.013719689689275168,2019-03-31 16:30:00,2019-03-31 16:45:00
115,3,2,1,0.0065173510115377085,2019-03-31 16:30:00,2019-03-31 16:45:00
116,1,0,1,0.0015391439305957738,2019-03-31 16:30:00,2019-03-31 16:45:00
119,30,21,9,0.02697963724872871,2019-03-31 16:30:00,2019-03-31 16:45:00
120,5,2,3,0.003082004407725822,2019-03-31 16:30:00,2019-03-31 16:45:00
122,10,3,7,0.0027221688001590207,2019-03-31 16:30:00,2019-03-31 16:45:00
126,15,6,9,0.0060971065995867055,2019-03-31 16:30:00,2019-03-31 16:45:00
127,15,8,7,0.008729663670883424,2019-03-31 16:30:00,2019-03-31 16:45:00
129,18,11,7,0.02634004345427274,2019-03-31 16:30:00,2019-03-31 16:45:00
133,1,1,0,0.0031724636094114453,2019-03-31 16:30:00,2019-03-31 16:45:00
135,1,1,0,0.0023421396706491695,2019-03-31 16:30:00,2019-03-31 16:45:00
137,39,19,20,0.016899189843283056,2019-03-31 16:30:00,2019-03-31 16:45:00
138,35,17,18,0.020339996032529176,2019-03-31 16:30:00,2019-03-31 16:45:00
140,1,1,0,0.0018697210191402824,2019-03-31 16:30:00,2019-03-31 16:45:00
141,5,4,1,0.07363127717699869,2019-03-31 16:30:00,2019-03-31 16:45:00
151,5,2,3,0.0035519681005153304,2019-03-31 16:30:00,2019-03-31 16:45:00
153,11,7,4,0.010332866912325971,2019-03-31 16:30:00,2019-03-31 16:45:00
154,8,2,6,0.00401613441274375,2019-03-31 16:30:00,2019-03-31 16:45:00
157,15,8,7,0.009882407060352299,2019-03-31 16:30:00,2019-03-31 16:45:00
158,4,3,1,0.003536481435407087,2019-03-31 16:30:00,2019-03-31 16:45:00
159,10,2,8,0.002848181206548798,2019-03-31 16:30:00,2019-03-31 16:45:00
160,5,2,3,0.0035519681005153304,2019-03-31 16:30:00,2019-03-31 16:45:00
161,4,2,2,0.010257537109406781,2019-03-31 16:30:00,2019-03-31 16:45:00
162,2,1,1,0.010257537109406781,2019-03-31 16:30:00,2019-03-31 16:45:00
164,12,6,6,0.004145094154768785,2019-03-31 16:30:00,2019-03-31 16:45:00
168,49,24,25,0.024646072140651565,2019-03-31 16:30:00,2019-03-31 16:45:00
169,22,3,19,0.0021887617080144865,2019-03-31 16:30:00,2019-03-31 16:45:00
170,10,8,2,0.015095719198222172,2019-03-31 16:30:00,2019-03-31 16:45:00
171,1,0,1,0.0015391439305957738,2019-03-31 16:30:00,2019-03-31 16:45:00
172,16,10,6,0.013466340458879442,2019-03-31 16:30:00,2019-03-31 16:45:00
173,8,5,3,0.008574108950418675,2019-03-31 16:30:00,2019-03-31 16:45:00
175,10,3,7,0.002574376548312233,2019-03-31 16:30:00,2019-03-31 16:45:00
177,8,4,4,0.004910909943889924,2019-03-31 16:30:00,2019-03-31 16:45:00
189,15,7,8,0.005997559108564034,2019-03-31 16:30:00,2019-03-31 16:45:00
190,6,3,3,0.0036333396696445323,2019-03-31 16:30:00,2019-03-31 16:45:00
191,8,4,4,0.006648518634713634,2019-03-31 16:30:00,2019-03-31 16:45:00
196,1,0,1,0.0015391439305957738,2019-03-31 16:30:00,2019-03-31 16:45:00
197,5,4,1,0.006529965123900212,2019-03-31 16:30:00,2019-03-31 16:45:00
199,3,2,1,0.002193289723396858,2019-03-31 16:30:00,2019-03-31 16:45:00
202,3,2,1,0.013715224938730173,2019-03-31 16:30:00,2019-03-31 16:45:00
203,23,13,10,0.035502841067107584,2019-03-31 16:30:00,2019-03-31 16:45:00
1,21,10,11,0.010355939402156393,2019-03-31 16:45:00,2019-03-31 17:00:00
2,26,11,15,0.01144187442570143,2019-03-31 16:45:00,2019-03-31 17:00:00
5,10,6,4,0.0071410596101734135,2019-03-31 16:45:00,2019-03-31 17:00:00
10,10,5,5,0.01970080934064952,2019-03-31 16:45:00,2019-03-31 17:00:00
11,5,2,3,0.0038618809364838846,2019-03-31 16:45:00,2019-03-31 17:00:00
13,1,0,1,0.0016733776189228073,2019-03-31 16:45:00,2019-03-31 17:00:00
15,11,6,5,0.008030282818763623,2019-03-31 16:45:00,2019-03-31 17:00:00
16,12,6,6,0.008076719485744892,2019-03-31 16:45:00,2019-03-31 17:00:00
18,11,5,6,0.008863053991287482,2019-03-31 16:45:00,2019-03-31 17:00:00
19,21,9,12,0.013142064968392878,2019-03-31 16:45:00,2019-03-31 17:00:00
20,8,8,0,0.018352961419081167,2019-03-31 16:45:00,2019-03-31 17:00:00
22,1,0,1,0.0016733776189228073,2019-03-31 16:45:00,2019-03-31 17:00:00
23,20,12,8,0.014441898310771252,2019-03-31 16:45:00,2019-03-31 17:00:00
26,9,6,3,0.009667589471904528,2019-03-31 16:45:00,2019-03-31 17:00:00
27,10,6,4,0.016516656799477225,2019-03-31 16:45:00,2019-03-31 17:00:00
28,3,0,3,0.0016733776189228073,2019-03-31 16:45:00,2019-03-31 17:00:00
30,1,0,1,0.0016733776189228073,2019-03-31 16:45:00,2019-03-31 17:00:00
35,4,3,1,0.00488736681337377,2019-03-31 16:45:00,2019-03-31 17:00:00
37,2,2,0,0.0035856456105022557,2019-03-31 16:45:00,2019-03-31 17:00:00
40,2,1,1,0.011124341313935573,2019-03-31 16:45:00,2019-03-31 17:00:00
41,7,5,2,0.011163407675006108,2019-03-31 16:45:00,2019-03-31 17:00:00
46,16,9,7,0.01015554974330284,2019-03-31 16:45:00,2019-03-31 17:00:00
50,7,3,4,0.0037409104554373836,2019-03-31 16:45:00,2019-03-31 17:00:00
57,3,1,2,0.00521422619474312,2019-03-31 16:45:00,2019-03-31 17:00:00
58,14,7,7,0.006318615243601248,2019-03-31 16:45:00,2019-03-31 17:00:00
61,7,5,2,0.0074657779332886805,2019-03-31 16:45:00,2019-03-31 17:00:00
62,16,7,9,0.01254887443001694,2019-03-31 16:45:00,2019-03-31 17:00:00
64,13,4,9,0.003662206144265564,2019-03-31 16:45:00,2019-03-31 17:00:00
66,4,1,3,0.002334980344852148,2019-03-31 16:45:00,2019-03-31 17:00:00
67,20,13,7,0.014450020445720817,2019-03-31 16:45:00,2019-03-31 17:00:00
68,5,3,2,0.003017585581114317,2019-03-31 16:45:00,2019-03-31 17:00:00
69,13,4,9,0.0031017787451396994,2019-03-31 16:45:00,2019-03-31 17:00:00
70,11,2,9,0.00422839043943893,2019-03-31 16:45:00,2019-03-31 17:00:00
71,8,4,4,0.011124341313935573,2019-03-31 16:45:00,2019-03-31 17:00:00
74,6,3,3,0.004188535957957885,2019-03-31 16:45:00,2019-03-31 17:00:00
75,15,8,7,0.008827791810093117,2019-03-31 16:45:00,2019-03-31 17:00:00
79,6,4,2,0.0063831595622327805,2019-03-31 16:45:00,2019-03-31 17:00:00
80,6,3,3,0.011124341313935573,2019-03-31 16:45:00,2019-03-31 17:00:00
85,2,1,1,0.011124341313935573,2019-03-31 16:45:00,2019-03-31 17:00:00
86,5,0,5,0.0016733776189228073,2019-03-31 16:45:00,2019-03-31 17:00:00
87,13,5,8,0.012913437943416602,2019-03-31 16:45:00,2019-03-31 17:00:00
88,11,6,5,0.008561790973846316,2019-03-31 16:45:00,2019-03-31 17:00:00
89,5,4,1,0.005818056717062105,2019-03-31 16:45:00,2019-03-31 17:00:00
90,22,10,12,0.015895869091246927,2019-03-31 16:45:00,2019-03-31 17:00:00
99,23,7,16,0.002664145857745883,2019-03-31 16:45:00,2019-03-31 17:00:00
101,2,1,1,0.011124341313935573,2019-03-31 16:45:00,2019-03-31 17:00:00
104,7,7,0,0.006031982063394752,2019-03-31 16:45:00,2019-03-31 17:00:00
106,9,3,6,0.002910309452944795,2019-03-31 16:45:00,2019-03-31 17:00:00
108,8,7,1,0.023473023273534913,2019-03-31 16:45:00,2019-03-31 17:00:00
109,24,13,11,0.016120547948494855,2019-03-31 16:45:00,2019-03-31 17:00:00
110,17,6,11,0.01237168899911696,2019-03-31 16:45:00,2019-03-31 17:00:00
111,8,4,4,0.006052233787992875,2019-03-31 16:45:00,2019-03-31 17:00:00
112,12,6,6,0.00977954365025244,2019-03-31 16:45:00,2019-03-31 17:00:00
114,7,5,2,0.012368587471541702,2019-03-31 16:45:00,2019-03-31 17:00:00
115,12,6,6,0.012672696461948602,2019-03-31 16:45:00,2019-03-31 17:00:00
116,5,4,1,0.008855550976455778,2019-03-31 16:45:00,2019-03-31 17:00:00
119,31,18,13,0.021719467139253414,2019-03-31 16:45:00,2019-03-31 17:00:00
120,6,1,5,0.0032080682290208454,2019-03-31 16:45:00,2019-03-31 17:00:00
122,4,2,2,0.0037422455421509864,2019-03-31 16:45:00,2019-03-31 17:00:00
126,13,6,7,0.006715997361835415,2019-03-31 16:45:00,2019-03-31 17:00:00
127,15,9,6,0.01521420279855599,2019-03-31 16:45:00,2019-03-31 17:00:00
129,13,7,6,0.01158143829488953,2019-03-31 16:45:00,2019-03-31 17:00:00
133,1,1,0,0.0026295116147125315,2019-03-31 16:45:00,2019-03-31 17:00:00
135,1,0,1,0.0016733776189228073,2019-03-31 16:45:00,2019-03-31 17:00:00
137,31,18,13,0.017981064847925256,2019-03-31 16:45:00,2019-03-31 17:00:00
138,30,16,14,0.021730662121220407,2019-03-31 16:45:00,2019-03-31 17:00:00
140,2,2,0,0.003925708515654265,2019-03-31 16:45:00,2019-03-31 17:00:00
141,5,3,2,0.006043189686108157,2019-03-31 16:45:00,2019-03-31 17:00:00
147,1,1,0,0.002072766720939227,2019-03-31 16:45:00,2019-03-31 17:00:00
151,10,5,5,0.011124341313935573,2019-03-31 16:45:00,2019-03-31 17:00:00
153,10,7,3,0.014975716060260652,2019-03-31 16:45:00,2019-03-31 17:00:00
154,4,3,1,0.0033747030775253895,2019-03-31 16:45:00,2019-03-31 17:00:00
157,12,7,5,0.01340754091852521,2019-03-31 16:45:00,2019-03-31 17:00:00
158,3,2,1,0.004165151317885649,2019-03-31 16:45:00,2019-03-31 17:00:00
159,9,2,7,0.005480710932273482,2019-03-31 16:45:00,2019-03-31 17:00:00
160,5,2,3,0.0038618809364838846,2019-03-31 16:45:00,2019-03-31 17:00:00
161,4,2,2,0.011124341313935573,2019-03-31 16:45:00,2019-03-31 17:00:00
162,4,3,1,0.02036849556135884,2019-03-31 16:45:00,2019-03-31 17:00:00
164,12,4,8,0.006717264083329878,2019-03-31 16:45:00,2019-03-31 17:00:00
168,44,17,27,0.022754423440943698,2019-03-31 16:45:00,2019-03-31 17:00:00
169,14,4,10,0.0057525361410125115,2019-03-31 16:45:00,2019-03-31 17:00:00
170,8,4,4,0.005393434642376122,2019-03-31 16:45:00,2019-03-31 17:00:00
171,9,3,6,0.006038868241336169,2019-03-31 16:45:00,2019-03-31 17:00:00
172,9,2,7,0.0022101477166720906,2019-03-31 16:45:00,2019-03-31 17:00:00
173,6,3,3,0.008685798459170859,2019-03-31 16:45:00,2019-03-31 17:00:00
175,7,3,4,0.003511980134327859,2019-03-31 16:45:00,2019-03-31 17:00:00
177,18,8,10,0.00825414190600321,2019-03-31 16:45:00,2019-03-31 17:00:00
189,15,8,7,0.011410731206616424,2019-03-31 16:45:00,2019-03-31 17:00:00
190,3,3,0,0.004104958157287263,2019-03-31 16:45:00,2019-03-31 17:00:00
191,4,3,1,0.003921933148502905,2019-03-31 16:45:00,2019-03-31 17:00:00
196,5,1,4,0.0021249450369250854,2019-03-31 16:45:00,2019-03-31 17:00:00
197,6,5,1,0.00998332154011107,2019-03-31 16:45:00,2019-03-31 17:00:00
199,3,2,1,0.0026216579602540814,2019-03-31 16:45:00,2019-03-31 17:00:00
202,1,1,0,0.00232187417021043,2019-03-31 16:45:00,2019-03-31 17:00:00
203,15,8,7,0.01865419056607573,2019-03-31 16:45:00,2019-03-31 17:00:00
1,12,4,8,0.0033691232506058376,2019-03-31 17:00:00,2019-03-31 17:15:00
2,20,7,13,0.006826772095354401,2019-03-31 17:00:00,2019-03-31 17:15:00
5,6,4,2,0.012387996778636116,2019-03-31 17:00:00,2019-03-31 17:15:00
10,11,8,3,0.02307144021694492,2019-03-31 17:00:00,2019-03-31 17:15:00
11,4,3,1,0.02013413517736081,2019-03-31 17:00:00,2019-03-31 17:15:00
13,2,0,2,0.0017884226226609836,2019-03-31 17:00:00,2019-03-31 17:15:00
15,12,4,8,0.005668101424010313,2019-03-31 17:00:00,2019-03-31 17:15:00
16,10,8,2,0.012078839453857838,2019-03-31 17:00:00,2019-03-31 17:15:00
18,8,5,3,0.007834782697750824,2019-03-31 17:00:00,2019-03-31 17:15:00
19,8,2,6,0.0038027016869359434,2019-03-31 17:00:00,2019-03-31 17:15:00
20,16,13,3,0.022833891571206823,2019-03-31 17:00:00,2019-03-31 17:15:00
21,2,0,2,0.0017884226226609836,2019-03-31 17:00:00,2019-03-31 17:15:00
22,1,0,1,0.0017884226226609836,2019-03-31 17:00:00,2019-03-31 17:15:00
23,20,8,12,0.008789767728326679,2019-03-31 17:00:00,2019-03-31 17:15:00
26,13,8,5,0.00891944187944437,2019-03-31 17:00:00,2019-03-31 17:15:00
27,8,5,3,0.00938355328495442,2019-03-31 17:00:00,2019-03-31 17:15:00
28,8,3,5,0.00593044358492062,2019-03-31 17:00:00,2019-03-31 17:15:00
30,2,1,1,0.0035680904841932067,2019-03-31 17:00:00,2019-03-31 17:15:00
35,4,2,2,0.004572649119426611,2019-03-31 17:00:00,2019-03-31 17:15:00
40,2,2,0,0.0029929730684206033,2019-03-31 17:00:00,2019-03-31 17:15:00
41,13,5,8,0.011492504813575225,2019-03-31 17:00:00,2019-03-31 17:15:00
46,14,11,3,0.0194584448451291,2019-03-31 17:00:00,2019-03-31 17:15:00
50,2,2,0,0.008765749462501346,2019-03-31 17:00:00,2019-03-31 17:15:00
57,4,2,2,0.005805126503984305,2019-03-31 17:00:00,2019-03-31 17:15:00
58,10,4,6,0.007226924103040575,2019-03-31 17:00:00,2019-03-31 17:15:00
61,9,6,3,0.006695274487548357,2019-03-31 17:00:00,2019-03-31 17:15:00
62,13,6,7,0.007265144204190828,2019-03-31 17:00:00,2019-03-31 17:15:00
64,12,4,8,0.0034048660422044434,2019-03-31 17:00:00,2019-03-31 17:15:00
66,3,0,3,0.0017884226226609836,2019-03-31 17:00:00,2019-03-31 17:15:00
67,23,16,7,0.01558660997881241,2019-03-31 17:00:00,2019-03-31 17:15:00
68,6,4,2,0.006087525298414863,2019-03-31 17:00:00,2019-03-31 17:15:00
69,15,4,11,0.005603002773132337,2019-03-31 17:00:00,2019-03-31 17:15:00
70,12,2,10,0.004572649119426611,2019-03-31 17:00:00,2019-03-31 17:15:00
74,7,3,4,0.003370904987606111,2019-03-31 17:00:00,2019-03-31 17:15:00
75,14,4,10,0.0027097962674555824,2019-03-31 17:00:00,2019-03-31 17:15:00
79,6,4,2,0.0079051803934553,2019-03-31 17:00:00,2019-03-31 17:15:00
80,8,3,5,0.0036500427493579178,2019-03-31 17:00:00,2019-03-31 17:15:00
85,5,3,2,0.006174783511458633,2019-03-31 17:00:00,2019-03-31 17:15:00
86,7,4,3,0.008773588909033611,2019-03-31 17:00:00,2019-03-31 17:15:00
87,10,4,6,0.007108543168315891,2019-03-31 17:00:00,2019-03-31 17:15:00
88,9,6,3,0.0052083562466729025,2019-03-31 17:00:00,2019-03-31 17:15:00
89,11,7,4,0.007752328096301346,2019-03-31 17:00:00,2019-03-31 17:15:00
90,17,7,10,0.005380844871690651,2019-03-31 17:00:00,2019-03-31 17:15:00
99,12,1,11,0.0019381988973182222,2019-03-31 17:00:00,2019-03-31 17:15:00
101,2,1,1,0.011892088963359363,2019-03-31 17:00:00,2019-03-31 17:15:00
104,11,11,0,0.010529478325731348,2019-03-31 17:00:00,2019-03-31 17:15:00
106,5,1,4,0.002271039906902245,2019-03-31 17:00:00,2019-03-31 17:15:00
108,15,10,5,0.010516114451720095,2019-03-31 17:00:00,2019-03-31 17:15:00
109,21,14,7,0.024545157157078803,2019-03-31 17:00:00,2019-03-31 17:15:00
110,8,3,5,0.005196051738364882,2019-03-31 17:00:00,2019-03-31 17:15:00
111,12,10,2,0.011924568430322472,2019-03-31 17:00:00,2019-03-31 17:15:00
112,14,7,7,0.010319256661789771,2019-03-31 17:00:00,2019-03-31 17:15:00
113,2,1,1,0.011892088963359363,2019-03-31 17:00:00,2019-03-31 17:15:00
114,9,5,4,0.006560375702728861,2019-03-31 17:00:00,2019-03-31 17:15:00
115,12,7,5,0.008870965383760532,2019-03-31 17:00:00,2019-03-31 17:15:00
116,4,4,0,0.007821235605552987,2019-03-31 17:00:00,2019-03-31 17:15:00
118,2,1,1,0.002092467161859856,2019-03-31 17:00:00,2019-03-31 17:15:00
119,20,8,12,0.019650389768399674,2019-03-31 17:00:00,2019-03-31 17:15:00
120,6,1,5,0.003180535871043797,2019-03-31 17:00:00,2019-03-31 17:15:00
122,2,2,0,0.0059860597283773135,2019-03-31 17:00:00,2019-03-31 17:15:00
126,18,7,11,0.012449397071825057,2019-03-31 17:00:00,2019-03-31 17:15:00
127,16,6,10,0.007341254562137316,2019-03-31 17:00:00,2019-03-31 17:15:00
129,11,7,4,0.011067444914215354,2019-03-31 17:00:00,2019-03-31 17:15:00
133,1,1,0,0.002671838320152733,2019-03-31 17:00:00,2019-03-31 17:15:00
135,1,0,1,0.0017884226226609836,2019-03-31 17:00:00,2019-03-31 17:15:00
137,40,18,22,0.022795802773048476,2019-03-31 17:00:00,2019-03-31 17:15:00
138,31,15,16,0.017141977628338145,2019-03-31 17:00:00,2019-03-31 17:15:00
140,2,2,0,0.0050214926794931005,2019-03-31 17:00:00,2019-03-31 17:15:00
141,8,4,4,0.005316968888372599,2019-03-31 17:00:00,2019-03-31 17:15:00
147,1,1,0,0.002177146022825966,2019-03-31 17:00:00,2019-03-31 17:15:00
151,4,1,3,0.0024955181759078555,2019-03-31 17:00:00,2019-03-31 17:15:00
153,12,8,4,0.008004483594399467,2019-03-31 17:00:00,2019-03-31 17:15:00
154,5,3,2,0.004186977007032893,2019-03-31 17:00:00,2019-03-31 17:15:00
157,14,7,7,0.013772176682954435,2019-03-31 17:00:00,2019-03-31 17:15:00
158,4,3,1,0.004088931184139411,2019-03-31 17:00:00,2019-03-31 17:15:00
159,6,2,4,0.006317859306514146,2019-03-31 17:00:00,2019-03-31 17:15:00
160,5,2,3,0.004127435693932166,2019-03-31 17:00:00,2019-03-31 17:15:00
161,4,2,2,0.011892088963359363,2019-03-31 17:00:00,2019-03-31 17:15:00
162,7,4,3,0.019625301915655497,2019-03-31 17:00:00,2019-03-31 17:15:00
164,13,8,5,0.022062830154515326,2019-03-31 17:00:00,2019-03-31 17:15:00
168,36,17,19,0.01695997840140734,2019-03-31 17:00:00,2019-03-31 17:15:00
169,12,4,8,0.00618699343575097,2019-03-31 17:00:00,2019-03-31 17:15:00
170,6,2,4,0.0031104129711901313,2019-03-31 17:00:00,2019-03-31 17:15:00
171,5,0,5,0.0017884226226609836,2019-03-31 17:00:00,2019-03-31 17:15:00
172,6,1,5,0.002154745268048444,2019-03-31 17:00:00,2019-03-31 17:15:00
173,5,2,3,0.0055827987484523165,2019-03-31 17:00:00,2019-03-31 17:15:00
175,4,2,2,0.011892088963359363,2019-03-31 17:00:00,2019-03-31 17:15:00
177,12,6,6,0.008200361061507854,2019-03-31 17:00:00,2019-03-31 17:15:00
189,11,5,6,0.008244163913220087,2019-03-31 17:00:00,2019-03-31 17:15:00
190,5,4,1,0.004958067642162049,2019-03-31 17:00:00,2019-03-31 17:15:00
191,5,5,0,0.011700972499806658,2019-03-31 17:00:00,2019-03-31 17:15:00
196,3,0,3,0.0017884226226609836,2019-03-31 17:00:00,2019-03-31 17:15:00
197,8,3,5,0.010681449184957944,2019-03-31 17:00:00,2019-03-31 17:15:00
199,4,2,2,0.003804973302408506,2019-03-31 17:00:00,2019-03-31 17:15:00
202,1,1,0,0.0022348472334618487,2019-03-31 17:00:00,2019-03-31 17:15:00
203,14,8,6,0.03692523055344493,2019-03-31 17:00:00,2019-03-31 17:15:00
1,11,3,8,0.009033580807263998,2019-03-31 17:15:00,2019-03-31 17:30:00
2,19,7,12,0.010600413514561981,2019-03-31 17:15:00,2019-03-31 17:30:00
5,8,6,2,0.01569595138648249,2019-03-31 17:15:00,2019-03-31 17:30:00
10,14,7,7,0.009312218924364762,2019-03-31 17:15:00,2019-03-31 17:30:00
11,6,4,2,0.019190016005118476,2019-03-31 17:15:00,2019-03-31 17:30:00
13,1,0,1,0.0017037889356781612,2019-03-31 17:15:00,2019-03-31 17:30:00
15,12,6,6,0.01747082534702493,2019-03-31 17:15:00,2019-03-31 17:30:00
16,9,7,2,0.008414714753529957,2019-03-31 17:15:00,2019-03-31 17:30:00
18,14,9,5,0.014237698388447028,2019-03-31 17:15:00,2019-03-31 17:30:00
19,4,4,0,0.004163199898531116,2019-03-31 17:15:00,2019-03-31 17:30:00
20,13,5,8,0.0062722925023928075,2019-03-31 17:15:00,2019-03-31 17:30:00
21,2,0,2,0.0017037889356781612,2019-03-31 17:15:00,2019-03-31 17:30:00
23,13,4,9,0.005040233954109076,2019-03-31 17:15:00,2019-03-31 17:30:00
26,10,6,4,0.007874301516057997,2019-03-31 17:15:00,2019-03-31 17:30:00
27,16,8,8,0.0112264518614969,2019-03-31 17:15:00,2019-03-31 17:30:00
28,6,2,4,0.003009951589240318,2019-03-31 17:15:00,2019-03-31 17:30:00
30,2,1,1,0.002809633732408253,2019-03-31 17:15:00,2019-03-31 17:30:00
35,7,5,2,0.005647809956662026,2019-03-31 17:15:00,2019-03-31 17:30:00
40,5,3,2,0.009210391811528997,2019-03-31 17:15:00,2019-03-31 17:30:00
41,5,2,3,0.006586200596405498,2019-03-31 17:15:00,2019-03-31 17:30:00
46,17,12,5,0.025648065342460235,2019-03-31 17:15:00,2019-03-31 17:30:00
50,3,2,1,0.003501163554500651,2019-03-31 17:15:00,2019-03-31 17:30:00
57,4,2,2,0.0049819434256825265,2019-03-31 17:15:00,2019-03-31 17:30:00
58,9,5,4,0.009549913624056034,2019-03-31 17:15:00,2019-03-31 17:30:00
61,8,5,3,0.006340939596377205,2019-03-31 17:15:00,2019-03-31 17:30:00
62,10,5,5,0.006327221183018239,2019-03-31 17:15:00,2019-03-31 17:30:00
64,8,3,5,0.0038624764336494728,2019-03-31 17:15:00,2019-03-31 17:30:00
66,3,0,3,0.0017037889356781612,2019-03-31 17:15:00,2019-03-31 17:30:00
67,17,10,7,0.015126181214407721,2019-03-31 17:15:00,2019-03-31 17:30:00
68,6,3,3,0.005449783894951254,2019-03-31 17:15:00,2019-03-31 17:30:00
69,8,2,6,0.005295271695369256,2019-03-31 17:15:00,2019-03-31 17:30:00
70,7,4,3,0.006787874593642598,2019-03-31 17:15:00,2019-03-31 17:30:00
74,2,0,2,0.0017037889356781612,2019-03-31 17:15:00,2019-03-31 17:30:00
75,12,3,9,0.002377422124428971,2019-03-31 17:15:00,2019-03-31 17:30:00
79,4,1,3,0.002377422124428971,2019-03-31 17:15:00,2019-03-31 17:30:00
80,8,3,5,0.003477310512900446,2019-03-31 17:15:00,2019-03-31 17:30:00
85,5,3,2,0.006087065740296301,2019-03-31 17:15:00,2019-03-31 17:30:00
86,7,4,3,0.007563534221321189,2019-03-31 17:15:00,2019-03-31 17:30:00
87,15,6,9,0.006833530756538345,2019-03-31 17:15:00,2019-03-31 17:30:00
88,6,6,0,0.011304084858093418,2019-03-31 17:15:00,2019-03-31 17:30:00
89,9,6,3,0.00914218742689374,2019-03-31 17:15:00,2019-03-31 17:30:00
90,17,8,9,0.02240739143120592,2019-03-31 17:15:00,2019-03-31 17:30:00
99,10,3,7,0.003862306329644726,2019-03-31 17:15:00,2019-03-31 17:30:00
101,2,0,2,0.0017037889356781612,2019-03-31 17:15:00,2019-03-31 17:30:00
104,14,11,3,0.01124014210218136,2019-03-31 17:15:00,2019-03-31 17:30:00
106,4,1,3,0.002377422124428971,2019-03-31 17:15:00,2019-03-31 17:30:00
108,8,4,4,0.0055274740963294185,2019-03-31 17:15:00,2019-03-31 17:30:00
109,18,7,11,0.01424453899376375,2019-03-31 17:15:00,2019-03-31 17:30:00
110,9,4,5,0.004895866061271891,2019-03-31 17:15:00,2019-03-31 17:30:00
111,12,11,1,0.012843703118221212,2019-03-31 17:15:00,2019-03-31 17:30:00
112,12,4,8,0.006092025456116489,2019-03-31 17:15:00,2019-03-31 17:30:00
113,5,2,3,0.003090789384644789,2019-03-31 17:15:00,2019-03-31 17:30:00
114,8,4,4,0.006292385121519539,2019-03-31 17:15:00,2019-03-31 17:30:00
115,14,6,8,0.026115732252877825,2019-03-31 17:15:00,2019-03-31 17:30:00
116,7,7,0,0.01755460580690693,2019-03-31 17:15:00,2019-03-31 17:30:00
118,1,0,1,0.0017037889356781612,2019-03-31 17:15:00,2019-03-31 17:30:00
119,18,8,10,0.014176876275854127,2019-03-31 17:15:00,2019-03-31 17:30:00
120,3,1,2,0.002908990941809968,2019-03-31 17:15:00,2019-03-31 17:30:00
122,1,1,0,0.0024547812118812648,2019-03-31 17:15:00,2019-03-31 17:30:00
126,11,5,6,0.0072606431008302805,2019-03-31 17:15:00,2019-03-31 17:30:00
127,9,3,6,0.008030545341358167,2019-03-31 17:15:00,2019-03-31 17:30:00
129,18,12,6,0.02726666160792834,2019-03-31 17:15:00,2019-03-31 17:30:00
133,1,1,0,0.0025361789852889308,2019-03-31 17:15:00,2019-03-31 17:30:00
135,2,1,1,0.002179850725806892,2019-03-31 17:15:00,2019-03-31 17:30:00
137,32,14,18,0.019013485438623707,2019-03-31 17:15:00,2019-03-31 17:30:00
138,19,6,13,0.006260528787145956,2019-03-31 17:15:00,2019-03-31 17:30:00
140,6,3,3,0.00902029521814059,2019-03-31 17:15:00,2019-03-31 17:30:00
141,6,4,2,0.006303537197504328,2019-03-31 17:15:00,2019-03-31 17:30:00
147,2,1,1,0.0024540070280449234,2019-03-31 17:15:00,2019-03-31 17:30:00
151,1,1,0,0.0031520692264794536,2019-03-31 17:15:00,2019-03-31 17:30:00
153,20,11,9,0.013487675704695223,2019-03-31 17:15:00,2019-03-31 17:30:00
154,3,1,2,0.002601771963555251,2019-03-31 17:15:00,2019-03-31 17:30:00
157,10,5,5,0.00917183105440244,2019-03-31 17:15:00,2019-03-31 17:30:00
158,5,3,2,0.004803483788621177,2019-03-31 17:15:00,2019-03-31 17:30:00
159,7,4,3,0.004310484225247484,2019-03-31 17:15:00,2019-03-31 17:30:00
160,6,2,4,0.0029632178477458637,2019-03-31 17:15:00,2019-03-31 17:30:00
161,4,2,2,0.01133366325900946,2019-03-31 17:15:00,2019-03-31 17:30:00
162,7,4,3,0.015200573311713636,2019-03-31 17:15:00,2019-03-31 17:30:00
164,14,8,6,0.01629878688850203,2019-03-31 17:15:00,2019-03-31 17:30:00
168,54,22,32,0.019242425868577676,2019-03-31 17:15:00,2019-03-31 17:30:00
169,12,5,7,0.008433544975276984,2019-03-31 17:15:00,2019-03-31 17:30:00
170,2,1,1,0.01133366325900946,2019-03-31 17:15:00,2019-03-31 17:30:00
171,1,0,1,0.0017037889356781612,2019-03-31 17:15:00,2019-03-31 17:30:00
172,2,1,1,0.01133366325900946,2019-03-31 17:15:00,2019-03-31 17:30:00
173,8,7,1,0.01657262495626142,2019-03-31 17:15:00,2019-03-31 17:30:00
175,6,3,3,0.01133366325900946,2019-03-31 17:15:00,2019-03-31 17:30:00
177,8,5,3,0.025593029353865437,2019-03-31 17:15:00,2019-03-31 17:30:00
189,12,4,8,0.005498260348107665,2019-03-31 17:15:00,2019-03-31 17:30:00
190,5,4,1,0.00471327853532582,2019-03-31 17:15:00,2019-03-31 17:30:00
191,3,3,0,0.0033927032880288026,2019-03-31 17:15:00,2019-03-31 17:30:00
196,1,0,1,0.0017037889356781612,2019-03-31 17:15:00,2019-03-31 17:30:00
197,5,1,4,0.0028346605412968443,2019-03-31 17:15:00,2019-03-31 17:30:00
199,3,2,1,0.0029831082163948607,2019-03-31 17:15:00,2019-03-31 17:30:00
202,1,1,0,0.0024547812118812648,2019-03-31 17:15:00,2019-03-31 17:30:00
203,8,5,3,0.03566989823998658,2019-03-31 17:15:00,2019-03-31 17:30:00
1,10,4,6,0.006175031823403333,2019-03-31 17:30:00,2019-03-31 17:45:00
2,14,5,9,0.014977390632747821,2019-03-31 17:30:00,2019-03-31 17:45:00
5,9,7,2,0.024616891656804068,2019-03-31 17:30:00,2019-03-31 17:45:00
10,10,3,7,0.00366973452865742,2019-03-31 17:30:00,2019-03-31 17:45:00
11,6,4,2,0.023383189864389038,2019-03-31 17:30:00,2019-03-31 17:45:00
13,1,0,1,0.001904840290160976,2019-03-31 17:30:00,2019-03-31 17:45:00
15,11,7,4,0.009189672616217146,2019-03-31 17:30:00,2019-03-31 17:45:00
16,19,12,7,0.030337569311023046,2019-03-31 17:30:00,2019-03-31 17:45:00
18,20,11,9,0.012167057823778941,2019-03-31 17:30:00,2019-03-31 17:45:00
19,8,6,2,0.005230869038077153,2019-03-31 17:30:00,2019-03-31 17:45:00
20,8,3,5,0.004280889909317036,2019-03-31 17:30:00,2019-03-31 17:45:00
21,2,0,2,0.001904840290160976,2019-03-31 17:30:00,2019-03-31 17:45:00
23,11,4,7,0.010937582508981782,2019-03-31 17:30:00,2019-03-31 17:45:00
26,9,6,3,0.02869800662018973,2019-03-31 17:30:00,2019-03-31 17:45:00
27,10,5,5,0.006179005682836046,2019-03-31 17:30:00,2019-03-31 17:45:00
28,6,2,4,0.003343132767555837,2019-03-31 17:30:00,2019-03-31 17:45:00
30,1,0,1,0.001904840290160976,2019-03-31 17:30:00,2019-03-31 17:45:00
35,6,3,3,0.003566601216192819,2019-03-31 17:30:00,2019-03-31 17:45:00
40,4,1,3,0.0035240299380018226,2019-03-31 17:30:00,2019-03-31 17:45:00
41,2,0,2,0.001904840290160976,2019-03-31 17:30:00,2019-03-31 17:45:00
46,16,9,7,0.01423012032425435,2019-03-31 17:30:00,2019-03-31 17:45:00
50,1,1,0,0.002350486005726455,2019-03-31 17:30:00,2019-03-31 17:45:00
57,6,3,3,0.010249002528044202,2019-03-31 17:30:00,2019-03-31 17:45:00
58,8,5,3,0.011874188620716111,2019-03-31 17:30:00,2019-03-31 17:45:00
61,10,5,5,0.006801574751030506,2019-03-31 17:30:00,2019-03-31 17:45:00
62,9,4,5,0.004251784105391882,2019-03-31 17:30:00,2019-03-31 17:45:00
64,9,6,3,0.009829024372399393,2019-03-31 17:30:00,2019-03-31 17:45:00
66,2,0,2,0.001904840290160976,2019-03-31 17:30:00,2019-03-31 17:45:00
67,10,3,7,0.004093700847050082,2019-03-31 17:30:00,2019-03-31 17:45:00
68,10,3,7,0.004467163917324448,2019-03-31 17:30:00,2019-03-31 17:45:00
69,5,5,0,0.0106127316469303,2019-03-31 17:30:00,2019-03-31 17:45:00
70,7,4,3,0.006957205370685204,2019-03-31 17:30:00,2019-03-31 17:45:00
74,2,0,2,0.001904840290160976,2019-03-31 17:30:00,2019-03-31 17:45:00
75,10,3,7,0.0029964679577596663,2019-03-31 17:30:00,2019-03-31 17:45:00
79,3,1,2,0.003312898947023051,2019-03-31 17:30:00,2019-03-31 17:45:00
80,2,0,2,0.001904840290160976,2019-03-31 17:30:00,2019-03-31 17:45:00
85,2,1,1,0.012644015077275007,2019-03-31 17:30:00,2019-03-31 17:45:00
86,6,3,3,0.012043908162808927,2019-03-31 17:30:00,2019-03-31 17:45:00
87,15,6,9,0.0065143283275018,2019-03-31 17:30:00,2019-03-31 17:45:00
88,5,5,0,0.013873822072253466,2019-03-31 17:30:00,2019-03-31 17:45:00
89,7,6,1,0.009063187779598605,2019-03-31 17:30:00,2019-03-31 17:45:00
90,15,6,9,0.011309523648702163,2019-03-31 17:30:00,2019-03-31 17:45:00
99,8,3,5,0.004574568873663759,2019-03-31 17:30:00,2019-03-31 17:45:00
101,2,0,2,0.001904840290160976,2019-03-31 17:30:00,2019-03-31 17:45:00
104,12,7,5,0.00741267457523663,2019-03-31 17:30:00,2019-03-31 17:45:00
106,4,1,3,0.0026579696755154817,2019-03-31 17:30:00,2019-03-31 17:45:00
108,7,3,4,0.0047209576038851255,2019-03-31 17:30:00,2019-03-31 17:45:00
109,21,8,13,0.011477907176859668,2019-03-31 17:30:00,2019-03-31 17:45:00
110,16,7,9,0.01126268853724538,2019-03-31 17:30:00,2019-03-31 17:45:00
111,3,2,1,0.004032557030397409,2019-03-31 17:30:00,2019-03-31 17:45:00
112,7,2,5,0.0034650310289213067,2019-03-31 17:30:00,2019-03-31 17:45:00
113,2,2,0,0.0030012560521191804,2019-03-31 17:30:00,2019-03-31 17:45:00
114,7,4,3,0.008021860734577127,2019-03-31 17:30:00,2019-03-31 17:45:00
115,8,3,5,0.013309664186140895,2019-03-31 17:30:00,2019-03-31 17:45:00
116,4,4,0,0.004685828740827914,2019-03-31 17:30:00,2019-03-31 17:45:00
118,1,1,0,0.003233179719283597,2019-03-31 17:30:00,2019-03-31 17:45:00
119,16,9,7,0.010451440052754371,2019-03-31 17:30:00,2019-03-31 17:45:00
120,3,1,2,0.0035240299380018226,2019-03-31 17:30:00,2019-03-31 17:45:00
122,8,5,3,0.010026911587859675,2019-03-31 17:30:00,2019-03-31 17:45:00
126,6,1,5,0.002778443097526463,2019-03-31 17:30:00,2019-03-31 17:45:00
127,11,5,6,0.014249963493771316,2019-03-31 17:30:00,2019-03-31 17:45:00
129,14,8,6,0.010791556782128935,2019-03-31 17:30:00,2019-03-31 17:45:00
133,1,1,0,0.002968698660279193,2019-03-31 17:30:00,2019-03-31 17:45:00
135,3,2,1,0.003775675172564521,2019-03-31 17:30:00,2019-03-31 17:45:00
137,25,13,12,0.01263976130350868,2019-03-31 17:30:00,2019-03-31 17:45:00
138,23,10,13,0.013359481666043047,2019-03-31 17:30:00,2019-03-31 17:45:00
140,1,0,1,0.001904840290160976,2019-03-31 17:30:00,2019-03-31 17:45:00
141,2,1,1,0.002800264622740793,2019-03-31 17:30:00,2019-03-31 17:45:00
151,1,1,0,0.004570197747234947,2019-03-31 17:30:00,2019-03-31 17:45:00
153,15,7,8,0.009172222624846004,2019-03-31 17:30:00,2019-03-31 17:45:00
154,2,0,2,0.001904840290160976,2019-03-31 17:30:00,2019-03-31 17:45:00
157,10,7,3,0.019167170318771222,2019-03-31 17:30:00,2019-03-31 17:45:00
158,4,2,2,0.00927383704396,2019-03-31 17:30:00,2019-03-31 17:45:00
159,3,3,0,0.004558554086731057,2019-03-31 17:30:00,2019-03-31 17:45:00
160,10,4,6,0.004396150569576988,2019-03-31 17:30:00,2019-03-31 17:45:00
161,2,1,1,0.012644015077275007,2019-03-31 17:30:00,2019-03-31 17:45:00
162,3,2,1,0.01461358552464223,2019-03-31 17:30:00,2019-03-31 17:45:00
164,11,9,2,0.021030152178052607,2019-03-31 17:30:00,2019-03-31 17:45:00
168,52,21,31,0.020198333408519294,2019-03-31 17:30:00,2019-03-31 17:45:00
169,20,7,13,0.011400121178012541,2019-03-31 17:30:00,2019-03-31 17:45:00
170,3,1,2,0.003312898947023051,2019-03-31 17:30:00,2019-03-31 17:45:00
171,3,2,1,0.003135462174878734,2019-03-31 17:30:00,2019-03-31 17:45:00
172,7,4,3,0.007484868532002396,2019-03-31 17:30:00,2019-03-31 17:45:00
173,13,10,3,0.02622745378993998,2019-03-31 17:30:00,2019-03-31 17:45:00
175,10,4,6,0.004396150569576988,2019-03-31 17:30:00,2019-03-31 17:45:00
177,6,4,2,0.022194016118809303,2019-03-31 17:30:00,2019-03-31 17:45:00
189,11,3,8,0.002796162840438884,2019-03-31 17:30:00,2019-03-31 17:45:00
190,2,2,0,0.0028495807851797415,2019-03-31 17:30:00,2019-03-31 17:45:00
191,4,4,0,0.014378473532809391,2019-03-31 17:30:00,2019-03-31 17:45:00
196,2,0,2,0.001904840290160976,2019-03-31 17:30:00,2019-03-31 17:45:00
197,9,7,2,0.005912140295310448,2019-03-31 17:30:00,2019-03-31 17:45:00
199,2,2,0,0.0033257728608507495,2019-03-31 17:30:00,2019-03-31 17:45:00
201,1,1,0,0.0029731012450773934,2019-03-31 17:30:00,2019-03-31 17:45:00
202,2,1,1,0.0033195563607907558,2019-03-31 17:30:00,2019-03-31 17:45:00
203,8,5,3,0.019210186367710602,2019-03-31 17:30:00,2019-03-31 17:45:00
1,5,3,2,0.004821674376909682,2019-03-31 17:45:00,2019-03-31 18:00:00
2,5,1,4,0.0027502843951609283,2019-03-31 17:45:00,2019-03-31 18:00:00
5,6,4,2,0.006495048201474428,2019-03-31 17:45:00,2019-03-31 18:00:00
10,9,4,5,0.006789056134440502,2019-03-31 17:45:00,2019-03-31 18:00:00
11,6,4,2,0.01982800763120265,2019-03-31 17:45:00,2019-03-31 18:00:00
13,1,0,1,0.0016086464867972855,2019-03-31 17:45:00,2019-03-31 18:00:00
15,12,7,5,0.008297895835352455,2019-03-31 17:45:00,2019-03-31 18:00:00
16,14,7,7,0.022754766019953646,2019-03-31 17:45:00,2019-03-31 18:00:00
18,16,12,4,0.019973379400605725,2019-03-31 17:45:00,2019-03-31 18:00:00
19,9,6,3,0.0076937573145431735,2019-03-31 17:45:00,2019-03-31 18:00:00
20,17,9,8,0.018654620351144985,2019-03-31 17:45:00,2019-03-31 18:00:00
21,2,0,2,0.0016086464867972855,2019-03-31 17:45:00,2019-03-31 18:00:00
23,14,6,8,0.013783931260994184,2019-03-31 17:45:00,2019-03-31 18:00:00
26,11,6,5,0.027061880818970728,2019-03-31 17:45:00,2019-03-31 18:00:00
27,6,2,4,0.002685194601903991,2019-03-31 17:45:00,2019-03-31 18:00:00
28,6,3,3,0.005249561850960583,2019-03-31 17:45:00,2019-03-31 18:00:00
30,2,0,2,0.0016086464867972855,2019-03-31 17:45:00,2019-03-31 18:00:00
35,6,3,3,0.003363701497969638,2019-03-31 17:45:00,2019-03-31 18:00:00
37,2,0,2,0.0016086464867972855,2019-03-31 17:45:00,2019-03-31 18:00:00
41,4,1,3,0.0021656473750667968,2019-03-31 17:45:00,2019-03-31 18:00:00
46,9,6,3,0.007551398700021939,2019-03-31 17:45:00,2019-03-31 18:00:00
50,1,0,1,0.0016086464867972855,2019-03-31 17:45:00,2019-03-31 18:00:00
57,9,6,3,0.009582803387399393,2019-03-31 17:45:00,2019-03-31 18:00:00
58,7,4,3,0.013815688170013631,2019-03-31 17:45:00,2019-03-31 18:00:00
61,10,4,6,0.0037123798542706586,2019-03-31 17:45:00,2019-03-31 18:00:00
62,22,9,13,0.02195536414012456,2019-03-31 17:45:00,2019-03-31 18:00:00
64,8,5,3,0.0089235069805755,2019-03-31 17:45:00,2019-03-31 18:00:00
66,3,1,2,0.002966913163161617,2019-03-31 17:45:00,2019-03-31 18:00:00
67,8,0,8,0.0016086464867972855,2019-03-31 17:45:00,2019-03-31 18:00:00
68,8,2,6,0.003927824071691879,2019-03-31 17:45:00,2019-03-31 18:00:00
69,5,5,0,0.007282641172361751,2019-03-31 17:45:00,2019-03-31 18:00:00
70,5,1,4,0.0020427358148695837,2019-03-31 17:45:00,2019-03-31 18:00:00
74,1,0,1,0.0016086464867972855,2019-03-31 17:45:00,2019-03-31 18:00:00
75,11,3,8,0.0023613371863480414,2019-03-31 17:45:00,2019-03-31 18:00:00
79,4,3,1,0.05181865758288554,2019-03-31 17:45:00,2019-03-31 18:00:00
80,2,0,2,0.0016086464867972855,2019-03-31 17:45:00,2019-03-31 18:00:00
85,2,1,1,0.010718327058999968,2019-03-31 17:45:00,2019-03-31 18:00:00
86,3,2,1,0.0036737433681969618,2019-03-31 17:45:00,2019-03-31 18:00:00
87,12,3,9,0.002704519257821455,2019-03-31 17:45:00,2019-03-31 18:00:00
88,12,6,6,0.028912213904271074,2019-03-31 17:45:00,2019-03-31 18:00:00
89,3,3,0,0.004476308703043844,2019-03-31 17:45:00,2019-03-31 18:00:00
90,18,9,9,0.010765792105505009,2019-03-31 17:45:00,2019-03-31 18:00:00
99,6,4,2,0.00817685554801643,2019-03-31 17:45:00,2019-03-31 18:00:00
104,7,2,5,0.002976019643365766,2019-03-31 17:45:00,2019-03-31 18:00:00
106,6,3,3,0.010718327058999968,2019-03-31 17:45:00,2019-03-31 18:00:00
108,9,4,5,0.006073664965465281,2019-03-31 17:45:00,2019-03-31 18:00:00
109,20,9,11,0.01078695088311361,2019-03-31 17:45:00,2019-03-31 18:00:00
110,6,2,4,0.0053720499791078445,2019-03-31 17:45:00,2019-03-31 18:00:00
111,6,2,4,0.005491308602614977,2019-03-31 17:45:00,2019-03-31 18:00:00
112,8,4,4,0.006390804338957837,2019-03-31 17:45:00,2019-03-31 18:00:00
113,3,2,1,0.002750176285275783,2019-03-31 17:45:00,2019-03-31 18:00:00
114,5,2,3,0.004358143363409903,2019-03-31 17:45:00,2019-03-31 18:00:00
115,3,1,2,0.004324237959925187,2019-03-31 17:45:00,2019-03-31 18:00:00
116,7,3,4,0.0030921276843030483,2019-03-31 17:45:00,2019-03-31 18:00:00
118,1,1,0,0.0030735496947379873,2019-03-31 17:45:00,2019-03-31 18:00:00
119,15,10,5,0.016922441265034106,2019-03-31 17:45:00,2019-03-31 18:00:00
120,2,1,1,0.002292333065081526,2019-03-31 17:45:00,2019-03-31 18:00:00
122,10,8,2,0.019160036407092837,2019-03-31 17:45:00,2019-03-31 18:00:00
126,9,3,6,0.003931381194859398,2019-03-31 17:45:00,2019-03-31 18:00:00
127,12,7,5,0.008085863174461293,2019-03-31 17:45:00,2019-03-31 18:00:00
129,10,5,5,0.005620452312827066,2019-03-31 17:45:00,2019-03-31 18:00:00
135,1,1,0,0.0021651579482183324,2019-03-31 17:45:00,2019-03-31 18:00:00
137,22,9,13,0.02549966270849395,2019-03-31 17:45:00,2019-03-31 18:00:00
138,20,10,10,0.01355163497378593,2019-03-31 17:45:00,2019-03-31 18:00:00
151,3,2,1,0.004599343951682684,2019-03-31 17:45:00,2019-03-31 18:00:00
153,11,5,6,0.00686797990548072,2019-03-31 17:45:00,2019-03-31 18:00:00
154,2,1,1,0.0021651579482183324,2019-03-31 17:45:00,2019-03-31 18:00:00
157,11,4,7,0.013338918798119178,2019-03-31 17:45:00,2019-03-31 18:00:00
158,5,3,2,0.012413009993164689,2019-03-31 17:45:00,2019-03-31 18:00:00
159,3,2,1,0.002660513170533972,2019-03-31 17:45:00,2019-03-31 18:00:00
160,10,4,6,0.0037123798542706586,2019-03-31 17:45:00,2019-03-31 18:00:00
162,3,2,1,0.017839586245676192,2019-03-31 17:45:00,2019-03-31 18:00:00
164,10,8,2,0.020648771777676694,2019-03-31 17:45:00,2019-03-31 18:00:00
168,40,17,23,0.015826469915087817,2019-03-31 17:45:00,2019-03-31 18:00:00
169,13,3,10,0.004943161700467354,2019-03-31 17:45:00,2019-03-31 18:00:00
170,2,1,1,0.010718327058999968,2019-03-31 17:45:00,2019-03-31 18:00:00
171,3,2,1,0.002119530215886527,2019-03-31 17:45:00,2019-03-31 18:00:00
172,5,3,2,0.005739637791055422,2019-03-31 17:45:00,2019-03-31 18:00:00
173,9,7,2,0.013574503200326262,2019-03-31 17:45:00,2019-03-31 18:00:00
175,8,3,5,0.003283028416297784,2019-03-31 17:45:00,2019-03-31 18:00:00
177,9,7,2,0.06326593619725294,2019-03-31 17:45:00,2019-03-31 18:00:00
189,10,4,6,0.00760534929961526,2019-03-31 17:45:00,2019-03-31 18:00:00
190,2,2,0,0.002722648263336308,2019-03-31 17:45:00,2019-03-31 18:00:00
191,14,8,6,0.015535038457398632,2019-03-31 17:45:00,2019-03-31 18:00:00
195,3,1,2,0.0027976886060658277,2019-03-31 17:45:00,2019-03-31 18:00:00
196,6,3,3,0.003975880390499735,2019-03-31 17:45:00,2019-03-31 18:00:00
197,14,12,2,0.013251998439023539,2019-03-31 17:45:00,2019-03-31 18:00:00
199,2,2,0,0.004583802744288822,2019-03-31 17:45:00,2019-03-31 18:00:00
202,1,1,0,0.002193108391316691,2019-03-31 17:45:00,2019-03-31 18:00:00
203,9,5,4,0.005380970646827552,2019-03-31 17:45:00,2019-03-31 18:00:00
1,7,3,4,0.006714194491762757,2019-03-31 18:00:00,2019-03-31 18:15:00
2,1,1,0,0.002694896056889169,2019-03-31 18:00:00,2019-03-31 18:15:00
5,7,4,3,0.007935667874389684,2019-03-31 18:00:00,2019-03-31 18:15:00
10,7,4,3,0.009058073787732481,2019-03-31 18:00:00,2019-03-31 18:15:00
11,6,4,2,0.0213042583806369,2019-03-31 18:00:00,2019-03-31 18:15:00
15,15,9,6,0.011961717876271543,2019-03-31 18:00:00,2019-03-31 18:15:00
16,13,6,7,0.00835470107220099,2019-03-31 18:00:00,2019-03-31 18:15:00
18,23,12,11,0.01993793996691108,2019-03-31 18:00:00,2019-03-31 18:15:00
19,10,8,2,0.007280642375004649,2019-03-31 18:00:00,2019-03-31 18:15:00
20,8,4,4,0.009190617996374856,2019-03-31 18:00:00,2019-03-31 18:15:00
21,2,0,2,0.0019779944272342227,2019-03-31 18:00:00,2019-03-31 18:15:00
23,6,2,4,0.010767993679307444,2019-03-31 18:00:00,2019-03-31 18:15:00
26,8,2,6,0.007278575620261777,2019-03-31 18:00:00,2019-03-31 18:15:00
27,2,1,1,0.013169885164108873,2019-03-31 18:00:00,2019-03-31 18:15:00
28,5,3,2,0.004623466854602652,2019-03-31 18:00:00,2019-03-31 18:15:00
30,4,2,2,0.0039346615082966035,2019-03-31 18:00:00,2019-03-31 18:15:00
37,2,0,2,0.0019779944272342227,2019-03-31 18:00:00,2019-03-31 18:15:00
40,1,0,1,0.0019779944272342227,2019-03-31 18:00:00,2019-03-31 18:15:00
41,2,1,1,0.004048194371586602,2019-03-31 18:00:00,2019-03-31 18:15:00
46,5,3,2,0.008234783609763128,2019-03-31 18:00:00,2019-03-31 18:15:00
50,2,1,1,0.0026409722334362,2019-03-31 18:00:00,2019-03-31 18:15:00
57,9,5,4,0.006596396435216173,2019-03-31 18:00:00,2019-03-31 18:15:00
58,6,5,1,0.03897778094017186,2019-03-31 18:00:00,2019-03-31 18:15:00
61,6,2,4,0.0034401480965856853,2019-03-31 18:00:00,2019-03-31 18:15:00
62,22,10,12,0.013822544856899705,2019-03-31 18:00:00,2019-03-31 18:15:00
64,5,3,2,0.01792977108270616,2019-03-31 18:00:00,2019-03-31 18:15:00
66,4,1,3,0.005371219267996621,2019-03-31 18:00:00,2019-03-31 18:15:00
67,7,0,7,0.0019779944272342227,2019-03-31 18:00:00,2019-03-31 18:15:00
68,6,3,3,0.0048639112324423365,2019-03-31 18:00:00,2019-03-31 18:15:00
69,2,1,1,0.00440956679924173,2019-03-31 18:00:00,2019-03-31 18:15:00
70,3,0,3,0.0019779944272342227,2019-03-31 18:00:00,2019-03-31 18:15:00
74,1,0,1,0.0019779944272342227,2019-03-31 18:00:00,2019-03-31 18:15:00
75,9,3,6,0.0034401480965856853,2019-03-31 18:00:00,2019-03-31 18:15:00
80,12,5,7,0.005035511947580858,2019-03-31 18:00:00,2019-03-31 18:15:00
86,2,2,0,0.004683072745434185,2019-03-31 18:00:00,2019-03-31 18:15:00
87,13,3,10,0.002833071404908776,2019-03-31 18:00:00,2019-03-31 18:15:00
88,3,1,2,0.0026409722334362,2019-03-31 18:00:00,2019-03-31 18:15:00
89,2,2,0,0.00457454175789989,2019-03-31 18:00:00,2019-03-31 18:15:00
90,20,12,8,0.012217843219294906,2019-03-31 18:00:00,2019-03-31 18:15:00
99,3,2,1,0.005022112547304603,2019-03-31 18:00:00,2019-03-31 18:15:00
101,2,0,2,0.0019779944272342227,2019-03-31 18:00:00,2019-03-31 18:15:00
104,4,2,2,0.0036593771170886492,2019-03-31 18:00:00,2019-03-31 18:15:00
106,4,2,2,0.013169885164108873,2019-03-31 18:00:00,2019-03-31 18:15:00
108,7,3,4,0.0063644554352886105,2019-03-31 18:00:00,2019-03-31 18:15:00
109,19,9,10,0.008870796429543764,2019-03-31 18:00:00,2019-03-31 18:15:00
110,8,2,6,0.005059793435811544,2019-03-31 18:00:00,2019-03-31 18:15:00
111,9,3,6,0.004813768353314105,2019-03-31 18:00:00,2019-03-31 18:15:00
112,9,6,3,0.01197419530060081,2019-03-31 18:00:00,2019-03-31 18:15:00
113,4,1,3,0.002760054337898772,2019-03-31 18:00:00,2019-03-31 18:15:00
114,7,6,1,0.007759513624687998,2019-03-31 18:00:00,2019-03-31 18:15:00
115,6,5,1,0.014351646871372838,2019-03-31 18:00:00,2019-03-31 18:15:00
116,8,5,3,0.00699105943309413,2019-03-31 18:00:00,2019-03-31 18:15:00
118,6,4,2,0.006453677510329962,2019-03-31 18:00:00,2019-03-31 18:15:00
119,16,10,6,0.0240368062885775,2019-03-31 18:00:00,2019-03-31 18:15:00
120,3,3,0,0.006027291606142434,2019-03-31 18:00:00,2019-03-31 18:15:00
122,3,3,0,0.010627355744151325,2019-03-31 18:00:00,2019-03-31 18:15:00
126,13,7,6,0.014610986077802292,2019-03-31 18:00:00,2019-03-31 18:15:00
127,14,5,9,0.010357247430981332,2019-03-31 18:00:00,2019-03-31 18:15:00
129,4,2,2,0.012965664214087605,2019-03-31 18:00:00,2019-03-31 18:15:00
137,21,8,13,0.008939656311104015,2019-03-31 18:00:00,2019-03-31 18:15:00
138,16,7,9,0.007018966360981477,2019-03-31 18:00:00,2019-03-31 18:15:00
140,1,0,1,0.0019779944272342227,2019-03-31 18:00:00,2019-03-31 18:15:00
141,2,1,1,0.01417931141813183,2019-03-31 18:00:00,2019-03-31 18:15:00
151,6,6,0,0.010262960970740266,2019-03-31 18:00:00,2019-03-31 18:15:00
153,11,5,6,0.0068256314241758355,2019-03-31 18:00:00,2019-03-31 18:15:00
154,5,5,0,0.0059155821163311174,2019-03-31 18:00:00,2019-03-31 18:15:00
156,2,0,2,0.0019779944272342227,2019-03-31 18:00:00,2019-03-31 18:15:00
157,7,1,6,0.00230448004522984,2019-03-31 18:00:00,2019-03-31 18:15:00
158,6,2,4,0.006441724115272494,2019-03-31 18:00:00,2019-03-31 18:15:00
159,2,2,0,0.0034401480965856853,2019-03-31 18:00:00,2019-03-31 18:15:00
160,6,2,4,0.0034401480965856853,2019-03-31 18:00:00,2019-03-31 18:15:00
161,8,4,4,0.013169885164108873,2019-03-31 18:00:00,2019-03-31 18:15:00
162,2,1,1,0.013169885164108873,2019-03-31 18:00:00,2019-03-31 18:15:00
164,8,5,3,0.015508341135143273,2019-03-31 18:00:00,2019-03-31 18:15:00
168,39,16,23,0.008309561895399413,2019-03-31 18:00:00,2019-03-31 18:15:00
169,13,5,8,0.006285059809789353,2019-03-31 18:00:00,2019-03-31 18:15:00
171,5,2,3,0.002459650816038487,2019-03-31 18:00:00,2019-03-31 18:15:00
172,3,2,1,0.014772016945429324,2019-03-31 18:00:00,2019-03-31 18:15:00
173,7,4,3,0.010885458473956095,2019-03-31 18:00:00,2019-03-31 18:15:00
175,6,3,3,0.013169885164108873,2019-03-31 18:00:00,2019-03-31 18:15:00
177,9,7,2,0.05014979036595573,2019-03-31 18:00:00,2019-03-31 18:15:00
189,1,1,0,0.002992634643808789,2019-03-31 18:00:00,2019-03-31 18:15:00
190,2,1,1,0.013169885164108873,2019-03-31 18:00:00,2019-03-31 18:15:00
191,14,7,7,0.013624641651737083,2019-03-31 18:00:00,2019-03-31 18:15:00
195,4,0,4,0.0019779944272342227,2019-03-31 18:00:00,2019-03-31 18:15:00
196,4,2,2,0.005720623693111058,2019-03-31 18:00:00,2019-03-31 18:15:00
197,8,8,0,0.008469381159068007,2019-03-31 18:00:00,2019-03-31 18:15:00
199,2,2,0,0.0059083772532639404,2019-03-31 18:00:00,2019-03-31 18:15:00
202,1,1,0,0.007489165702699944,2019-03-31 18:00:00,2019-03-31 18:15:00
203,6,4,2,0.012884413480623328,2019-03-31 18:00:00,2019-03-31 18:15:00
1,6,3,3,0.007704414690683754,2019-03-31 18:15:00,2019-03-31 18:30:00
2,2,2,0,0.003798641287555615,2019-03-31 18:15:00,2019-03-31 18:30:00
5,4,1,3,0.0027373987794484214,2019-03-31 18:15:00,2019-03-31 18:30:00
10,6,3,3,0.006505538620980897,2019-03-31 18:15:00,2019-03-31 18:30:00
11,3,2,1,0.01657159247936541,2019-03-31 18:15:00,2019-03-31 18:30:00
15,20,9,11,0.013803190672123027,2019-03-31 18:15:00,2019-03-31 18:30:00
16,6,3,3,0.007759426830120215,2019-03-31 18:15:00,2019-03-31 18:30:00
18,16,6,10,0.007688230156469451,2019-03-31 18:15:00,2019-03-31 18:30:00
19,7,4,3,0.008119049703820146,2019-03-31 18:15:00,2019-03-31 18:30:00
20,8,3,5,0.0053771517901641495,2019-03-31 18:15:00,2019-03-31 18:30:00
21,2,0,2,0.001961763637206634,2019-03-31 18:15:00,2019-03-31 18:30:00
23,8,4,4,0.0098905961413806,2019-03-31 18:15:00,2019-03-31 18:30:00
26,6,3,3,0.006583525395041714,2019-03-31 18:15:00,2019-03-31 18:30:00
28,1,1,0,0.003364172811665919,2019-03-31 18:15:00,2019-03-31 18:30:00
30,7,4,3,0.011002612237799532,2019-03-31 18:15:00,2019-03-31 18:30:00
35,1,0,1,0.001961763637206634,2019-03-31 18:15:00,2019-03-31 18:30:00
37,2,0,2,0.001961763637206634,2019-03-31 18:15:00,2019-03-31 18:30:00
40,1,0,1,0.001961763637206634,2019-03-31 18:15:00,2019-03-31 18:30:00
41,3,3,0,0.00847917172365272,2019-03-31 18:15:00,2019-03-31 18:30:00
46,7,4,3,0.0064855968363826825,2019-03-31 18:15:00,2019-03-31 18:30:00
50,3,1,2,0.003113565782168097,2019-03-31 18:15:00,2019-03-31 18:30:00
57,5,4,1,0.003967192336752902,2019-03-31 18:15:00,2019-03-31 18:30:00
58,6,4,2,0.013023281244002882,2019-03-31 18:15:00,2019-03-31 18:30:00
61,5,2,3,0.0045275156287579565,2019-03-31 18:15:00,2019-03-31 18:30:00
62,13,5,8,0.0075989335983536015,2019-03-31 18:15:00,2019-03-31 18:30:00
64,5,3,2,0.019708060838081003,2019-03-31 18:15:00,2019-03-31 18:30:00
66,6,6,0,0.012993218770514552,2019-03-31 18:15:00,2019-03-31 18:30:00
67,4,0,4,0.001961763637206634,2019-03-31 18:15:00,2019-03-31 18:30:00
68,6,2,4,0.003154907383149134,2019-03-31 18:15:00,2019-03-31 18:30:00
69,4,3,1,0.0036916168535693697,2019-03-31 18:15:00,2019-03-31 18:30:00
70,10,5,5,0.0062064692799118845,2019-03-31 18:15:00,2019-03-31 18:30:00
74,5,2,3,0.0045275156287579565,2019-03-31 18:15:00,2019-03-31 18:30:00
75,11,5,6,0.022369112353456358,2019-03-31 18:15:00,2019-03-31 18:30:00
80,6,3,3,0.01305148465767933,2019-03-31 18:15:00,2019-03-31 18:30:00
87,8,4,4,0.004712002119612321,2019-03-31 18:15:00,2019-03-31 18:30:00
88,2,1,1,0.003113565782168097,2019-03-31 18:15:00,2019-03-31 18:30:00
89,2,2,0,0.0043723086738205975,2019-03-31 18:15:00,2019-03-31 18:30:00
90,24,15,9,0.012760139408147788,2019-03-31 18:15:00,2019-03-31 18:30:00
99,1,0,1,0.001961763637206634,2019-03-31 18:15:00,2019-03-31 18:30:00
101,2,0,2,0.001961763637206634,2019-03-31 18:15:00,2019-03-31 18:30:00
104,4,2,2,0.003629339658598917,2019-03-31 18:15:00,2019-03-31 18:30:00
106,2,0,2,0.001961763637206634,2019-03-31 18:15:00,2019-03-31 18:30:00
108,1,1,0,0.003244639632982295,2019-03-31 18:15:00,2019-03-31 18:30:00
109,21,9,12,0.018987692113851862,2019-03-31 18:15:00,2019-03-31 18:30:00
110,8,4,4,0.004720019800820731,2019-03-31 18:15:00,2019-03-31 18:30:00
111,17,5,12,0.00413711978947302,2019-03-31 18:15:00,2019-03-31 18:30:00
112,6,5,1,0.0059957718138035935,2019-03-31 18:15:00,2019-03-31 18:30:00
113,6,3,3,0.009379880604477534,2019-03-31 18:15:00,2019-03-31 18:30:00
114,8,6,2,0.011645903811373344,2019-03-31 18:15:00,2019-03-31 18:30:00
115,7,6,1,0.017977120878989738,2019-03-31 18:15:00,2019-03-31 18:30:00
116,2,1,1,0.00906032528279933,2019-03-31 18:15:00,2019-03-31 18:30:00
118,9,3,6,0.003808474343713114,2019-03-31 18:15:00,2019-03-31 18:30:00
119,9,6,3,0.006452302029358445,2019-03-31 18:15:00,2019-03-31 18:30:00
120,3,3,0,0.006439585446497457,2019-03-31 18:15:00,2019-03-31 18:30:00
122,5,3,2,0.012615311446568975,2019-03-31 18:15:00,2019-03-31 18:30:00
126,7,4,3,0.013303016129980553,2019-03-31 18:15:00,2019-03-31 18:30:00
127,22,10,12,0.019795226632356458,2019-03-31 18:15:00,2019-03-31 18:30:00
129,2,0,2,0.001961763637206634,2019-03-31 18:15:00,2019-03-31 18:30:00
137,25,8,17,0.008959845807896386,2019-03-31 18:15:00,2019-03-31 18:30:00
138,17,9,8,0.01083938893859716,2019-03-31 18:15:00,2019-03-31 18:30:00
140,2,0,2,0.001961763637206634,2019-03-31 18:15:00,2019-03-31 18:30:00
141,6,2,4,0.021898624275342105,2019-03-31 18:15:00,2019-03-31 18:30:00
151,7,7,0,0.009830697299618985,2019-03-31 18:15:00,2019-03-31 18:30:00
153,13,6,7,0.007057461621269649,2019-03-31 18:15:00,2019-03-31 18:30:00
154,9,7,2,0.018902210517475936,2019-03-31 18:15:00,2019-03-31 18:30:00
156,2,0,2,0.001961763637206634,2019-03-31 18:15:00,2019-03-31 18:30:00
157,5,1,4,0.002491161192621085,2019-03-31 18:15:00,2019-03-31 18:30:00
158,6,2,4,0.005414184558046915,2019-03-31 18:15:00,2019-03-31 18:30:00
159,3,1,2,0.004063816482506448,2019-03-31 18:15:00,2019-03-31 18:30:00
160,4,2,2,0.01305148465767933,2019-03-31 18:15:00,2019-03-31 18:30:00
162,2,1,1,0.01305148465767933,2019-03-31 18:15:00,2019-03-31 18:30:00
164,8,5,3,0.010965479381281923,2019-03-31 18:15:00,2019-03-31 18:30:00
168,26,8,18,0.01455721728511768,2019-03-31 18:15:00,2019-03-31 18:30:00
169,8,3,5,0.006304323996983893,2019-03-31 18:15:00,2019-03-31 18:30:00
171,1,0,1,0.001961763637206634,2019-03-31 18:15:00,2019-03-31 18:30:00
172,5,3,2,0.005663564079809137,2019-03-31 18:15:00,2019-03-31 18:30:00
173,18,13,5,0.04174878093638613,2019-03-31 18:15:00,2019-03-31 18:30:00
175,6,3,3,0.01305148465767933,2019-03-31 18:15:00,2019-03-31 18:30:00
177,10,7,3,0.03894372246027597,2019-03-31 18:15:00,2019-03-31 18:30:00
189,1,0,1,0.001961763637206634,2019-03-31 18:15:00,2019-03-31 18:30:00
190,5,2,3,0.004657967171103343,2019-03-31 18:15:00,2019-03-31 18:30:00
191,9,4,5,0.008095121264203019,2019-03-31 18:15:00,2019-03-31 18:30:00
195,3,0,3,0.001961763637206634,2019-03-31 18:15:00,2019-03-31 18:30:00
196,2,0,2,0.001961763637206634,2019-03-31 18:15:00,2019-03-31 18:30:00
197,9,9,0,0.011798097780601952,2019-03-31 18:15:00,2019-03-31 18:30:00
199,1,0,1,0.001961763637206634,2019-03-31 18:15:00,2019-03-31 18:30:00
202,1,1,0,0.002795551647902775,2019-03-31 18:15:00,2019-03-31 18:30:00
203,5,4,1,0.044990835670235554,2019-03-31 18:15:00,2019-03-31 18:30:00
1,11,4,7,0.008863629272525686,2019-03-31 18:30:00,2019-03-31 18:45:00
2,1,1,0,0.0028816787594472173,2019-03-31 18:30:00,2019-03-31 18:45:00
5,3,1,2,0.00351702469413088,2019-03-31 18:30:00,2019-03-31 18:45:00
10,5,2,3,0.004667038312360547,2019-03-31 18:30:00,2019-03-31 18:45:00
11,3,2,1,0.025802542917467457,2019-03-31 18:30:00,2019-03-31 18:45:00
15,12,7,5,0.011818604391373447,2019-03-31 18:30:00,2019-03-31 18:45:00
16,8,7,1,0.01332288826489576,2019-03-31 18:30:00,2019-03-31 18:45:00
18,10,5,5,0.01209657524536665,2019-03-31 18:30:00,2019-03-31 18:45:00
19,11,6,5,0.021244368475435146,2019-03-31 18:30:00,2019-03-31 18:45:00
20,14,6,8,0.009827868682832825,2019-03-31 18:30:00,2019-03-31 18:45:00
21,2,0,2,0.0020222002165134582,2019-03-31 18:30:00,2019-03-31 18:45:00
23,10,7,3,0.014223166344581,2019-03-31 18:30:00,2019-03-31 18:45:00
26,2,2,0,0.007690972366089328,2019-03-31 18:30:00,2019-03-31 18:45:00
27,1,1,0,0.0038100788705194974,2019-03-31 18:30:00,2019-03-31 18:45:00
28,6,1,5,0.002951718348956748,2019-03-31 18:30:00,2019-03-31 18:45:00
30,2,1,1,0.01345508061303122,2019-03-31 18:30:00,2019-03-31 18:45:00
35,3,2,1,0.006214931884378136,2019-03-31 18:30:00,2019-03-31 18:45:00
40,2,0,2,0.0020222002165134582,2019-03-31 18:30:00,2019-03-31 18:45:00
41,3,2,1,0.0038621856323571534,2019-03-31 18:30:00,2019-03-31 18:45:00
46,7,6,1,0.04742061341774466,2019-03-31 18:30:00,2019-03-31 18:45:00
50,1,0,1,0.0020222002165134582,2019-03-31 18:30:00,2019-03-31 18:45:00
57,4,3,1,0.006626352436389682,2019-03-31 18:30:00,2019-03-31 18:45:00
58,9,7,2,0.02824174113302687,2019-03-31 18:30:00,2019-03-31 18:45:00
61,5,3,2,0.016787696036559586,2019-03-31 18:30:00,2019-03-31 18:45:00
62,13,3,10,0.002936157999998332,2019-03-31 18:30:00,2019-03-31 18:45:00
64,4,2,2,0.01345508061303122,2019-03-31 18:30:00,2019-03-31 18:45:00
66,3,3,0,0.009872311296647632,2019-03-31 18:30:00,2019-03-31 18:45:00
67,6,1,5,0.0028718772494899162,2019-03-31 18:30:00,2019-03-31 18:45:00
68,4,1,3,0.002436412130255095,2019-03-31 18:30:00,2019-03-31 18:45:00
69,8,5,3,0.006762807472080933,2019-03-31 18:30:00,2019-03-31 18:45:00
70,13,8,5,0.021441664934744763,2019-03-31 18:30:00,2019-03-31 18:45:00
74,4,2,2,0.01345508061303122,2019-03-31 18:30:00,2019-03-31 18:45:00
75,11,5,6,0.03473373618412474,2019-03-31 18:30:00,2019-03-31 18:45:00
80,4,2,2,0.01345508061303122,2019-03-31 18:30:00,2019-03-31 18:45:00
87,4,2,2,0.0051100815142865585,2019-03-31 18:30:00,2019-03-31 18:45:00
88,6,4,2,0.0049425280511988905,2019-03-31 18:30:00,2019-03-31 18:45:00
90,21,12,9,0.007211826250218541,2019-03-31 18:30:00,2019-03-31 18:45:00
104,7,4,3,0.006309791421224953,2019-03-31 18:30:00,2019-03-31 18:45:00
106,2,0,2,0.0020222002165134582,2019-03-31 18:30:00,2019-03-31 18:45:00
109,19,9,10,0.010710407964684152,2019-03-31 18:30:00,2019-03-31 18:45:00
110,3,1,2,0.0022372170692529785,2019-03-31 18:30:00,2019-03-31 18:45:00
111,8,2,6,0.003463802317725081,2019-03-31 18:30:00,2019-03-31 18:45:00
112,5,2,3,0.0029986926606270386,2019-03-31 18:30:00,2019-03-31 18:45:00
113,3,1,2,0.00351702469413088,2019-03-31 18:30:00,2019-03-31 18:45:00
114,5,3,2,0.004730913514376496,2019-03-31 18:30:00,2019-03-31 18:45:00
115,10,5,5,0.007899225726855872,2019-03-31 18:30:00,2019-03-31 18:45:00
116,16,12,4,0.021926819188094162,2019-03-31 18:30:00,2019-03-31 18:45:00
118,6,1,5,0.002436412130255095,2019-03-31 18:30:00,2019-03-31 18:45:00
119,9,6,3,0.014309703915760284,2019-03-31 18:30:00,2019-03-31 18:45:00
120,3,3,0,0.005020691040281473,2019-03-31 18:30:00,2019-03-31 18:45:00
122,3,2,1,0.006987740027766632,2019-03-31 18:30:00,2019-03-31 18:45:00
126,2,2,0,0.007780602961810001,2019-03-31 18:30:00,2019-03-31 18:45:00
127,17,7,10,0.010934105098229997,2019-03-31 18:30:00,2019-03-31 18:45:00
129,2,0,2,0.0020222002165134582,2019-03-31 18:30:00,2019-03-31 18:45:00
135,1,1,0,0.0025129335932708684,2019-03-31 18:30:00,2019-03-31 18:45:00
137,21,3,18,0.004552966849543055,2019-03-31 18:30:00,2019-03-31 18:45:00
138,20,13,7,0.026869966664559885,2019-03-31 18:30:00,2019-03-31 18:45:00
141,3,2,1,0.0035347104149360104,2019-03-31 18:30:00,2019-03-31 18:45:00
151,6,6,0,0.009714930900189742,2019-03-31 18:30:00,2019-03-31 18:45:00
153,16,9,7,0.01003333718159415,2019-03-31 18:30:00,2019-03-31 18:45:00
154,1,0,1,0.0020222002165134582,2019-03-31 18:30:00,2019-03-31 18:45:00
156,2,0,2,0.0020222002165134582,2019-03-31 18:30:00,2019-03-31 18:45:00
157,4,2,2,0.004370525227708867,2019-03-31 18:30:00,2019-03-31 18:45:00
158,9,1,8,0.005285413751934846,2019-03-31 18:30:00,2019-03-31 18:45:00
159,3,1,2,0.006052621283229557,2019-03-31 18:30:00,2019-03-31 18:45:00
160,4,2,2,0.01345508061303122,2019-03-31 18:30:00,2019-03-31 18:45:00
164,7,4,3,0.010230883358881832,2019-03-31 18:30:00,2019-03-31 18:45:00
168,24,10,14,0.0254228332213844,2019-03-31 18:30:00,2019-03-31 18:45:00
169,6,2,4,0.00351702469413088,2019-03-31 18:30:00,2019-03-31 18:45:00
170,3,1,2,0.003365180050066533,2019-03-31 18:30:00,2019-03-31 18:45:00
171,4,1,3,0.005667965119933855,2019-03-31 18:30:00,2019-03-31 18:45:00
172,8,2,6,0.002927716687056623,2019-03-31 18:30:00,2019-03-31 18:45:00
173,12,8,4,0.0242222831572186,2019-03-31 18:30:00,2019-03-31 18:45:00
175,4,2,2,0.01345508061303122,2019-03-31 18:30:00,2019-03-31 18:45:00
177,14,8,6,0.012230301644738189,2019-03-31 18:30:00,2019-03-31 18:45:00
189,1,0,1,0.0020222002165134582,2019-03-31 18:30:00,2019-03-31 18:45:00
190,5,2,3,0.00427904772132047,2019-03-31 18:30:00,2019-03-31 18:45:00
191,10,4,6,0.006792145745756713,2019-03-31 18:30:00,2019-03-31 18:45:00
196,3,1,2,0.002583841690481798,2019-03-31 18:30:00,2019-03-31 18:45:00
197,8,8,0,0.012341727246474874,2019-03-31 18:30:00,2019-03-31 18:45:00
199,1,0,1,0.0020222002165134582,2019-03-31 18:30:00,2019-03-31 18:45:00
202,1,1,0,0.0028816787594472173,2019-03-31 18:30:00,2019-03-31 18:45:00
203,9,3,6,0.00351702469413088,2019-03-31 18:30:00,2019-03-31 18:45:00
1,5,2,3,0.0047755412984228545,2019-03-31 18:45:00,2019-03-31 19:00:00
2,1,0,1,0.0018387108022995067,2019-03-31 18:45:00,2019-03-31 19:00:00
5,3,1,2,0.0031978561114386285,2019-03-31 18:45:00,2019-03-31 19:00:00
10,1,0,1,0.0018387108022995067,2019-03-31 18:45:00,2019-03-31 19:00:00
11,3,2,1,0.02661021744502741,2019-03-31 18:45:00,2019-03-31 19:00:00
13,1,1,0,0.003632281463439511,2019-03-31 18:45:00,2019-03-31 19:00:00
15,13,9,4,0.01113950830731599,2019-03-31 18:45:00,2019-03-31 19:00:00
16,7,7,0,0.00793316685657995,2019-03-31 18:45:00,2019-03-31 19:00:00
18,9,6,3,0.016230219102911267,2019-03-31 18:45:00,2019-03-31 19:00:00
19,9,4,5,0.011670485367540931,2019-03-31 18:45:00,2019-03-31 19:00:00
20,13,4,9,0.00776094467351909,2019-03-31 18:45:00,2019-03-31 19:00:00
23,11,6,5,0.01269288216953143,2019-03-31 18:45:00,2019-03-31 19:00:00
26,8,3,5,0.006739961509860523,2019-03-31 18:45:00,2019-03-31 19:00:00
27,8,3,5,0.005601259226303112,2019-03-31 18:45:00,2019-03-31 19:00:00
28,11,6,5,0.010911581036657389,2019-03-31 18:45:00,2019-03-31 19:00:00
30,2,1,1,0.012247392078201406,2019-03-31 18:45:00,2019-03-31 19:00:00
35,4,2,2,0.004971100249489065,2019-03-31 18:45:00,2019-03-31 19:00:00
40,1,0,1,0.0018387108022995067,2019-03-31 18:45:00,2019-03-31 19:00:00
41,2,0,2,0.0018387108022995067,2019-03-31 18:45:00,2019-03-31 19:00:00
46,7,6,1,0.08917709358172463,2019-03-31 18:45:00,2019-03-31 19:00:00
50,1,0,1,0.0018387108022995067,2019-03-31 18:45:00,2019-03-31 19:00:00
57,3,2,1,0.011038034776562731,2019-03-31 18:45:00,2019-03-31 19:00:00
58,6,5,1,0.012542196215018479,2019-03-31 18:45:00,2019-03-31 19:00:00
61,4,2,2,0.012247392078201406,2019-03-31 18:45:00,2019-03-31 19:00:00
62,13,3,10,0.0034949384833811623,2019-03-31 18:45:00,2019-03-31 19:00:00
64,6,2,4,0.0031978561114386285,2019-03-31 18:45:00,2019-03-31 19:00:00
66,2,2,0,0.00803196231932651,2019-03-31 18:45:00,2019-03-31 19:00:00
67,7,4,3,0.008091341424101504,2019-03-31 18:45:00,2019-03-31 19:00:00
68,4,3,1,0.006972552956591205,2019-03-31 18:45:00,2019-03-31 19:00:00
69,8,5,3,0.005737787954276354,2019-03-31 18:45:00,2019-03-31 19:00:00
70,8,4,4,0.009651828361406838,2019-03-31 18:45:00,2019-03-31 19:00:00
74,4,2,2,0.012247392078201406,2019-03-31 18:45:00,2019-03-31 19:00:00
75,11,5,6,0.02276331537897891,2019-03-31 18:45:00,2019-03-31 19:00:00
79,2,1,1,0.012247392078201406,2019-03-31 18:45:00,2019-03-31 19:00:00
80,4,2,2,0.012247392078201406,2019-03-31 18:45:00,2019-03-31 19:00:00
87,3,2,1,0.003775644235904031,2019-03-31 18:45:00,2019-03-31 19:00:00
88,6,5,1,0.0047466323647298555,2019-03-31 18:45:00,2019-03-31 19:00:00
90,23,10,13,0.010083190820653612,2019-03-31 18:45:00,2019-03-31 19:00:00
104,8,5,3,0.006556389250113621,2019-03-31 18:45:00,2019-03-31 19:00:00
106,3,1,2,0.0034645693727317645,2019-03-31 18:45:00,2019-03-31 19:00:00
109,15,10,5,0.020229600620797154,2019-03-31 18:45:00,2019-03-31 19:00:00
110,7,3,4,0.003928507195857533,2019-03-31 18:45:00,2019-03-31 19:00:00
111,5,1,4,0.005101821604387935,2019-03-31 18:45:00,2019-03-31 19:00:00
112,3,0,3,0.0018387108022995067,2019-03-31 18:45:00,2019-03-31 19:00:00
114,6,4,2,0.00648572626853991,2019-03-31 18:45:00,2019-03-31 19:00:00
115,1,0,1,0.0018387108022995067,2019-03-31 18:45:00,2019-03-31 19:00:00
116,24,14,10,0.014879093290902897,2019-03-31 18:45:00,2019-03-31 19:00:00
118,7,2,5,0.006064873114899048,2019-03-31 18:45:00,2019-03-31 19:00:00
119,10,5,5,0.005355574720570319,2019-03-31 18:45:00,2019-03-31 19:00:00
120,5,2,3,0.005146424870118176,2019-03-31 18:45:00,2019-03-31 19:00:00
122,11,2,9,0.006188861706348201,2019-03-31 18:45:00,2019-03-31 19:00:00
126,6,3,3,0.006329691084401654,2019-03-31 18:45:00,2019-03-31 19:00:00
127,12,5,7,0.014579912484186969,2019-03-31 18:45:00,2019-03-31 19:00:00
129,3,3,0,0.003948065656282713,2019-03-31 18:45:00,2019-03-31 19:00:00
135,1,1,0,0.00292299017963097,2019-03-31 18:45:00,2019-03-31 19:00:00
137,17,5,12,0.005929210874697081,2019-03-31 18:45:00,2019-03-31 19:00:00
138,25,13,12,0.02965707436022493,2019-03-31 18:45:00,2019-03-31 19:00:00
140,1,0,1,0.0018387108022995067,2019-03-31 18:45:00,2019-03-31 19:00:00
141,1,1,0,0.00267358256073594,2019-03-31 18:45:00,2019-03-31 19:00:00
151,4,4,0,0.00656267054517116,2019-03-31 18:45:00,2019-03-31 19:00:00
153,15,10,5,0.03970310369920196,2019-03-31 18:45:00,2019-03-31 19:00:00
154,3,2,1,0.0038383669647546106,2019-03-31 18:45:00,2019-03-31 19:00:00
156,2,0,2,0.0018387108022995067,2019-03-31 18:45:00,2019-03-31 19:00:00
157,4,2,2,0.005083822585900932,2019-03-31 18:45:00,2019-03-31 19:00:00
158,5,1,4,0.00292299017963097,2019-03-31 18:45:00,2019-03-31 19:00:00
159,5,2,3,0.005577400962748324,2019-03-31 18:45:00,2019-03-31 19:00:00
160,8,4,4,0.012247392078201406,2019-03-31 18:45:00,2019-03-31 19:00:00
162,6,2,4,0.0031978561114386285,2019-03-31 18:45:00,2019-03-31 19:00:00
164,6,3,3,0.006611577836017359,2019-03-31 18:45:00,2019-03-31 19:00:00
168,21,8,13,0.014807717919410207,2019-03-31 18:45:00,2019-03-31 19:00:00
169,4,2,2,0.012247392078201406,2019-03-31 18:45:00,2019-03-31 19:00:00
170,4,1,3,0.002565681583104325,2019-03-31 18:45:00,2019-03-31 19:00:00
171,4,1,3,0.0028699002479523486,2019-03-31 18:45:00,2019-03-31 19:00:00
172,5,2,3,0.004693711380522825,2019-03-31 18:45:00,2019-03-31 19:00:00
173,10,6,4,0.01620338975855319,2019-03-31 18:45:00,2019-03-31 19:00:00
175,4,3,1,0.021296928044964185,2019-03-31 18:45:00,2019-03-31 19:00:00
177,10,6,4,0.008735374579904438,2019-03-31 18:45:00,2019-03-31 19:00:00
189,4,2,2,0.003775644235904031,2019-03-31 18:45:00,2019-03-31 19:00:00
190,3,2,1,0.01711619311557385,2019-03-31 18:45:00,2019-03-31 19:00:00
191,11,6,5,0.008272138917071938,2019-03-31 18:45:00,2019-03-31 19:00:00
196,4,2,2,0.0033704480951347784,2019-03-31 18:45:00,2019-03-31 19:00:00
197,3,3,0,0.006943111689370436,2019-03-31 18:45:00,2019-03-31 19:00:00
203,10,4,6,0.006635762881466826,2019-03-31 18:45:00,2019-03-31 19:00:00
1,6,3,3,0.003981707772426401,2019-03-31 19:00:00,2019-03-31 19:15:00
5,5,3,2,0.010872492295955582,2019-03-31 19:00:00,2019-03-31 19:15:00
10,4,3,1,0.007498937360146895,2019-03-31 19:00:00,2019-03-31 19:15:00
13,2,1,1,0.0031321605451828135,2019-03-31 19:00:00,2019-03-31 19:15:00
15,14,5,9,0.011620087784607085,2019-03-31 19:00:00,2019-03-31 19:15:00
16,3,3,0,0.0032943079898537612,2019-03-31 19:00:00,2019-03-31 19:15:00
18,11,7,4,0.015621498869983475,2019-03-31 19:00:00,2019-03-31 19:15:00
19,6,2,4,0.003329076563249272,2019-03-31 19:00:00,2019-03-31 19:15:00
20,10,5,5,0.019691033305030463,2019-03-31 19:00:00,2019-03-31 19:15:00
22,2,0,2,0.0019336924388645054,2019-03-31 19:00:00,2019-03-31 19:15:00
23,3,2,1,0.003100151157218914,2019-03-31 19:00:00,2019-03-31 19:15:00
26,6,2,4,0.004558094779714931,2019-03-31 19:00:00,2019-03-31 19:15:00
27,3,0,3,0.0019336924388645054,2019-03-31 19:00:00,2019-03-31 19:15:00
28,9,5,4,0.003729751343824492,2019-03-31 19:00:00,2019-03-31 19:15:00
30,3,2,1,0.020399639297238658,2019-03-31 19:00:00,2019-03-31 19:15:00
35,6,3,3,0.0065183128337961424,2019-03-31 19:00:00,2019-03-31 19:15:00
41,2,2,0,0.005850621392172364,2019-03-31 19:00:00,2019-03-31 19:15:00
46,6,4,2,0.008492239916938562,2019-03-31 19:00:00,2019-03-31 19:15:00
57,3,0,3,0.0019336924388645054,2019-03-31 19:00:00,2019-03-31 19:15:00
58,7,6,1,0.007906780818332708,2019-03-31 19:00:00,2019-03-31 19:15:00
62,13,3,10,0.002595602244872845,2019-03-31 19:00:00,2019-03-31 19:15:00
64,2,0,2,0.0019336924388645054,2019-03-31 19:00:00,2019-03-31 19:15:00
66,1,1,0,0.0032212897766806465,2019-03-31 19:00:00,2019-03-31 19:15:00
67,6,3,3,0.0069112308122330594,2019-03-31 19:00:00,2019-03-31 19:15:00
68,4,2,2,0.007550813717725487,2019-03-31 19:00:00,2019-03-31 19:15:00
69,7,2,5,0.003651713352872529,2019-03-31 19:00:00,2019-03-31 19:15:00
70,7,5,2,0.006607724607169512,2019-03-31 19:00:00,2019-03-31 19:15:00
74,4,2,2,0.012885048129252678,2019-03-31 19:00:00,2019-03-31 19:15:00
75,8,5,3,0.0674766740517866,2019-03-31 19:00:00,2019-03-31 19:15:00
79,4,2,2,0.0050478991698629135,2019-03-31 19:00:00,2019-03-31 19:15:00
80,4,2,2,0.012885048129252678,2019-03-31 19:00:00,2019-03-31 19:15:00
87,5,4,1,0.0029735752549156095,2019-03-31 19:00:00,2019-03-31 19:15:00
88,9,5,4,0.006281746540511976,2019-03-31 19:00:00,2019-03-31 19:15:00
89,4,3,1,0.004476135856799587,2019-03-31 19:00:00,2019-03-31 19:15:00
90,18,4,14,0.004130259811473138,2019-03-31 19:00:00,2019-03-31 19:15:00
99,4,4,0,0.0028162388468756247,2019-03-31 19:00:00,2019-03-31 19:15:00
104,4,2,2,0.003029498409010651,2019-03-31 19:00:00,2019-03-31 19:15:00
106,3,1,2,0.002554546783815747,2019-03-31 19:00:00,2019-03-31 19:15:00
109,15,9,6,0.02145578202794669,2019-03-31 19:00:00,2019-03-31 19:15:00
110,4,2,2,0.00483729718504738,2019-03-31 19:00:00,2019-03-31 19:15:00
111,1,1,0,0.0028747983457586474,2019-03-31 19:00:00,2019-03-31 19:15:00
113,1,1,0,0.0035894181223875632,2019-03-31 19:00:00,2019-03-31 19:15:00
114,8,4,4,0.008032225077902027,2019-03-31 19:00:00,2019-03-31 19:15:00
115,3,3,0,0.004757010159546931,2019-03-31 19:00:00,2019-03-31 19:15:00
116,12,3,9,0.0026560515300611716,2019-03-31 19:00:00,2019-03-31 19:15:00
118,6,3,3,0.007853288741251102,2019-03-31 19:00:00,2019-03-31 19:15:00
119,11,8,3,0.02005307350835126,2019-03-31 19:00:00,2019-03-31 19:15:00
120,5,3,2,0.004379907793349472,2019-03-31 19:00:00,2019-03-31 19:15:00
122,10,2,8,0.014107646423435295,2019-03-31 19:00:00,2019-03-31 19:15:00
126,8,4,4,0.0056394665096241685,2019-03-31 19:00:00,2019-03-31 19:15:00
127,8,4,4,0.0077909204274893154,2019-03-31 19:00:00,2019-03-31 19:15:00
129,4,3,1,0.010741587492829534,2019-03-31 19:00:00,2019-03-31 19:15:00
135,2,2,0,0.0035774013940837244,2019-03-31 19:00:00,2019-03-31 19:15:00
137,26,11,15,0.014952528537775355,2019-03-31 19:00:00,2019-03-31 19:15:00
138,25,9,16,0.010976248224650174,2019-03-31 19:00:00,2019-03-31 19:15:00
140,2,2,0,0.003628654717487893,2019-03-31 19:00:00,2019-03-31 19:15:00
151,4,4,0,0.006803208596858196,2019-03-31 19:00:00,2019-03-31 19:15:00
153,7,6,1,0.010018950123609701,2019-03-31 19:00:00,2019-03-31 19:15:00
154,6,2,4,0.004428236351767843,2019-03-31 19:00:00,2019-03-31 19:15:00
156,2,0,2,0.0019336924388645054,2019-03-31 19:00:00,2019-03-31 19:15:00
157,3,2,1,0.03309325009564833,2019-03-31 19:00:00,2019-03-31 19:15:00
158,4,1,3,0.0024815954239375783,2019-03-31 19:00:00,2019-03-31 19:15:00
159,5,2,3,0.005692126113922782,2019-03-31 19:00:00,2019-03-31 19:15:00
160,8,4,4,0.012885048129252678,2019-03-31 19:00:00,2019-03-31 19:15:00
162,4,2,2,0.012885048129252678,2019-03-31 19:00:00,2019-03-31 19:15:00
164,4,3,1,0.006193469091245343,2019-03-31 19:00:00,2019-03-31 19:15:00
168,19,7,12,0.0037993281520547076,2019-03-31 19:00:00,2019-03-31 19:15:00
169,4,2,2,0.012885048129252678,2019-03-31 19:00:00,2019-03-31 19:15:00
170,2,1,1,0.012885048129252678,2019-03-31 19:00:00,2019-03-31 19:15:00
171,4,1,3,0.0030313988426106777,2019-03-31 19:00:00,2019-03-31 19:15:00
172,3,1,2,0.0026411908607811138,2019-03-31 19:00:00,2019-03-31 19:15:00
173,10,4,6,0.004462757888012207,2019-03-31 19:00:00,2019-03-31 19:15:00
175,5,3,2,0.006221844773509925,2019-03-31 19:00:00,2019-03-31 19:15:00
177,5,3,2,0.004130550855953112,2019-03-31 19:00:00,2019-03-31 19:15:00
189,4,2,2,0.0024719701609303654,2019-03-31 19:00:00,2019-03-31 19:15:00
190,3,1,2,0.0033630765504129786,2019-03-31 19:00:00,2019-03-31 19:15:00
191,6,5,1,0.049992155734500034,2019-03-31 19:00:00,2019-03-31 19:15:00
196,4,1,3,0.007616596236401813,2019-03-31 19:00:00,2019-03-31 19:15:00
197,2,1,1,0.00830857428285946,2019-03-31 19:00:00,2019-03-31 19:15:00
199,1,1,0,0.010451212086190827,2019-03-31 19:00:00,2019-03-31 19:15:00
201,4,3,1,0.043825873407484416,2019-03-31 19:00:00,2019-03-31 19:15:00
202,2,2,0,0.003100151157218914,2019-03-31 19:00:00,2019-03-31 19:15:00
203,12,7,5,0.034158105221523974,2019-03-31 19:00:00,2019-03-31 19:15:00
1,6,3,3,0.0034160077308259314,2019-03-31 19:15:00,2019-03-31 19:30:00
5,5,3,2,0.008055476799033557,2019-03-31 19:15:00,2019-03-31 19:30:00
10,5,3,2,0.009051900302868657,2019-03-31 19:15:00,2019-03-31 19:30:00
13,1,0,1,0.0022610009027659423,2019-03-31 19:15:00,2019-03-31 19:30:00
15,8,3,5,0.013009025770885908,2019-03-31 19:15:00,2019-03-31 19:30:00
16,2,0,2,0.0022610009027659423,2019-03-31 19:15:00,2019-03-31 19:30:00
18,9,5,4,0.009878063203195415,2019-03-31 19:15:00,2019-03-31 19:30:00
19,13,3,10,0.0045436009135697425,2019-03-31 19:15:00,2019-03-31 19:30:00
20,9,4,5,0.014688642192517486,2019-03-31 19:15:00,2019-03-31 19:30:00
22,2,0,2,0.0022610009027659423,2019-03-31 19:15:00,2019-03-31 19:30:00
23,2,2,0,0.003683279937271333,2019-03-31 19:15:00,2019-03-31 19:30:00
26,8,3,5,0.007830338064399017,2019-03-31 19:15:00,2019-03-31 19:30:00
28,5,3,2,0.006839178293853883,2019-03-31 19:15:00,2019-03-31 19:30:00
30,3,2,1,0.02145030986259215,2019-03-31 19:15:00,2019-03-31 19:30:00
35,9,3,6,0.005046767536532273,2019-03-31 19:15:00,2019-03-31 19:30:00
41,1,1,0,0.003446233431520434,2019-03-31 19:15:00,2019-03-31 19:30:00
46,5,2,3,0.007001476449052041,2019-03-31 19:15:00,2019-03-31 19:30:00
57,9,3,6,0.007209100439606084,2019-03-31 19:15:00,2019-03-31 19:30:00
58,4,3,1,0.006561222428827539,2019-03-31 19:15:00,2019-03-31 19:30:00
62,7,0,7,0.0022610009027659423,2019-03-31 19:15:00,2019-03-31 19:30:00
66,3,3,0,0.0040754343239427305,2019-03-31 19:15:00,2019-03-31 19:30:00
67,6,5,1,0.01103954172846524,2019-03-31 19:15:00,2019-03-31 19:30:00
68,4,1,3,0.004182948060924381,2019-03-31 19:15:00,2019-03-31 19:30:00
69,5,1,4,0.0030875686691471684,2019-03-31 19:15:00,2019-03-31 19:30:00
70,7,7,0,0.00719263070234032,2019-03-31 19:15:00,2019-03-31 19:30:00
75,13,6,7,0.03230686209233345,2019-03-31 19:15:00,2019-03-31 19:30:00
79,3,2,1,0.02384845679639287,2019-03-31 19:15:00,2019-03-31 19:30:00
80,4,2,2,0.015024537907478005,2019-03-31 19:15:00,2019-03-31 19:30:00
86,6,2,4,0.003932340697436521,2019-03-31 19:15:00,2019-03-31 19:30:00
87,4,4,0,0.011121220169619904,2019-03-31 19:15:00,2019-03-31 19:30:00
88,1,0,1,0.0022610009027659423,2019-03-31 19:15:00,2019-03-31 19:30:00
89,3,3,0,0.0067806070041284035,2019-03-31 19:15:00,2019-03-31 19:30:00
90,12,7,5,0.014804511349235033,2019-03-31 19:15:00,2019-03-31 19:30:00
99,4,4,0,0.003359256421713621,2019-03-31 19:15:00,2019-03-31 19:30:00
101,1,0,1,0.0022610009027659423,2019-03-31 19:15:00,2019-03-31 19:30:00
104,5,0,5,0.0022610009027659423,2019-03-31 19:15:00,2019-03-31 19:30:00
106,4,1,3,0.002917144106833733,2019-03-31 19:15:00,2019-03-31 19:30:00
109,14,11,3,0.035298856941777826,2019-03-31 19:15:00,2019-03-31 19:30:00
111,1,0,1,0.0022610009027659423,2019-03-31 19:15:00,2019-03-31 19:30:00
112,3,1,2,0.011645224866482007,2019-03-31 19:15:00,2019-03-31 19:30:00
114,6,3,3,0.009726166532347988,2019-03-31 19:15:00,2019-03-31 19:30:00
116,7,4,3,0.008587234746482809,2019-03-31 19:15:00,2019-03-31 19:30:00
118,1,0,1,0.0022610009027659423,2019-03-31 19:15:00,2019-03-31 19:30:00
119,11,9,2,0.019955834295342836,2019-03-31 19:15:00,2019-03-31 19:30:00
120,2,2,0,0.008396762554443701,2019-03-31 19:15:00,2019-03-31 19:30:00
122,2,1,1,0.012263953814883984,2019-03-31 19:15:00,2019-03-31 19:30:00
126,3,3,0,0.006630061395597511,2019-03-31 19:15:00,2019-03-31 19:30:00
127,6,3,3,0.012492664514859673,2019-03-31 19:15:00,2019-03-31 19:30:00
135,2,2,0,0.004182948060924381,2019-03-31 19:15:00,2019-03-31 19:30:00
137,15,4,11,0.019493409350564955,2019-03-31 19:15:00,2019-03-31 19:30:00
138,20,9,11,0.01665516315856426,2019-03-31 19:15:00,2019-03-31 19:30:00
140,1,0,1,0.0022610009027659423,2019-03-31 19:15:00,2019-03-31 19:30:00
141,6,1,5,0.004182948060924381,2019-03-31 19:15:00,2019-03-31 19:30:00
151,5,4,1,0.005970849845870216,2019-03-31 19:15:00,2019-03-31 19:30:00
153,4,4,0,0.005957103381665094,2019-03-31 19:15:00,2019-03-31 19:30:00
156,2,0,2,0.0022610009027659423,2019-03-31 19:15:00,2019-03-31 19:30:00
158,2,1,1,0.0032824843758342916,2019-03-31 19:15:00,2019-03-31 19:30:00
159,4,1,3,0.00315495179523886,2019-03-31 19:15:00,2019-03-31 19:30:00
160,4,2,2,0.015024537907478005,2019-03-31 19:15:00,2019-03-31 19:30:00
162,5,3,2,0.02239957158178233,2019-03-31 19:15:00,2019-03-31 19:30:00
164,9,4,5,0.0044659482756666926,2019-03-31 19:15:00,2019-03-31 19:30:00
168,13,6,7,0.015750021389048602,2019-03-31 19:15:00,2019-03-31 19:30:00
169,1,0,1,0.0022610009027659423,2019-03-31 19:15:00,2019-03-31 19:30:00
170,1,1,0,0.007838762464276998,2019-03-31 19:15:00,2019-03-31 19:30:00
171,1,1,0,0.004472812809223191,2019-03-31 19:15:00,2019-03-31 19:30:00
172,6,4,2,0.005519014882718555,2019-03-31 19:15:00,2019-03-31 19:30:00
173,13,4,9,0.003633873999173058,2019-03-31 19:15:00,2019-03-31 19:30:00
175,1,0,1,0.0022610009027659423,2019-03-31 19:15:00,2019-03-31 19:30:00
177,6,3,3,0.003921195417358504,2019-03-31 19:15:00,2019-03-31 19:30:00
190,9,6,3,0.041526826615327854,2019-03-31 19:15:00,2019-03-31 19:30:00
191,12,6,6,0.03474091779918932,2019-03-31 19:15:00,2019-03-31 19:30:00
195,1,0,1,0.0022610009027659423,2019-03-31 19:15:00,2019-03-31 19:30:00
197,2,1,1,0.004758372577965981,2019-03-31 19:15:00,2019-03-31 19:30:00
201,2,1,1,0.015024537907478005,2019-03-31 19:15:00,2019-03-31 19:30:00
202,4,2,2,0.004835302486405853,2019-03-31 19:15:00,2019-03-31 19:30:00
203,13,8,5,0.029504873713028706,2019-03-31 19:15:00,2019-03-31 19:30:00
1,6,2,4,0.003306840692719259,2019-03-31 19:30:00,2019-03-31 19:45:00
2,1,0,1,0.0019013930386781509,2019-03-31 19:30:00,2019-03-31 19:45:00
5,2,1,1,0.012673222262242432,2019-03-31 19:30:00,2019-03-31 19:45:00
10,3,1,2,0.0038742257056481755,2019-03-31 19:30:00,2019-03-31 19:45:00
13,1,0,1,0.0019013930386781509,2019-03-31 19:30:00,2019-03-31 19:45:00
15,11,5,6,0.006873264866286952,2019-03-31 19:30:00,2019-03-31 19:45:00
16,3,1,2,0.002170763118919067,2019-03-31 19:30:00,2019-03-31 19:45:00
18,8,4,4,0.009282501255172835,2019-03-31 19:30:00,2019-03-31 19:45:00
19,6,2,4,0.0031103653711224383,2019-03-31 19:30:00,2019-03-31 19:45:00
20,8,3,5,0.009765254381899627,2019-03-31 19:30:00,2019-03-31 19:45:00
23,5,3,2,0.0042438057954133305,2019-03-31 19:30:00,2019-03-31 19:45:00
26,3,2,1,0.06729927928080329,2019-03-31 19:30:00,2019-03-31 19:45:00
28,15,10,5,0.04844314867569134,2019-03-31 19:30:00,2019-03-31 19:45:00
30,2,1,1,0.012673222262242432,2019-03-31 19:30:00,2019-03-31 19:45:00
35,3,1,2,0.0037050656349314984,2019-03-31 19:30:00,2019-03-31 19:45:00
41,4,4,0,0.008645962039465948,2019-03-31 19:30:00,2019-03-31 19:45:00
46,7,2,5,0.002880937857792782,2019-03-31 19:30:00,2019-03-31 19:45:00
57,7,4,3,0.005160718445155067,2019-03-31 19:30:00,2019-03-31 19:45:00
62,9,3,6,0.006787477330021677,2019-03-31 19:30:00,2019-03-31 19:45:00
64,2,1,1,0.012673222262242432,2019-03-31 19:30:00,2019-03-31 19:45:00
66,3,3,0,0.007023628466358877,2019-03-31 19:30:00,2019-03-31 19:45:00
67,9,5,4,0.012394647264878104,2019-03-31 19:30:00,2019-03-31 19:45:00
68,6,2,4,0.004421524729764469,2019-03-31 19:30:00,2019-03-31 19:45:00
69,3,1,2,0.0035176135201236474,2019-03-31 19:30:00,2019-03-31 19:45:00
70,2,2,0,0.004891440815511627,2019-03-31 19:30:00,2019-03-31 19:45:00
75,6,2,4,0.003306840692719259,2019-03-31 19:30:00,2019-03-31 19:45:00
79,2,1,1,0.012673222262242432,2019-03-31 19:30:00,2019-03-31 19:45:00
80,4,2,2,0.012673222262242432,2019-03-31 19:30:00,2019-03-31 19:45:00
86,2,0,2,0.0019013930386781509,2019-03-31 19:30:00,2019-03-31 19:45:00
87,5,4,1,0.02123897817959853,2019-03-31 19:30:00,2019-03-31 19:45:00
88,2,1,1,0.0035176135201236474,2019-03-31 19:30:00,2019-03-31 19:45:00
89,13,5,8,0.008507085654074912,2019-03-31 19:30:00,2019-03-31 19:45:00
90,15,9,6,0.023233551754611767,2019-03-31 19:30:00,2019-03-31 19:45:00
99,7,4,3,0.0057479248803400645,2019-03-31 19:30:00,2019-03-31 19:45:00
101,1,0,1,0.0019013930386781509,2019-03-31 19:30:00,2019-03-31 19:45:00
104,1,0,1,0.0019013930386781509,2019-03-31 19:30:00,2019-03-31 19:45:00
106,1,0,1,0.0019013930386781509,2019-03-31 19:30:00,2019-03-31 19:45:00
109,21,14,7,0.05000024351330831,2019-03-31 19:30:00,2019-03-31 19:45:00
110,5,0,5,0.0019013930386781509,2019-03-31 19:30:00,2019-03-31 19:45:00
111,7,6,1,0.005653415052786366,2019-03-31 19:30:00,2019-03-31 19:45:00
112,5,3,2,0.009803255543056928,2019-03-31 19:30:00,2019-03-31 19:45:00
114,4,2,2,0.0031939828240186547,2019-03-31 19:30:00,2019-03-31 19:45:00
115,1,0,1,0.0019013930386781509,2019-03-31 19:30:00,2019-03-31 19:45:00
116,6,3,3,0.006556537933066712,2019-03-31 19:30:00,2019-03-31 19:45:00
118,1,0,1,0.0019013930386781509,2019-03-31 19:30:00,2019-03-31 19:45:00
119,11,9,2,0.030353137302972722,2019-03-31 19:30:00,2019-03-31 19:45:00
120,2,2,0,0.0035779665761156948,2019-03-31 19:30:00,2019-03-31 19:45:00
122,2,1,1,0.007974245978633786,2019-03-31 19:30:00,2019-03-31 19:45:00
126,3,3,0,0.005164612013811853,2019-03-31 19:30:00,2019-03-31 19:45:00
127,18,6,12,0.00912302941124011,2019-03-31 19:30:00,2019-03-31 19:45:00
129,7,6,1,0.014052794080836902,2019-03-31 19:30:00,2019-03-31 19:45:00
137,13,3,10,0.009913710556368383,2019-03-31 19:30:00,2019-03-31 19:45:00
138,24,14,10,0.02858807192654754,2019-03-31 19:30:00,2019-03-31 19:45:00
141,6,0,6,0.0019013930386781509,2019-03-31 19:30:00,2019-03-31 19:45:00
151,5,4,1,0.0051338340015691444,2019-03-31 19:30:00,2019-03-31 19:45:00
153,7,4,3,0.00611855671140607,2019-03-31 19:30:00,2019-03-31 19:45:00
154,4,1,3,0.002653133251813052,2019-03-31 19:30:00,2019-03-31 19:45:00
156,2,0,2,0.0019013930386781509,2019-03-31 19:30:00,2019-03-31 19:45:00
159,2,0,2,0.0019013930386781509,2019-03-31 19:30:00,2019-03-31 19:45:00
162,5,3,2,0.022746916028139715,2019-03-31 19:30:00,2019-03-31 19:45:00
164,12,6,6,0.009264811647217805,2019-03-31 19:30:00,2019-03-31 19:45:00
168,14,7,7,0.05253541729689106,2019-03-31 19:30:00,2019-03-31 19:45:00
169,1,0,1,0.0019013930386781509,2019-03-31 19:30:00,2019-03-31 19:45:00
170,1,0,1,0.0019013930386781509,2019-03-31 19:30:00,2019-03-31 19:45:00
172,1,1,0,0.0038742257056481755,2019-03-31 19:30:00,2019-03-31 19:45:00
173,14,7,7,0.009756518032385468,2019-03-31 19:30:00,2019-03-31 19:45:00
175,1,0,1,0.0019013930386781509,2019-03-31 19:30:00,2019-03-31 19:45:00
177,6,3,3,0.005336877044570984,2019-03-31 19:30:00,2019-03-31 19:45:00
190,7,5,2,0.021515981755438673,2019-03-31 19:30:00,2019-03-31 19:45:00
191,13,5,8,0.019212633365373103,2019-03-31 19:30:00,2019-03-31 19:45:00
195,1,0,1,0.0019013930386781509,2019-03-31 19:30:00,2019-03-31 19:45:00
197,3,2,1,0.005534515187845522,2019-03-31 19:30:00,2019-03-31 19:45:00
199,1,1,0,0.003635115697438871,2019-03-31 19:30:00,2019-03-31 19:45:00
201,2,1,1,0.012673222262242432,2019-03-31 19:30:00,2019-03-31 19:45:00
202,2,0,2,0.0019013930386781509,2019-03-31 19:30:00,2019-03-31 19:45:00
203,12,7,5,0.011733284411884362,2019-03-31 19:30:00,2019-03-31 19:45:00
1,3,0,3,0.002056017390063897,2019-03-31 19:45:00,2019-03-31 20:00:00
2,4,2,2,0.005417547719847728,2019-03-31 19:45:00,2019-03-31 20:00:00
5,2,1,1,0.013701148146090808,2019-03-31 19:45:00,2019-03-31 20:00:00
10,1,1,0,0.0035157802242569893,2019-03-31 19:45:00,2019-03-31 20:00:00
13,2,0,2,0.002056017390063897,2019-03-31 19:45:00,2019-03-31 20:00:00
15,10,2,8,0.0038037541458670887,2019-03-31 19:45:00,2019-03-31 20:00:00
16,5,3,2,0.005548724452651119,2019-03-31 19:45:00,2019-03-31 20:00:00
18,10,7,3,0.010921309419453233,2019-03-31 19:45:00,2019-03-31 20:00:00
19,3,2,1,0.006549089102975251,2019-03-31 19:45:00,2019-03-31 20:00:00
20,6,1,5,0.00651571432992046,2019-03-31 19:45:00,2019-03-31 20:00:00
23,8,2,6,0.004431620994579045,2019-03-31 19:45:00,2019-03-31 20:00:00
26,2,1,1,0.013701148146090808,2019-03-31 19:45:00,2019-03-31 20:00:00
27,2,2,0,0.0029298857679654925,2019-03-31 19:45:00,2019-03-31 20:00:00
28,8,6,2,0.04942047390224911,2019-03-31 19:45:00,2019-03-31 20:00:00
30,3,1,2,0.0035759304717626643,2019-03-31 19:45:00,2019-03-31 20:00:00
35,2,1,1,0.0026838842387758534,2019-03-31 19:45:00,2019-03-31 20:00:00
41,10,6,4,0.009066792186399377,2019-03-31 19:45:00,2019-03-31 20:00:00
46,6,1,5,0.002477167502650154,2019-03-31 19:45:00,2019-03-31 20:00:00
57,2,2,0,0.008044662228067639,2019-03-31 19:45:00,2019-03-31 20:00:00
58,4,3,1,0.003642325339852282,2019-03-31 19:45:00,2019-03-31 20:00:00
62,7,5,2,0.004677622523768684,2019-03-31 19:45:00,2019-03-31 20:00:00
64,2,1,1,0.013701148146090808,2019-03-31 19:45:00,2019-03-31 20:00:00
67,8,4,4,0.007064300793334924,2019-03-31 19:45:00,2019-03-31 20:00:00
68,4,2,2,0.003443840779625237,2019-03-31 19:45:00,2019-03-31 20:00:00
69,3,1,2,0.005080159223647093,2019-03-31 19:45:00,2019-03-31 20:00:00
70,2,2,0,0.006374687370689622,2019-03-31 19:45:00,2019-03-31 20:00:00
74,3,1,2,0.0035759304717626643,2019-03-31 19:45:00,2019-03-31 20:00:00
75,7,3,4,0.004183895704442171,2019-03-31 19:45:00,2019-03-31 20:00:00
79,2,1,1,0.013701148146090808,2019-03-31 19:45:00,2019-03-31 20:00:00
80,4,2,2,0.013701148146090808,2019-03-31 19:45:00,2019-03-31 20:00:00
86,5,3,2,0.04556643877965656,2019-03-31 19:45:00,2019-03-31 20:00:00
87,4,4,0,0.008699385864439014,2019-03-31 19:45:00,2019-03-31 20:00:00
88,4,1,3,0.005151058595770213,2019-03-31 19:45:00,2019-03-31 20:00:00
89,6,2,4,0.0035759304717626643,2019-03-31 19:45:00,2019-03-31 20:00:00
90,7,5,2,0.054028669578440824,2019-03-31 19:45:00,2019-03-31 20:00:00
99,4,0,4,0.002056017390063897,2019-03-31 19:45:00,2019-03-31 20:00:00
104,7,1,6,0.002395389333566061,2019-03-31 19:45:00,2019-03-31 20:00:00
106,2,1,1,0.0035573897553272415,2019-03-31 19:45:00,2019-03-31 20:00:00
109,16,12,4,0.023932612323644437,2019-03-31 19:45:00,2019-03-31 20:00:00
111,2,1,1,0.004604463926205823,2019-03-31 19:45:00,2019-03-31 20:00:00
112,5,3,2,0.0065601344858539305,2019-03-31 19:45:00,2019-03-31 20:00:00
113,1,0,1,0.002056017390063897,2019-03-31 19:45:00,2019-03-31 20:00:00
114,4,0,4,0.002056017390063897,2019-03-31 19:45:00,2019-03-31 20:00:00
116,8,5,3,0.01631182275100643,2019-03-31 19:45:00,2019-03-31 20:00:00
119,10,7,3,0.009974512053798389,2019-03-31 19:45:00,2019-03-31 20:00:00
120,2,2,0,0.003349364447166412,2019-03-31 19:45:00,2019-03-31 20:00:00
122,4,1,3,0.007142875192941586,2019-03-31 19:45:00,2019-03-31 20:00:00
126,10,9,1,0.10247992593243097,2019-03-31 19:45:00,2019-03-31 20:00:00
127,10,3,7,0.00663458692096204,2019-03-31 19:45:00,2019-03-31 20:00:00
129,5,4,1,0.007191439896599712,2019-03-31 19:45:00,2019-03-31 20:00:00
137,5,0,5,0.002056017390063897,2019-03-31 19:45:00,2019-03-31 20:00:00
138,13,7,6,0.008203741765067822,2019-03-31 19:45:00,2019-03-31 20:00:00
151,2,2,0,0.0038037541458670887,2019-03-31 19:45:00,2019-03-31 20:00:00
153,5,2,3,0.004203797320474621,2019-03-31 19:45:00,2019-03-31 20:00:00
154,2,0,2,0.002056017390063897,2019-03-31 19:45:00,2019-03-31 20:00:00
157,1,1,0,0.007142875192941586,2019-03-31 19:45:00,2019-03-31 20:00:00
158,3,0,3,0.002056017390063897,2019-03-31 19:45:00,2019-03-31 20:00:00
159,2,0,2,0.002056017390063897,2019-03-31 19:45:00,2019-03-31 20:00:00
164,8,4,4,0.008193176182643414,2019-03-31 19:45:00,2019-03-31 20:00:00
168,11,5,6,0.006798027635461798,2019-03-31 19:45:00,2019-03-31 20:00:00
169,1,0,1,0.002056017390063897,2019-03-31 19:45:00,2019-03-31 20:00:00
170,8,4,4,0.011990519769222958,2019-03-31 19:45:00,2019-03-31 20:00:00
172,2,1,1,0.004337502634189252,2019-03-31 19:45:00,2019-03-31 20:00:00
173,8,5,3,0.013759581814130454,2019-03-31 19:45:00,2019-03-31 20:00:00
177,5,3,2,0.010492024857943228,2019-03-31 19:45:00,2019-03-31 20:00:00
190,5,4,1,0.05364254552327699,2019-03-31 19:45:00,2019-03-31 20:00:00
191,4,1,3,0.0028689532066744333,2019-03-31 19:45:00,2019-03-31 20:00:00
197,2,1,1,0.005151058595770213,2019-03-31 19:45:00,2019-03-31 20:00:00
201,2,1,1,0.013701148146090808,2019-03-31 19:45:00,2019-03-31 20:00:00
202,2,0,2,0.002056017390063897,2019-03-31 19:45:00,2019-03-31 20:00:00
203,8,4,4,0.004981931716409219,2019-03-31 19:45:00,2019-03-31 20:00:00
1,4,2,2,0.016078633661200444,2019-03-31 20:00:00,2019-03-31 20:15:00
2,6,3,3,0.011011423106516384,2019-03-31 20:00:00,2019-03-31 20:15:00
5,5,2,3,0.006096114845237398,2019-03-31 20:00:00,2019-03-31 20:15:00
10,1,1,0,0.003700292302951728,2019-03-31 20:00:00,2019-03-31 20:15:00
13,2,0,2,0.002292612355480439,2019-03-31 20:00:00,2019-03-31 20:15:00
15,9,0,9,0.002292612355480439,2019-03-31 20:00:00,2019-03-31 20:15:00
16,6,4,2,0.00970823420422838,2019-03-31 20:00:00,2019-03-31 20:15:00
18,11,6,5,0.007866265547298152,2019-03-31 20:00:00,2019-03-31 20:15:00
19,3,1,2,0.0048840009067828505,2019-03-31 20:00:00,2019-03-31 20:15:00
20,8,3,5,0.00549111872111642,2019-03-31 20:00:00,2019-03-31 20:15:00
23,11,4,7,0.004172162692940761,2019-03-31 20:00:00,2019-03-31 20:15:00
26,5,2,3,0.00410566943234358,2019-03-31 20:00:00,2019-03-31 20:15:00
27,3,3,0,0.004430489386658139,2019-03-31 20:00:00,2019-03-31 20:15:00
28,3,0,3,0.002292612355480439,2019-03-31 20:00:00,2019-03-31 20:15:00
30,3,2,1,0.03455054126425256,2019-03-31 20:00:00,2019-03-31 20:15:00
35,1,0,1,0.002292612355480439,2019-03-31 20:00:00,2019-03-31 20:15:00
41,11,4,7,0.006190451807255145,2019-03-31 20:00:00,2019-03-31 20:15:00
46,4,1,3,0.003199140893912009,2019-03-31 20:00:00,2019-03-31 20:15:00
50,2,0,2,0.002292612355480439,2019-03-31 20:00:00,2019-03-31 20:15:00
57,4,3,1,0.008994294995176743,2019-03-31 20:00:00,2019-03-31 20:15:00
58,3,1,2,0.003199140893912009,2019-03-31 20:00:00,2019-03-31 20:15:00
61,1,0,1,0.002292612355480439,2019-03-31 20:00:00,2019-03-31 20:15:00
62,6,6,0,0.005865631852940586,2019-03-31 20:00:00,2019-03-31 20:15:00
64,4,3,1,0.04292807636743141,2019-03-31 20:00:00,2019-03-31 20:15:00
67,4,1,3,0.00577512620684314,2019-03-31 20:00:00,2019-03-31 20:15:00
68,1,1,0,0.002799294251791188,2019-03-31 20:00:00,2019-03-31 20:15:00
69,3,1,2,0.003929198605683984,2019-03-31 20:00:00,2019-03-31 20:15:00
70,2,2,0,0.005632963275527256,2019-03-31 20:00:00,2019-03-31 20:15:00
74,3,2,1,0.03560438651989921,2019-03-31 20:00:00,2019-03-31 20:15:00
75,7,3,4,0.010259268168586551,2019-03-31 20:00:00,2019-03-31 20:15:00
79,2,1,1,0.015271757598609319,2019-03-31 20:00:00,2019-03-31 20:15:00
80,4,2,2,0.015271757598609319,2019-03-31 20:00:00,2019-03-31 20:15:00
86,3,2,1,0.0035918921727386742,2019-03-31 20:00:00,2019-03-31 20:15:00
87,4,4,0,0.013472659684808961,2019-03-31 20:00:00,2019-03-31 20:15:00
88,5,2,3,0.004967535624764032,2019-03-31 20:00:00,2019-03-31 20:15:00
89,4,2,2,0.015271757598609319,2019-03-31 20:00:00,2019-03-31 20:15:00
90,7,5,2,0.04653827249916383,2019-03-31 20:00:00,2019-03-31 20:15:00
99,4,0,4,0.002292612355480439,2019-03-31 20:00:00,2019-03-31 20:15:00
104,3,0,3,0.002292612355480439,2019-03-31 20:00:00,2019-03-31 20:15:00
106,1,1,0,0.003929198605683984,2019-03-31 20:00:00,2019-03-31 20:15:00
108,1,1,0,0.003929198605683984,2019-03-31 20:00:00,2019-03-31 20:15:00
109,16,8,8,0.009796877995507249,2019-03-31 20:00:00,2019-03-31 20:15:00
110,2,2,0,0.003448934160420306,2019-03-31 20:00:00,2019-03-31 20:15:00
111,3,0,3,0.002292612355480439,2019-03-31 20:00:00,2019-03-31 20:15:00
112,1,1,0,0.0036524051631277948,2019-03-31 20:00:00,2019-03-31 20:15:00
114,4,0,4,0.002292612355480439,2019-03-31 20:00:00,2019-03-31 20:15:00
115,1,1,0,0.0048840009067828505,2019-03-31 20:00:00,2019-03-31 20:15:00
116,10,5,5,0.011367221858411648,2019-03-31 20:00:00,2019-03-31 20:15:00
119,11,8,3,0.007905624049035147,2019-03-31 20:00:00,2019-03-31 20:15:00
120,1,1,0,0.004473079168740275,2019-03-31 20:00:00,2019-03-31 20:15:00
122,3,1,2,0.0033337043244575067,2019-03-31 20:00:00,2019-03-31 20:15:00
126,8,6,2,0.01621399160876701,2019-03-31 20:00:00,2019-03-31 20:15:00
127,2,1,1,0.0034560295237144626,2019-03-31 20:00:00,2019-03-31 20:15:00
129,2,2,0,0.0027257056278998503,2019-03-31 20:00:00,2019-03-31 20:15:00
137,2,1,1,0.004241532081367792,2019-03-31 20:00:00,2019-03-31 20:15:00
138,6,1,5,0.0027622452294574426,2019-03-31 20:00:00,2019-03-31 20:15:00
140,2,2,0,0.004967535624764032,2019-03-31 20:00:00,2019-03-31 20:15:00
151,1,1,0,0.004672280530911942,2019-03-31 20:00:00,2019-03-31 20:15:00
153,4,2,2,0.006816218175820208,2019-03-31 20:00:00,2019-03-31 20:15:00
154,3,2,1,0.004374796293434575,2019-03-31 20:00:00,2019-03-31 20:15:00
157,2,1,1,0.0033337043244575067,2019-03-31 20:00:00,2019-03-31 20:15:00
158,1,0,1,0.002292612355480439,2019-03-31 20:00:00,2019-03-31 20:15:00
164,6,3,3,0.012288987982370223,2019-03-31 20:00:00,2019-03-31 20:15:00
168,11,5,6,0.010326087012576132,2019-03-31 20:00:00,2019-03-31 20:15:00
169,1,0,1,0.002292612355480439,2019-03-31 20:00:00,2019-03-31 20:15:00
170,10,5,5,0.014564990298478998,2019-03-31 20:00:00,2019-03-31 20:15:00
172,5,3,2,0.00609656398347061,2019-03-31 20:00:00,2019-03-31 20:15:00
173,7,3,4,0.004364190893792962,2019-03-31 20:00:00,2019-03-31 20:15:00
177,3,1,2,0.0039875402504634125,2019-03-31 20:00:00,2019-03-31 20:15:00
189,1,0,1,0.002292612355480439,2019-03-31 20:00:00,2019-03-31 20:15:00
190,4,3,1,0.1005524145209682,2019-03-31 20:00:00,2019-03-31 20:15:00
191,7,5,2,0.01410156739427261,2019-03-31 20:00:00,2019-03-31 20:15:00
195,2,1,1,0.002799294251791188,2019-03-31 20:00:00,2019-03-31 20:15:00
196,1,1,0,0.009939050331009188,2019-03-31 20:00:00,2019-03-31 20:15:00
197,4,3,1,0.008581671185320348,2019-03-31 20:00:00,2019-03-31 20:15:00
201,2,1,1,0.015271757598609319,2019-03-31 20:00:00,2019-03-31 20:15:00
202,1,0,1,0.002292612355480439,2019-03-31 20:00:00,2019-03-31 20:15:00
203,2,2,0,0.0027257056278998503,2019-03-31 20:00:00,2019-03-31 20:15:00
1,3,2,1,0.006505197676844519,2019-03-31 20:15:00,2019-03-31 20:30:00
2,1,1,0,0.0033757992072695085,2019-03-31 20:15:00,2019-03-31 20:30:00
5,9,4,5,0.0048804419798447836,2019-03-31 20:15:00,2019-03-31 20:30:00
10,5,3,2,0.02490850701199053,2019-03-31 20:15:00,2019-03-31 20:30:00
11,1,1,0,0.0042864737757077696,2019-03-31 20:15:00,2019-03-31 20:30:00
13,1,0,1,0.0025914858189495524,2019-03-31 20:15:00,2019-03-31 20:30:00
15,3,1,2,0.004794452153907832,2019-03-31 20:15:00,2019-03-31 20:30:00
16,3,3,0,0.006654524871514947,2019-03-31 20:15:00,2019-03-31 20:30:00
18,7,0,7,0.0025914858189495524,2019-03-31 20:15:00,2019-03-31 20:30:00
19,1,0,1,0.0025914858189495524,2019-03-31 20:15:00,2019-03-31 20:30:00
20,2,1,1,0.008905295815863135,2019-03-31 20:15:00,2019-03-31 20:30:00
23,3,2,1,0.00887015895082947,2019-03-31 20:15:00,2019-03-31 20:30:00
26,1,0,1,0.0025914858189495524,2019-03-31 20:15:00,2019-03-31 20:30:00
28,2,0,2,0.0025914858189495524,2019-03-31 20:15:00,2019-03-31 20:30:00
41,4,2,2,0.007455608319106811,2019-03-31 20:15:00,2019-03-31 20:30:00
46,3,1,2,0.0045073151458251606,2019-03-31 20:15:00,2019-03-31 20:30:00
50,3,1,2,0.0045073151458251606,2019-03-31 20:15:00,2019-03-31 20:30:00
57,2,1,1,0.004794452153907832,2019-03-31 20:15:00,2019-03-31 20:30:00
58,1,0,1,0.0025914858189495524,2019-03-31 20:15:00,2019-03-31 20:30:00
61,5,2,3,0.005981461732465986,2019-03-31 20:15:00,2019-03-31 20:30:00
62,3,2,1,0.0069974184888661126,2019-03-31 20:15:00,2019-03-31 20:30:00
64,1,1,0,0.0036672451482367106,2019-03-31 20:15:00,2019-03-31 20:30:00
67,5,1,4,0.004794452153907832,2019-03-31 20:15:00,2019-03-31 20:30:00
69,1,0,1,0.0025914858189495524,2019-03-31 20:15:00,2019-03-31 20:30:00
75,6,3,3,0.011066425602740638,2019-03-31 20:15:00,2019-03-31 20:30:00
80,5,2,3,0.005981461732465986,2019-03-31 20:15:00,2019-03-31 20:30:00
86,2,2,0,0.004794452153907832,2019-03-31 20:15:00,2019-03-31 20:30:00
87,8,4,4,0.01725899407667692,2019-03-31 20:15:00,2019-03-31 20:30:00
88,5,2,3,0.004055326528582184,2019-03-31 20:15:00,2019-03-31 20:30:00
89,4,2,2,0.01725899407667692,2019-03-31 20:15:00,2019-03-31 20:30:00
90,6,3,3,0.01725899407667692,2019-03-31 20:15:00,2019-03-31 20:30:00
104,1,0,1,0.0025914858189495524,2019-03-31 20:15:00,2019-03-31 20:30:00
108,1,1,0,0.003610412518179962,2019-03-31 20:15:00,2019-03-31 20:30:00
109,11,4,7,0.008858121192755183,2019-03-31 20:15:00,2019-03-31 20:30:00
110,2,2,0,0.01091631183485065,2019-03-31 20:15:00,2019-03-31 20:30:00
111,1,0,1,0.0025914858189495524,2019-03-31 20:15:00,2019-03-31 20:30:00
112,1,1,0,0.004794452153907832,2019-03-31 20:15:00,2019-03-31 20:30:00
114,2,0,2,0.0025914858189495524,2019-03-31 20:15:00,2019-03-31 20:30:00
115,1,1,0,0.01118327017151518,2019-03-31 20:15:00,2019-03-31 20:30:00
116,11,3,8,0.00846656239885802,2019-03-31 20:15:00,2019-03-31 20:30:00
119,2,1,1,0.0035148062246201785,2019-03-31 20:15:00,2019-03-31 20:30:00
120,3,2,1,0.007765325941826774,2019-03-31 20:15:00,2019-03-31 20:30:00
122,2,2,0,0.005870211483194991,2019-03-31 20:15:00,2019-03-31 20:30:00
126,7,5,2,0.007090900531479849,2019-03-31 20:15:00,2019-03-31 20:30:00
127,2,1,1,0.004794452153907832,2019-03-31 20:15:00,2019-03-31 20:30:00
129,1,0,1,0.0025914858189495524,2019-03-31 20:15:00,2019-03-31 20:30:00
137,1,0,1,0.0025914858189495524,2019-03-31 20:15:00,2019-03-31 20:30:00
138,7,2,5,0.005430635551495787,2019-03-31 20:15:00,2019-03-31 20:30:00
140,2,2,0,0.0032209047717947754,2019-03-31 20:15:00,2019-03-31 20:30:00
147,2,2,0,0.0046293392174103715,2019-03-31 20:15:00,2019-03-31 20:30:00
151,1,1,0,0.005660653611572709,2019-03-31 20:15:00,2019-03-31 20:30:00
153,4,4,0,0.008480641897625091,2019-03-31 20:15:00,2019-03-31 20:30:00
154,3,3,0,0.006780857875984688,2019-03-31 20:15:00,2019-03-31 20:30:00
157,1,0,1,0.0025914858189495524,2019-03-31 20:15:00,2019-03-31 20:30:00
158,1,0,1,0.0025914858189495524,2019-03-31 20:15:00,2019-03-31 20:30:00
164,5,4,1,0.07215447358444226,2019-03-31 20:15:00,2019-03-31 20:30:00
168,9,5,4,0.02490850701199053,2019-03-31 20:15:00,2019-03-31 20:30:00
170,6,2,4,0.00369050868369212,2019-03-31 20:15:00,2019-03-31 20:30:00
171,3,1,2,0.0045073151458251606,2019-03-31 20:15:00,2019-03-31 20:30:00
172,3,2,1,0.010105618027722522,2019-03-31 20:15:00,2019-03-31 20:30:00
173,7,3,4,0.01767636682219403,2019-03-31 20:15:00,2019-03-31 20:30:00
177,4,2,2,0.01485374307474813,2019-03-31 20:15:00,2019-03-31 20:30:00
190,1,1,0,0.008121653212380911,2019-03-31 20:15:00,2019-03-31 20:30:00
191,9,7,2,0.05683253754701805,2019-03-31 20:15:00,2019-03-31 20:30:00
195,2,1,1,0.003610412518179962,2019-03-31 20:15:00,2019-03-31 20:30:00
197,4,3,1,0.006453989361957841,2019-03-31 20:15:00,2019-03-31 20:30:00
201,2,1,1,0.01725899407667692,2019-03-31 20:15:00,2019-03-31 20:30:00
202,2,1,1,0.06388289476116582,2019-03-31 20:15:00,2019-03-31 20:30:00
203,1,0,1,0.0025914858189495524,2019-03-31 20:15:00,2019-03-31 20:30:00
1,6,2,4,0.005414136015971981,2019-03-31 20:30:00,2019-03-31 20:45:00
2,1,1,0,0.004810864453808683,2019-03-31 20:30:00,2019-03-31 20:45:00
5,3,2,1,0.004876972500712466,2019-03-31 20:30:00,2019-03-31 20:45:00
10,5,3,2,0.026304266947788743,2019-03-31 20:30:00,2019-03-31 20:45:00
11,1,1,0,0.00514885403308905,2019-03-31 20:30:00,2019-03-31 20:45:00
15,5,1,4,0.007029007424238301,2019-03-31 20:30:00,2019-03-31 20:45:00
16,1,1,0,0.004435941307723475,2019-03-31 20:30:00,2019-03-31 20:45:00
18,3,0,3,0.003112847728756503,2019-03-31 20:30:00,2019-03-31 20:45:00
19,2,0,2,0.003112847728756503,2019-03-31 20:30:00,2019-03-31 20:45:00
20,2,1,1,0.004263491872364241,2019-03-31 20:30:00,2019-03-31 20:45:00
23,10,4,6,0.013291443092664255,2019-03-31 20:30:00,2019-03-31 20:45:00
26,3,3,0,0.01699318210243436,2019-03-31 20:30:00,2019-03-31 20:45:00
28,1,1,0,0.0069616191694717895,2019-03-31 20:30:00,2019-03-31 20:45:00
46,1,0,1,0.003112847728756503,2019-03-31 20:30:00,2019-03-31 20:45:00
50,1,1,0,0.0057590348866904464,2019-03-31 20:30:00,2019-03-31 20:45:00
57,4,2,2,0.010654760921135637,2019-03-31 20:30:00,2019-03-31 20:45:00
58,1,0,1,0.003112847728756503,2019-03-31 20:30:00,2019-03-31 20:45:00
62,1,0,1,0.003112847728756503,2019-03-31 20:30:00,2019-03-31 20:45:00
64,1,1,0,0.003922595704215522,2019-03-31 20:30:00,2019-03-31 20:45:00
67,4,0,4,0.003112847728756503,2019-03-31 20:30:00,2019-03-31 20:45:00
68,2,2,0,0.004435941307723475,2019-03-31 20:30:00,2019-03-31 20:45:00
70,1,1,0,0.0038201165240338486,2019-03-31 20:30:00,2019-03-31 20:45:00
71,1,1,0,0.008008573763201694,2019-03-31 20:30:00,2019-03-31 20:45:00
74,1,0,1,0.003112847728756503,2019-03-31 20:30:00,2019-03-31 20:45:00
80,5,2,3,0.007184860337421597,2019-03-31 20:30:00,2019-03-31 20:45:00
87,1,0,1,0.003112847728756503,2019-03-31 20:30:00,2019-03-31 20:45:00
88,5,1,4,0.003952937248638983,2019-03-31 20:30:00,2019-03-31 20:45:00
90,6,3,3,0.020716434523001304,2019-03-31 20:30:00,2019-03-31 20:45:00
104,2,0,2,0.003112847728756503,2019-03-31 20:30:00,2019-03-31 20:45:00
108,2,1,1,0.0057590348866904464,2019-03-31 20:30:00,2019-03-31 20:45:00
109,7,2,5,0.0047626852240980014,2019-03-31 20:30:00,2019-03-31 20:45:00
110,1,1,0,0.004810864453808683,2019-03-31 20:30:00,2019-03-31 20:45:00
111,2,1,1,0.0057590348866904464,2019-03-31 20:30:00,2019-03-31 20:45:00
112,2,1,1,0.020716434523001304,2019-03-31 20:30:00,2019-03-31 20:45:00
114,2,2,0,0.0057590348866904464,2019-03-31 20:30:00,2019-03-31 20:45:00
115,4,2,2,0.010016712590402935,2019-03-31 20:30:00,2019-03-31 20:45:00
119,3,3,0,0.005234654114588541,2019-03-31 20:30:00,2019-03-31 20:45:00
120,1,1,0,0.00460670031183882,2019-03-31 20:30:00,2019-03-31 20:45:00
122,3,3,0,0.007891876441116438,2019-03-31 20:30:00,2019-03-31 20:45:00
126,8,6,2,0.023721714632711974,2019-03-31 20:30:00,2019-03-31 20:45:00
127,3,2,1,0.004527385319311195,2019-03-31 20:30:00,2019-03-31 20:45:00
129,1,0,1,0.003112847728756503,2019-03-31 20:30:00,2019-03-31 20:45:00
137,2,2,0,0.01189935873549705,2019-03-31 20:30:00,2019-03-31 20:45:00
138,20,6,14,0.01164734931310895,2019-03-31 20:30:00,2019-03-31 20:45:00
140,1,1,0,0.0038201165240338486,2019-03-31 20:30:00,2019-03-31 20:45:00
147,2,2,0,0.004435941307723475,2019-03-31 20:30:00,2019-03-31 20:45:00
154,5,4,1,0.041419612488155164,2019-03-31 20:30:00,2019-03-31 20:45:00
157,1,0,1,0.003112847728756503,2019-03-31 20:30:00,2019-03-31 20:45:00
164,8,3,5,0.007197223127409398,2019-03-31 20:30:00,2019-03-31 20:45:00
168,11,7,4,0.04256991857741099,2019-03-31 20:30:00,2019-03-31 20:45:00
170,3,1,2,0.003994910114734484,2019-03-31 20:30:00,2019-03-31 20:45:00
171,1,0,1,0.003112847728756503,2019-03-31 20:30:00,2019-03-31 20:45:00
172,1,0,1,0.003112847728756503,2019-03-31 20:30:00,2019-03-31 20:45:00
173,7,5,2,0.06108617805677527,2019-03-31 20:30:00,2019-03-31 20:45:00
177,4,2,2,0.010016712590402935,2019-03-31 20:30:00,2019-03-31 20:45:00
189,1,1,0,0.004336554163657561,2019-03-31 20:30:00,2019-03-31 20:45:00
191,4,2,2,0.020716434523001304,2019-03-31 20:30:00,2019-03-31 20:45:00
196,1,0,1,0.003112847728756503,2019-03-31 20:30:00,2019-03-31 20:45:00
197,1,1,0,0.0057590348866904464,2019-03-31 20:30:00,2019-03-31 20:45:00
203,2,1,1,0.00460670031183882,2019-03-31 20:30:00,2019-03-31 20:45:00
1,9,3,6,0.00554318475534667,2019-03-31 20:45:00,2019-03-31 21:00:00
2,1,1,0,0.010906614924941889,2019-03-31 20:45:00,2019-03-31 21:00:00
5,2,2,0,0.00632855797435936,2019-03-31 20:45:00,2019-03-31 21:00:00
10,3,2,1,0.046038254198884965,2019-03-31 20:45:00,2019-03-31 21:00:00
15,1,0,1,0.003187065098308601,2019-03-31 20:45:00,2019-03-31 21:00:00
16,4,4,0,0.0076899997011099525,2019-03-31 20:45:00,2019-03-31 21:00:00
18,3,3,0,0.019530937671153433,2019-03-31 20:45:00,2019-03-31 21:00:00
19,2,0,2,0.003187065098308601,2019-03-31 20:45:00,2019-03-31 21:00:00
20,5,2,3,0.00554318475534667,2019-03-31 20:45:00,2019-03-31 21:00:00
23,7,0,7,0.003187065098308601,2019-03-31 20:45:00,2019-03-31 21:00:00
26,5,4,1,0.016038649195207432,2019-03-31 20:45:00,2019-03-31 21:00:00
28,1,1,0,0.004885117562925931,2019-03-31 20:45:00,2019-03-31 21:00:00
41,1,1,0,0.008199467484811096,2019-03-31 20:45:00,2019-03-31 21:00:00
46,4,1,3,0.004447250246865262,2019-03-31 20:45:00,2019-03-31 21:00:00
57,4,1,3,0.005896328098025809,2019-03-31 20:45:00,2019-03-31 21:00:00
62,2,1,1,0.005896328098025809,2019-03-31 20:45:00,2019-03-31 21:00:00
64,1,1,0,0.004307889292753326,2019-03-31 20:45:00,2019-03-31 21:00:00
67,2,0,2,0.003187065098308601,2019-03-31 20:45:00,2019-03-31 21:00:00
68,2,2,0,0.005896328098025809,2019-03-31 20:45:00,2019-03-31 21:00:00
71,1,1,0,0.007111519510190937,2019-03-31 20:45:00,2019-03-31 21:00:00
74,2,1,1,0.007111519510190937,2019-03-31 20:45:00,2019-03-31 21:00:00
80,4,2,2,0.021192468291057497,2019-03-31 20:45:00,2019-03-31 21:00:00
87,2,0,2,0.003187065098308601,2019-03-31 20:45:00,2019-03-31 21:00:00
88,4,3,1,0.004398988208809489,2019-03-31 20:45:00,2019-03-31 21:00:00
89,2,0,2,0.003187065098308601,2019-03-31 20:45:00,2019-03-31 21:00:00
90,9,5,4,0.030195169887431945,2019-03-31 20:45:00,2019-03-31 21:00:00
104,2,0,2,0.003187065098308601,2019-03-31 20:45:00,2019-03-31 21:00:00
108,3,1,2,0.009232692243207283,2019-03-31 20:45:00,2019-03-31 21:00:00
109,15,3,12,0.01582045386935209,2019-03-31 20:45:00,2019-03-31 21:00:00
110,8,4,4,0.021192468291057497,2019-03-31 20:45:00,2019-03-31 21:00:00
111,1,0,1,0.003187065098308601,2019-03-31 20:45:00,2019-03-31 21:00:00
112,2,1,1,0.005896328098025809,2019-03-31 20:45:00,2019-03-31 21:00:00
114,2,2,0,0.005896328098025809,2019-03-31 20:45:00,2019-03-31 21:00:00
115,1,0,1,0.003187065098308601,2019-03-31 20:45:00,2019-03-31 21:00:00
116,1,1,0,0.0035741026696967737,2019-03-31 20:45:00,2019-03-31 21:00:00
119,2,2,0,0.0039950138386425265,2019-03-31 20:45:00,2019-03-31 21:00:00
120,5,3,2,0.02956507731315361,2019-03-31 20:45:00,2019-03-31 21:00:00
122,4,4,0,0.009004122383613592,2019-03-31 20:45:00,2019-03-31 21:00:00
126,4,3,1,0.010083006950955594,2019-03-31 20:45:00,2019-03-31 21:00:00
127,4,2,2,0.0039950138386425265,2019-03-31 20:45:00,2019-03-31 21:00:00
135,2,2,0,0.004834287818253435,2019-03-31 20:45:00,2019-03-31 21:00:00
137,9,7,2,0.024447003754199233,2019-03-31 20:45:00,2019-03-31 21:00:00
138,14,4,10,0.004752152182640082,2019-03-31 20:45:00,2019-03-31 21:00:00
140,1,1,0,0.0035910394684755638,2019-03-31 20:45:00,2019-03-31 21:00:00
153,1,0,1,0.003187065098308601,2019-03-31 20:45:00,2019-03-31 21:00:00
154,3,3,0,0.008137976486915261,2019-03-31 20:45:00,2019-03-31 21:00:00
157,2,0,2,0.003187065098308601,2019-03-31 20:45:00,2019-03-31 21:00:00
158,1,1,0,0.004307889292753326,2019-03-31 20:45:00,2019-03-31 21:00:00
159,1,1,0,0.005896328098025809,2019-03-31 20:45:00,2019-03-31 21:00:00
160,1,0,1,0.003187065098308601,2019-03-31 20:45:00,2019-03-31 21:00:00
164,8,3,5,0.00533270853972234,2019-03-31 20:45:00,2019-03-31 21:00:00
168,11,6,5,0.015632563663841692,2019-03-31 20:45:00,2019-03-31 21:00:00
170,6,4,2,0.018160665700333832,2019-03-31 20:45:00,2019-03-31 21:00:00
171,1,0,1,0.003187065098308601,2019-03-31 20:45:00,2019-03-31 21:00:00
172,1,0,1,0.003187065098308601,2019-03-31 20:45:00,2019-03-31 21:00:00
173,6,4,2,0.03323997378932807,2019-03-31 20:45:00,2019-03-31 21:00:00
177,3,1,2,0.00554318475534667,2019-03-31 20:45:00,2019-03-31 21:00:00
191,2,1,1,0.004885117562925931,2019-03-31 20:45:00,2019-03-31 21:00:00
196,1,0,1,0.003187065098308601,2019-03-31 20:45:00,2019-03-31 21:00:00
203,1,1,0,0.005896328098025809,2019-03-31 20:45:00,2019-03-31 21:00:00
1,4,2,2,0.022299199053257654,2019-03-31 21:00:00,2019-03-31 21:15:00
5,6,6,0,0.011998881183093998,2019-03-31 21:00:00,2019-03-31 21:15:00
16,7,2,5,0.004503987609503081,2019-03-31 21:00:00,2019-03-31 21:15:00
18,5,4,1,0.012499475501276771,2019-03-31 21:00:00,2019-03-31 21:15:00
20,4,2,2,0.005631685951191094,2019-03-31 21:00:00,2019-03-31 21:15:00
23,9,3,6,0.012034582946999856,2019-03-31 21:00:00,2019-03-31 21:15:00
26,1,0,1,0.0033550019250478975,2019-03-31 21:00:00,2019-03-31 21:15:00
28,2,2,0,0.01369160716827019,2019-03-31 21:00:00,2019-03-31 21:15:00
30,2,2,0,0.011081316913045742,2019-03-31 21:00:00,2019-03-31 21:15:00
41,6,3,3,0.013632999291037591,2019-03-31 21:00:00,2019-03-31 21:15:00
46,6,3,3,0.0062849263713553715,2019-03-31 21:00:00,2019-03-31 21:15:00
57,3,1,2,0.006501179528341837,2019-03-31 21:00:00,2019-03-31 21:15:00
62,2,1,1,0.006207016863256582,2019-03-31 21:00:00,2019-03-31 21:15:00
64,1,1,0,0.003929494767275489,2019-03-31 21:00:00,2019-03-31 21:15:00
67,2,0,2,0.0033550019250478975,2019-03-31 21:00:00,2019-03-31 21:15:00
68,2,2,0,0.006207016863256582,2019-03-31 21:00:00,2019-03-31 21:15:00
69,2,0,2,0.0033550019250478975,2019-03-31 21:00:00,2019-03-31 21:15:00
71,1,1,0,0.006207016863256582,2019-03-31 21:00:00,2019-03-31 21:15:00
74,2,2,0,0.006207016863256582,2019-03-31 21:00:00,2019-03-31 21:15:00
79,1,0,1,0.0033550019250478975,2019-03-31 21:00:00,2019-03-31 21:15:00
80,4,2,2,0.022299199053257654,2019-03-31 21:00:00,2019-03-31 21:15:00
86,1,1,0,0.006207016863256582,2019-03-31 21:00:00,2019-03-31 21:15:00
87,2,0,2,0.0033550019250478975,2019-03-31 21:00:00,2019-03-31 21:15:00
88,3,3,0,0.0051599035026882786,2019-03-31 21:00:00,2019-03-31 21:15:00
89,2,0,2,0.0033550019250478975,2019-03-31 21:00:00,2019-03-31 21:15:00
90,5,5,0,0.007844052029471589,2019-03-31 21:00:00,2019-03-31 21:15:00
108,1,0,1,0.0033550019250478975,2019-03-31 21:00:00,2019-03-31 21:15:00
109,19,5,14,0.009461026045915219,2019-03-31 21:00:00,2019-03-31 21:15:00
110,4,2,2,0.022299199053257654,2019-03-31 21:00:00,2019-03-31 21:15:00
112,2,1,1,0.004260432341606997,2019-03-31 21:00:00,2019-03-31 21:15:00
114,3,3,0,0.005696611656546416,2019-03-31 21:00:00,2019-03-31 21:15:00
116,1,1,0,0.005060130036659841,2019-03-31 21:00:00,2019-03-31 21:15:00
118,1,1,0,0.003929494767275489,2019-03-31 21:00:00,2019-03-31 21:15:00
120,1,1,0,0.005135940686900188,2019-03-31 21:00:00,2019-03-31 21:15:00
122,4,4,0,0.010030685588693434,2019-03-31 21:00:00,2019-03-31 21:15:00
126,3,2,1,0.0061984720497314395,2019-03-31 21:00:00,2019-03-31 21:15:00
127,2,1,1,0.003929494767275489,2019-03-31 21:00:00,2019-03-31 21:15:00
135,2,2,0,0.006841068798512132,2019-03-31 21:00:00,2019-03-31 21:15:00
137,7,4,3,0.01110266796038091,2019-03-31 21:00:00,2019-03-31 21:15:00
138,10,2,8,0.005661763895873302,2019-03-31 21:00:00,2019-03-31 21:15:00
140,1,0,1,0.0033550019250478975,2019-03-31 21:00:00,2019-03-31 21:15:00
141,1,1,0,0.006207016863256582,2019-03-31 21:00:00,2019-03-31 21:15:00
153,1,0,1,0.0033550019250478975,2019-03-31 21:00:00,2019-03-31 21:15:00
154,3,3,0,0.007356002547711765,2019-03-31 21:00:00,2019-03-31 21:15:00
157,3,1,2,0.006501179528341837,2019-03-31 21:00:00,2019-03-31 21:15:00
164,3,1,2,0.00478100939415224,2019-03-31 21:00:00,2019-03-31 21:15:00
168,10,5,5,0.016841221715699323,2019-03-31 21:00:00,2019-03-31 21:15:00
170,5,3,2,0.046350888002125196,2019-03-31 21:00:00,2019-03-31 21:15:00
171,1,0,1,0.0033550019250478975,2019-03-31 21:00:00,2019-03-31 21:15:00
172,5,1,4,0.004260432341606997,2019-03-31 21:00:00,2019-03-31 21:15:00
173,7,3,4,0.02431749258981214,2019-03-31 21:00:00,2019-03-31 21:15:00
175,2,1,1,0.022299199053257654,2019-03-31 21:00:00,2019-03-31 21:15:00
177,2,1,1,0.022299199053257654,2019-03-31 21:00:00,2019-03-31 21:15:00
191,6,1,5,0.006695411041226833,2019-03-31 21:00:00,2019-03-31 21:15:00
197,4,1,3,0.004681584184679349,2019-03-31 21:00:00,2019-03-31 21:15:00
201,1,1,0,0.003929494767275489,2019-03-31 21:00:00,2019-03-31 21:15:00
1,4,2,2,0.022407025635759626,2019-03-31 21:15:00,2019-03-31 21:30:00
5,4,4,0,0.015119355803242614,2019-03-31 21:15:00,2019-03-31 21:30:00
15,5,4,1,0.05413881843038338,2019-03-31 21:15:00,2019-03-31 21:30:00
16,3,1,2,0.004322304314169069,2019-03-31 21:15:00,2019-03-31 21:30:00
18,4,1,3,0.005205135290199779,2019-03-31 21:15:00,2019-03-31 21:30:00
20,3,2,1,0.006231013024536446,2019-03-31 21:15:00,2019-03-31 21:30:00
23,1,1,0,0.008664935815169642,2019-03-31 21:15:00,2019-03-31 21:30:00
26,1,1,0,0.006231013024536446,2019-03-31 21:15:00,2019-03-31 21:30:00
28,3,3,0,0.008975654358375197,2019-03-31 21:15:00,2019-03-31 21:30:00
30,2,2,0,0.006031416275841818,2019-03-31 21:15:00,2019-03-31 21:30:00
37,1,0,1,0.0033679499589853805,2019-03-31 21:15:00,2019-03-31 21:30:00
41,4,1,3,0.004699683117413599,2019-03-31 21:15:00,2019-03-31 21:30:00
58,3,1,2,0.005857860507646252,2019-03-31 21:15:00,2019-03-31 21:30:00
61,1,0,1,0.0033679499589853805,2019-03-31 21:15:00,2019-03-31 21:30:00
62,1,0,1,0.0033679499589853805,2019-03-31 21:15:00,2019-03-31 21:30:00
64,1,1,0,0.005535353270905793,2019-03-31 21:15:00,2019-03-31 21:30:00
66,1,1,0,0.006231013024536446,2019-03-31 21:15:00,2019-03-31 21:30:00
67,3,1,2,0.005857860507646252,2019-03-31 21:15:00,2019-03-31 21:30:00
79,2,1,1,0.022407025635759626,2019-03-31 21:15:00,2019-03-31 21:30:00
80,4,2,2,0.022407025635759626,2019-03-31 21:15:00,2019-03-31 21:30:00
86,2,1,1,0.022407025635759626,2019-03-31 21:15:00,2019-03-31 21:30:00
87,3,0,3,0.0033679499589853805,2019-03-31 21:15:00,2019-03-31 21:30:00
88,1,1,0,0.005205135290199779,2019-03-31 21:15:00,2019-03-31 21:30:00
89,2,2,0,0.006899273863108221,2019-03-31 21:15:00,2019-03-31 21:30:00
90,2,2,0,0.0063178737946935765,2019-03-31 21:15:00,2019-03-31 21:30:00
108,9,4,5,0.010529405743759445,2019-03-31 21:15:00,2019-03-31 21:30:00
109,12,6,6,0.015297266385783737,2019-03-31 21:15:00,2019-03-31 21:30:00
111,1,0,1,0.0033679499589853805,2019-03-31 21:15:00,2019-03-31 21:30:00
112,1,0,1,0.0033679499589853805,2019-03-31 21:15:00,2019-03-31 21:30:00
114,1,0,1,0.0033679499589853805,2019-03-31 21:15:00,2019-03-31 21:30:00
118,1,1,0,0.005535353270905793,2019-03-31 21:15:00,2019-03-31 21:30:00
119,1,0,1,0.0033679499589853805,2019-03-31 21:15:00,2019-03-31 21:30:00
122,3,3,0,0.009134288115601739,2019-03-31 21:15:00,2019-03-31 21:30:00
126,2,1,1,0.006231013024536446,2019-03-31 21:15:00,2019-03-31 21:30:00
137,4,1,3,0.006231013024536446,2019-03-31 21:15:00,2019-03-31 21:30:00
138,3,1,2,0.0051583139051788966,2019-03-31 21:15:00,2019-03-31 21:30:00
140,2,0,2,0.0033679499589853805,2019-03-31 21:15:00,2019-03-31 21:30:00
141,1,1,0,0.004799481491760914,2019-03-31 21:15:00,2019-03-31 21:30:00
157,1,1,0,0.005133611911046801,2019-03-31 21:15:00,2019-03-31 21:30:00
158,1,1,0,0.005857860507646252,2019-03-31 21:15:00,2019-03-31 21:30:00
159,1,1,0,0.005857860507646252,2019-03-31 21:15:00,2019-03-31 21:30:00
164,1,0,1,0.0033679499589853805,2019-03-31 21:15:00,2019-03-31 21:30:00
168,8,4,4,0.022407025635759626,2019-03-31 21:15:00,2019-03-31 21:30:00
170,4,2,2,0.022407025635759626,2019-03-31 21:15:00,2019-03-31 21:30:00
172,4,1,3,0.004699683117413599,2019-03-31 21:15:00,2019-03-31 21:30:00
173,4,1,3,0.004842911876839478,2019-03-31 21:15:00,2019-03-31 21:30:00
175,2,1,1,0.022407025635759626,2019-03-31 21:15:00,2019-03-31 21:30:00
177,2,1,1,0.022407025635759626,2019-03-31 21:15:00,2019-03-31 21:30:00
191,2,0,2,0.0033679499589853805,2019-03-31 21:15:00,2019-03-31 21:30:00
197,3,1,2,0.008664935815169642,2019-03-31 21:15:00,2019-03-31 21:30:00
201,1,1,0,0.005535353270905793,2019-03-31 21:15:00,2019-03-31 21:30:00
1,4,2,2,0.022640729298137933,2019-03-31 21:30:00,2019-03-31 21:45:00
5,1,0,1,0.0034046447836246206,2019-03-31 21:30:00,2019-03-31 21:45:00
15,3,3,0,0.016204585653214303,2019-03-31 21:30:00,2019-03-31 21:45:00
16,2,2,0,0.005536228964845821,2019-03-31 21:30:00,2019-03-31 21:45:00
18,6,2,4,0.005490322373143585,2019-03-31 21:30:00,2019-03-31 21:45:00
20,5,1,4,0.004323489552207824,2019-03-31 21:30:00,2019-03-31 21:45:00
26,1,1,0,0.006298898864480939,2019-03-31 21:30:00,2019-03-31 21:45:00
28,1,1,0,0.006298898864480939,2019-03-31 21:30:00,2019-03-31 21:45:00
35,1,0,1,0.0034046447836246206,2019-03-31 21:30:00,2019-03-31 21:45:00
37,2,1,1,0.01278691931146146,2019-03-31 21:30:00,2019-03-31 21:45:00
58,1,1,0,0.00592167335335974,2019-03-31 21:30:00,2019-03-31 21:45:00
61,1,0,1,0.0034046447836246206,2019-03-31 21:30:00,2019-03-31 21:45:00
62,1,0,1,0.0034046447836246206,2019-03-31 21:30:00,2019-03-31 21:45:00
64,1,1,0,0.004125915858937493,2019-03-31 21:30:00,2019-03-31 21:45:00
66,1,1,0,0.006298898864480939,2019-03-31 21:30:00,2019-03-31 21:45:00
67,3,1,2,0.00592167335335974,2019-03-31 21:30:00,2019-03-31 21:45:00
68,3,2,1,0.011036549528198195,2019-03-31 21:30:00,2019-03-31 21:45:00
79,1,1,0,0.006298898864480939,2019-03-31 21:30:00,2019-03-31 21:45:00
80,4,2,2,0.022640729298137933,2019-03-31 21:30:00,2019-03-31 21:45:00
86,1,0,1,0.0034046447836246206,2019-03-31 21:30:00,2019-03-31 21:45:00
87,3,0,3,0.0034046447836246206,2019-03-31 21:30:00,2019-03-31 21:45:00
88,1,0,1,0.0034046447836246206,2019-03-31 21:30:00,2019-03-31 21:45:00
89,10,6,4,0.019590403546824793,2019-03-31 21:30:00,2019-03-31 21:45:00
90,5,5,0,0.009662980375838064,2019-03-31 21:30:00,2019-03-31 21:45:00
108,5,2,3,0.007858393906833816,2019-03-31 21:30:00,2019-03-31 21:45:00
109,14,5,9,0.007635968837053982,2019-03-31 21:30:00,2019-03-31 21:45:00
111,2,1,1,0.006298898864480939,2019-03-31 21:30:00,2019-03-31 21:45:00
112,2,0,2,0.0034046447836246206,2019-03-31 21:30:00,2019-03-31 21:45:00
114,1,0,1,0.0034046447836246206,2019-03-31 21:30:00,2019-03-31 21:45:00
118,2,1,1,0.004125915858937493,2019-03-31 21:30:00,2019-03-31 21:45:00
119,4,1,3,0.004750884535802494,2019-03-31 21:30:00,2019-03-31 21:45:00
120,1,1,0,0.004750884535802494,2019-03-31 21:30:00,2019-03-31 21:45:00
122,2,2,0,0.0055730428993656525,2019-03-31 21:30:00,2019-03-31 21:45:00
126,2,1,1,0.00485177182405278,2019-03-31 21:30:00,2019-03-31 21:45:00
127,2,1,1,0.022640729298137933,2019-03-31 21:30:00,2019-03-31 21:45:00
129,2,0,2,0.0034046447836246206,2019-03-31 21:30:00,2019-03-31 21:45:00
137,2,0,2,0.0034046447836246206,2019-03-31 21:30:00,2019-03-31 21:45:00
138,4,3,1,0.05665914920395537,2019-03-31 21:30:00,2019-03-31 21:45:00
140,2,0,2,0.0034046447836246206,2019-03-31 21:30:00,2019-03-31 21:45:00
141,1,1,0,0.00485177182405278,2019-03-31 21:30:00,2019-03-31 21:45:00
147,2,1,1,0.00485177182405278,2019-03-31 21:30:00,2019-03-31 21:45:00
153,1,1,0,0.004323489552207824,2019-03-31 21:30:00,2019-03-31 21:45:00
157,1,1,0,0.005631519345229218,2019-03-31 21:30:00,2019-03-31 21:45:00
158,5,2,3,0.007858393906833816,2019-03-31 21:30:00,2019-03-31 21:45:00
159,1,1,0,0.00592167335335974,2019-03-31 21:30:00,2019-03-31 21:45:00
162,1,0,1,0.0034046447836246206,2019-03-31 21:30:00,2019-03-31 21:45:00
164,4,1,3,0.008759331819561698,2019-03-31 21:30:00,2019-03-31 21:45:00
168,8,4,4,0.022640729298137933,2019-03-31 21:30:00,2019-03-31 21:45:00
170,3,1,2,0.00592167335335974,2019-03-31 21:30:00,2019-03-31 21:45:00
173,1,1,0,0.006298898864480939,2019-03-31 21:30:00,2019-03-31 21:45:00
177,3,2,1,0.04187681381265126,2019-03-31 21:30:00,2019-03-31 21:45:00
191,1,1,0,0.007529115342021319,2019-03-31 21:30:00,2019-03-31 21:45:00
197,1,1,0,0.004323489552207824,2019-03-31 21:30:00,2019-03-31 21:45:00
203,4,4,0,0.014626147947392445,2019-03-31 21:30:00,2019-03-31 21:45:00
1,4,2,2,0.02333508737078641,2019-03-31 21:45:00,2019-03-31 22:00:00
2,2,2,0,0.008397373231197406,2019-03-31 21:45:00,2019-03-31 22:00:00
5,1,0,1,0.003510316390262461,2019-03-31 21:45:00,2019-03-31 22:00:00
10,4,3,1,0.04717297827643207,2019-03-31 21:45:00,2019-03-31 22:00:00
15,1,1,0,0.008936851030701902,2019-03-31 21:45:00,2019-03-31 22:00:00
16,3,1,2,0.005636552046038443,2019-03-31 21:45:00,2019-03-31 22:00:00
18,3,1,2,0.005002355614362373,2019-03-31 21:45:00,2019-03-31 22:00:00
20,2,0,2,0.003510316390262461,2019-03-31 21:45:00,2019-03-31 22:00:00
26,2,1,1,0.0064943948384622845,2019-03-31 21:45:00,2019-03-31 22:00:00
35,1,1,0,0.0064943948384622845,2019-03-31 21:45:00,2019-03-31 22:00:00
37,1,1,0,0.011187777301258521,2019-03-31 21:45:00,2019-03-31 22:00:00
41,3,0,3,0.003510316390262461,2019-03-31 21:45:00,2019-03-31 22:00:00
57,3,2,1,0.029943344364294393,2019-03-31 21:45:00,2019-03-31 22:00:00
58,1,1,0,0.0064943948384622845,2019-03-31 21:45:00,2019-03-31 22:00:00
61,1,1,0,0.005636552046038443,2019-03-31 21:45:00,2019-03-31 22:00:00
62,1,0,1,0.003510316390262461,2019-03-31 21:45:00,2019-03-31 22:00:00
64,1,1,0,0.003983996691770696,2019-03-31 21:45:00,2019-03-31 22:00:00
66,1,0,1,0.003510316390262461,2019-03-31 21:45:00,2019-03-31 22:00:00
67,1,0,1,0.003510316390262461,2019-03-31 21:45:00,2019-03-31 22:00:00
68,2,1,1,0.009031180565166566,2019-03-31 21:45:00,2019-03-31 22:00:00
69,2,2,0,0.011187777301258521,2019-03-31 21:45:00,2019-03-31 22:00:00
74,3,1,2,0.009031180565166566,2019-03-31 21:45:00,2019-03-31 22:00:00
75,2,1,1,0.02333508737078641,2019-03-31 21:45:00,2019-03-31 22:00:00
79,1,1,0,0.0064943948384622845,2019-03-31 21:45:00,2019-03-31 22:00:00
80,4,2,2,0.02333508737078641,2019-03-31 21:45:00,2019-03-31 22:00:00
86,1,0,1,0.003510316390262461,2019-03-31 21:45:00,2019-03-31 22:00:00
88,1,1,0,0.005636552046038443,2019-03-31 21:45:00,2019-03-31 22:00:00
89,6,2,4,0.011497249401977609,2019-03-31 21:45:00,2019-03-31 22:00:00
90,4,4,0,0.01143522194733633,2019-03-31 21:45:00,2019-03-31 22:00:00
108,1,0,1,0.003510316390262461,2019-03-31 21:45:00,2019-03-31 22:00:00
109,10,2,8,0.004457676993278932,2019-03-31 21:45:00,2019-03-31 22:00:00
111,2,1,1,0.0059538448107299335,2019-03-31 21:45:00,2019-03-31 22:00:00
112,1,0,1,0.003510316390262461,2019-03-31 21:45:00,2019-03-31 22:00:00
116,1,1,0,0.005636552046038443,2019-03-31 21:45:00,2019-03-31 22:00:00
118,1,1,0,0.003983996691770696,2019-03-31 21:45:00,2019-03-31 22:00:00
122,1,1,0,0.003983996691770696,2019-03-31 21:45:00,2019-03-31 22:00:00
126,3,1,2,0.004505009206329069,2019-03-31 21:45:00,2019-03-31 22:00:00
127,5,3,2,0.012766524721136485,2019-03-31 21:45:00,2019-03-31 22:00:00
138,1,1,0,0.0064943948384622845,2019-03-31 21:45:00,2019-03-31 22:00:00
140,3,2,1,0.008301936885837413,2019-03-31 21:45:00,2019-03-31 22:00:00
141,1,1,0,0.01056784048800942,2019-03-31 21:45:00,2019-03-31 22:00:00
147,2,1,1,0.0064943948384622845,2019-03-31 21:45:00,2019-03-31 22:00:00
158,1,1,0,0.003983996691770696,2019-03-31 21:45:00,2019-03-31 22:00:00
159,1,1,0,0.0064943948384622845,2019-03-31 21:45:00,2019-03-31 22:00:00
164,5,2,3,0.014092632266659341,2019-03-31 21:45:00,2019-03-31 22:00:00
168,4,2,2,0.02333508737078641,2019-03-31 21:45:00,2019-03-31 22:00:00
170,1,0,1,0.003510316390262461,2019-03-31 21:45:00,2019-03-31 22:00:00
173,2,1,1,0.0064943948384622845,2019-03-31 21:45:00,2019-03-31 22:00:00
177,3,1,2,0.006105453458648747,2019-03-31 21:45:00,2019-03-31 22:00:00
189,1,0,1,0.003510316390262461,2019-03-31 21:45:00,2019-03-31 22:00:00
191,3,1,2,0.005002355614362373,2019-03-31 21:45:00,2019-03-31 22:00:00
203,1,1,0,0.0059538448107299335,2019-03-31 21:45:00,2019-03-31 22:00:00
10,5,2,3,0.011386006041382304,2019-03-31 22:00:00,2019-03-31 22:15:00
15,3,3,0,0.009706130608822439,2019-03-31 22:00:00,2019-03-31 22:15:00
16,1,1,0,0.00442247145282911,2019-03-31 22:00:00,2019-03-31 22:15:00
18,1,0,1,0.0034460001582163192,2019-03-31 22:00:00,2019-03-31 22:15:00
23,1,0,1,0.0034460001582163192,2019-03-31 22:00:00,2019-03-31 22:15:00
26,1,0,1,0.0034460001582163192,2019-03-31 22:00:00,2019-03-31 22:15:00
41,3,2,1,0.009899125393008286,2019-03-31 22:00:00,2019-03-31 22:15:00
46,3,3,0,0.009304827925893065,2019-03-31 22:00:00,2019-03-31 22:15:00
57,5,4,1,0.09833169978940098,2019-03-31 22:00:00,2019-03-31 22:15:00
58,1,1,0,0.0038473028411456925,2019-03-31 22:00:00,2019-03-31 22:15:00
61,1,1,0,0.0063754140420546924,2019-03-31 22:00:00,2019-03-31 22:15:00
62,2,0,2,0.0034460001582163192,2019-03-31 22:00:00,2019-03-31 22:15:00
64,1,1,0,0.0038473028411456925,2019-03-31 22:00:00,2019-03-31 22:15:00
74,2,1,1,0.0063754140420546924,2019-03-31 22:00:00,2019-03-31 22:15:00
80,4,2,2,0.02293294814134148,2019-03-31 22:00:00,2019-03-31 22:15:00
88,1,1,0,0.0063754140420546924,2019-03-31 22:00:00,2019-03-31 22:15:00
89,2,1,1,0.0063754140420546924,2019-03-31 22:00:00,2019-03-31 22:15:00
104,2,0,2,0.0034460001582163192,2019-03-31 22:00:00,2019-03-31 22:15:00
108,2,1,1,0.008865745842206459,2019-03-31 22:00:00,2019-03-31 22:15:00
109,11,2,9,0.004248605524075066,2019-03-31 22:00:00,2019-03-31 22:15:00
110,1,1,0,0.00442247145282911,2019-03-31 22:00:00,2019-03-31 22:15:00
111,2,1,1,0.008865745842206459,2019-03-31 22:00:00,2019-03-31 22:15:00
112,1,0,1,0.0034460001582163192,2019-03-31 22:00:00,2019-03-31 22:15:00
118,2,1,1,0.0038473028411456925,2019-03-31 22:00:00,2019-03-31 22:15:00
120,2,0,2,0.0034460001582163192,2019-03-31 22:00:00,2019-03-31 22:15:00
122,1,1,0,0.0038473028411456925,2019-03-31 22:00:00,2019-03-31 22:15:00
127,1,0,1,0.0034460001582163192,2019-03-31 22:00:00,2019-03-31 22:15:00
137,3,0,3,0.0034460001582163192,2019-03-31 22:00:00,2019-03-31 22:15:00
138,2,1,1,0.010982874962346262,2019-03-31 22:00:00,2019-03-31 22:15:00
140,2,1,1,0.024159947030671928,2019-03-31 22:00:00,2019-03-31 22:15:00
141,3,2,1,0.024375141054477665,2019-03-31 22:00:00,2019-03-31 22:15:00
153,1,0,1,0.0034460001582163192,2019-03-31 22:00:00,2019-03-31 22:15:00
158,1,1,0,0.0038473028411456925,2019-03-31 22:00:00,2019-03-31 22:15:00
164,2,2,0,0.013912288846184635,2019-03-31 22:00:00,2019-03-31 22:15:00
168,3,2,1,0.029428597469049866,2019-03-31 22:00:00,2019-03-31 22:15:00
171,1,1,0,0.006716569173317686,2019-03-31 22:00:00,2019-03-31 22:15:00
172,1,1,0,0.012782799780771549,2019-03-31 22:00:00,2019-03-31 22:15:00
173,1,0,1,0.0034460001582163192,2019-03-31 22:00:00,2019-03-31 22:15:00
177,5,3,2,0.011088857307824697,2019-03-31 22:00:00,2019-03-31 22:15:00
191,1,0,1,0.0034460001582163192,2019-03-31 22:00:00,2019-03-31 22:15:00
201,2,1,1,0.02293294814134148,2019-03-31 22:00:00,2019-03-31 22:15:00
1,1,0,1,0.0034667197353946545,2019-03-31 22:15:00,2019-03-31 22:30:00
10,2,0,2,0.0034667197353946545,2019-03-31 22:15:00,2019-03-31 22:30:00
15,4,3,1,0.006881549710283893,2019-03-31 22:15:00,2019-03-31 22:30:00
16,1,0,1,0.0034667197353946545,2019-03-31 22:15:00,2019-03-31 22:30:00
20,1,0,1,0.0034667197353946545,2019-03-31 22:15:00,2019-03-31 22:30:00
23,2,0,2,0.0034667197353946545,2019-03-31 22:15:00,2019-03-31 22:30:00
41,3,3,0,0.009360778779060235,2019-03-31 22:15:00,2019-03-31 22:30:00
46,3,1,2,0.0049402344963110495,2019-03-31 22:15:00,2019-03-31 22:30:00
57,5,4,1,0.04578548091253039,2019-03-31 22:15:00,2019-03-31 22:30:00
58,5,2,3,0.005490296308372909,2019-03-31 22:15:00,2019-03-31 22:30:00
62,2,0,2,0.0034667197353946545,2019-03-31 22:15:00,2019-03-31 22:30:00
64,3,2,1,0.026181775684151372,2019-03-31 22:15:00,2019-03-31 22:30:00
80,4,2,2,0.023070424963773678,2019-03-31 22:15:00,2019-03-31 22:30:00
89,1,1,0,0.007736361043850681,2019-03-31 22:15:00,2019-03-31 22:30:00
90,2,2,0,0.019661937465093156,2019-03-31 22:15:00,2019-03-31 22:30:00
109,10,2,8,0.00440232064150755,2019-03-31 22:15:00,2019-03-31 22:30:00
111,1,0,1,0.0034667197353946545,2019-03-31 22:15:00,2019-03-31 22:30:00
112,2,1,1,0.005022495855316462,2019-03-31 22:15:00,2019-03-31 22:30:00
113,1,1,0,0.0049402344963110495,2019-03-31 22:15:00,2019-03-31 22:30:00
114,1,1,0,0.006413749257227445,2019-03-31 22:15:00,2019-03-31 22:30:00
115,1,0,1,0.0034667197353946545,2019-03-31 22:15:00,2019-03-31 22:30:00
116,1,1,0,0.0049402344963110495,2019-03-31 22:15:00,2019-03-31 22:30:00
118,1,1,0,0.003934520188451102,2019-03-31 22:15:00,2019-03-31 22:30:00
119,2,0,2,0.0034667197353946545,2019-03-31 22:15:00,2019-03-31 22:30:00
120,2,0,2,0.0034667197353946545,2019-03-31 22:15:00,2019-03-31 22:30:00
122,2,1,1,0.003934520188451102,2019-03-31 22:15:00,2019-03-31 22:30:00
126,1,0,1,0.0034667197353946545,2019-03-31 22:15:00,2019-03-31 22:30:00
137,3,2,1,0.009360778779060235,2019-03-31 22:15:00,2019-03-31 22:30:00
138,1,0,1,0.0034667197353946545,2019-03-31 22:15:00,2019-03-31 22:30:00
140,1,1,0,0.006413749257227445,2019-03-31 22:15:00,2019-03-31 22:30:00
141,1,0,1,0.0034667197353946545,2019-03-31 22:15:00,2019-03-31 22:30:00
153,2,0,2,0.0034667197353946545,2019-03-31 22:15:00,2019-03-31 22:30:00
164,6,5,1,0.0151162390413529,2019-03-31 22:15:00,2019-03-31 22:30:00
168,3,2,1,0.07598748160524518,2019-03-31 22:15:00,2019-03-31 22:30:00
172,1,1,0,0.009316745549612974,2019-03-31 22:15:00,2019-03-31 22:30:00
177,4,3,1,0.04267413019215271,2019-03-31 22:15:00,2019-03-31 22:30:00
196,1,1,0,0.0049402344963110495,2019-03-31 22:15:00,2019-03-31 22:30:00
199,1,1,0,0.006413749257227445,2019-03-31 22:15:00,2019-03-31 22:30:00
201,2,1,1,0.023070424963773678,2019-03-31 22:15:00,2019-03-31 22:30:00
1,1,1,0,0.009589756566072331,2019-03-31 22:30:00,2019-03-31 22:45:00
10,1,1,0,0.007507817307750234,2019-03-31 22:30:00,2019-03-31 22:45:00
15,4,0,4,0.004336900847931409,2019-03-31 22:30:00,2019-03-31 22:45:00
16,1,0,1,0.004336900847931409,2019-03-31 22:30:00,2019-03-31 22:45:00
18,1,1,0,0.013817290739101571,2019-03-31 22:30:00,2019-03-31 22:45:00
20,2,0,2,0.004336900847931409,2019-03-31 22:30:00,2019-03-31 22:45:00
41,2,1,1,0.00618014235652211,2019-03-31 22:30:00,2019-03-31 22:45:00
46,3,0,3,0.004336900847931409,2019-03-31 22:30:00,2019-03-31 22:45:00
58,3,1,2,0.007529532849149213,2019-03-31 22:30:00,2019-03-31 22:45:00
64,1,1,0,0.0060512507171814655,2019-03-31 22:30:00,2019-03-31 22:45:00
66,1,1,0,0.00556572852032521,2019-03-31 22:30:00,2019-03-31 22:45:00
90,3,3,0,0.012865668102355631,2019-03-31 22:30:00,2019-03-31 22:45:00
109,4,1,3,0.0060512507171814655,2019-03-31 22:30:00,2019-03-31 22:45:00
110,2,1,1,0.011156129267031852,2019-03-31 22:30:00,2019-03-31 22:45:00
111,1,0,1,0.004336900847931409,2019-03-31 22:30:00,2019-03-31 22:45:00
113,1,1,0,0.00802338386511281,2019-03-31 22:30:00,2019-03-31 22:45:00
114,1,1,0,0.007529532849149213,2019-03-31 22:30:00,2019-03-31 22:45:00
116,1,1,0,0.00618014235652211,2019-03-31 22:30:00,2019-03-31 22:45:00
118,1,1,0,0.0060512507171814655,2019-03-31 22:30:00,2019-03-31 22:45:00
119,1,0,1,0.004336900847931409,2019-03-31 22:30:00,2019-03-31 22:45:00
120,1,1,0,0.005258521602226759,2019-03-31 22:30:00,2019-03-31 22:45:00
126,2,1,1,0.00618014235652211,2019-03-31 22:30:00,2019-03-31 22:45:00
137,2,1,1,0.00802338386511281,2019-03-31 22:30:00,2019-03-31 22:45:00
138,3,1,2,0.007529532849149213,2019-03-31 22:30:00,2019-03-31 22:45:00
153,2,0,2,0.004336900847931409,2019-03-31 22:30:00,2019-03-31 22:45:00
154,3,1,2,0.01102242659376493,2019-03-31 22:30:00,2019-03-31 22:45:00
157,1,1,0,0.007507817307750234,2019-03-31 22:30:00,2019-03-31 22:45:00
162,2,2,0,0.013707985286578257,2019-03-31 22:30:00,2019-03-31 22:45:00
164,6,4,2,0.015733894928041333,2019-03-31 22:30:00,2019-03-31 22:45:00
168,5,2,3,0.011194300324931634,2019-03-31 22:30:00,2019-03-31 22:45:00
171,1,1,0,0.007529532849149213,2019-03-31 22:30:00,2019-03-31 22:45:00
172,2,1,1,0.005258521602226759,2019-03-31 22:30:00,2019-03-31 22:45:00
189,1,0,1,0.004336900847931409,2019-03-31 22:30:00,2019-03-31 22:45:00
191,1,1,0,0.00618014235652211,2019-03-31 22:30:00,2019-03-31 22:45:00
199,1,1,0,0.008806570215592571,2019-03-31 22:30:00,2019-03-31 22:45:00
1,2,2,0,0.01614863055891951,2019-03-31 22:45:00,2019-03-31 23:00:00
10,1,1,0,0.007389535976686505,2019-03-31 22:45:00,2019-03-31 23:00:00
11,1,1,0,0.007894976330003791,2019-03-31 22:45:00,2019-03-31 23:00:00
15,1,0,1,0.004267365909939658,2019-03-31 22:45:00,2019-03-31 23:00:00
18,3,2,1,0.015045616795991283,2019-03-31 22:45:00,2019-03-31 23:00:00
20,1,0,1,0.004267365909939658,2019-03-31 22:45:00,2019-03-31 23:00:00
41,1,0,1,0.004267365909939658,2019-03-31 22:45:00,2019-03-31 23:00:00
46,4,0,4,0.004267365909939658,2019-03-31 22:45:00,2019-03-31 23:00:00
57,1,1,0,0.017037982107907315,2019-03-31 22:45:00,2019-03-31 23:00:00
58,3,1,2,0.0074223520509708475,2019-03-31 22:45:00,2019-03-31 23:00:00
64,1,1,0,0.00574743551004391,2019-03-31 22:45:00,2019-03-31 23:00:00
66,1,1,0,0.005174268514955691,2019-03-31 22:45:00,2019-03-31 23:00:00
80,1,0,1,0.004267365909939658,2019-03-31 22:45:00,2019-03-31 23:00:00
89,1,1,0,0.005174268514955691,2019-03-31 22:45:00,2019-03-31 23:00:00
108,1,1,0,0.010577338192002038,2019-03-31 22:45:00,2019-03-31 23:00:00
109,8,3,5,0.008707574710252415,2019-03-31 22:45:00,2019-03-31 23:00:00
110,1,0,1,0.004267365909939658,2019-03-31 22:45:00,2019-03-31 23:00:00
118,2,2,0,0.007984648718698972,2019-03-31 22:45:00,2019-03-31 23:00:00
120,1,1,0,0.007894976330003791,2019-03-31 22:45:00,2019-03-31 23:00:00
126,4,3,1,0.009708781540035858,2019-03-31 22:45:00,2019-03-31 23:00:00
138,2,1,1,0.0074223520509708475,2019-03-31 22:45:00,2019-03-31 23:00:00
141,2,1,1,0.007894976330003791,2019-03-31 22:45:00,2019-03-31 23:00:00
151,1,0,1,0.004267365909939658,2019-03-31 22:45:00,2019-03-31 23:00:00
153,1,0,1,0.004267365909939658,2019-03-31 22:45:00,2019-03-31 23:00:00
154,4,1,3,0.007894976330003791,2019-03-31 22:45:00,2019-03-31 23:00:00
157,1,1,0,0.007389535976686505,2019-03-31 22:45:00,2019-03-31 23:00:00
158,6,3,3,0.025280286467879828,2019-03-31 22:45:00,2019-03-31 23:00:00
159,1,1,0,0.007894976330003791,2019-03-31 22:45:00,2019-03-31 23:00:00
162,2,2,0,0.008741792327249783,2019-03-31 22:45:00,2019-03-31 23:00:00
164,1,0,1,0.004267365909939658,2019-03-31 22:45:00,2019-03-31 23:00:00
168,5,2,3,0.011017146396750638,2019-03-31 22:45:00,2019-03-31 23:00:00
170,1,0,1,0.004267365909939658,2019-03-31 22:45:00,2019-03-31 23:00:00
189,1,0,1,0.004267365909939658,2019-03-31 22:45:00,2019-03-31 23:00:00
191,1,1,0,0.007894976330003791,2019-03-31 22:45:00,2019-03-31 23:00:00
1,5,2,3,0.008890479673123664,2019-03-31 23:00:00,2019-03-31 23:15:00
10,1,1,0,0.005374873660440613,2019-03-31 23:00:00,2019-03-31 23:15:00
15,4,2,2,0.025598082899824286,2019-03-31 23:00:00,2019-03-31 23:15:00
18,3,1,2,0.00790983934625392,2019-03-31 23:00:00,2019-03-31 23:15:00
23,1,0,1,0.0038518202419665585,2019-03-31 23:00:00,2019-03-31 23:15:00
46,4,1,3,0.007126207694427582,2019-03-31 23:00:00,2019-03-31 23:15:00
57,2,2,0,0.010488332012869507,2019-03-31 23:00:00,2019-03-31 23:15:00
58,3,2,1,0.06581622076307872,2019-03-31 23:00:00,2019-03-31 23:15:00
64,1,1,0,0.005374873660440613,2019-03-31 23:00:00,2019-03-31 23:15:00
67,5,2,3,0.008890479673123664,2019-03-31 23:00:00,2019-03-31 23:15:00
68,1,1,0,0.004670417105081814,2019-03-31 23:00:00,2019-03-31 23:15:00
85,1,1,0,0.009984468400928797,2019-03-31 23:00:00,2019-03-31 23:15:00
88,1,1,0,0.007126207694427582,2019-03-31 23:00:00,2019-03-31 23:15:00
89,1,1,0,0.005871142440580816,2019-03-31 23:00:00,2019-03-31 23:15:00
104,2,2,0,0.008890479673123664,2019-03-31 23:00:00,2019-03-31 23:15:00
108,1,1,0,0.007126207694427582,2019-03-31 23:00:00,2019-03-31 23:15:00
109,4,1,3,0.005374873660440613,2019-03-31 23:00:00,2019-03-31 23:15:00
111,2,1,1,0.007213944560408483,2019-03-31 23:00:00,2019-03-31 23:15:00
112,2,1,1,0.00548901396819707,2019-03-31 23:00:00,2019-03-31 23:15:00
113,2,1,1,0.007126207694427582,2019-03-31 23:00:00,2019-03-31 23:15:00
115,1,0,1,0.0038518202419665585,2019-03-31 23:00:00,2019-03-31 23:15:00
116,1,0,1,0.0038518202419665585,2019-03-31 23:00:00,2019-03-31 23:15:00
118,2,2,0,0.006193470523555869,2019-03-31 23:00:00,2019-03-31 23:15:00
126,4,3,1,0.052410174808660566,2019-03-31 23:00:00,2019-03-31 23:15:00
137,1,0,1,0.0038518202419665585,2019-03-31 23:00:00,2019-03-31 23:15:00
138,1,0,1,0.0038518202419665585,2019-03-31 23:00:00,2019-03-31 23:15:00
141,2,2,0,0.008649261112901636,2019-03-31 23:00:00,2019-03-31 23:15:00
154,4,0,4,0.0038518202419665585,2019-03-31 23:00:00,2019-03-31 23:15:00
158,4,2,2,0.009547033072484432,2019-03-31 23:00:00,2019-03-31 23:15:00
162,2,2,0,0.00548901396819707,2019-03-31 23:00:00,2019-03-31 23:15:00
164,2,0,2,0.0038518202419665585,2019-03-31 23:00:00,2019-03-31 23:15:00
168,4,1,3,0.005374873660440613,2019-03-31 23:00:00,2019-03-31 23:15:00
170,1,0,1,0.0038518202419665585,2019-03-31 23:00:00,2019-03-31 23:15:00
171,1,1,0,0.008517997266118457,2019-03-31 23:00:00,2019-03-31 23:15:00
1,4,3,1,0.05052863908643201,2019-03-31 23:15:00,2019-03-31 23:30:00
5,3,1,2,0.00717622824043586,2019-03-31 23:15:00,2019-03-31 23:30:00
10,1,1,0,0.005757420042079357,2019-03-31 23:15:00,2019-03-31 23:30:00
15,4,2,2,0.027327306138781645,2019-03-31 23:15:00,2019-03-31 23:30:00
16,1,0,1,0.004125973191131275,2019-03-31 23:15:00,2019-03-31 23:30:00
18,1,0,1,0.004125973191131275,2019-03-31 23:15:00,2019-03-31 23:30:00
28,2,0,2,0.004125973191131275,2019-03-31 23:15:00,2019-03-31 23:30:00
41,1,1,0,0.00482745930164381,2019-03-31 23:15:00,2019-03-31 23:30:00
46,1,1,0,0.010615077698635497,2019-03-31 23:15:00,2019-03-31 23:30:00
57,1,1,0,0.007633403743693949,2019-03-31 23:15:00,2019-03-31 23:30:00
58,2,2,0,0.011737169087244932,2019-03-31 23:15:00,2019-03-31 23:30:00
61,1,1,0,0.007633403743693949,2019-03-31 23:15:00,2019-03-31 23:30:00
62,3,2,1,0.00717622824043586,2019-03-31 23:15:00,2019-03-31 23:30:00
64,1,1,0,0.00717622824043586,2019-03-31 23:15:00,2019-03-31 23:30:00
67,1,0,1,0.004125973191131275,2019-03-31 23:15:00,2019-03-31 23:30:00
68,1,1,0,0.007633403743693949,2019-03-31 23:15:00,2019-03-31 23:30:00
75,1,1,0,0.005757420042079357,2019-03-31 23:15:00,2019-03-31 23:30:00
104,1,1,0,0.007633403743693949,2019-03-31 23:15:00,2019-03-31 23:30:00
108,1,1,0,0.007633403743693949,2019-03-31 23:15:00,2019-03-31 23:30:00
109,3,1,2,0.00717622824043586,2019-03-31 23:15:00,2019-03-31 23:30:00
111,1,1,0,0.007633403743693949,2019-03-31 23:15:00,2019-03-31 23:30:00
112,1,1,0,0.00482745930164381,2019-03-31 23:15:00,2019-03-31 23:30:00
113,1,0,1,0.004125973191131275,2019-03-31 23:15:00,2019-03-31 23:30:00
115,3,2,1,0.007633403743693949,2019-03-31 23:15:00,2019-03-31 23:30:00
116,1,0,1,0.004125973191131275,2019-03-31 23:15:00,2019-03-31 23:30:00
122,1,1,0,0.00482745930164381,2019-03-31 23:15:00,2019-03-31 23:30:00
126,6,2,4,0.00717622824043586,2019-03-31 23:15:00,2019-03-31 23:30:00
127,1,1,0,0.007633403743693949,2019-03-31 23:15:00,2019-03-31 23:30:00
137,2,1,1,0.00717622824043586,2019-03-31 23:15:00,2019-03-31 23:30:00
138,1,0,1,0.004125973191131275,2019-03-31 23:15:00,2019-03-31 23:30:00
140,1,1,0,0.010226483289740447,2019-03-31 23:15:00,2019-03-31 23:30:00
141,1,1,0,0.007633403743693949,2019-03-31 23:15:00,2019-03-31 23:30:00
153,1,0,1,0.004125973191131275,2019-03-31 23:15:00,2019-03-31 23:30:00
154,1,0,1,0.004125973191131275,2019-03-31 23:15:00,2019-03-31 23:30:00
158,2,1,1,0.00482745930164381,2019-03-31 23:15:00,2019-03-31 23:30:00
164,5,0,5,0.004125973191131275,2019-03-31 23:15:00,2019-03-31 23:30:00
168,4,1,3,0.005757420042079357,2019-03-31 23:15:00,2019-03-31 23:30:00
170,1,0,1,0.004125973191131275,2019-03-31 23:15:00,2019-03-31 23:30:00
177,1,1,0,0.010226483289740447,2019-03-31 23:15:00,2019-03-31 23:30:00
191,2,0,2,0.004125973191131275,2019-03-31 23:15:00,2019-03-31 23:30:00
197,1,1,0,0.00482745930164381,2019-03-31 23:15:00,2019-03-31 23:30:00
1,2,2,0,0.007178381972442251,2019-03-31 23:30:00,2019-03-31 23:45:00
5,1,0,1,0.0038800168857159893,2019-03-31 23:30:00,2019-03-31 23:45:00
16,1,0,1,0.0038800168857159893,2019-03-31 23:30:00,2019-03-31 23:45:00
28,2,0,2,0.0038800168857159893,2019-03-31 23:30:00,2019-03-31 23:45:00
41,1,1,0,0.00552919942907912,2019-03-31 23:30:00,2019-03-31 23:45:00
46,1,1,0,0.007696041707048713,2019-03-31 23:30:00,2019-03-31 23:45:00
61,1,1,0,0.007178381972442251,2019-03-31 23:30:00,2019-03-31 23:45:00
62,1,0,1,0.0038800168857159893,2019-03-31 23:30:00,2019-03-31 23:45:00
67,1,0,1,0.0038800168857159893,2019-03-31 23:30:00,2019-03-31 23:45:00
68,1,1,0,0.007178381972442251,2019-03-31 23:30:00,2019-03-31 23:45:00
75,1,1,0,0.006748485680784783,2019-03-31 23:30:00,2019-03-31 23:45:00
90,1,0,1,0.0038800168857159893,2019-03-31 23:30:00,2019-03-31 23:45:00
108,5,3,2,0.04770646146789075,2019-03-31 23:30:00,2019-03-31 23:45:00
109,2,1,1,0.025793239176803366,2019-03-31 23:30:00,2019-03-31 23:45:00
112,1,0,1,0.0038800168857159893,2019-03-31 23:30:00,2019-03-31 23:45:00
113,1,1,0,0.007178381972442251,2019-03-31 23:30:00,2019-03-31 23:45:00
115,11,6,5,0.022442481257773147,2019-03-31 23:30:00,2019-03-31 23:45:00
126,2,1,1,0.025793239176803366,2019-03-31 23:30:00,2019-03-31 23:45:00
137,1,1,0,0.007178381972442251,2019-03-31 23:30:00,2019-03-31 23:45:00
138,1,0,1,0.0038800168857159893,2019-03-31 23:30:00,2019-03-31 23:45:00
141,6,4,2,0.06961968375897815,2019-03-31 23:30:00,2019-03-31 23:45:00
164,2,0,2,0.0038800168857159893,2019-03-31 23:30:00,2019-03-31 23:45:00
168,3,1,2,0.006748485680784783,2019-03-31 23:30:00,2019-03-31 23:45:00
170,1,0,1,0.0038800168857159893,2019-03-31 23:30:00,2019-03-31 23:45:00
177,1,1,0,0.007178381972442251,2019-03-31 23:30:00,2019-03-31 23:45:00
191,2,0,2,0.0038800168857159893,2019-03-31 23:30:00,2019-03-31 23:45:00
197,1,1,0,0.00552919942907912,2019-03-31 23:30:00,2019-03-31 23:45:00
1,1,0,1,0.004071716492607814,2019-03-31 23:45:00,2019-04-01 00:00:00
5,1,0,1,0.004071716492607814,2019-03-31 23:45:00,2019-04-01 00:00:00
16,1,0,1,0.004071716492607814,2019-03-31 23:45:00,2019-04-01 00:00:00
26,1,1,0,0.007533035036618858,2019-03-31 23:45:00,2019-04-01 00:00:00
61,1,1,0,0.007533035036618858,2019-03-31 23:45:00,2019-04-01 00:00:00
67,1,0,1,0.004071716492607814,2019-03-31 23:45:00,2019-04-01 00:00:00
68,1,1,0,0.007533035036618858,2019-03-31 23:45:00,2019-04-01 00:00:00
88,1,1,0,0.005802375764613336,2019-03-31 23:45:00,2019-04-01 00:00:00
108,2,1,1,0.02705267099263973,2019-03-31 23:45:00,2019-04-01 00:00:00
109,2,1,1,0.02705267099263973,2019-03-31 23:45:00,2019-04-01 00:00:00
110,1,0,1,0.004071716492607814,2019-03-31 23:45:00,2019-04-01 00:00:00
111,1,1,0,0.007533035036618858,2019-03-31 23:45:00,2019-04-01 00:00:00
112,1,0,1,0.004071716492607814,2019-03-31 23:45:00,2019-04-01 00:00:00
113,1,1,0,0.007533035036618858,2019-03-31 23:45:00,2019-04-01 00:00:00
114,1,0,1,0.004071716492607814,2019-03-31 23:45:00,2019-04-01 00:00:00
115,6,2,4,0.007081888041167954,2019-03-31 23:45:00,2019-04-01 00:00:00
120,1,1,0,0.007533035036618858,2019-03-31 23:45:00,2019-04-01 00:00:00
122,1,0,1,0.004071716492607814,2019-03-31 23:45:00,2019-04-01 00:00:00
137,1,1,0,0.007533035036618858,2019-03-31 23:45:00,2019-04-01 00:00:00
141,5,3,2,0.03854314824265568,2019-03-31 23:45:00,2019-04-01 00:00:00
153,2,2,0,0.007081888041167954,2019-03-31 23:45:00,2019-04-01 00:00:00
158,4,2,2,0.02705267099263973,2019-03-31 23:45:00,2019-04-01 00:00:00
164,1,1,0,0.007533035036618858,2019-03-31 23:45:00,2019-04-01 00:00:00
168,2,1,1,0.02705267099263973,2019-03-31 23:45:00,2019-04-01 00:00:00
170,2,0,2,0.004071716492607814,2019-03-31 23:45:00,2019-04-01 00:00:00
171,1,0,1,0.004071716492607814,2019-03-31 23:45:00,2019-04-01 00:00:00
201,1,1,0,0.007533035036618858,2019-03-31 23:45:00,2019-04-01 00:00:00
